trnOpDate,staCode,gateInComingCnt,gateOutGoingCnt,Total,stationName,Level
2020-01-01,900,7552,8154,15706,基隆,一等
2020-01-02,900,7709,7240,14949,基隆,一等
2020-01-03,900,8713,8086,16799,基隆,一等
2020-01-04,900,8625,8407,17032,基隆,一等
2020-01-05,900,8015,7355,15370,基隆,一等
2020-01-06,900,7484,7124,14608,基隆,一等
2020-01-07,900,7529,7401,14930,基隆,一等
2020-01-08,900,7382,7030,14412,基隆,一等
2020-01-09,900,7916,7405,15321,基隆,一等
2020-01-10,900,9695,8944,18639,基隆,一等
2020-01-11,900,8356,8012,16368,基隆,一等
2020-01-12,900,7257,6637,13894,基隆,一等
2020-01-13,900,7154,6913,14067,基隆,一等
2020-01-14,900,7744,7102,14846,基隆,一等
2020-01-15,900,6155,6775,12930,基隆,一等
2020-01-16,900,8447,7936,16383,基隆,一等
2020-01-17,900,7965,7454,15419,基隆,一等
2020-01-18,900,7634,7280,14914,基隆,一等
2020-01-19,900,6923,6636,13559,基隆,一等
2020-01-20,900,7889,7302,15191,基隆,一等
2020-01-21,900,8248,7650,15898,基隆,一等
2020-01-22,900,7840,7859,15699,基隆,一等
2020-01-23,900,6009,6158,12167,基隆,一等
2020-01-24,900,4827,5694,10521,基隆,一等
2020-01-25,900,8749,7894,16643,基隆,一等
2020-01-26,900,7832,7367,15199,基隆,一等
2020-01-27,900,8688,8039,16727,基隆,一等
2020-01-28,900,8107,8206,16313,基隆,一等
2020-01-29,900,7093,6639,13732,基隆,一等
2020-01-30,900,7138,6668,13806,基隆,一等
2020-01-31,900,7980,7600,15580,基隆,一等
2020-02-01,900,6499,6593,13092,基隆,一等
2020-02-02,900,6736,6422,13158,基隆,一等
2020-02-03,900,7046,6658,13704,基隆,一等
2020-02-04,900,6693,6260,12953,基隆,一等
2020-02-05,900,6393,5827,12220,基隆,一等
2020-02-06,900,6576,5939,12515,基隆,一等
2020-02-07,900,6381,5139,11520,基隆,一等
2020-02-08,900,4586,4332,8918,基隆,一等
2020-02-09,900,4446,4292,8738,基隆,一等
2020-02-10,900,6180,5795,11975,基隆,一等
2020-02-11,900,5999,5591,11590,基隆,一等
2020-02-12,900,6562,5875,12437,基隆,一等
2020-02-13,900,6172,5674,11846,基隆,一等
2020-02-14,900,6892,6184,13076,基隆,一等
2020-02-15,900,6012,5467,11479,基隆,一等
2020-02-16,900,4205,4045,8250,基隆,一等
2020-02-17,900,5489,5534,11023,基隆,一等
2020-02-18,900,5952,5603,11555,基隆,一等
2020-02-19,900,6360,5875,12235,基隆,一等
2020-02-20,900,6347,5709,12056,基隆,一等
2020-02-21,900,6873,6428,13301,基隆,一等
2020-02-22,900,5184,5109,10293,基隆,一等
2020-02-23,900,4841,4504,9345,基隆,一等
2020-02-24,900,6525,6220,12745,基隆,一等
2020-02-25,900,6775,6237,13012,基隆,一等
2020-02-26,900,6426,5832,12258,基隆,一等
2020-02-27,900,6899,6419,13318,基隆,一等
2020-02-28,900,6312,5790,12102,基隆,一等
2020-02-29,900,5747,5442,11189,基隆,一等
2020-03-01,900,5160,5098,10258,基隆,一等
2020-03-02,900,6129,5984,12113,基隆,一等
2020-03-03,900,6130,5607,11737,基隆,一等
2020-03-04,900,5837,5448,11285,基隆,一等
2020-03-05,900,6032,5552,11584,基隆,一等
2020-03-06,900,7257,6676,13933,基隆,一等
2020-03-07,900,5581,5376,10957,基隆,一等
2020-03-08,900,5261,5085,10346,基隆,一等
2020-03-09,900,6443,5855,12298,基隆,一等
2020-03-10,900,5870,5413,11283,基隆,一等
2020-03-11,900,6411,6098,12509,基隆,一等
2020-03-12,900,6221,5586,11807,基隆,一等
2020-03-13,900,7041,6276,13317,基隆,一等
2020-03-14,900,4855,4776,9631,基隆,一等
2020-03-15,900,5852,5632,11484,基隆,一等
2020-03-16,900,6300,6097,12397,基隆,一等
2020-03-17,900,6189,5678,11867,基隆,一等
2020-03-18,900,6011,5702,11713,基隆,一等
2020-03-19,900,5749,5265,11014,基隆,一等
2020-03-20,900,6941,6347,13288,基隆,一等
2020-03-21,900,5075,5019,10094,基隆,一等
2020-03-22,900,4866,4515,9381,基隆,一等
2020-03-23,900,5795,5447,11242,基隆,一等
2020-03-24,900,5751,5285,11036,基隆,一等
2020-03-25,900,5733,5445,11178,基隆,一等
2020-03-26,900,5938,5427,11365,基隆,一等
2020-03-27,900,6438,5974,12412,基隆,一等
2020-03-28,900,3688,3706,7394,基隆,一等
2020-03-29,900,4465,4299,8764,基隆,一等
2020-03-30,900,5799,5464,11263,基隆,一等
2020-03-31,900,6581,5124,11705,基隆,一等
2020-04-01,900,6769,5721,12490,基隆,一等
2020-04-02,900,4389,3879,8268,基隆,一等
2020-04-03,900,4181,3979,8160,基隆,一等
2020-04-04,900,3671,3226,6897,基隆,一等
2020-04-05,900,4173,3608,7781,基隆,一等
2020-04-06,900,5729,5675,11404,基隆,一等
2020-04-07,900,5387,4825,10212,基隆,一等
2020-04-08,900,5512,5101,10613,基隆,一等
2020-04-09,900,5507,5099,10606,基隆,一等
2020-04-10,900,6485,5888,12373,基隆,一等
2020-04-11,900,4156,4002,8158,基隆,一等
2020-04-12,900,3750,3702,7452,基隆,一等
2020-04-13,900,5684,5455,11139,基隆,一等
2020-04-14,900,5642,5228,10870,基隆,一等
2020-04-15,900,5791,5472,11263,基隆,一等
2020-04-16,900,5889,5454,11343,基隆,一等
2020-04-17,900,6790,6382,13172,基隆,一等
2020-04-18,900,5335,5197,10532,基隆,一等
2020-04-19,900,4931,4782,9713,基隆,一等
2020-04-20,900,6069,5644,11713,基隆,一等
2020-04-21,900,5633,5162,10795,基隆,一等
2020-04-22,900,5352,5040,10392,基隆,一等
2020-04-23,900,5469,4988,10457,基隆,一等
2020-04-24,900,6259,5802,12061,基隆,一等
2020-04-25,900,4113,4158,8271,基隆,一等
2020-04-26,900,3911,3936,7847,基隆,一等
2020-04-27,900,5734,5553,11287,基隆,一等
2020-04-28,900,5812,5366,11178,基隆,一等
2020-04-29,900,5961,5603,11564,基隆,一等
2020-04-30,900,6383,6001,12384,基隆,一等
2020-05-01,900,6593,6180,12773,基隆,一等
2020-05-02,900,5800,5556,11356,基隆,一等
2020-05-03,900,5428,5145,10573,基隆,一等
2020-05-04,900,6133,5871,12004,基隆,一等
2020-05-05,900,5934,5593,11527,基隆,一等
2020-05-06,900,6054,5708,11762,基隆,一等
2020-05-07,900,6135,5639,11774,基隆,一等
2020-05-08,900,7318,6635,13953,基隆,一等
2020-05-09,900,5954,5977,11931,基隆,一等
2020-05-10,900,5552,5203,10755,基隆,一等
2020-05-11,900,6156,5818,11974,基隆,一等
2020-05-12,900,5728,5510,11238,基隆,一等
2020-05-13,900,6401,6036,12437,基隆,一等
2020-05-14,900,6400,5921,12321,基隆,一等
2020-05-15,900,7663,7006,14669,基隆,一等
2020-05-16,900,5612,5350,10962,基隆,一等
2020-05-17,900,5527,5133,10660,基隆,一等
2020-05-18,900,6161,5883,12044,基隆,一等
2020-05-19,900,5642,5368,11010,基隆,一等
2020-05-20,900,6133,5806,11939,基隆,一等
2020-05-21,900,5989,5595,11584,基隆,一等
2020-05-22,900,6523,6276,12799,基隆,一等
2020-05-23,900,5048,4782,9830,基隆,一等
2020-05-24,900,6179,6115,12294,基隆,一等
2020-05-25,900,6352,6181,12533,基隆,一等
2020-05-26,900,6314,5756,12070,基隆,一等
2020-05-27,900,5921,5710,11631,基隆,一等
2020-05-28,900,5953,5559,11512,基隆,一等
2020-05-29,900,7435,6629,14064,基隆,一等
2020-05-30,900,6831,6505,13336,基隆,一等
2020-05-31,900,6905,6469,13374,基隆,一等
2020-06-01,900,6489,6228,12717,基隆,一等
2020-06-02,900,6530,5878,12408,基隆,一等
2020-06-03,900,6522,5994,12516,基隆,一等
2020-06-04,900,6612,6052,12664,基隆,一等
2020-06-05,900,7732,6981,14713,基隆,一等
2020-06-06,900,7223,7012,14235,基隆,一等
2020-06-07,900,6031,5758,11789,基隆,一等
2020-06-08,900,6503,6410,12913,基隆,一等
2020-06-09,900,6617,5994,12611,基隆,一等
2020-06-10,900,6918,6496,13414,基隆,一等
2020-06-11,900,6637,6262,12899,基隆,一等
2020-06-12,900,7866,7446,15312,基隆,一等
2020-06-13,900,7934,7594,15528,基隆,一等
2020-06-14,900,6977,6515,13492,基隆,一等
2020-06-15,900,6799,6254,13053,基隆,一等
2020-06-16,900,7124,6583,13707,基隆,一等
2020-06-17,900,6566,6085,12651,基隆,一等
2020-06-18,900,6789,6467,13256,基隆,一等
2020-06-19,900,7381,6776,14157,基隆,一等
2020-06-20,900,7601,7244,14845,基隆,一等
2020-06-21,900,6480,5945,12425,基隆,一等
2020-06-22,900,7047,6604,13651,基隆,一等
2020-06-23,900,7064,6495,13559,基隆,一等
2020-06-24,900,7931,7840,15771,基隆,一等
2020-06-25,900,7388,7577,14965,基隆,一等
2020-06-26,900,9534,8591,18125,基隆,一等
2020-06-27,900,9079,8443,17522,基隆,一等
2020-06-28,900,7554,6701,14255,基隆,一等
2020-06-29,900,7123,6925,14048,基隆,一等
2020-06-30,900,6944,6444,13388,基隆,一等
2020-07-01,900,6569,6051,12620,基隆,一等
2020-07-02,900,6456,6242,12698,基隆,一等
2020-07-03,900,7310,6973,14283,基隆,一等
2020-07-04,900,7359,7046,14405,基隆,一等
2020-07-05,900,6590,6376,12966,基隆,一等
2020-07-06,900,6944,6616,13560,基隆,一等
2020-07-07,900,7015,6597,13612,基隆,一等
2020-07-08,900,6753,6424,13177,基隆,一等
2020-07-09,900,7156,6656,13812,基隆,一等
2020-07-10,900,8270,7792,16062,基隆,一等
2020-07-11,900,7827,7763,15590,基隆,一等
2020-07-12,900,7410,6709,14119,基隆,一等
2020-07-13,900,7343,6903,14246,基隆,一等
2020-07-14,900,7355,7140,14495,基隆,一等
2020-07-15,900,7498,6854,14352,基隆,一等
2020-07-16,900,7501,7159,14660,基隆,一等
2020-07-17,900,8501,7722,16223,基隆,一等
2020-07-18,900,8144,7728,15872,基隆,一等
2020-07-19,900,7459,6745,14204,基隆,一等
2020-07-20,900,7548,7083,14631,基隆,一等
2020-07-21,900,7380,6541,13921,基隆,一等
2020-07-22,900,7558,7079,14637,基隆,一等
2020-07-23,900,7693,7069,14762,基隆,一等
2020-07-24,900,8465,7819,16284,基隆,一等
2020-07-25,900,7608,7389,14997,基隆,一等
2020-07-26,900,7058,6854,13912,基隆,一等
2020-07-27,900,7406,6865,14271,基隆,一等
2020-07-28,900,7313,6704,14017,基隆,一等
2020-07-29,900,7425,7137,14562,基隆,一等
2020-07-30,900,7691,7020,14711,基隆,一等
2020-07-31,900,8234,7899,16133,基隆,一等
2020-08-01,900,8340,8141,16481,基隆,一等
2020-08-02,900,7209,6378,13587,基隆,一等
2020-08-03,900,5992,5366,11358,基隆,一等
2020-08-04,900,6568,6405,12973,基隆,一等
2020-08-05,900,7230,6918,14148,基隆,一等
2020-08-06,900,7438,6796,14234,基隆,一等
2020-08-07,900,8217,7522,15739,基隆,一等
2020-08-08,900,7162,7216,14378,基隆,一等
2020-08-09,900,7654,7109,14763,基隆,一等
2020-08-10,900,7431,6772,14203,基隆,一等
2020-08-11,900,6853,6289,13142,基隆,一等
2020-08-12,900,7451,7124,14575,基隆,一等
2020-08-13,900,7536,7195,14731,基隆,一等
2020-08-14,900,8202,7787,15989,基隆,一等
2020-08-15,900,8399,8073,16472,基隆,一等
2020-08-16,900,8083,7657,15740,基隆,一等
2020-08-17,900,7530,7104,14634,基隆,一等
2020-08-18,900,7635,6918,14553,基隆,一等
2020-08-19,900,7676,7240,14916,基隆,一等
2020-08-20,900,7595,6971,14566,基隆,一等
2020-08-21,900,8384,7818,16202,基隆,一等
2020-08-22,900,7231,7216,14447,基隆,一等
2020-08-23,900,6961,6461,13422,基隆,一等
2020-08-24,900,7529,7157,14686,基隆,一等
2020-08-25,900,7678,7079,14757,基隆,一等
2020-08-26,900,7834,7327,15161,基隆,一等
2020-08-27,900,6899,6522,13421,基隆,一等
2020-08-28,900,8301,7708,16009,基隆,一等
2020-08-29,900,7130,6941,14071,基隆,一等
2020-08-30,900,7083,6560,13643,基隆,一等
2020-08-31,900,6520,6247,12767,基隆,一等
2020-09-01,900,6789,6789,13578,基隆,一等
2020-09-02,900,7093,6999,14092,基隆,一等
2020-09-03,900,6752,6619,13371,基隆,一等
2020-09-04,900,8186,7722,15908,基隆,一等
2020-09-05,900,7872,7418,15290,基隆,一等
2020-09-06,900,7208,6906,14114,基隆,一等
2020-09-07,900,7002,7143,14145,基隆,一等
2020-09-08,900,7113,6655,13768,基隆,一等
2020-09-09,900,7592,7067,14659,基隆,一等
2020-09-10,900,7194,6820,14014,基隆,一等
2020-09-11,900,8322,7989,16311,基隆,一等
2020-09-12,900,7205,6797,14002,基隆,一等
2020-09-13,900,6282,6278,12560,基隆,一等
2020-09-14,900,6850,6722,13572,基隆,一等
2020-09-15,900,6827,6416,13243,基隆,一等
2020-09-16,900,7218,6795,14013,基隆,一等
2020-09-17,900,7011,6590,13601,基隆,一等
2020-09-18,900,8646,7962,16608,基隆,一等
2020-09-19,900,7951,7917,15868,基隆,一等
2020-09-20,900,6896,7013,13909,基隆,一等
2020-09-21,900,6800,6840,13640,基隆,一等
2020-09-22,900,7268,6826,14094,基隆,一等
2020-09-23,900,7764,7176,14940,基隆,一等
2020-09-24,900,7238,6517,13755,基隆,一等
2020-09-25,900,8031,7355,15386,基隆,一等
2020-09-26,900,7634,7443,15077,基隆,一等
2020-09-27,900,5498,5743,11241,基隆,一等
2020-09-28,900,6965,6762,13727,基隆,一等
2020-09-29,900,7434,6822,14256,基隆,一等
2020-09-30,900,9705,8995,18700,基隆,一等
2020-10-01,900,8845,8439,17284,基隆,一等
2020-10-02,900,10773,9912,20685,基隆,一等
2020-10-03,900,9912,9599,19511,基隆,一等
2020-10-04,900,8800,8302,17102,基隆,一等
2020-10-05,900,6914,6776,13690,基隆,一等
2020-10-06,900,6853,6559,13412,基隆,一等
2020-10-07,900,7370,7010,14380,基隆,一等
2020-10-08,900,8713,7896,16609,基隆,一等
2020-10-09,900,10224,9968,20192,基隆,一等
2020-10-10,900,8893,8588,17481,基隆,一等
2020-10-11,900,7363,7671,15034,基隆,一等
2020-10-12,900,6978,6618,13596,基隆,一等
2020-10-13,900,6626,6447,13073,基隆,一等
2020-10-14,900,7355,7076,14431,基隆,一等
2020-10-15,900,7390,6738,14128,基隆,一等
2020-10-16,900,8519,7953,16472,基隆,一等
2020-10-17,900,7527,7085,14612,基隆,一等
2020-10-18,900,7168,7099,14267,基隆,一等
2020-10-19,900,7175,6912,14087,基隆,一等
2020-10-20,900,7091,6637,13728,基隆,一等
2020-10-21,900,7001,6460,13461,基隆,一等
2020-10-22,900,7101,6626,13727,基隆,一等
2020-10-23,900,8250,7684,15934,基隆,一等
2020-10-24,900,8331,8390,16721,基隆,一等
2020-10-25,900,7745,7567,15312,基隆,一等
2020-10-26,900,7473,7435,14908,基隆,一等
2020-10-27,900,7499,7102,14601,基隆,一等
2020-10-28,900,7335,7043,14378,基隆,一等
2020-10-29,900,7396,6653,14049,基隆,一等
2020-10-30,900,8716,8110,16826,基隆,一等
2020-10-31,900,8165,7905,16070,基隆,一等
2020-11-01,900,8063,7635,15698,基隆,一等
2020-11-02,900,7130,6882,14012,基隆,一等
2020-11-03,900,6836,6478,13314,基隆,一等
2020-11-04,900,6972,6655,13627,基隆,一等
2020-11-05,900,7373,6503,13876,基隆,一等
2020-11-06,900,8190,7874,16064,基隆,一等
2020-11-07,900,7902,7501,15403,基隆,一等
2020-11-08,900,6442,5991,12433,基隆,一等
2020-11-09,900,7147,6786,13933,基隆,一等
2020-11-10,900,6902,6597,13499,基隆,一等
2020-11-11,900,7211,6742,13953,基隆,一等
2020-11-12,900,7509,6703,14212,基隆,一等
2020-11-13,900,8500,7908,16408,基隆,一等
2020-11-14,900,7745,7952,15697,基隆,一等
2020-11-15,900,8158,8149,16307,基隆,一等
2020-11-16,900,7447,7195,14642,基隆,一等
2020-11-17,900,7318,7039,14357,基隆,一等
2020-11-18,900,7685,7578,15263,基隆,一等
2020-11-19,900,8054,7592,15646,基隆,一等
2020-11-20,900,8957,7947,16904,基隆,一等
2020-11-21,900,7728,7379,15107,基隆,一等
2020-11-22,900,7921,7389,15310,基隆,一等
2020-11-23,900,7143,6702,13845,基隆,一等
2020-11-24,900,6932,6589,13521,基隆,一等
2020-11-25,900,7378,7069,14447,基隆,一等
2020-11-26,900,7703,6950,14653,基隆,一等
2020-11-27,900,8558,7832,16390,基隆,一等
2020-11-28,900,7199,6995,14194,基隆,一等
2020-11-29,900,6267,6244,12511,基隆,一等
2020-11-30,900,6952,6748,13700,基隆,一等
2020-12-01,900,6457,6008,12465,基隆,一等
2020-12-02,900,6789,6263,13052,基隆,一等
2020-12-03,900,6792,6306,13098,基隆,一等
2020-12-04,900,8084,7810,15894,基隆,一等
2020-12-05,900,7180,6809,13989,基隆,一等
2020-12-06,900,6618,6194,12812,基隆,一等
2020-12-07,900,6675,6431,13106,基隆,一等
2020-12-08,900,6591,6203,12794,基隆,一等
2020-12-09,900,6443,6274,12717,基隆,一等
2020-12-10,900,6894,6329,13223,基隆,一等
2020-12-11,900,8152,7651,15803,基隆,一等
2020-12-12,900,8197,8070,16267,基隆,一等
2020-12-13,900,7693,7445,15138,基隆,一等
2020-12-14,900,6941,6522,13463,基隆,一等
2020-12-15,900,6802,6112,12914,基隆,一等
2020-12-16,900,6541,6174,12715,基隆,一等
2020-12-17,900,6948,6324,13272,基隆,一等
2020-12-18,900,8673,7812,16485,基隆,一等
2020-12-19,900,7043,6761,13804,基隆,一等
2020-12-20,900,6570,6332,12902,基隆,一等
2020-12-21,900,7029,6504,13533,基隆,一等
2020-12-22,900,6860,6578,13438,基隆,一等
2020-12-23,900,6520,6020,12540,基隆,一等
2020-12-24,900,6864,6244,13108,基隆,一等
2020-12-25,900,8377,7867,16244,基隆,一等
2020-12-26,900,7498,7196,14694,基隆,一等
2020-12-27,900,6960,6738,13698,基隆,一等
2020-12-28,900,7060,6759,13819,基隆,一等
2020-12-29,900,7002,6575,13577,基隆,一等
2020-12-30,900,6690,6200,12890,基隆,一等
2020-12-31,900,9159,8124,17283,基隆,一等
2020-01-01,910,1020,1135,2155,三坑,簡易
2020-01-02,910,1504,1482,2986,三坑,簡易
2020-01-03,910,1500,1570,3070,三坑,簡易
2020-01-04,910,1244,1293,2537,三坑,簡易
2020-01-05,910,1172,1200,2372,三坑,簡易
2020-01-06,910,1504,1472,2976,三坑,簡易
2020-01-07,910,1497,1511,3008,三坑,簡易
2020-01-08,910,1427,1421,2848,三坑,簡易
2020-01-09,910,1490,1532,3022,三坑,簡易
2020-01-10,910,1557,1645,3202,三坑,簡易
2020-01-11,910,1298,1406,2704,三坑,簡易
2020-01-12,910,1138,1033,2171,三坑,簡易
2020-01-13,910,1489,1476,2965,三坑,簡易
2020-01-14,910,1459,1419,2878,三坑,簡易
2020-01-15,910,1143,1281,2424,三坑,簡易
2020-01-16,910,1505,1532,3037,三坑,簡易
2020-01-17,910,1447,1508,2955,三坑,簡易
2020-01-18,910,1187,1227,2414,三坑,簡易
2020-01-19,910,1139,1154,2293,三坑,簡易
2020-01-20,910,1522,1508,3030,三坑,簡易
2020-01-21,910,1418,1539,2957,三坑,簡易
2020-01-22,910,1420,1619,3039,三坑,簡易
2020-01-23,910,1025,1113,2138,三坑,簡易
2020-01-24,910,824,945,1769,三坑,簡易
2020-01-25,910,1086,1035,2121,三坑,簡易
2020-01-26,910,994,1020,2014,三坑,簡易
2020-01-27,910,1317,1258,2575,三坑,簡易
2020-01-28,910,1139,1105,2244,三坑,簡易
2020-01-29,910,1004,1032,2036,三坑,簡易
2020-01-30,910,1376,1386,2762,三坑,簡易
2020-01-31,910,1354,1410,2764,三坑,簡易
2020-02-01,910,1075,1214,2289,三坑,簡易
2020-02-02,910,1024,1087,2111,三坑,簡易
2020-02-03,910,1370,1380,2750,三坑,簡易
2020-02-04,910,1284,1269,2553,三坑,簡易
2020-02-05,910,1301,1316,2617,三坑,簡易
2020-02-06,910,1374,1328,2702,三坑,簡易
2020-02-07,910,1314,1359,2673,三坑,簡易
2020-02-08,910,861,879,1740,三坑,簡易
2020-02-09,910,839,822,1661,三坑,簡易
2020-02-10,910,1345,1354,2699,三坑,簡易
2020-02-11,910,1349,1320,2669,三坑,簡易
2020-02-12,910,1330,1395,2725,三坑,簡易
2020-02-13,910,1342,1325,2667,三坑,簡易
2020-02-14,910,1335,1372,2707,三坑,簡易
2020-02-15,910,1252,1304,2556,三坑,簡易
2020-02-16,910,858,820,1678,三坑,簡易
2020-02-17,910,1193,1348,2541,三坑,簡易
2020-02-18,910,1283,1284,2567,三坑,簡易
2020-02-19,910,1322,1377,2699,三坑,簡易
2020-02-20,910,1299,1238,2537,三坑,簡易
2020-02-21,910,1404,1406,2810,三坑,簡易
2020-02-22,910,1005,1072,2077,三坑,簡易
2020-02-23,910,930,979,1909,三坑,簡易
2020-02-24,910,1406,1378,2784,三坑,簡易
2020-02-25,910,1355,1354,2709,三坑,簡易
2020-02-26,910,1289,1329,2618,三坑,簡易
2020-02-27,910,1347,1408,2755,三坑,簡易
2020-02-28,910,1040,1121,2161,三坑,簡易
2020-02-29,910,902,1005,1907,三坑,簡易
2020-03-01,910,887,796,1683,三坑,簡易
2020-03-02,910,1346,1355,2701,三坑,簡易
2020-03-03,910,1348,1373,2721,三坑,簡易
2020-03-04,910,1307,1324,2631,三坑,簡易
2020-03-05,910,1260,1213,2473,三坑,簡易
2020-03-06,910,1449,1458,2907,三坑,簡易
2020-03-07,910,895,975,1870,三坑,簡易
2020-03-08,910,863,840,1703,三坑,簡易
2020-03-09,910,1384,1374,2758,三坑,簡易
2020-03-10,910,1294,1273,2567,三坑,簡易
2020-03-11,910,1371,1394,2765,三坑,簡易
2020-03-12,910,1276,1285,2561,三坑,簡易
2020-03-13,910,1329,1302,2631,三坑,簡易
2020-03-14,910,850,946,1796,三坑,簡易
2020-03-15,910,917,947,1864,三坑,簡易
2020-03-16,910,1398,1355,2753,三坑,簡易
2020-03-17,910,1368,1357,2725,三坑,簡易
2020-03-18,910,1309,1288,2597,三坑,簡易
2020-03-19,910,1269,1256,2525,三坑,簡易
2020-03-20,910,1329,1403,2732,三坑,簡易
2020-03-21,910,834,918,1752,三坑,簡易
2020-03-22,910,810,789,1599,三坑,簡易
2020-03-23,910,1269,1303,2572,三坑,簡易
2020-03-24,910,1235,1271,2506,三坑,簡易
2020-03-25,910,1311,1252,2563,三坑,簡易
2020-03-26,910,1255,1253,2508,三坑,簡易
2020-03-27,910,1322,1330,2652,三坑,簡易
2020-03-28,910,696,781,1477,三坑,簡易
2020-03-29,910,846,773,1619,三坑,簡易
2020-03-30,910,1254,1291,2545,三坑,簡易
2020-03-31,910,1310,1295,2605,三坑,簡易
2020-04-01,910,1277,1356,2633,三坑,簡易
2020-04-02,910,771,891,1662,三坑,簡易
2020-04-03,910,829,867,1696,三坑,簡易
2020-04-04,910,722,749,1471,三坑,簡易
2020-04-05,910,802,676,1478,三坑,簡易
2020-04-06,910,1287,1274,2561,三坑,簡易
2020-04-07,910,1231,1234,2465,三坑,簡易
2020-04-08,910,1240,1238,2478,三坑,簡易
2020-04-09,910,1201,1194,2395,三坑,簡易
2020-04-10,910,1305,1361,2666,三坑,簡易
2020-04-11,910,848,925,1773,三坑,簡易
2020-04-12,910,719,703,1422,三坑,簡易
2020-04-13,910,1272,1270,2542,三坑,簡易
2020-04-14,910,1234,1269,2503,三坑,簡易
2020-04-15,910,1304,1292,2596,三坑,簡易
2020-04-16,910,1240,1243,2483,三坑,簡易
2020-04-17,910,1278,1335,2613,三坑,簡易
2020-04-18,910,785,862,1647,三坑,簡易
2020-04-19,910,737,719,1456,三坑,簡易
2020-04-20,910,1312,1280,2592,三坑,簡易
2020-04-21,910,1202,1217,2419,三坑,簡易
2020-04-22,910,1220,1237,2457,三坑,簡易
2020-04-23,910,1181,1217,2398,三坑,簡易
2020-04-24,910,1260,1305,2565,三坑,簡易
2020-04-25,910,808,847,1655,三坑,簡易
2020-04-26,910,739,678,1417,三坑,簡易
2020-04-27,910,1264,1272,2536,三坑,簡易
2020-04-28,910,1201,1286,2487,三坑,簡易
2020-04-29,910,1254,1262,2516,三坑,簡易
2020-04-30,910,1315,1350,2665,三坑,簡易
2020-05-01,910,1018,1163,2181,三坑,簡易
2020-05-02,910,842,927,1769,三坑,簡易
2020-05-03,910,887,859,1746,三坑,簡易
2020-05-04,910,1300,1258,2558,三坑,簡易
2020-05-05,910,1314,1328,2642,三坑,簡易
2020-05-06,910,1361,1344,2705,三坑,簡易
2020-05-07,910,1281,1283,2564,三坑,簡易
2020-05-08,910,1379,1438,2817,三坑,簡易
2020-05-09,910,964,1093,2057,三坑,簡易
2020-05-10,910,922,869,1791,三坑,簡易
2020-05-11,910,1354,1266,2620,三坑,簡易
2020-05-12,910,1299,1306,2605,三坑,簡易
2020-05-13,910,1347,1382,2729,三坑,簡易
2020-05-14,910,1313,1345,2658,三坑,簡易
2020-05-15,910,1397,1466,2863,三坑,簡易
2020-05-16,910,841,1010,1851,三坑,簡易
2020-05-17,910,897,904,1801,三坑,簡易
2020-05-18,910,1314,1305,2619,三坑,簡易
2020-05-19,910,1257,1312,2569,三坑,簡易
2020-05-20,910,1334,1333,2667,三坑,簡易
2020-05-21,910,1340,1343,2683,三坑,簡易
2020-05-22,910,1295,1333,2628,三坑,簡易
2020-05-23,910,862,944,1806,三坑,簡易
2020-05-24,910,984,945,1929,三坑,簡易
2020-05-25,910,1368,1368,2736,三坑,簡易
2020-05-26,910,1318,1362,2680,三坑,簡易
2020-05-27,910,1336,1354,2690,三坑,簡易
2020-05-28,910,1276,1292,2568,三坑,簡易
2020-05-29,910,1442,1429,2871,三坑,簡易
2020-05-30,910,990,1076,2066,三坑,簡易
2020-05-31,910,940,935,1875,三坑,簡易
2020-06-01,910,1408,1396,2804,三坑,簡易
2020-06-02,910,1377,1291,2668,三坑,簡易
2020-06-03,910,1396,1363,2759,三坑,簡易
2020-06-04,910,1299,1351,2650,三坑,簡易
2020-06-05,910,1375,1290,2665,三坑,簡易
2020-06-06,910,966,1077,2043,三坑,簡易
2020-06-07,910,1002,891,1893,三坑,簡易
2020-06-08,910,1323,1326,2649,三坑,簡易
2020-06-09,910,1321,1371,2692,三坑,簡易
2020-06-10,910,1382,1406,2788,三坑,簡易
2020-06-11,910,1371,1313,2684,三坑,簡易
2020-06-12,910,1426,1462,2888,三坑,簡易
2020-06-13,910,1095,1157,2252,三坑,簡易
2020-06-14,910,931,980,1911,三坑,簡易
2020-06-15,910,1362,1372,2734,三坑,簡易
2020-06-16,910,1414,1413,2827,三坑,簡易
2020-06-17,910,1383,1464,2847,三坑,簡易
2020-06-18,910,1296,1298,2594,三坑,簡易
2020-06-19,910,1340,1397,2737,三坑,簡易
2020-06-20,910,1125,1276,2401,三坑,簡易
2020-06-21,910,980,1089,2069,三坑,簡易
2020-06-22,910,1346,1383,2729,三坑,簡易
2020-06-23,910,1357,1356,2713,三坑,簡易
2020-06-24,910,1400,1489,2889,三坑,簡易
2020-06-25,910,1033,1136,2169,三坑,簡易
2020-06-26,910,1128,1148,2276,三坑,簡易
2020-06-27,910,1052,1137,2189,三坑,簡易
2020-06-28,910,993,972,1965,三坑,簡易
2020-06-29,910,1394,1387,2781,三坑,簡易
2020-06-30,910,1384,1396,2780,三坑,簡易
2020-07-01,910,1324,1320,2644,三坑,簡易
2020-07-02,910,1278,1272,2550,三坑,簡易
2020-07-03,910,1391,1440,2831,三坑,簡易
2020-07-04,910,1013,1119,2132,三坑,簡易
2020-07-05,910,947,952,1899,三坑,簡易
2020-07-06,910,1341,1372,2713,三坑,簡易
2020-07-07,910,1342,1412,2754,三坑,簡易
2020-07-08,910,1310,1328,2638,三坑,簡易
2020-07-09,910,1314,1301,2615,三坑,簡易
2020-07-10,910,1439,1422,2861,三坑,簡易
2020-07-11,910,1113,1242,2355,三坑,簡易
2020-07-12,910,1022,1056,2078,三坑,簡易
2020-07-13,910,1341,1348,2689,三坑,簡易
2020-07-14,910,1373,1390,2763,三坑,簡易
2020-07-15,910,1375,1366,2741,三坑,簡易
2020-07-16,910,1354,1302,2656,三坑,簡易
2020-07-17,910,1380,1445,2825,三坑,簡易
2020-07-18,910,1136,1232,2368,三坑,簡易
2020-07-19,910,1073,1028,2101,三坑,簡易
2020-07-20,910,1415,1466,2881,三坑,簡易
2020-07-21,910,1349,1276,2625,三坑,簡易
2020-07-22,910,1396,1387,2783,三坑,簡易
2020-07-23,910,1339,1348,2687,三坑,簡易
2020-07-24,910,1363,1420,2783,三坑,簡易
2020-07-25,910,1000,1110,2110,三坑,簡易
2020-07-26,910,975,1011,1986,三坑,簡易
2020-07-27,910,1346,1331,2677,三坑,簡易
2020-07-28,910,1359,1342,2701,三坑,簡易
2020-07-29,910,1326,1318,2644,三坑,簡易
2020-07-30,910,1386,1373,2759,三坑,簡易
2020-07-31,910,1435,1431,2866,三坑,簡易
2020-08-01,910,1092,1160,2252,三坑,簡易
2020-08-02,910,991,992,1983,三坑,簡易
2020-08-03,910,1254,1247,2501,三坑,簡易
2020-08-04,910,1290,1310,2600,三坑,簡易
2020-08-05,910,1288,1305,2593,三坑,簡易
2020-08-06,910,1282,1260,2542,三坑,簡易
2020-08-07,910,1398,1382,2780,三坑,簡易
2020-08-08,910,987,1068,2055,三坑,簡易
2020-08-09,910,1160,1115,2275,三坑,簡易
2020-08-10,910,1310,1331,2641,三坑,簡易
2020-08-11,910,1323,1335,2658,三坑,簡易
2020-08-12,910,1434,1355,2789,三坑,簡易
2020-08-13,910,1350,1356,2706,三坑,簡易
2020-08-14,910,1347,1410,2757,三坑,簡易
2020-08-15,910,1159,1214,2373,三坑,簡易
2020-08-16,910,1095,1086,2181,三坑,簡易
2020-08-17,910,1372,1352,2724,三坑,簡易
2020-08-18,910,1386,1425,2811,三坑,簡易
2020-08-19,910,1434,1421,2855,三坑,簡易
2020-08-20,910,1386,1366,2752,三坑,簡易
2020-08-21,910,1391,1410,2801,三坑,簡易
2020-08-22,910,1014,1110,2124,三坑,簡易
2020-08-23,910,982,954,1936,三坑,簡易
2020-08-24,910,1416,1499,2915,三坑,簡易
2020-08-25,910,1382,1392,2774,三坑,簡易
2020-08-26,910,1402,1373,2775,三坑,簡易
2020-08-27,910,1310,1334,2644,三坑,簡易
2020-08-28,910,1360,1413,2773,三坑,簡易
2020-08-29,910,1015,1116,2131,三坑,簡易
2020-08-30,910,938,982,1920,三坑,簡易
2020-08-31,910,1381,1363,2744,三坑,簡易
2020-09-01,910,1373,1460,2833,三坑,簡易
2020-09-02,910,1324,1342,2666,三坑,簡易
2020-09-03,910,1337,1371,2708,三坑,簡易
2020-09-04,910,1444,1482,2926,三坑,簡易
2020-09-05,910,1081,1247,2328,三坑,簡易
2020-09-06,910,1041,1130,2171,三坑,簡易
2020-09-07,910,1403,1383,2786,三坑,簡易
2020-09-08,910,1422,1403,2825,三坑,簡易
2020-09-09,910,1373,1406,2779,三坑,簡易
2020-09-10,910,1349,1384,2733,三坑,簡易
2020-09-11,910,1426,1459,2885,三坑,簡易
2020-09-12,910,1078,1164,2242,三坑,簡易
2020-09-13,910,1017,997,2014,三坑,簡易
2020-09-14,910,1380,1379,2759,三坑,簡易
2020-09-15,910,1361,1417,2778,三坑,簡易
2020-09-16,910,1379,1379,2758,三坑,簡易
2020-09-17,910,1335,1365,2700,三坑,簡易
2020-09-18,910,1411,1528,2939,三坑,簡易
2020-09-19,910,1045,1196,2241,三坑,簡易
2020-09-20,910,1005,938,1943,三坑,簡易
2020-09-21,910,1376,1296,2672,三坑,簡易
2020-09-22,910,1373,1436,2809,三坑,簡易
2020-09-23,910,1433,1402,2835,三坑,簡易
2020-09-24,910,1361,1376,2737,三坑,簡易
2020-09-25,910,1421,1470,2891,三坑,簡易
2020-09-26,910,1168,1336,2504,三坑,簡易
2020-09-27,910,797,881,1678,三坑,簡易
2020-09-28,910,1403,1375,2778,三坑,簡易
2020-09-29,910,1403,1458,2861,三坑,簡易
2020-09-30,910,1416,1589,3005,三坑,簡易
2020-10-01,910,1126,1306,2432,三坑,簡易
2020-10-02,910,1200,1280,2480,三坑,簡易
2020-10-03,910,1153,1185,2338,三坑,簡易
2020-10-04,910,1051,1067,2118,三坑,簡易
2020-10-05,910,1402,1394,2796,三坑,簡易
2020-10-06,910,1359,1434,2793,三坑,簡易
2020-10-07,910,1443,1454,2897,三坑,簡易
2020-10-08,910,1424,1500,2924,三坑,簡易
2020-10-09,910,1167,1359,2526,三坑,簡易
2020-10-10,910,1101,1223,2324,三坑,簡易
2020-10-11,910,1044,967,2011,三坑,簡易
2020-10-12,910,1393,1376,2769,三坑,簡易
2020-10-13,910,1351,1354,2705,三坑,簡易
2020-10-14,910,1392,1415,2807,三坑,簡易
2020-10-15,910,1320,1370,2690,三坑,簡易
2020-10-16,910,1449,1537,2986,三坑,簡易
2020-10-17,910,1072,1119,2191,三坑,簡易
2020-10-18,910,1014,989,2003,三坑,簡易
2020-10-19,910,1396,1363,2759,三坑,簡易
2020-10-20,910,1360,1356,2716,三坑,簡易
2020-10-21,910,1411,1411,2822,三坑,簡易
2020-10-22,910,1336,1406,2742,三坑,簡易
2020-10-23,910,1478,1536,3014,三坑,簡易
2020-10-24,910,1184,1356,2540,三坑,簡易
2020-10-25,910,1098,1072,2170,三坑,簡易
2020-10-26,910,1402,1420,2822,三坑,簡易
2020-10-27,910,1398,1357,2755,三坑,簡易
2020-10-28,910,1409,1413,2822,三坑,簡易
2020-10-29,910,1375,1394,2769,三坑,簡易
2020-10-30,910,1426,1506,2932,三坑,簡易
2020-10-31,910,1101,1180,2281,三坑,簡易
2020-11-01,910,1054,1053,2107,三坑,簡易
2020-11-02,910,1403,1426,2829,三坑,簡易
2020-11-03,910,1402,1421,2823,三坑,簡易
2020-11-04,910,1389,1427,2816,三坑,簡易
2020-11-05,910,1381,1374,2755,三坑,簡易
2020-11-06,910,1429,1543,2972,三坑,簡易
2020-11-07,910,1088,1146,2234,三坑,簡易
2020-11-08,910,982,948,1930,三坑,簡易
2020-11-09,910,1424,1435,2859,三坑,簡易
2020-11-10,910,1392,1360,2752,三坑,簡易
2020-11-11,910,1423,1456,2879,三坑,簡易
2020-11-12,910,1383,1421,2804,三坑,簡易
2020-11-13,910,1464,1520,2984,三坑,簡易
2020-11-14,910,1196,1214,2410,三坑,簡易
2020-11-15,910,1101,1144,2245,三坑,簡易
2020-11-16,910,1417,1417,2834,三坑,簡易
2020-11-17,910,1419,1359,2778,三坑,簡易
2020-11-18,910,1456,1446,2902,三坑,簡易
2020-11-19,910,1444,1524,2968,三坑,簡易
2020-11-20,910,1439,1505,2944,三坑,簡易
2020-11-21,910,1157,1256,2413,三坑,簡易
2020-11-22,910,1162,1184,2346,三坑,簡易
2020-11-23,910,1415,1395,2810,三坑,簡易
2020-11-24,910,1429,1424,2853,三坑,簡易
2020-11-25,910,1431,1446,2877,三坑,簡易
2020-11-26,910,1438,1507,2945,三坑,簡易
2020-11-27,910,1477,1558,3035,三坑,簡易
2020-11-28,910,1058,1183,2241,三坑,簡易
2020-11-29,910,1054,972,2026,三坑,簡易
2020-11-30,910,1360,1394,2754,三坑,簡易
2020-12-01,910,1381,1382,2763,三坑,簡易
2020-12-02,910,1382,1366,2748,三坑,簡易
2020-12-03,910,1339,1347,2686,三坑,簡易
2020-12-04,910,1427,1471,2898,三坑,簡易
2020-12-05,910,1111,1166,2277,三坑,簡易
2020-12-06,910,1066,1027,2093,三坑,簡易
2020-12-07,910,1354,1377,2731,三坑,簡易
2020-12-08,910,1393,1343,2736,三坑,簡易
2020-12-09,910,1387,1325,2712,三坑,簡易
2020-12-10,910,1377,1373,2750,三坑,簡易
2020-12-11,910,1403,1522,2925,三坑,簡易
2020-12-12,910,1168,1299,2467,三坑,簡易
2020-12-13,910,1117,1150,2267,三坑,簡易
2020-12-14,910,1423,1418,2841,三坑,簡易
2020-12-15,910,1368,1413,2781,三坑,簡易
2020-12-16,910,1432,1398,2830,三坑,簡易
2020-12-17,910,1454,1414,2868,三坑,簡易
2020-12-18,910,1505,1529,3034,三坑,簡易
2020-12-19,910,1059,1172,2231,三坑,簡易
2020-12-20,910,1080,1108,2188,三坑,簡易
2020-12-21,910,1381,1338,2719,三坑,簡易
2020-12-22,910,1432,1459,2891,三坑,簡易
2020-12-23,910,1438,1417,2855,三坑,簡易
2020-12-24,910,1414,1415,2829,三坑,簡易
2020-12-25,910,1486,1527,3013,三坑,簡易
2020-12-26,910,1106,1209,2315,三坑,簡易
2020-12-27,910,1046,1105,2151,三坑,簡易
2020-12-28,910,1495,1404,2899,三坑,簡易
2020-12-29,910,1431,1485,2916,三坑,簡易
2020-12-30,910,1395,1453,2848,三坑,簡易
2020-12-31,910,1384,1388,2772,三坑,簡易
2020-01-01,920,1623,1972,3595,八堵,二等
2020-01-02,920,2597,2350,4947,八堵,二等
2020-01-03,920,2794,2568,5362,八堵,二等
2020-01-04,920,2452,2279,4731,八堵,二等
2020-01-05,920,2145,1829,3974,八堵,二等
2020-01-06,920,2797,2465,5262,八堵,二等
2020-01-07,920,2717,2367,5084,八堵,二等
2020-01-08,920,2606,2319,4925,八堵,二等
2020-01-09,920,2879,2594,5473,八堵,二等
2020-01-10,920,2954,2998,5952,八堵,二等
2020-01-11,920,2220,2264,4484,八堵,二等
2020-01-12,920,1974,1739,3713,八堵,二等
2020-01-13,920,2708,2374,5082,八堵,二等
2020-01-14,920,2708,2304,5012,八堵,二等
2020-01-15,920,2323,2603,4926,八堵,二等
2020-01-16,920,2837,2605,5442,八堵,二等
2020-01-17,920,2386,2195,4581,八堵,二等
2020-01-18,920,1933,1962,3895,八堵,二等
2020-01-19,920,2238,1977,4215,八堵,二等
2020-01-20,920,2568,2380,4948,八堵,二等
2020-01-21,920,2505,2443,4948,八堵,二等
2020-01-22,920,2484,2469,4953,八堵,二等
2020-01-23,920,1647,1725,3372,八堵,二等
2020-01-24,920,1618,1795,3413,八堵,二等
2020-01-25,920,1861,1587,3448,八堵,二等
2020-01-26,920,1926,1831,3757,八堵,二等
2020-01-27,920,2001,1881,3882,八堵,二等
2020-01-28,920,1862,1851,3713,八堵,二等
2020-01-29,920,1651,1615,3266,八堵,二等
2020-01-30,920,2292,2108,4400,八堵,二等
2020-01-31,920,2326,2108,4434,八堵,二等
2020-02-01,920,1623,1692,3315,八堵,二等
2020-02-02,920,1707,1722,3429,八堵,二等
2020-02-03,920,2340,2141,4481,八堵,二等
2020-02-04,920,2192,1891,4083,八堵,二等
2020-02-05,920,2197,2028,4225,八堵,二等
2020-02-06,920,2318,2060,4378,八堵,二等
2020-02-07,920,2351,2105,4456,八堵,二等
2020-02-08,920,1498,1510,3008,八堵,二等
2020-02-09,920,1468,1401,2869,八堵,二等
2020-02-10,920,2257,1946,4203,八堵,二等
2020-02-11,920,2243,1972,4215,八堵,二等
2020-02-12,920,2257,2080,4337,八堵,二等
2020-02-13,920,2262,2006,4268,八堵,二等
2020-02-14,920,2306,2013,4319,八堵,二等
2020-02-15,920,1964,1864,3828,八堵,二等
2020-02-16,920,1411,1390,2801,八堵,二等
2020-02-17,920,2007,2052,4059,八堵,二等
2020-02-18,920,2225,1994,4219,八堵,二等
2020-02-19,920,2338,2095,4433,八堵,二等
2020-02-20,920,2201,1945,4146,八堵,二等
2020-02-21,920,2348,2111,4459,八堵,二等
2020-02-22,920,1629,1550,3179,八堵,二等
2020-02-23,920,1457,1383,2840,八堵,二等
2020-02-24,920,2394,2145,4539,八堵,二等
2020-02-25,920,2512,2242,4754,八堵,二等
2020-02-26,920,2388,2173,4561,八堵,二等
2020-02-27,920,2550,2243,4793,八堵,二等
2020-02-28,920,1796,1634,3430,八堵,二等
2020-02-29,920,1647,1625,3272,八堵,二等
2020-03-01,920,1491,1451,2942,八堵,二等
2020-03-02,920,2309,1931,4240,八堵,二等
2020-03-03,920,2381,2060,4441,八堵,二等
2020-03-04,920,2277,2110,4387,八堵,二等
2020-03-05,920,2326,2048,4374,八堵,二等
2020-03-06,920,2482,2319,4801,八堵,二等
2020-03-07,920,1549,1543,3092,八堵,二等
2020-03-08,920,1554,1417,2971,八堵,二等
2020-03-09,920,2415,2027,4442,八堵,二等
2020-03-10,920,2214,1942,4156,八堵,二等
2020-03-11,920,2389,2091,4480,八堵,二等
2020-03-12,920,2354,2141,4495,八堵,二等
2020-03-13,920,2445,2240,4685,八堵,二等
2020-03-14,920,1384,1424,2808,八堵,二等
2020-03-15,920,1665,1487,3152,八堵,二等
2020-03-16,920,2526,2152,4678,八堵,二等
2020-03-17,920,2349,2122,4471,八堵,二等
2020-03-18,920,2245,2028,4273,八堵,二等
2020-03-19,920,2256,1999,4255,八堵,二等
2020-03-20,920,2400,2237,4637,八堵,二等
2020-03-21,920,1440,1572,3012,八堵,二等
2020-03-22,920,1517,1409,2926,八堵,二等
2020-03-23,920,2263,1946,4209,八堵,二等
2020-03-24,920,2247,2031,4278,八堵,二等
2020-03-25,920,2301,2049,4350,八堵,二等
2020-03-26,920,2267,2076,4343,八堵,二等
2020-03-27,920,2360,2079,4439,八堵,二等
2020-03-28,920,1247,1227,2474,八堵,二等
2020-03-29,920,1388,1331,2719,八堵,二等
2020-03-30,920,2236,2032,4268,八堵,二等
2020-03-31,920,2228,1922,4150,八堵,二等
2020-04-01,920,2317,2226,4543,八堵,二等
2020-04-02,920,1284,1279,2563,八堵,二等
2020-04-03,920,1308,1304,2612,八堵,二等
2020-04-04,920,1129,1188,2317,八堵,二等
2020-04-05,920,1348,1160,2508,八堵,二等
2020-04-06,920,2329,1967,4296,八堵,二等
2020-04-07,920,2052,1747,3799,八堵,二等
2020-04-08,920,2183,1861,4044,八堵,二等
2020-04-09,920,2117,1911,4028,八堵,二等
2020-04-10,920,2321,2058,4379,八堵,二等
2020-04-11,920,1216,1224,2440,八堵,二等
2020-04-12,920,1111,1041,2152,八堵,二等
2020-04-13,920,2185,1851,4036,八堵,二等
2020-04-14,920,2109,1834,3943,八堵,二等
2020-04-15,920,2115,1841,3956,八堵,二等
2020-04-16,920,2168,1947,4115,八堵,二等
2020-04-17,920,2187,2019,4206,八堵,二等
2020-04-18,920,1462,1386,2848,八堵,二等
2020-04-19,920,1308,1227,2535,八堵,二等
2020-04-20,920,2179,1851,4030,八堵,二等
2020-04-21,920,2050,1795,3845,八堵,二等
2020-04-22,920,1922,1726,3648,八堵,二等
2020-04-23,920,2003,1776,3779,八堵,二等
2020-04-24,920,2055,1866,3921,八堵,二等
2020-04-25,920,1150,1174,2324,八堵,二等
2020-04-26,920,1114,1040,2154,八堵,二等
2020-04-27,920,2105,1860,3965,八堵,二等
2020-04-28,920,2058,1849,3907,八堵,二等
2020-04-29,920,2155,1900,4055,八堵,二等
2020-04-30,920,2239,2058,4297,八堵,二等
2020-05-01,920,1836,1805,3641,八堵,二等
2020-05-02,920,1415,1288,2703,八堵,二等
2020-05-03,920,1425,1330,2755,八堵,二等
2020-05-04,920,2227,1960,4187,八堵,二等
2020-05-05,920,2175,1914,4089,八堵,二等
2020-05-06,920,2212,1964,4176,八堵,二等
2020-05-07,920,2150,1959,4109,八堵,二等
2020-05-08,920,2319,2186,4505,八堵,二等
2020-05-09,920,1519,1628,3147,八堵,二等
2020-05-10,920,1523,1340,2863,八堵,二等
2020-05-11,920,2282,1891,4173,八堵,二等
2020-05-12,920,2128,1853,3981,八堵,二等
2020-05-13,920,2218,2028,4246,八堵,二等
2020-05-14,920,2216,2064,4280,八堵,二等
2020-05-15,920,2613,2488,5101,八堵,二等
2020-05-16,920,1595,1536,3131,八堵,二等
2020-05-17,920,1662,1448,3110,八堵,二等
2020-05-18,920,2240,2000,4240,八堵,二等
2020-05-19,920,2205,1934,4139,八堵,二等
2020-05-20,920,2166,1916,4082,八堵,二等
2020-05-21,920,2200,1957,4157,八堵,二等
2020-05-22,920,2191,2054,4245,八堵,二等
2020-05-23,920,1280,1193,2473,八堵,二等
2020-05-24,920,1471,1362,2833,八堵,二等
2020-05-25,920,2263,1964,4227,八堵,二等
2020-05-26,920,2241,1989,4230,八堵,二等
2020-05-27,920,2200,1911,4111,八堵,二等
2020-05-28,920,2101,1889,3990,八堵,二等
2020-05-29,920,2342,2199,4541,八堵,二等
2020-05-30,920,1656,1711,3367,八堵,二等
2020-05-31,920,1661,1633,3294,八堵,二等
2020-06-01,920,2283,1993,4276,八堵,二等
2020-06-02,920,2265,2113,4378,八堵,二等
2020-06-03,920,2441,2098,4539,八堵,二等
2020-06-04,920,2272,2062,4334,八堵,二等
2020-06-05,920,2466,2237,4703,八堵,二等
2020-06-06,920,1645,1640,3285,八堵,二等
2020-06-07,920,1587,1490,3077,八堵,二等
2020-06-08,920,2339,2014,4353,八堵,二等
2020-06-09,920,2285,2056,4341,八堵,二等
2020-06-10,920,2353,2178,4531,八堵,二等
2020-06-11,920,2383,2206,4589,八堵,二等
2020-06-12,920,2548,2413,4961,八堵,二等
2020-06-13,920,1815,1863,3678,八堵,二等
2020-06-14,920,1732,1711,3443,八堵,二等
2020-06-15,920,2471,2190,4661,八堵,二等
2020-06-16,920,2388,2082,4470,八堵,二等
2020-06-17,920,2275,2029,4304,八堵,二等
2020-06-18,920,2314,2173,4487,八堵,二等
2020-06-19,920,2374,2249,4623,八堵,二等
2020-06-20,920,2061,1942,4003,八堵,二等
2020-06-21,920,1553,1567,3120,八堵,二等
2020-06-22,920,2441,2124,4565,八堵,二等
2020-06-23,920,2340,2159,4499,八堵,二等
2020-06-24,920,2596,2466,5062,八堵,二等
2020-06-25,920,1875,1967,3842,八堵,二等
2020-06-26,920,2126,2048,4174,八堵,二等
2020-06-27,920,1738,1832,3570,八堵,二等
2020-06-28,920,1713,1697,3410,八堵,二等
2020-06-29,920,2401,2244,4645,八堵,二等
2020-06-30,920,2294,2105,4399,八堵,二等
2020-07-01,920,2239,2072,4311,八堵,二等
2020-07-02,920,2280,2111,4391,八堵,二等
2020-07-03,920,2380,2211,4591,八堵,二等
2020-07-04,920,1830,1875,3705,八堵,二等
2020-07-05,920,1650,1661,3311,八堵,二等
2020-07-06,920,2393,2192,4585,八堵,二等
2020-07-07,920,2295,2133,4428,八堵,二等
2020-07-08,920,2371,2234,4605,八堵,二等
2020-07-09,920,2307,2148,4455,八堵,二等
2020-07-10,920,2680,2450,5130,八堵,二等
2020-07-11,920,1893,1824,3717,八堵,二等
2020-07-12,920,1772,1692,3464,八堵,二等
2020-07-13,920,2511,2248,4759,八堵,二等
2020-07-14,920,2323,2248,4571,八堵,二等
2020-07-15,920,2388,2189,4577,八堵,二等
2020-07-16,920,2371,1956,4327,八堵,二等
2020-07-17,920,2481,2330,4811,八堵,二等
2020-07-18,920,2110,1904,4014,八堵,二等
2020-07-19,920,1794,1679,3473,八堵,二等
2020-07-20,920,2317,2067,4384,八堵,二等
2020-07-21,920,2278,2106,4384,八堵,二等
2020-07-22,920,2380,2158,4538,八堵,二等
2020-07-23,920,2457,2223,4680,八堵,二等
2020-07-24,920,2440,2213,4653,八堵,二等
2020-07-25,920,1803,1730,3533,八堵,二等
2020-07-26,920,1786,1757,3543,八堵,二等
2020-07-27,920,2261,2197,4458,八堵,二等
2020-07-28,920,2324,2150,4474,八堵,二等
2020-07-29,920,2436,2211,4647,八堵,二等
2020-07-30,920,2396,2220,4616,八堵,二等
2020-07-31,920,2494,2361,4855,八堵,二等
2020-08-01,920,2020,1957,3977,八堵,二等
2020-08-02,920,1818,1796,3614,八堵,二等
2020-08-03,920,2201,1949,4150,八堵,二等
2020-08-04,920,2251,2098,4349,八堵,二等
2020-08-05,920,2340,2169,4509,八堵,二等
2020-08-06,920,2381,2177,4558,八堵,二等
2020-08-07,920,2478,2401,4879,八堵,二等
2020-08-08,920,1779,1799,3578,八堵,二等
2020-08-09,920,1867,1712,3579,八堵,二等
2020-08-10,920,2393,2261,4654,八堵,二等
2020-08-11,920,2352,2129,4481,八堵,二等
2020-08-12,920,2480,2235,4715,八堵,二等
2020-08-13,920,2574,2365,4939,八堵,二等
2020-08-14,920,2570,2373,4943,八堵,二等
2020-08-15,920,2093,1976,4069,八堵,二等
2020-08-16,920,1838,1878,3716,八堵,二等
2020-08-17,920,2432,2319,4751,八堵,二等
2020-08-18,920,2435,2305,4740,八堵,二等
2020-08-19,920,2451,2331,4782,八堵,二等
2020-08-20,920,2450,2251,4701,八堵,二等
2020-08-21,920,2481,2358,4839,八堵,二等
2020-08-22,920,2111,2104,4215,八堵,二等
2020-08-23,920,1774,1675,3449,八堵,二等
2020-08-24,920,2496,2350,4846,八堵,二等
2020-08-25,920,2513,2319,4832,八堵,二等
2020-08-26,920,2649,2480,5129,八堵,二等
2020-08-27,920,2534,2295,4829,八堵,二等
2020-08-28,920,2436,2254,4690,八堵,二等
2020-08-29,920,1858,1841,3699,八堵,二等
2020-08-30,920,1703,1636,3339,八堵,二等
2020-08-31,920,2405,2184,4589,八堵,二等
2020-09-01,920,2386,2214,4600,八堵,二等
2020-09-02,920,2469,2290,4759,八堵,二等
2020-09-03,920,2440,2205,4645,八堵,二等
2020-09-04,920,2570,2368,4938,八堵,二等
2020-09-05,920,1992,1893,3885,八堵,二等
2020-09-06,920,1669,1695,3364,八堵,二等
2020-09-07,920,2591,2230,4821,八堵,二等
2020-09-08,920,2460,2257,4717,八堵,二等
2020-09-09,920,2440,2268,4708,八堵,二等
2020-09-10,920,2449,2272,4721,八堵,二等
2020-09-11,920,2673,2425,5098,八堵,二等
2020-09-12,920,1780,1728,3508,八堵,二等
2020-09-13,920,1592,1471,3063,八堵,二等
2020-09-14,920,2435,2217,4652,八堵,二等
2020-09-15,920,2393,2112,4505,八堵,二等
2020-09-16,920,2388,2205,4593,八堵,二等
2020-09-17,920,2383,2225,4608,八堵,二等
2020-09-18,920,2654,2554,5208,八堵,二等
2020-09-19,920,1850,1857,3707,八堵,二等
2020-09-20,920,1707,1600,3307,八堵,二等
2020-09-21,920,2396,2238,4634,八堵,二等
2020-09-22,920,2559,2293,4852,八堵,二等
2020-09-23,920,2533,2268,4801,八堵,二等
2020-09-24,920,2417,2253,4670,八堵,二等
2020-09-25,920,2384,2257,4641,八堵,二等
2020-09-26,920,2154,2104,4258,八堵,二等
2020-09-27,920,1480,1494,2974,八堵,二等
2020-09-28,920,2335,2038,4373,八堵,二等
2020-09-29,920,2420,2204,4624,八堵,二等
2020-09-30,920,2765,2872,5637,八堵,二等
2020-10-01,920,2057,2216,4273,八堵,二等
2020-10-02,920,2287,2205,4492,八堵,二等
2020-10-03,920,2002,2064,4066,八堵,二等
2020-10-04,920,1954,1839,3793,八堵,二等
2020-10-05,920,2466,2232,4698,八堵,二等
2020-10-06,920,2403,2230,4633,八堵,二等
2020-10-07,920,2431,2200,4631,八堵,二等
2020-10-08,920,2654,2593,5247,八堵,二等
2020-10-09,920,2072,2125,4197,八堵,二等
2020-10-10,920,1641,1560,3201,八堵,二等
2020-10-11,920,1622,1527,3149,八堵,二等
2020-10-12,920,2425,2155,4580,八堵,二等
2020-10-13,920,2354,2114,4468,八堵,二等
2020-10-14,920,2462,2196,4658,八堵,二等
2020-10-15,920,2495,2273,4768,八堵,二等
2020-10-16,920,2691,2480,5171,八堵,二等
2020-10-17,920,1950,2012,3962,八堵,二等
2020-10-18,920,1743,1724,3467,八堵,二等
2020-10-19,920,2422,2132,4554,八堵,二等
2020-10-20,920,2421,2222,4643,八堵,二等
2020-10-21,920,2359,2118,4477,八堵,二等
2020-10-22,920,2352,2064,4416,八堵,二等
2020-10-23,920,2614,2452,5066,八堵,二等
2020-10-24,920,2008,2031,4039,八堵,二等
2020-10-25,920,1853,1659,3512,八堵,二等
2020-10-26,920,2574,2366,4940,八堵,二等
2020-10-27,920,2549,2341,4890,八堵,二等
2020-10-28,920,2508,2227,4735,八堵,二等
2020-10-29,920,2394,2196,4590,八堵,二等
2020-10-30,920,2616,2506,5122,八堵,二等
2020-10-31,920,1921,1920,3841,八堵,二等
2020-11-01,920,1732,1775,3507,八堵,二等
2020-11-02,920,2436,2178,4614,八堵,二等
2020-11-03,920,2402,2149,4551,八堵,二等
2020-11-04,920,2465,2215,4680,八堵,二等
2020-11-05,920,2484,2331,4815,八堵,二等
2020-11-06,920,2583,2416,4999,八堵,二等
2020-11-07,920,1905,1951,3856,八堵,二等
2020-11-08,920,1537,1521,3058,八堵,二等
2020-11-09,920,2442,2181,4623,八堵,二等
2020-11-10,920,2402,2157,4559,八堵,二等
2020-11-11,920,2432,2186,4618,八堵,二等
2020-11-12,920,2446,2269,4715,八堵,二等
2020-11-13,920,2536,2475,5011,八堵,二等
2020-11-14,920,1832,1794,3626,八堵,二等
2020-11-15,920,1967,1832,3799,八堵,二等
2020-11-16,920,2542,2281,4823,八堵,二等
2020-11-17,920,2462,2282,4744,八堵,二等
2020-11-18,920,2603,2458,5061,八堵,二等
2020-11-19,920,2593,2349,4942,八堵,二等
2020-11-20,920,2618,2588,5206,八堵,二等
2020-11-21,920,1758,1785,3543,八堵,二等
2020-11-22,920,1941,1897,3838,八堵,二等
2020-11-23,920,2409,2213,4622,八堵,二等
2020-11-24,920,2393,2195,4588,八堵,二等
2020-11-25,920,2450,2255,4705,八堵,二等
2020-11-26,920,2553,2264,4817,八堵,二等
2020-11-27,920,2616,2482,5098,八堵,二等
2020-11-28,920,1667,1665,3332,八堵,二等
2020-11-29,920,1640,1564,3204,八堵,二等
2020-11-30,920,2377,2026,4403,八堵,二等
2020-12-01,920,2285,2047,4332,八堵,二等
2020-12-02,920,2412,2185,4597,八堵,二等
2020-12-03,920,2329,2099,4428,八堵,二等
2020-12-04,920,2485,2370,4855,八堵,二等
2020-12-05,920,1751,1624,3375,八堵,二等
2020-12-06,920,1546,1390,2936,八堵,二等
2020-12-07,920,2378,1949,4327,八堵,二等
2020-12-08,920,2222,1961,4183,八堵,二等
2020-12-09,920,2189,1892,4081,八堵,二等
2020-12-10,920,2262,1952,4214,八堵,二等
2020-12-11,920,2489,2203,4692,八堵,二等
2020-12-12,920,1613,1595,3208,八堵,二等
2020-12-13,920,1806,1636,3442,八堵,二等
2020-12-14,920,2448,1977,4425,八堵,二等
2020-12-15,920,2367,2039,4406,八堵,二等
2020-12-16,920,2271,1965,4236,八堵,二等
2020-12-17,920,2399,2198,4597,八堵,二等
2020-12-18,920,2641,2471,5112,八堵,二等
2020-12-19,920,1653,1695,3348,八堵,二等
2020-12-20,920,1616,1580,3196,八堵,二等
2020-12-21,920,2395,2076,4471,八堵,二等
2020-12-22,920,2324,2046,4370,八堵,二等
2020-12-23,920,2274,2074,4348,八堵,二等
2020-12-24,920,2352,2102,4454,八堵,二等
2020-12-25,920,2564,2359,4923,八堵,二等
2020-12-26,920,1831,1868,3699,八堵,二等
2020-12-27,920,1775,1737,3512,八堵,二等
2020-12-28,920,2408,2088,4496,八堵,二等
2020-12-29,920,2354,2145,4499,八堵,二等
2020-12-30,920,2387,2049,4436,八堵,二等
2020-12-31,920,2661,2389,5050,八堵,二等
2020-01-01,930,4130,4813,8943,七堵,一等
2020-01-02,930,6525,6731,13256,七堵,一等
2020-01-03,930,7112,7329,14441,七堵,一等
2020-01-04,930,5682,5883,11565,七堵,一等
2020-01-05,930,4530,4486,9016,七堵,一等
2020-01-06,930,6657,6787,13444,七堵,一等
2020-01-07,930,6748,6849,13597,七堵,一等
2020-01-08,930,6537,6732,13269,七堵,一等
2020-01-09,930,6940,7109,14049,七堵,一等
2020-01-10,930,7366,8288,15654,七堵,一等
2020-01-11,930,5300,5325,10625,七堵,一等
2020-01-12,930,4392,4507,8899,七堵,一等
2020-01-13,930,6899,6806,13705,七堵,一等
2020-01-14,930,6714,6896,13610,七堵,一等
2020-01-15,930,6300,6926,13226,七堵,一等
2020-01-16,930,7154,7044,14198,七堵,一等
2020-01-17,930,6373,6158,12531,七堵,一等
2020-01-18,930,4758,4943,9701,七堵,一等
2020-01-19,930,4364,4664,9028,七堵,一等
2020-01-20,930,6327,6413,12740,七堵,一等
2020-01-21,930,5449,6337,11786,七堵,一等
2020-01-22,930,5754,6422,12176,七堵,一等
2020-01-23,930,4365,4461,8826,七堵,一等
2020-01-24,930,3177,3325,6502,七堵,一等
2020-01-25,930,4278,3814,8092,七堵,一等
2020-01-26,930,4275,4410,8685,七堵,一等
2020-01-27,930,4497,4711,9208,七堵,一等
2020-01-28,930,4537,4767,9304,七堵,一等
2020-01-29,930,3993,4333,8326,七堵,一等
2020-01-30,930,5424,5690,11114,七堵,一等
2020-01-31,930,5737,5898,11635,七堵,一等
2020-02-01,930,4069,4137,8206,七堵,一等
2020-02-02,930,4064,4070,8134,七堵,一等
2020-02-03,930,5552,5723,11275,七堵,一等
2020-02-04,930,5189,5441,10630,七堵,一等
2020-02-05,930,5138,5364,10502,七堵,一等
2020-02-06,930,5508,5597,11105,七堵,一等
2020-02-07,930,5631,5886,11517,七堵,一等
2020-02-08,930,3785,3857,7642,七堵,一等
2020-02-09,930,3592,3646,7238,七堵,一等
2020-02-10,930,5276,5433,10709,七堵,一等
2020-02-11,930,5229,5417,10646,七堵,一等
2020-02-12,930,5360,5433,10793,七堵,一等
2020-02-13,930,5187,5375,10562,七堵,一等
2020-02-14,930,5555,5656,11211,七堵,一等
2020-02-15,930,4966,4946,9912,七堵,一等
2020-02-16,930,3140,3226,6366,七堵,一等
2020-02-17,930,4563,5290,9853,七堵,一等
2020-02-18,930,5203,5298,10501,七堵,一等
2020-02-19,930,5245,5350,10595,七堵,一等
2020-02-20,930,5196,5300,10496,七堵,一等
2020-02-21,930,5605,5676,11281,七堵,一等
2020-02-22,930,3738,3723,7461,七堵,一等
2020-02-23,930,3416,3395,6811,七堵,一等
2020-02-24,930,5876,5954,11830,七堵,一等
2020-02-25,930,6201,6290,12491,七堵,一等
2020-02-26,930,6199,6273,12472,七堵,一等
2020-02-27,930,6679,6833,13512,七堵,一等
2020-02-28,930,4352,4138,8490,七堵,一等
2020-02-29,930,3571,3702,7273,七堵,一等
2020-03-01,930,3594,3527,7121,七堵,一等
2020-03-02,930,5990,6211,12201,七堵,一等
2020-03-03,930,6000,6053,12053,七堵,一等
2020-03-04,930,5949,6040,11989,七堵,一等
2020-03-05,930,6035,6134,12169,七堵,一等
2020-03-06,930,6514,6811,13325,七堵,一等
2020-03-07,930,3860,3800,7660,七堵,一等
2020-03-08,930,3506,3621,7127,七堵,一等
2020-03-09,930,6146,6148,12294,七堵,一等
2020-03-10,930,5928,5967,11895,七堵,一等
2020-03-11,930,5992,6071,12063,七堵,一等
2020-03-12,930,5954,6200,12154,七堵,一等
2020-03-13,930,6203,6555,12758,七堵,一等
2020-03-14,930,3692,3598,7290,七堵,一等
2020-03-15,930,3710,3714,7424,七堵,一等
2020-03-16,930,6174,6290,12464,七堵,一等
2020-03-17,930,5903,5975,11878,七堵,一等
2020-03-18,930,5868,5958,11826,七堵,一等
2020-03-19,930,5876,5967,11843,七堵,一等
2020-03-20,930,6380,6567,12947,七堵,一等
2020-03-21,930,3615,3580,7195,七堵,一等
2020-03-22,930,3283,3189,6472,七堵,一等
2020-03-23,930,5830,5910,11740,七堵,一等
2020-03-24,930,5692,5800,11492,七堵,一等
2020-03-25,930,5804,5849,11653,七堵,一等
2020-03-26,930,5858,5985,11843,七堵,一等
2020-03-27,930,6216,6351,12567,七堵,一等
2020-03-28,930,2992,3058,6050,七堵,一等
2020-03-29,930,3167,3155,6322,七堵,一等
2020-03-30,930,5677,5956,11633,七堵,一等
2020-03-31,930,5766,5963,11729,七堵,一等
2020-04-01,930,6244,6657,12901,七堵,一等
2020-04-02,930,3523,3420,6943,七堵,一等
2020-04-03,930,3175,3301,6476,七堵,一等
2020-04-04,930,2618,2808,5426,七堵,一等
2020-04-05,930,2977,2870,5847,七堵,一等
2020-04-06,930,5779,5861,11640,七堵,一等
2020-04-07,930,5586,5684,11270,七堵,一等
2020-04-08,930,5528,5562,11090,七堵,一等
2020-04-09,930,5623,5768,11391,七堵,一等
2020-04-10,930,6038,6299,12337,七堵,一等
2020-04-11,930,2979,2999,5978,七堵,一等
2020-04-12,930,2616,2607,5223,七堵,一等
2020-04-13,930,5617,5733,11350,七堵,一等
2020-04-14,930,5626,5732,11358,七堵,一等
2020-04-15,930,5686,5736,11422,七堵,一等
2020-04-16,930,5625,5862,11487,七堵,一等
2020-04-17,930,6045,6292,12337,七堵,一等
2020-04-18,930,3509,3508,7017,七堵,一等
2020-04-19,930,3122,2996,6118,七堵,一等
2020-04-20,930,5747,5817,11564,七堵,一等
2020-04-21,930,5696,5714,11410,七堵,一等
2020-04-22,930,5472,5532,11004,七堵,一等
2020-04-23,930,5608,5777,11385,七堵,一等
2020-04-24,930,6007,6250,12257,七堵,一等
2020-04-25,930,3170,3094,6264,七堵,一等
2020-04-26,930,2784,2718,5502,七堵,一等
2020-04-27,930,5739,5753,11492,七堵,一等
2020-04-28,930,5737,5805,11542,七堵,一等
2020-04-29,930,5706,5753,11459,七堵,一等
2020-04-30,930,6061,5952,12013,七堵,一等
2020-05-01,930,5299,5332,10631,七堵,一等
2020-05-02,930,3447,3558,7005,七堵,一等
2020-05-03,930,3192,3280,6472,七堵,一等
2020-05-04,930,5860,5885,11745,七堵,一等
2020-05-05,930,5816,5870,11686,七堵,一等
2020-05-06,930,5897,5963,11860,七堵,一等
2020-05-07,930,5887,6028,11915,七堵,一等
2020-05-08,930,6465,6862,13327,七堵,一等
2020-05-09,930,4078,4183,8261,七堵,一等
2020-05-10,930,3743,3539,7282,七堵,一等
2020-05-11,930,6047,6101,12148,七堵,一等
2020-05-12,930,5787,5869,11656,七堵,一等
2020-05-13,930,5995,6111,12106,七堵,一等
2020-05-14,930,6006,6197,12203,七堵,一等
2020-05-15,930,6610,6871,13481,七堵,一等
2020-05-16,930,3742,3692,7434,七堵,一等
2020-05-17,930,3438,3542,6980,七堵,一等
2020-05-18,930,6025,6101,12126,七堵,一等
2020-05-19,930,5697,5837,11534,七堵,一等
2020-05-20,930,5945,5981,11926,七堵,一等
2020-05-21,930,6021,6022,12043,七堵,一等
2020-05-22,930,6271,6535,12806,七堵,一等
2020-05-23,930,3798,3798,7596,七堵,一等
2020-05-24,930,3943,3460,7403,七堵,一等
2020-05-25,930,5989,6022,12011,七堵,一等
2020-05-26,930,5920,6043,11963,七堵,一等
2020-05-27,930,5892,5899,11791,七堵,一等
2020-05-28,930,5914,5993,11907,七堵,一等
2020-05-29,930,6453,6729,13182,七堵,一等
2020-05-30,930,4390,4396,8786,七堵,一等
2020-05-31,930,3703,3832,7535,七堵,一等
2020-06-01,930,6050,6143,12193,七堵,一等
2020-06-02,930,6036,6077,12113,七堵,一等
2020-06-03,930,5973,6082,12055,七堵,一等
2020-06-04,930,5843,4752,10595,七堵,一等
2020-06-05,930,6729,6846,13575,七堵,一等
2020-06-06,930,4355,4262,8617,七堵,一等
2020-06-07,930,3817,3880,7697,七堵,一等
2020-06-08,930,6160,6238,12398,七堵,一等
2020-06-09,930,6014,6207,12221,七堵,一等
2020-06-10,930,6186,6233,12419,七堵,一等
2020-06-11,930,6421,6388,12809,七堵,一等
2020-06-12,930,6707,7013,13720,七堵,一等
2020-06-13,930,4545,4632,9177,七堵,一等
2020-06-14,930,4037,4101,8138,七堵,一等
2020-06-15,930,6164,6262,12426,七堵,一等
2020-06-16,930,6286,6324,12610,七堵,一等
2020-06-17,930,5866,6009,11875,七堵,一等
2020-06-18,930,5834,5950,11784,七堵,一等
2020-06-19,930,6133,6418,12551,七堵,一等
2020-06-20,930,5426,5546,10972,七堵,一等
2020-06-21,930,3640,3771,7411,七堵,一等
2020-06-22,930,6117,6237,12354,七堵,一等
2020-06-23,930,6079,6094,12173,七堵,一等
2020-06-24,930,6437,6915,13352,七堵,一等
2020-06-25,930,4619,4607,9226,七堵,一等
2020-06-26,930,4971,4887,9858,七堵,一等
2020-06-27,930,4419,4602,9021,七堵,一等
2020-06-28,930,3912,4041,7953,七堵,一等
2020-06-29,930,6158,6256,12414,七堵,一等
2020-06-30,930,5904,6072,11976,七堵,一等
2020-07-01,930,5822,5870,11692,七堵,一等
2020-07-02,930,5985,6014,11999,七堵,一等
2020-07-03,930,6146,6505,12651,七堵,一等
2020-07-04,930,4913,4538,9451,七堵,一等
2020-07-05,930,3959,4412,8371,七堵,一等
2020-07-06,930,6060,6172,12232,七堵,一等
2020-07-07,930,5984,6002,11986,七堵,一等
2020-07-08,930,5972,6048,12020,七堵,一等
2020-07-09,930,5995,6033,12028,七堵,一等
2020-07-10,930,6851,7022,13873,七堵,一等
2020-07-11,930,4720,4493,9213,七堵,一等
2020-07-12,930,3932,4149,8081,七堵,一等
2020-07-13,930,6222,6429,12651,七堵,一等
2020-07-14,930,6358,6373,12731,七堵,一等
2020-07-15,930,6038,6134,12172,七堵,一等
2020-07-16,930,6037,5681,11718,七堵,一等
2020-07-17,930,6669,6634,13303,七堵,一等
2020-07-18,930,4782,4797,9579,七堵,一等
2020-07-19,930,4020,4444,8464,七堵,一等
2020-07-20,930,6175,6135,12310,七堵,一等
2020-07-21,930,6081,6266,12347,七堵,一等
2020-07-22,930,6036,6006,12042,七堵,一等
2020-07-23,930,6205,6072,12277,七堵,一等
2020-07-24,930,6532,6659,13191,七堵,一等
2020-07-25,930,4467,4434,8901,七堵,一等
2020-07-26,930,4127,4324,8451,七堵,一等
2020-07-27,930,6008,6258,12266,七堵,一等
2020-07-28,930,5894,5923,11817,七堵,一等
2020-07-29,930,6005,5949,11954,七堵,一等
2020-07-30,930,6056,6082,12138,七堵,一等
2020-07-31,930,6369,6532,12901,七堵,一等
2020-08-01,930,4784,4726,9510,七堵,一等
2020-08-02,930,4027,4208,8235,七堵,一等
2020-08-03,930,5327,5553,10880,七堵,一等
2020-08-04,930,5838,5755,11593,七堵,一等
2020-08-05,930,5763,5773,11536,七堵,一等
2020-08-06,930,5811,5790,11601,七堵,一等
2020-08-07,930,6150,6436,12586,七堵,一等
2020-08-08,930,4372,4521,8893,七堵,一等
2020-08-09,930,4464,4474,8938,七堵,一等
2020-08-10,930,5881,5972,11853,七堵,一等
2020-08-11,930,5572,5751,11323,七堵,一等
2020-08-12,930,5593,5823,11416,七堵,一等
2020-08-13,930,5826,5845,11671,七堵,一等
2020-08-14,930,6104,6222,12326,七堵,一等
2020-08-15,930,4771,4778,9549,七堵,一等
2020-08-16,930,4538,4700,9238,七堵,一等
2020-08-17,930,5813,6080,11893,七堵,一等
2020-08-18,930,6137,6365,12502,七堵,一等
2020-08-19,930,5681,5785,11466,七堵,一等
2020-08-20,930,5656,5795,11451,七堵,一等
2020-08-21,930,6290,6608,12898,七堵,一等
2020-08-22,930,4705,4546,9251,七堵,一等
2020-08-23,930,4049,4280,8329,七堵,一等
2020-08-24,930,5946,6080,12026,七堵,一等
2020-08-25,930,5993,6028,12021,七堵,一等
2020-08-26,930,5789,5915,11704,七堵,一等
2020-08-27,930,5644,5859,11503,七堵,一等
2020-08-28,930,6179,6092,12271,七堵,一等
2020-08-29,930,4483,4647,9130,七堵,一等
2020-08-30,930,3979,4256,8235,七堵,一等
2020-08-31,930,6302,6448,12750,七堵,一等
2020-09-01,930,6249,6271,12520,七堵,一等
2020-09-02,930,6338,6382,12720,七堵,一等
2020-09-03,930,6376,6319,12695,七堵,一等
2020-09-04,930,6953,7049,14002,七堵,一等
2020-09-05,930,4544,4543,9087,七堵,一等
2020-09-06,930,4181,4350,8531,七堵,一等
2020-09-07,930,6421,6543,12964,七堵,一等
2020-09-08,930,6345,6408,12753,七堵,一等
2020-09-09,930,6440,6550,12990,七堵,一等
2020-09-10,930,6396,6380,12776,七堵,一等
2020-09-11,930,6983,7208,14191,七堵,一等
2020-09-12,930,4566,4518,9084,七堵,一等
2020-09-13,930,3870,3921,7791,七堵,一等
2020-09-14,930,6415,6435,12850,七堵,一等
2020-09-15,930,6370,6357,12727,七堵,一等
2020-09-16,930,6245,6400,12645,七堵,一等
2020-09-17,930,6073,6230,12303,七堵,一等
2020-09-18,930,6862,7228,14090,七堵,一等
2020-09-19,930,4913,4782,9695,七堵,一等
2020-09-20,930,4158,4208,8366,七堵,一等
2020-09-21,930,6394,6453,12847,七堵,一等
2020-09-22,930,6468,6551,13019,七堵,一等
2020-09-23,930,6418,6480,12898,七堵,一等
2020-09-24,930,6435,6504,12939,七堵,一等
2020-09-25,930,6655,6842,13497,七堵,一等
2020-09-26,930,5744,5874,11618,七堵,一等
2020-09-27,930,3498,3715,7213,七堵,一等
2020-09-28,930,6432,6424,12856,七堵,一等
2020-09-29,930,6440,6486,12926,七堵,一等
2020-09-30,930,6936,7730,14666,七堵,一等
2020-10-01,930,5144,5311,10455,七堵,一等
2020-10-02,930,5196,5190,10386,七堵,一等
2020-10-03,930,4704,4845,9549,七堵,一等
2020-10-04,930,4888,4558,9446,七堵,一等
2020-10-05,930,6605,6534,13139,七堵,一等
2020-10-06,930,6380,6429,12809,七堵,一等
2020-10-07,930,6476,6568,13044,七堵,一等
2020-10-08,930,6924,7209,14133,七堵,一等
2020-10-09,930,5339,5446,10785,七堵,一等
2020-10-10,930,4377,4474,8851,七堵,一等
2020-10-11,930,4354,4383,8737,七堵,一等
2020-10-12,930,6545,6543,13088,七堵,一等
2020-10-13,930,6354,6372,12726,七堵,一等
2020-10-14,930,6515,6526,13041,七堵,一等
2020-10-15,930,6551,6552,13103,七堵,一等
2020-10-16,930,6954,7221,14175,七堵,一等
2020-10-17,930,4602,4703,9305,七堵,一等
2020-10-18,930,4329,4348,8677,七堵,一等
2020-10-19,930,6456,6594,13050,七堵,一等
2020-10-20,930,6452,6529,12981,七堵,一等
2020-10-21,930,6313,6447,12760,七堵,一等
2020-10-22,930,6511,6510,13021,七堵,一等
2020-10-23,930,7017,7387,14404,七堵,一等
2020-10-24,930,4765,4843,9608,七堵,一等
2020-10-25,930,4515,4518,9033,七堵,一等
2020-10-26,930,6648,6574,13222,七堵,一等
2020-10-27,930,6673,6633,13306,七堵,一等
2020-10-28,930,6576,6380,12956,七堵,一等
2020-10-29,930,6390,6573,12963,七堵,一等
2020-10-30,930,6897,7342,14239,七堵,一等
2020-10-31,930,4775,4774,9549,七堵,一等
2020-11-01,930,4225,4300,8525,七堵,一等
2020-11-02,930,6405,6539,12944,七堵,一等
2020-11-03,930,6324,6251,12575,七堵,一等
2020-11-04,930,6534,6565,13099,七堵,一等
2020-11-05,930,6287,6427,12714,七堵,一等
2020-11-06,930,7001,7120,14121,七堵,一等
2020-11-07,930,4848,4799,9647,七堵,一等
2020-11-08,930,4145,4127,8272,七堵,一等
2020-11-09,930,6523,6488,13011,七堵,一等
2020-11-10,930,6453,6441,12894,七堵,一等
2020-11-11,930,6494,6481,12975,七堵,一等
2020-11-12,930,6445,6436,12881,七堵,一等
2020-11-13,930,6916,7240,14156,七堵,一等
2020-11-14,930,4714,4669,9383,七堵,一等
2020-11-15,930,4850,4796,9646,七堵,一等
2020-11-16,930,6640,6678,13318,七堵,一等
2020-11-17,930,6503,6505,13008,七堵,一等
2020-11-18,930,6605,6594,13199,七堵,一等
2020-11-19,930,6961,6856,13817,七堵,一等
2020-11-20,930,7202,7613,14815,七堵,一等
2020-11-21,930,4738,4842,9580,七堵,一等
2020-11-22,930,4623,4636,9259,七堵,一等
2020-11-23,930,6492,6520,13012,七堵,一等
2020-11-24,930,6410,6398,12808,七堵,一等
2020-11-25,930,6590,6589,13179,七堵,一等
2020-11-26,930,6556,6626,13182,七堵,一等
2020-11-27,930,6936,7377,14313,七堵,一等
2020-11-28,930,4424,4372,8796,七堵,一等
2020-11-29,930,4011,4100,8111,七堵,一等
2020-11-30,930,6494,6450,12944,七堵,一等
2020-12-01,930,6255,6246,12501,七堵,一等
2020-12-02,930,6376,6406,12782,七堵,一等
2020-12-03,930,6346,6478,12824,七堵,一等
2020-12-04,930,7005,7248,14253,七堵,一等
2020-12-05,930,4340,4385,8725,七堵,一等
2020-12-06,930,4627,4828,9455,七堵,一等
2020-12-07,930,6375,6392,12767,七堵,一等
2020-12-08,930,6177,6183,12360,七堵,一等
2020-12-09,930,6077,6161,12238,七堵,一等
2020-12-10,930,6169,6095,12264,七堵,一等
2020-12-11,930,6772,6982,13754,七堵,一等
2020-12-12,930,5149,4796,9945,七堵,一等
2020-12-13,930,4478,4519,8997,七堵,一等
2020-12-14,930,6438,6413,12851,七堵,一等
2020-12-15,930,6284,6290,12574,七堵,一等
2020-12-16,930,6231,6274,12505,七堵,一等
2020-12-17,930,6505,6479,12984,七堵,一等
2020-12-18,930,7076,7325,14401,七堵,一等
2020-12-19,930,4668,4606,9274,七堵,一等
2020-12-20,930,4261,4205,8466,七堵,一等
2020-12-21,930,6393,6447,12840,七堵,一等
2020-12-22,930,6424,6373,12797,七堵,一等
2020-12-23,930,6301,6250,12551,七堵,一等
2020-12-24,930,6475,6476,12951,七堵,一等
2020-12-25,930,6965,7193,14158,七堵,一等
2020-12-26,930,4576,4665,9241,七堵,一等
2020-12-27,930,4130,4228,8358,七堵,一等
2020-12-28,930,6617,6518,13135,七堵,一等
2020-12-29,930,6461,6483,12944,七堵,一等
2020-12-30,930,6405,6273,12678,七堵,一等
2020-12-31,930,7236,6907,14143,七堵,一等
2020-01-01,940,1818,2128,3946,百福,簡易
2020-01-02,940,3007,2934,5941,百福,簡易
2020-01-03,940,3141,3120,6261,百福,簡易
2020-01-04,940,2553,2435,4988,百福,簡易
2020-01-05,940,1903,1848,3751,百福,簡易
2020-01-06,940,2976,2898,5874,百福,簡易
2020-01-07,940,2971,2942,5913,百福,簡易
2020-01-08,940,2887,2898,5785,百福,簡易
2020-01-09,940,3030,3035,6065,百福,簡易
2020-01-10,940,3294,3381,6675,百福,簡易
2020-01-11,940,2478,2490,4968,百福,簡易
2020-01-12,940,2007,1886,3893,百福,簡易
2020-01-13,940,3042,2967,6009,百福,簡易
2020-01-14,940,2869,3003,5872,百福,簡易
2020-01-15,940,2795,2862,5657,百福,簡易
2020-01-16,940,3091,3054,6145,百福,簡易
2020-01-17,940,2850,2843,5693,百福,簡易
2020-01-18,940,2515,2368,4883,百福,簡易
2020-01-19,940,1958,1973,3931,百福,簡易
2020-01-20,940,2897,2896,5793,百福,簡易
2020-01-21,940,2607,2912,5519,百福,簡易
2020-01-22,940,2633,2872,5505,百福,簡易
2020-01-23,940,1802,1840,3642,百福,簡易
2020-01-24,940,1155,1189,2344,百福,簡易
2020-01-25,940,1606,1464,3070,百福,簡易
2020-01-26,940,1498,1408,2906,百福,簡易
2020-01-27,940,1707,1641,3348,百福,簡易
2020-01-28,940,1753,1782,3535,百福,簡易
2020-01-29,940,1653,1726,3379,百福,簡易
2020-01-30,940,2502,2476,4978,百福,簡易
2020-01-31,940,2715,2672,5387,百福,簡易
2020-02-01,940,1988,1867,3855,百福,簡易
2020-02-02,940,1755,1711,3466,百福,簡易
2020-02-03,940,2636,2563,5199,百福,簡易
2020-02-04,940,2488,2524,5012,百福,簡易
2020-02-05,940,2472,2471,4943,百福,簡易
2020-02-06,940,2641,2613,5254,百福,簡易
2020-02-07,940,2749,2615,5364,百福,簡易
2020-02-08,940,1852,1689,3541,百福,簡易
2020-02-09,940,1502,1505,3007,百福,簡易
2020-02-10,940,2570,2493,5063,百福,簡易
2020-02-11,940,2568,2594,5162,百福,簡易
2020-02-12,940,2717,2625,5342,百福,簡易
2020-02-13,940,2633,2521,5154,百福,簡易
2020-02-14,940,2741,2698,5439,百福,簡易
2020-02-15,940,2390,2310,4700,百福,簡易
2020-02-16,940,1406,1447,2853,百福,簡易
2020-02-17,940,2033,2507,4540,百福,簡易
2020-02-18,940,2587,2627,5214,百福,簡易
2020-02-19,940,2570,2633,5203,百福,簡易
2020-02-20,940,2528,2533,5061,百福,簡易
2020-02-21,940,2712,2589,5301,百福,簡易
2020-02-22,940,1781,1787,3568,百福,簡易
2020-02-23,940,1591,1551,3142,百福,簡易
2020-02-24,940,2577,2559,5136,百福,簡易
2020-02-25,940,2779,2790,5569,百福,簡易
2020-02-26,940,2733,2760,5493,百福,簡易
2020-02-27,940,2896,2822,5718,百福,簡易
2020-02-28,940,1925,1885,3810,百福,簡易
2020-02-29,940,1729,1714,3443,百福,簡易
2020-03-01,940,1547,1477,3024,百福,簡易
2020-03-02,940,2721,2776,5497,百福,簡易
2020-03-03,940,2729,2749,5478,百福,簡易
2020-03-04,940,2640,2656,5296,百福,簡易
2020-03-05,940,2591,2668,5259,百福,簡易
2020-03-06,940,2888,2967,5855,百福,簡易
2020-03-07,940,1864,1811,3675,百福,簡易
2020-03-08,940,1627,1526,3153,百福,簡易
2020-03-09,940,2764,2751,5515,百福,簡易
2020-03-10,940,2621,2653,5274,百福,簡易
2020-03-11,940,2737,2791,5528,百福,簡易
2020-03-12,940,2615,2747,5362,百福,簡易
2020-03-13,940,2762,2883,5645,百福,簡易
2020-03-14,940,1714,1697,3411,百福,簡易
2020-03-15,940,1657,1598,3255,百福,簡易
2020-03-16,940,2786,2747,5533,百福,簡易
2020-03-17,940,2678,2745,5423,百福,簡易
2020-03-18,940,2602,2674,5276,百福,簡易
2020-03-19,940,2601,2607,5208,百福,簡易
2020-03-20,940,2769,2856,5625,百福,簡易
2020-03-21,940,1623,1662,3285,百福,簡易
2020-03-22,940,1434,1377,2811,百福,簡易
2020-03-23,940,2600,2338,4938,百福,簡易
2020-03-24,940,2500,2609,5109,百福,簡易
2020-03-25,940,2650,2613,5263,百福,簡易
2020-03-26,940,2583,2572,5155,百福,簡易
2020-03-27,940,2668,2740,5408,百福,簡易
2020-03-28,940,1415,1442,2857,百福,簡易
2020-03-29,940,1410,1352,2762,百福,簡易
2020-03-30,940,2478,2553,5031,百福,簡易
2020-03-31,940,2601,2624,5225,百福,簡易
2020-04-01,940,2658,2717,5375,百福,簡易
2020-04-02,940,1395,1468,2863,百福,簡易
2020-04-03,940,1420,1435,2855,百福,簡易
2020-04-04,940,1214,1171,2385,百福,簡易
2020-04-05,940,1290,1134,2424,百福,簡易
2020-04-06,940,2607,2522,5129,百福,簡易
2020-04-07,940,2480,2522,5002,百福,簡易
2020-04-08,940,2445,2494,4939,百福,簡易
2020-04-09,940,2516,2503,5019,百福,簡易
2020-04-10,940,2637,2726,5363,百福,簡易
2020-04-11,940,1446,1468,2914,百福,簡易
2020-04-12,940,1301,1262,2563,百福,簡易
2020-04-13,940,2517,2497,5014,百福,簡易
2020-04-14,940,2548,2536,5084,百福,簡易
2020-04-15,940,2543,2566,5109,百福,簡易
2020-04-16,940,2533,2524,5057,百福,簡易
2020-04-17,940,2659,2719,5378,百福,簡易
2020-04-18,940,1633,1640,3273,百福,簡易
2020-04-19,940,1448,1437,2885,百福,簡易
2020-04-20,940,2595,2520,5115,百福,簡易
2020-04-21,940,2527,2514,5041,百福,簡易
2020-04-22,940,2503,2501,5004,百福,簡易
2020-04-23,940,2425,2504,4929,百福,簡易
2020-04-24,940,2600,2651,5251,百福,簡易
2020-04-25,940,1588,1604,3192,百福,簡易
2020-04-26,940,1277,1230,2507,百福,簡易
2020-04-27,940,2659,2547,5206,百福,簡易
2020-04-28,940,2570,2628,5198,百福,簡易
2020-04-29,940,2520,2555,5075,百福,簡易
2020-04-30,940,2667,2642,5309,百福,簡易
2020-05-01,940,2193,2254,4447,百福,簡易
2020-05-02,940,1620,1661,3281,百福,簡易
2020-05-03,940,1475,1368,2843,百福,簡易
2020-05-04,940,2648,2608,5256,百福,簡易
2020-05-05,940,2554,2639,5193,百福,簡易
2020-05-06,940,2663,2613,5276,百福,簡易
2020-05-07,940,2600,2647,5247,百福,簡易
2020-05-08,940,2745,2885,5630,百福,簡易
2020-05-09,940,1865,1814,3679,百福,簡易
2020-05-10,940,1521,1410,2931,百福,簡易
2020-05-11,940,2688,2584,5272,百福,簡易
2020-05-12,940,2596,2622,5218,百福,簡易
2020-05-13,940,2598,2631,5229,百福,簡易
2020-05-14,940,2630,2623,5253,百福,簡易
2020-05-15,940,2899,2944,5843,百福,簡易
2020-05-16,940,1835,1776,3611,百福,簡易
2020-05-17,940,1573,1480,3053,百福,簡易
2020-05-18,940,2624,2579,5203,百福,簡易
2020-05-19,940,2587,2576,5163,百福,簡易
2020-05-20,940,2579,2615,5194,百福,簡易
2020-05-21,940,2653,2603,5256,百福,簡易
2020-05-22,940,2656,2695,5351,百福,簡易
2020-05-23,940,1614,1609,3223,百福,簡易
2020-05-24,940,1685,1566,3251,百福,簡易
2020-05-25,940,2646,2680,5326,百福,簡易
2020-05-26,940,2686,2742,5428,百福,簡易
2020-05-27,940,2608,2676,5284,百福,簡易
2020-05-28,940,2511,2503,5014,百福,簡易
2020-05-29,940,2741,2784,5525,百福,簡易
2020-05-30,940,1902,1848,3750,百福,簡易
2020-05-31,940,1649,1520,3169,百福,簡易
2020-06-01,940,2642,2640,5282,百福,簡易
2020-06-02,940,2653,2604,5257,百福,簡易
2020-06-03,940,2697,2651,5348,百福,簡易
2020-06-04,940,2530,2630,5160,百福,簡易
2020-06-05,940,2848,2746,5594,百福,簡易
2020-06-06,940,2047,1992,4039,百福,簡易
2020-06-07,940,1578,1642,3220,百福,簡易
2020-06-08,940,2686,2605,5291,百福,簡易
2020-06-09,940,2670,2630,5300,百福,簡易
2020-06-10,940,2689,2685,5374,百福,簡易
2020-06-11,940,2753,2649,5402,百福,簡易
2020-06-12,940,2875,2844,5719,百福,簡易
2020-06-13,940,2106,2116,4222,百福,簡易
2020-06-14,940,1726,1670,3396,百福,簡易
2020-06-15,940,2728,2689,5417,百福,簡易
2020-06-16,940,2668,2632,5300,百福,簡易
2020-06-17,940,2595,2644,5239,百福,簡易
2020-06-18,940,2637,2637,5274,百福,簡易
2020-06-19,940,2680,2746,5426,百福,簡易
2020-06-20,940,2326,2356,4682,百福,簡易
2020-06-21,940,1705,1632,3337,百福,簡易
2020-06-22,940,2569,2614,5183,百福,簡易
2020-06-23,940,2684,2696,5380,百福,簡易
2020-06-24,940,2784,2755,5539,百福,簡易
2020-06-25,940,1727,1680,3407,百福,簡易
2020-06-26,940,2011,1863,3874,百福,簡易
2020-06-27,940,1779,1755,3534,百福,簡易
2020-06-28,940,1668,1586,3254,百福,簡易
2020-06-29,940,2655,2610,5265,百福,簡易
2020-06-30,940,2603,2611,5214,百福,簡易
2020-07-01,940,2599,2582,5181,百福,簡易
2020-07-02,940,2605,2540,5145,百福,簡易
2020-07-03,940,2740,2715,5455,百福,簡易
2020-07-04,940,1955,1978,3933,百福,簡易
2020-07-05,940,1730,1691,3421,百福,簡易
2020-07-06,940,2623,2649,5272,百福,簡易
2020-07-07,940,2666,2630,5296,百福,簡易
2020-07-08,940,2634,2583,5217,百福,簡易
2020-07-09,940,2579,2663,5242,百福,簡易
2020-07-10,940,2868,2791,5659,百福,簡易
2020-07-11,940,2047,1977,4024,百福,簡易
2020-07-12,940,1726,1677,3403,百福,簡易
2020-07-13,940,2623,2623,5246,百福,簡易
2020-07-14,940,2713,2776,5489,百福,簡易
2020-07-15,940,2669,2601,5270,百福,簡易
2020-07-16,940,2599,2644,5243,百福,簡易
2020-07-17,940,2867,2692,5559,百福,簡易
2020-07-18,940,2127,2049,4176,百福,簡易
2020-07-19,940,1799,1779,3578,百福,簡易
2020-07-20,940,2670,2608,5278,百福,簡易
2020-07-21,940,2670,2582,5252,百福,簡易
2020-07-22,940,2578,2604,5182,百福,簡易
2020-07-23,940,2645,2612,5257,百福,簡易
2020-07-24,940,2673,2574,5247,百福,簡易
2020-07-25,940,1987,1969,3956,百福,簡易
2020-07-26,940,1669,1664,3333,百福,簡易
2020-07-27,940,2592,2585,5177,百福,簡易
2020-07-28,940,2667,2588,5255,百福,簡易
2020-07-29,940,2721,2732,5453,百福,簡易
2020-07-30,940,2721,2738,5459,百福,簡易
2020-07-31,940,2746,2615,5361,百福,簡易
2020-08-01,940,2262,2107,4369,百福,簡易
2020-08-02,940,1743,1786,3529,百福,簡易
2020-08-03,940,2326,2308,4634,百福,簡易
2020-08-04,940,2603,2625,5228,百福,簡易
2020-08-05,940,2652,2603,5255,百福,簡易
2020-08-06,940,2547,2599,5146,百福,簡易
2020-08-07,940,2811,2699,5510,百福,簡易
2020-08-08,940,1947,1885,3832,百福,簡易
2020-08-09,940,1841,1825,3666,百福,簡易
2020-08-10,940,2624,2626,5250,百福,簡易
2020-08-11,940,2593,2574,5167,百福,簡易
2020-08-12,940,2606,2619,5225,百福,簡易
2020-08-13,940,2720,2672,5392,百福,簡易
2020-08-14,940,2747,2654,5401,百福,簡易
2020-08-15,940,2215,2119,4334,百福,簡易
2020-08-16,940,1820,1916,3736,百福,簡易
2020-08-17,940,2566,2568,5134,百福,簡易
2020-08-18,940,2728,2656,5384,百福,簡易
2020-08-19,940,2709,2755,5464,百福,簡易
2020-08-20,940,2653,2654,5307,百福,簡易
2020-08-21,940,2701,2655,5356,百福,簡易
2020-08-22,940,2147,2003,4150,百福,簡易
2020-08-23,940,1594,1690,3284,百福,簡易
2020-08-24,940,2585,2594,5179,百福,簡易
2020-08-25,940,2724,2662,5386,百福,簡易
2020-08-26,940,2755,2705,5460,百福,簡易
2020-08-27,940,2490,2509,4999,百福,簡易
2020-08-28,940,2764,2632,5396,百福,簡易
2020-08-29,940,1990,2021,4011,百福,簡易
2020-08-30,940,1698,1661,3359,百福,簡易
2020-08-31,940,2676,2661,5337,百福,簡易
2020-09-01,940,2706,2700,5406,百福,簡易
2020-09-02,940,2658,2658,5316,百福,簡易
2020-09-03,940,2761,2729,5490,百福,簡易
2020-09-04,940,2877,2873,5750,百福,簡易
2020-09-05,940,2040,1999,4039,百福,簡易
2020-09-06,940,1682,1665,3347,百福,簡易
2020-09-07,940,2730,2711,5441,百福,簡易
2020-09-08,940,2723,2764,5487,百福,簡易
2020-09-09,940,2728,2673,5401,百福,簡易
2020-09-10,940,2763,2788,5551,百福,簡易
2020-09-11,940,2926,2880,5806,百福,簡易
2020-09-12,940,2127,2013,4140,百福,簡易
2020-09-13,940,1569,1585,3154,百福,簡易
2020-09-14,940,2728,2741,5469,百福,簡易
2020-09-15,940,2798,2740,5538,百福,簡易
2020-09-16,940,2812,2785,5597,百福,簡易
2020-09-17,940,2692,2746,5438,百福,簡易
2020-09-18,940,3004,2946,5950,百福,簡易
2020-09-19,940,2247,2214,4461,百福,簡易
2020-09-20,940,1593,1558,3151,百福,簡易
2020-09-21,940,2768,2717,5485,百福,簡易
2020-09-22,940,2794,2838,5632,百福,簡易
2020-09-23,940,2759,2788,5547,百福,簡易
2020-09-24,940,2688,2703,5391,百福,簡易
2020-09-25,940,2831,2881,5712,百福,簡易
2020-09-26,940,2457,2444,4901,百福,簡易
2020-09-27,940,1621,1629,3250,百福,簡易
2020-09-28,940,2683,2691,5374,百福,簡易
2020-09-29,940,2819,2776,5595,百福,簡易
2020-09-30,940,2829,3039,5868,百福,簡易
2020-10-01,940,2037,2040,4077,百福,簡易
2020-10-02,940,2227,2146,4373,百福,簡易
2020-10-03,940,2194,2130,4324,百福,簡易
2020-10-04,940,1828,1612,3440,百福,簡易
2020-10-05,940,2792,2729,5521,百福,簡易
2020-10-06,940,2748,2777,5525,百福,簡易
2020-10-07,940,2798,2785,5583,百福,簡易
2020-10-08,940,2943,3040,5983,百福,簡易
2020-10-09,940,2282,2218,4500,百福,簡易
2020-10-10,940,1933,1920,3853,百福,簡易
2020-10-11,940,1676,1595,3271,百福,簡易
2020-10-12,940,2773,2773,5546,百福,簡易
2020-10-13,940,2741,2764,5505,百福,簡易
2020-10-14,940,2827,2879,5706,百福,簡易
2020-10-15,940,2797,2785,5582,百福,簡易
2020-10-16,940,2919,2973,5892,百福,簡易
2020-10-17,940,2178,2100,4278,百福,簡易
2020-10-18,940,1739,1713,3452,百福,簡易
2020-10-19,940,2794,2765,5559,百福,簡易
2020-10-20,940,2809,2810,5619,百福,簡易
2020-10-21,940,2723,2741,5464,百福,簡易
2020-10-22,940,2670,2698,5368,百福,簡易
2020-10-23,940,2955,2917,5872,百福,簡易
2020-10-24,940,2386,2315,4701,百福,簡易
2020-10-25,940,1807,1793,3600,百福,簡易
2020-10-26,940,2807,2749,5556,百福,簡易
2020-10-27,940,2769,2804,5573,百福,簡易
2020-10-28,940,2791,2820,5611,百福,簡易
2020-10-29,940,2704,2742,5446,百福,簡易
2020-10-30,940,2997,2987,5984,百福,簡易
2020-10-31,940,2336,2246,4582,百福,簡易
2020-11-01,940,1938,1901,3839,百福,簡易
2020-11-02,940,2797,2817,5614,百福,簡易
2020-11-03,940,2800,2824,5624,百福,簡易
2020-11-04,940,2854,2876,5730,百福,簡易
2020-11-05,940,3019,2999,6018,百福,簡易
2020-11-06,940,2979,2989,5968,百福,簡易
2020-11-07,940,2361,2322,4683,百福,簡易
2020-11-08,940,1713,1691,3404,百福,簡易
2020-11-09,940,2797,2810,5607,百福,簡易
2020-11-10,940,2793,2834,5627,百福,簡易
2020-11-11,940,2918,2852,5770,百福,簡易
2020-11-12,940,2757,2832,5589,百福,簡易
2020-11-13,940,2995,3009,6004,百福,簡易
2020-11-14,940,2263,2239,4502,百福,簡易
2020-11-15,940,2063,1989,4052,百福,簡易
2020-11-16,940,2818,2788,5606,百福,簡易
2020-11-17,940,3003,3032,6035,百福,簡易
2020-11-18,940,2876,2875,5751,百福,簡易
2020-11-19,940,2789,2871,5660,百福,簡易
2020-11-20,940,2999,3020,6019,百福,簡易
2020-11-21,940,2323,2241,4564,百福,簡易
2020-11-22,940,1951,2012,3963,百福,簡易
2020-11-23,940,2729,2708,5437,百福,簡易
2020-11-24,940,2821,2848,5669,百福,簡易
2020-11-25,940,2831,2809,5640,百福,簡易
2020-11-26,940,2886,2833,5719,百福,簡易
2020-11-27,940,2986,3071,6057,百福,簡易
2020-11-28,940,2170,2094,4264,百福,簡易
2020-11-29,940,1776,1724,3500,百福,簡易
2020-11-30,940,2761,2740,5501,百福,簡易
2020-12-01,940,2641,2674,5315,百福,簡易
2020-12-02,940,2698,2734,5432,百福,簡易
2020-12-03,940,2757,2744,5501,百福,簡易
2020-12-04,940,2882,2960,5842,百福,簡易
2020-12-05,940,2144,2151,4295,百福,簡易
2020-12-06,940,1775,1665,3440,百福,簡易
2020-12-07,940,2673,2696,5369,百福,簡易
2020-12-08,940,2713,2760,5473,百福,簡易
2020-12-09,940,2678,2724,5402,百福,簡易
2020-12-10,940,2781,2746,5527,百福,簡易
2020-12-11,940,2980,3006,5986,百福,簡易
2020-12-12,940,2417,2316,4733,百福,簡易
2020-12-13,940,2016,1985,4001,百福,簡易
2020-12-14,940,2769,2743,5512,百福,簡易
2020-12-15,940,2707,2719,5426,百福,簡易
2020-12-16,940,2696,2733,5429,百福,簡易
2020-12-17,940,2752,2785,5537,百福,簡易
2020-12-18,940,3029,2992,6021,百福,簡易
2020-12-19,940,2176,2150,4326,百福,簡易
2020-12-20,940,1792,1714,3506,百福,簡易
2020-12-21,940,2745,2770,5515,百福,簡易
2020-12-22,940,2762,2858,5620,百福,簡易
2020-12-23,940,2756,2735,5491,百福,簡易
2020-12-24,940,2823,2788,5611,百福,簡易
2020-12-25,940,3058,3025,6083,百福,簡易
2020-12-26,940,2305,2238,4543,百福,簡易
2020-12-27,940,1907,1840,3747,百福,簡易
2020-12-28,940,2804,2811,5615,百福,簡易
2020-12-29,940,2846,2860,5706,百福,簡易
2020-12-30,940,2777,2767,5544,百福,簡易
2020-12-31,940,3154,2759,5913,百福,簡易
2020-01-01,950,1293,1453,2746,五堵,簡易
2020-01-02,950,2283,2032,4315,五堵,簡易
2020-01-03,950,2437,1999,4436,五堵,簡易
2020-01-04,950,1851,1478,3329,五堵,簡易
2020-01-05,950,1475,1323,2798,五堵,簡易
2020-01-06,950,2230,1989,4219,五堵,簡易
2020-01-07,950,2342,2024,4366,五堵,簡易
2020-01-08,950,2246,1952,4198,五堵,簡易
2020-01-09,950,2373,2080,4453,五堵,簡易
2020-01-10,950,2561,2062,4623,五堵,簡易
2020-01-11,950,1672,1501,3173,五堵,簡易
2020-01-12,950,1444,1261,2705,五堵,簡易
2020-01-13,950,2271,2017,4288,五堵,簡易
2020-01-14,950,2511,2033,4544,五堵,簡易
2020-01-15,950,1694,1830,3524,五堵,簡易
2020-01-16,950,2393,2046,4439,五堵,簡易
2020-01-17,950,2378,1892,4270,五堵,簡易
2020-01-18,950,1780,1508,3288,五堵,簡易
2020-01-19,950,1383,1259,2642,五堵,簡易
2020-01-20,950,2290,1954,4244,五堵,簡易
2020-01-21,950,2034,1872,3906,五堵,簡易
2020-01-22,950,2064,1798,3862,五堵,簡易
2020-01-23,950,1372,1136,2508,五堵,簡易
2020-01-24,950,927,763,1690,五堵,簡易
2020-01-25,950,1260,1085,2345,五堵,簡易
2020-01-26,950,1067,950,2017,五堵,簡易
2020-01-27,950,1409,1234,2643,五堵,簡易
2020-01-28,950,1221,1186,2407,五堵,簡易
2020-01-29,950,1166,1044,2210,五堵,簡易
2020-01-30,950,1862,1621,3483,五堵,簡易
2020-01-31,950,2032,1627,3659,五堵,簡易
2020-02-01,950,1364,1173,2537,五堵,簡易
2020-02-02,950,1229,1145,2374,五堵,簡易
2020-02-03,950,2018,1732,3750,五堵,簡易
2020-02-04,950,1989,1679,3668,五堵,簡易
2020-02-05,950,1993,1660,3653,五堵,簡易
2020-02-06,950,2062,1693,3755,五堵,簡易
2020-02-07,950,2038,1658,3696,五堵,簡易
2020-02-08,950,1267,1104,2371,五堵,簡易
2020-02-09,950,1104,1008,2112,五堵,簡易
2020-02-10,950,1968,1737,3705,五堵,簡易
2020-02-11,950,1964,1675,3639,五堵,簡易
2020-02-12,950,2055,1701,3756,五堵,簡易
2020-02-13,950,2026,1705,3731,五堵,簡易
2020-02-14,950,2109,1700,3809,五堵,簡易
2020-02-15,950,1789,1467,3256,五堵,簡易
2020-02-16,950,1023,896,1919,五堵,簡易
2020-02-17,950,1765,1729,3494,五堵,簡易
2020-02-18,950,1961,1651,3612,五堵,簡易
2020-02-19,950,2006,1706,3712,五堵,簡易
2020-02-20,950,1974,1657,3631,五堵,簡易
2020-02-21,950,2183,1815,3998,五堵,簡易
2020-02-22,950,1256,1132,2388,五堵,簡易
2020-02-23,950,1150,921,2071,五堵,簡易
2020-02-24,950,2084,1765,3849,五堵,簡易
2020-02-25,950,2170,1832,4002,五堵,簡易
2020-02-26,950,2124,1828,3952,五堵,簡易
2020-02-27,950,2113,1773,3886,五堵,簡易
2020-02-28,950,1426,1201,2627,五堵,簡易
2020-02-29,950,1227,1014,2241,五堵,簡易
2020-03-01,950,1067,945,2012,五堵,簡易
2020-03-02,950,2122,1836,3958,五堵,簡易
2020-03-03,950,2105,1770,3875,五堵,簡易
2020-03-04,950,2064,1796,3860,五堵,簡易
2020-03-05,950,2169,1834,4003,五堵,簡易
2020-03-06,950,2201,1879,4080,五堵,簡易
2020-03-07,950,1380,1192,2572,五堵,簡易
2020-03-08,950,1104,1019,2123,五堵,簡易
2020-03-09,950,2097,1855,3952,五堵,簡易
2020-03-10,950,2112,1763,3875,五堵,簡易
2020-03-11,950,2158,1871,4029,五堵,簡易
2020-03-12,950,2191,1874,4065,五堵,簡易
2020-03-13,950,2180,1853,4033,五堵,簡易
2020-03-14,950,1331,1069,2400,五堵,簡易
2020-03-15,950,1200,1097,2297,五堵,簡易
2020-03-16,950,2130,1861,3991,五堵,簡易
2020-03-17,950,2171,1867,4038,五堵,簡易
2020-03-18,950,2109,1821,3930,五堵,簡易
2020-03-19,950,2086,1850,3936,五堵,簡易
2020-03-20,950,2128,1841,3969,五堵,簡易
2020-03-21,950,1244,1055,2299,五堵,簡易
2020-03-22,950,1034,910,1944,五堵,簡易
2020-03-23,950,2066,1771,3837,五堵,簡易
2020-03-24,950,2003,1767,3770,五堵,簡易
2020-03-25,950,2039,1738,3777,五堵,簡易
2020-03-26,950,2095,1780,3875,五堵,簡易
2020-03-27,950,2052,1765,3817,五堵,簡易
2020-03-28,950,1098,955,2053,五堵,簡易
2020-03-29,950,1035,891,1926,五堵,簡易
2020-03-30,950,1953,1746,3699,五堵,簡易
2020-03-31,950,2043,1752,3795,五堵,簡易
2020-04-01,950,2024,1771,3795,五堵,簡易
2020-04-02,950,1072,962,2034,五堵,簡易
2020-04-03,950,1091,959,2050,五堵,簡易
2020-04-04,950,816,772,1588,五堵,簡易
2020-04-05,950,842,750,1592,五堵,簡易
2020-04-06,950,1967,1696,3663,五堵,簡易
2020-04-07,950,2010,1749,3759,五堵,簡易
2020-04-08,950,2015,1763,3778,五堵,簡易
2020-04-09,950,1958,1737,3695,五堵,簡易
2020-04-10,950,2105,1833,3938,五堵,簡易
2020-04-11,950,1039,918,1957,五堵,簡易
2020-04-12,950,895,803,1698,五堵,簡易
2020-04-13,950,1935,1773,3708,五堵,簡易
2020-04-14,950,1969,1734,3703,五堵,簡易
2020-04-15,950,1999,1748,3747,五堵,簡易
2020-04-16,950,1984,1757,3741,五堵,簡易
2020-04-17,950,2147,1841,3988,五堵,簡易
2020-04-18,950,1262,1155,2417,五堵,簡易
2020-04-19,950,995,919,1914,五堵,簡易
2020-04-20,950,2017,1671,3688,五堵,簡易
2020-04-21,950,2046,1738,3784,五堵,簡易
2020-04-22,950,1992,1680,3672,五堵,簡易
2020-04-23,950,1985,1738,3723,五堵,簡易
2020-04-24,950,2113,1744,3857,五堵,簡易
2020-04-25,950,1120,949,2069,五堵,簡易
2020-04-26,950,900,770,1670,五堵,簡易
2020-04-27,950,1961,1752,3713,五堵,簡易
2020-04-28,950,2024,1700,3724,五堵,簡易
2020-04-29,950,2038,1794,3832,五堵,簡易
2020-04-30,950,2121,1810,3931,五堵,簡易
2020-05-01,950,1671,1501,3172,五堵,簡易
2020-05-02,950,1205,1079,2284,五堵,簡易
2020-05-03,950,1039,952,1991,五堵,簡易
2020-05-04,950,2079,1827,3906,五堵,簡易
2020-05-05,950,2092,1767,3859,五堵,簡易
2020-05-06,950,2039,1810,3849,五堵,簡易
2020-05-07,950,2047,1793,3840,五堵,簡易
2020-05-08,950,2212,1763,3975,五堵,簡易
2020-05-09,950,1314,1164,2478,五堵,簡易
2020-05-10,950,1034,898,1932,五堵,簡易
2020-05-11,950,2016,1733,3749,五堵,簡易
2020-05-12,950,2048,1744,3792,五堵,簡易
2020-05-13,950,2116,1787,3903,五堵,簡易
2020-05-14,950,2056,1820,3876,五堵,簡易
2020-05-15,950,2252,1849,4101,五堵,簡易
2020-05-16,950,1263,1108,2371,五堵,簡易
2020-05-17,950,1146,1075,2221,五堵,簡易
2020-05-18,950,2048,1800,3848,五堵,簡易
2020-05-19,950,2052,1794,3846,五堵,簡易
2020-05-20,950,2094,1835,3929,五堵,簡易
2020-05-21,950,2090,1827,3917,五堵,簡易
2020-05-22,950,2071,1813,3884,五堵,簡易
2020-05-23,950,1217,1098,2315,五堵,簡易
2020-05-24,950,1157,1109,2266,五堵,簡易
2020-05-25,950,2160,1915,4075,五堵,簡易
2020-05-26,950,2122,1777,3899,五堵,簡易
2020-05-27,950,2064,1780,3844,五堵,簡易
2020-05-28,950,2025,1745,3770,五堵,簡易
2020-05-29,950,2195,1928,4123,五堵,簡易
2020-05-30,950,1511,1271,2782,五堵,簡易
2020-05-31,950,1187,1087,2274,五堵,簡易
2020-06-01,950,2059,1805,3864,五堵,簡易
2020-06-02,950,2065,1737,3802,五堵,簡易
2020-06-03,950,2124,1838,3962,五堵,簡易
2020-06-04,950,2011,1807,3818,五堵,簡易
2020-06-05,950,2292,1873,4165,五堵,簡易
2020-06-06,950,1510,1277,2787,五堵,簡易
2020-06-07,950,1049,998,2047,五堵,簡易
2020-06-08,950,2049,1771,3820,五堵,簡易
2020-06-09,950,2160,1884,4044,五堵,簡易
2020-06-10,950,2168,1881,4049,五堵,簡易
2020-06-11,950,2133,1899,4032,五堵,簡易
2020-06-12,950,2247,1869,4116,五堵,簡易
2020-06-13,950,1525,1281,2806,五堵,簡易
2020-06-14,950,1202,1074,2276,五堵,簡易
2020-06-15,950,2112,1803,3915,五堵,簡易
2020-06-16,950,2108,1892,4000,五堵,簡易
2020-06-17,950,2129,1810,3939,五堵,簡易
2020-06-18,950,2141,1819,3960,五堵,簡易
2020-06-19,950,2175,1831,4006,五堵,簡易
2020-06-20,950,1739,1572,3311,五堵,簡易
2020-06-21,950,1214,1052,2266,五堵,簡易
2020-06-22,950,2074,1851,3925,五堵,簡易
2020-06-23,950,2137,1840,3977,五堵,簡易
2020-06-24,950,2235,1828,4063,五堵,簡易
2020-06-25,950,1332,1187,2519,五堵,簡易
2020-06-26,950,1445,1264,2709,五堵,簡易
2020-06-27,950,1378,1263,2641,五堵,簡易
2020-06-28,950,1147,1113,2260,五堵,簡易
2020-06-29,950,2017,1760,3777,五堵,簡易
2020-06-30,950,2130,1764,3894,五堵,簡易
2020-07-01,950,2052,1745,3797,五堵,簡易
2020-07-02,950,2048,1756,3804,五堵,簡易
2020-07-03,950,2139,1787,3926,五堵,簡易
2020-07-04,950,1514,1287,2801,五堵,簡易
2020-07-05,950,1239,1156,2395,五堵,簡易
2020-07-06,950,2140,1832,3972,五堵,簡易
2020-07-07,950,2083,1765,3848,五堵,簡易
2020-07-08,950,2126,1801,3927,五堵,簡易
2020-07-09,950,2152,1852,4004,五堵,簡易
2020-07-10,950,2343,1879,4222,五堵,簡易
2020-07-11,950,1551,1325,2876,五堵,簡易
2020-07-12,950,1332,1147,2479,五堵,簡易
2020-07-13,950,2116,1769,3885,五堵,簡易
2020-07-14,950,2136,1832,3968,五堵,簡易
2020-07-15,950,2176,1819,3995,五堵,簡易
2020-07-16,950,2128,1772,3900,五堵,簡易
2020-07-17,950,2253,1835,4088,五堵,簡易
2020-07-18,950,1580,1316,2896,五堵,簡易
2020-07-19,950,1290,1170,2460,五堵,簡易
2020-07-20,950,2084,1807,3891,五堵,簡易
2020-07-21,950,2117,1745,3862,五堵,簡易
2020-07-22,950,2105,1734,3839,五堵,簡易
2020-07-23,950,2133,1798,3931,五堵,簡易
2020-07-24,950,2326,1807,4133,五堵,簡易
2020-07-25,950,1428,1221,2649,五堵,簡易
2020-07-26,950,1154,1094,2248,五堵,簡易
2020-07-27,950,2105,1811,3916,五堵,簡易
2020-07-28,950,2100,1783,3883,五堵,簡易
2020-07-29,950,2108,1801,3909,五堵,簡易
2020-07-30,950,2187,1851,4038,五堵,簡易
2020-07-31,950,2296,1891,4187,五堵,簡易
2020-08-01,950,1519,1374,2893,五堵,簡易
2020-08-02,950,1292,1179,2471,五堵,簡易
2020-08-03,950,1977,1709,3686,五堵,簡易
2020-08-04,950,2106,1787,3893,五堵,簡易
2020-08-05,950,2096,1745,3841,五堵,簡易
2020-08-06,950,2048,1748,3796,五堵,簡易
2020-08-07,950,2262,1848,4110,五堵,簡易
2020-08-08,950,1463,1221,2684,五堵,簡易
2020-08-09,950,1355,1251,2606,五堵,簡易
2020-08-10,950,2125,1860,3985,五堵,簡易
2020-08-11,950,2128,1801,3929,五堵,簡易
2020-08-12,950,2159,1807,3966,五堵,簡易
2020-08-13,950,2226,1875,4101,五堵,簡易
2020-08-14,950,2232,1799,4031,五堵,簡易
2020-08-15,950,1565,1326,2891,五堵,簡易
2020-08-16,950,1358,1218,2576,五堵,簡易
2020-08-17,950,2123,1814,3937,五堵,簡易
2020-08-18,950,2177,1787,3964,五堵,簡易
2020-08-19,950,2226,1860,4086,五堵,簡易
2020-08-20,950,2119,1787,3906,五堵,簡易
2020-08-21,950,2299,1833,4132,五堵,簡易
2020-08-22,950,1427,1218,2645,五堵,簡易
2020-08-23,950,1274,1277,2551,五堵,簡易
2020-08-24,950,2148,1796,3944,五堵,簡易
2020-08-25,950,2205,1807,4012,五堵,簡易
2020-08-26,950,2092,1735,3827,五堵,簡易
2020-08-27,950,2100,1727,3827,五堵,簡易
2020-08-28,950,2205,1755,3960,五堵,簡易
2020-08-29,950,1548,1308,2856,五堵,簡易
2020-08-30,950,1200,1133,2333,五堵,簡易
2020-08-31,950,2048,1787,3835,五堵,簡易
2020-09-01,950,2196,1812,4008,五堵,簡易
2020-09-02,950,2148,1787,3935,五堵,簡易
2020-09-03,950,2178,1822,4000,五堵,簡易
2020-09-04,950,2270,1836,4106,五堵,簡易
2020-09-05,950,1577,1306,2883,五堵,簡易
2020-09-06,950,1259,1115,2374,五堵,簡易
2020-09-07,950,2165,1812,3977,五堵,簡易
2020-09-08,950,2240,1862,4102,五堵,簡易
2020-09-09,950,2217,1867,4084,五堵,簡易
2020-09-10,950,2222,1899,4121,五堵,簡易
2020-09-11,950,2330,1877,4207,五堵,簡易
2020-09-12,950,1494,1290,2784,五堵,簡易
2020-09-13,950,1141,1023,2164,五堵,簡易
2020-09-14,950,2255,1862,4117,五堵,簡易
2020-09-15,950,2216,1861,4077,五堵,簡易
2020-09-16,950,2260,1837,4097,五堵,簡易
2020-09-17,950,2302,1995,4297,五堵,簡易
2020-09-18,950,2448,1986,4434,五堵,簡易
2020-09-19,950,1592,1385,2977,五堵,簡易
2020-09-20,950,1109,979,2088,五堵,簡易
2020-09-21,950,2260,1907,4167,五堵,簡易
2020-09-22,950,2275,1874,4149,五堵,簡易
2020-09-23,950,2191,1866,4057,五堵,簡易
2020-09-24,950,2315,1979,4294,五堵,簡易
2020-09-25,950,2365,1961,4326,五堵,簡易
2020-09-26,950,1834,1562,3396,五堵,簡易
2020-09-27,950,1165,952,2117,五堵,簡易
2020-09-28,950,2270,1937,4207,五堵,簡易
2020-09-29,950,2266,1934,4200,五堵,簡易
2020-09-30,950,2370,1927,4297,五堵,簡易
2020-10-01,950,1661,1513,3174,五堵,簡易
2020-10-02,950,1738,1566,3304,五堵,簡易
2020-10-03,950,1444,1336,2780,五堵,簡易
2020-10-04,950,1364,1156,2520,五堵,簡易
2020-10-05,950,2245,1881,4126,五堵,簡易
2020-10-06,950,2269,1913,4182,五堵,簡易
2020-10-07,950,2299,1933,4232,五堵,簡易
2020-10-08,950,2350,2012,4362,五堵,簡易
2020-10-09,950,1734,1495,3229,五堵,簡易
2020-10-10,950,1338,1198,2536,五堵,簡易
2020-10-11,950,1192,1064,2256,五堵,簡易
2020-10-12,950,2230,1899,4129,五堵,簡易
2020-10-13,950,2279,1871,4150,五堵,簡易
2020-10-14,950,2215,1865,4080,五堵,簡易
2020-10-15,950,2350,2046,4396,五堵,簡易
2020-10-16,950,2416,1954,4370,五堵,簡易
2020-10-17,950,1584,1373,2957,五堵,簡易
2020-10-18,950,1272,1182,2454,五堵,簡易
2020-10-19,950,2283,1916,4199,五堵,簡易
2020-10-20,950,2299,1933,4232,五堵,簡易
2020-10-21,950,2307,1906,4213,五堵,簡易
2020-10-22,950,2347,2007,4354,五堵,簡易
2020-10-23,950,2454,1972,4426,五堵,簡易
2020-10-24,950,1739,1452,3191,五堵,簡易
2020-10-25,950,1399,1299,2698,五堵,簡易
2020-10-26,950,2294,1905,4199,五堵,簡易
2020-10-27,950,2330,1979,4309,五堵,簡易
2020-10-28,950,2296,1912,4208,五堵,簡易
2020-10-29,950,2322,1949,4271,五堵,簡易
2020-10-30,950,2356,1931,4287,五堵,簡易
2020-10-31,950,1645,1404,3049,五堵,簡易
2020-11-01,950,1434,1331,2765,五堵,簡易
2020-11-02,950,2207,1897,4104,五堵,簡易
2020-11-03,950,2299,1938,4237,五堵,簡易
2020-11-04,950,2340,1981,4321,五堵,簡易
2020-11-05,950,2364,2034,4398,五堵,簡易
2020-11-06,950,2438,1981,4419,五堵,簡易
2020-11-07,950,1668,1410,3078,五堵,簡易
2020-11-08,950,1268,1170,2438,五堵,簡易
2020-11-09,950,2283,1889,4172,五堵,簡易
2020-11-10,950,2274,1367,3641,五堵,簡易
2020-11-11,950,2395,1948,4343,五堵,簡易
2020-11-12,950,2359,1987,4346,五堵,簡易
2020-11-13,950,2417,1953,4370,五堵,簡易
2020-11-14,950,1658,1451,3109,五堵,簡易
2020-11-15,950,1530,1384,2914,五堵,簡易
2020-11-16,950,2262,1959,4221,五堵,簡易
2020-11-17,950,2278,1933,4211,五堵,簡易
2020-11-18,950,2399,1990,4389,五堵,簡易
2020-11-19,950,2439,2079,4518,五堵,簡易
2020-11-20,950,2427,1993,4420,五堵,簡易
2020-11-21,950,1725,1461,3186,五堵,簡易
2020-11-22,950,1485,1305,2790,五堵,簡易
2020-11-23,950,2313,1870,4183,五堵,簡易
2020-11-24,950,2363,1954,4317,五堵,簡易
2020-11-25,950,2408,2035,4443,五堵,簡易
2020-11-26,950,2388,1983,4371,五堵,簡易
2020-11-27,950,2478,1957,4435,五堵,簡易
2020-11-28,950,1576,1426,3002,五堵,簡易
2020-11-29,950,1283,1234,2517,五堵,簡易
2020-11-30,950,2266,1907,4173,五堵,簡易
2020-12-01,950,2263,1898,4161,五堵,簡易
2020-12-02,950,2361,1980,4341,五堵,簡易
2020-12-03,950,2331,1967,4298,五堵,簡易
2020-12-04,950,2429,1991,4420,五堵,簡易
2020-12-05,950,1654,1381,3035,五堵,簡易
2020-12-06,950,1278,1173,2451,五堵,簡易
2020-12-07,950,2271,1903,4174,五堵,簡易
2020-12-08,950,2357,1957,4314,五堵,簡易
2020-12-09,950,2346,1949,4295,五堵,簡易
2020-12-10,950,2338,1907,4245,五堵,簡易
2020-12-11,950,2504,2044,4548,五堵,簡易
2020-12-12,950,1750,1419,3169,五堵,簡易
2020-12-13,950,1479,1333,2812,五堵,簡易
2020-12-14,950,2319,1944,4263,五堵,簡易
2020-12-15,950,2413,2009,4422,五堵,簡易
2020-12-16,950,2401,1993,4394,五堵,簡易
2020-12-17,950,2373,1944,4317,五堵,簡易
2020-12-18,950,2527,1998,4525,五堵,簡易
2020-12-19,950,1613,1397,3010,五堵,簡易
2020-12-20,950,1378,1234,2612,五堵,簡易
2020-12-21,950,2341,1965,4306,五堵,簡易
2020-12-22,950,2428,2010,4438,五堵,簡易
2020-12-23,950,2358,1958,4316,五堵,簡易
2020-12-24,950,2327,1963,4290,五堵,簡易
2020-12-25,950,2512,2025,4537,五堵,簡易
2020-12-26,950,1683,1456,3139,五堵,簡易
2020-12-27,950,1462,1352,2814,五堵,簡易
2020-12-28,950,2359,2000,4359,五堵,簡易
2020-12-29,950,2411,1983,4394,五堵,簡易
2020-12-30,950,2349,1943,4292,五堵,簡易
2020-12-31,950,2463,1812,4275,五堵,簡易
2020-01-01,960,7817,9251,17068,汐止,二等
2020-01-02,960,11076,11628,22704,汐止,二等
2020-01-03,960,11767,12305,24072,汐止,二等
2020-01-04,960,10438,10533,20971,汐止,二等
2020-01-05,960,7946,8433,16379,汐止,二等
2020-01-06,960,11162,11561,22723,汐止,二等
2020-01-07,960,11210,11746,22956,汐止,二等
2020-01-08,960,11103,11620,22723,汐止,二等
2020-01-09,960,11541,12325,23866,汐止,二等
2020-01-10,960,12269,13085,25354,汐止,二等
2020-01-11,960,9745,9695,19440,汐止,二等
2020-01-12,960,8112,8391,16503,汐止,二等
2020-01-13,960,11285,11450,22735,汐止,二等
2020-01-14,960,11233,11618,22851,汐止,二等
2020-01-15,960,9945,10861,20806,汐止,二等
2020-01-16,960,11964,12348,24312,汐止,二等
2020-01-17,960,11508,11888,23396,汐止,二等
2020-01-18,960,9976,10062,20038,汐止,二等
2020-01-19,960,8346,8611,16957,汐止,二等
2020-01-20,960,11269,11529,22798,汐止,二等
2020-01-21,960,10105,11739,21844,汐止,二等
2020-01-22,960,10151,11399,21550,汐止,二等
2020-01-23,960,7702,7213,14915,汐止,二等
2020-01-24,960,5114,4762,9876,汐止,二等
2020-01-25,960,6518,6083,12601,汐止,二等
2020-01-26,960,6065,5928,11993,汐止,二等
2020-01-27,960,7079,7315,14394,汐止,二等
2020-01-28,960,6920,7652,14572,汐止,二等
2020-01-29,960,6762,7353,14115,汐止,二等
2020-01-30,960,9716,10102,19818,汐止,二等
2020-01-31,960,10119,10150,20269,汐止,二等
2020-02-01,960,7748,7861,15609,汐止,二等
2020-02-02,960,6965,7237,14202,汐止,二等
2020-02-03,960,9921,10111,20032,汐止,二等
2020-02-04,960,9698,9992,19690,汐止,二等
2020-02-05,960,9940,10169,20109,汐止,二等
2020-02-06,960,10038,10323,20361,汐止,二等
2020-02-07,960,10226,10290,20516,汐止,二等
2020-02-08,960,7275,7340,14615,汐止,二等
2020-02-09,960,6094,6382,12476,汐止,二等
2020-02-10,960,9474,9762,19236,汐止,二等
2020-02-11,960,9489,9836,19325,汐止,二等
2020-02-12,960,9745,10203,19948,汐止,二等
2020-02-13,960,9678,10198,19876,汐止,二等
2020-02-14,960,10229,10288,20517,汐止,二等
2020-02-15,960,9045,9181,18226,汐止,二等
2020-02-16,960,6018,6418,12436,汐止,二等
2020-02-17,960,8657,9678,18335,汐止,二等
2020-02-18,960,9588,9950,19538,汐止,二等
2020-02-19,960,9804,10076,19880,汐止,二等
2020-02-20,960,9440,9813,19253,汐止,二等
2020-02-21,960,10178,10170,20348,汐止,二等
2020-02-22,960,7312,7322,14634,汐止,二等
2020-02-23,960,6246,6784,13030,汐止,二等
2020-02-24,960,9680,9792,19472,汐止,二等
2020-02-25,960,10107,10606,20713,汐止,二等
2020-02-26,960,10018,10554,20572,汐止,二等
2020-02-27,960,10632,11170,21802,汐止,二等
2020-02-28,960,7569,7374,14943,汐止,二等
2020-02-29,960,6965,7053,14018,汐止,二等
2020-03-01,960,5855,6252,12107,汐止,二等
2020-03-02,960,9877,10465,20342,汐止,二等
2020-03-03,960,10043,10538,20581,汐止,二等
2020-03-04,960,9847,10345,20192,汐止,二等
2020-03-05,960,9837,10302,20139,汐止,二等
2020-03-06,960,10505,11197,21702,汐止,二等
2020-03-07,960,7714,7744,15458,汐止,二等
2020-03-08,960,6519,6485,13004,汐止,二等
2020-03-09,960,10001,10334,20335,汐止,二等
2020-03-10,960,9748,10249,19997,汐止,二等
2020-03-11,960,10163,10562,20725,汐止,二等
2020-03-12,960,9773,10532,20305,汐止,二等
2020-03-13,960,10286,10858,21144,汐止,二等
2020-03-14,960,7023,6897,13920,汐止,二等
2020-03-15,960,6766,6980,13746,汐止,二等
2020-03-16,960,10081,10409,20490,汐止,二等
2020-03-17,960,9902,10374,20276,汐止,二等
2020-03-18,960,9789,10197,19986,汐止,二等
2020-03-19,960,9556,10186,19742,汐止,二等
2020-03-20,960,10098,10660,20758,汐止,二等
2020-03-21,960,6976,6927,13903,汐止,二等
2020-03-22,960,5590,5744,11334,汐止,二等
2020-03-23,960,9344,9634,18978,汐止,二等
2020-03-24,960,9309,9936,19245,汐止,二等
2020-03-25,960,9413,10024,19437,汐止,二等
2020-03-26,960,9604,10088,19692,汐止,二等
2020-03-27,960,9780,10557,20337,汐止,二等
2020-03-28,960,5567,5532,11099,汐止,二等
2020-03-29,960,5531,5511,11042,汐止,二等
2020-03-30,960,9108,9789,18897,汐止,二等
2020-03-31,960,9488,10004,19492,汐止,二等
2020-04-01,960,9743,10345,20088,汐止,二等
2020-04-02,960,5969,5616,11585,汐止,二等
2020-04-03,960,5546,5474,11020,汐止,二等
2020-04-04,960,4435,4652,9087,汐止,二等
2020-04-05,960,4651,4886,9537,汐止,二等
2020-04-06,960,9021,9604,18625,汐止,二等
2020-04-07,960,9184,9565,18749,汐止,二等
2020-04-08,960,8955,9550,18505,汐止,二等
2020-04-09,960,9042,9518,18560,汐止,二等
2020-04-10,960,9690,10170,19860,汐止,二等
2020-04-11,960,6042,6043,12085,汐止,二等
2020-04-12,960,4717,4872,9589,汐止,二等
2020-04-13,960,9196,9563,18759,汐止,二等
2020-04-14,960,9188,9671,18859,汐止,二等
2020-04-15,960,9302,9823,19125,汐止,二等
2020-04-16,960,9401,9787,19188,汐止,二等
2020-04-17,960,9913,10400,20313,汐止,二等
2020-04-18,960,6990,6977,13967,汐止,二等
2020-04-19,960,5579,5770,11349,汐止,二等
2020-04-20,960,9319,9723,19042,汐止,二等
2020-04-21,960,9268,9723,18991,汐止,二等
2020-04-22,960,9149,9670,18819,汐止,二等
2020-04-23,960,9170,9646,18816,汐止,二等
2020-04-24,960,9660,10096,19756,汐止,二等
2020-04-25,960,6151,6172,12323,汐止,二等
2020-04-26,960,5078,4939,10017,汐止,二等
2020-04-27,960,9324,9719,19043,汐止,二等
2020-04-28,960,9487,9907,19394,汐止,二等
2020-04-29,960,9585,10071,19656,汐止,二等
2020-04-30,960,9835,10147,19982,汐止,二等
2020-05-01,960,8613,8980,17593,汐止,二等
2020-05-02,960,6724,6700,13424,汐止,二等
2020-05-03,960,5849,6059,11908,汐止,二等
2020-05-04,960,9465,9893,19358,汐止,二等
2020-05-05,960,9679,10183,19862,汐止,二等
2020-05-06,960,9825,10360,20185,汐止,二等
2020-05-07,960,9869,10245,20114,汐止,二等
2020-05-08,960,10420,11023,21443,汐止,二等
2020-05-09,960,7568,7462,15030,汐止,二等
2020-05-10,960,6097,6162,12259,汐止,二等
2020-05-11,960,9838,10116,19954,汐止,二等
2020-05-12,960,9681,10001,19682,汐止,二等
2020-05-13,960,10159,10578,20737,汐止,二等
2020-05-14,960,9780,10340,20120,汐止,二等
2020-05-15,960,10832,11257,22089,汐止,二等
2020-05-16,960,7428,6819,14247,汐止,二等
2020-05-17,960,6343,6389,12732,汐止,二等
2020-05-18,960,9780,10044,19824,汐止,二等
2020-05-19,960,9517,9993,19510,汐止,二等
2020-05-20,960,9915,10462,20377,汐止,二等
2020-05-21,960,9655,10303,19958,汐止,二等
2020-05-22,960,9956,10463,20419,汐止,二等
2020-05-23,960,6846,6791,13637,汐止,二等
2020-05-24,960,6689,6847,13536,汐止,二等
2020-05-25,960,10186,9131,19317,汐止,二等
2020-05-26,960,9915,10402,20317,汐止,二等
2020-05-27,960,9829,10398,20227,汐止,二等
2020-05-28,960,9548,10116,19664,汐止,二等
2020-05-29,960,10595,11093,21688,汐止,二等
2020-05-30,960,7934,8038,15972,汐止,二等
2020-05-31,960,6807,6963,13770,汐止,二等
2020-06-01,960,9874,10231,20105,汐止,二等
2020-06-02,960,9907,10448,20355,汐止,二等
2020-06-03,960,10277,10626,20903,汐止,二等
2020-06-04,960,9724,10442,20166,汐止,二等
2020-06-05,960,10566,10806,21372,汐止,二等
2020-06-06,960,8593,8436,17029,汐止,二等
2020-06-07,960,6552,6802,13354,汐止,二等
2020-06-08,960,9762,10078,19840,汐止,二等
2020-06-09,960,10051,10629,20680,汐止,二等
2020-06-10,960,10539,11041,21580,汐止,二等
2020-06-11,960,10225,10661,20886,汐止,二等
2020-06-12,960,11092,11471,22563,汐止,二等
2020-06-13,960,8808,8594,17402,汐止,二等
2020-06-14,960,7021,7356,14377,汐止,二等
2020-06-15,960,10404,10603,21007,汐止,二等
2020-06-16,960,10378,10809,21187,汐止,二等
2020-06-17,960,9873,10642,20515,汐止,二等
2020-06-18,960,10081,10523,20604,汐止,二等
2020-06-19,960,10480,10921,21401,汐止,二等
2020-06-20,960,9403,9596,18999,汐止,二等
2020-06-21,960,6935,7111,14046,汐止,二等
2020-06-22,960,10114,10294,20408,汐止,二等
2020-06-23,960,10295,10702,20997,汐止,二等
2020-06-24,960,10985,11146,22131,汐止,二等
2020-06-25,960,7438,6796,14234,汐止,二等
2020-06-26,960,8066,8010,16076,汐止,二等
2020-06-27,960,7679,8077,15756,汐止,二等
2020-06-28,960,6649,6586,13235,汐止,二等
2020-06-29,960,10109,10541,20650,汐止,二等
2020-06-30,960,10116,10755,20871,汐止,二等
2020-07-01,960,9913,10361,20274,汐止,二等
2020-07-02,960,9859,10340,20199,汐止,二等
2020-07-03,960,10167,10887,21054,汐止,二等
2020-07-04,960,8457,8297,16754,汐止,二等
2020-07-05,960,7043,7489,14532,汐止,二等
2020-07-06,960,10225,10511,20736,汐止,二等
2020-07-07,960,10079,10495,20574,汐止,二等
2020-07-08,960,10177,10519,20696,汐止,二等
2020-07-09,960,10269,10597,20866,汐止,二等
2020-07-10,960,11140,11451,22591,汐止,二等
2020-07-11,960,8840,8666,17506,汐止,二等
2020-07-12,960,6982,7476,14458,汐止,二等
2020-07-13,960,10444,10849,21293,汐止,二等
2020-07-14,960,10240,11073,21313,汐止,二等
2020-07-15,960,10199,10548,20747,汐止,二等
2020-07-16,960,10395,10479,20874,汐止,二等
2020-07-17,960,11041,11042,22083,汐止,二等
2020-07-18,960,8966,8727,17693,汐止,二等
2020-07-19,960,7385,7903,15288,汐止,二等
2020-07-20,960,10156,10417,20573,汐止,二等
2020-07-21,960,10302,10623,20925,汐止,二等
2020-07-22,960,10231,10559,20790,汐止,二等
2020-07-23,960,10334,10684,21018,汐止,二等
2020-07-24,960,11112,11195,22307,汐止,二等
2020-07-25,960,8613,8423,17036,汐止,二等
2020-07-26,960,7323,7734,15057,汐止,二等
2020-07-27,960,9957,10299,20256,汐止,二等
2020-07-28,960,10194,10669,20863,汐止,二等
2020-07-29,960,10473,10805,21278,汐止,二等
2020-07-30,960,10277,10528,20805,汐止,二等
2020-07-31,960,11032,11174,22206,汐止,二等
2020-08-01,960,9039,8989,18028,汐止,二等
2020-08-02,960,7115,7713,14828,汐止,二等
2020-08-03,960,9004,9432,18436,汐止,二等
2020-08-04,960,10129,10374,20503,汐止,二等
2020-08-05,960,10287,10634,20921,汐止,二等
2020-08-06,960,10472,10639,21111,汐止,二等
2020-08-07,960,11183,11076,22259,汐止,二等
2020-08-08,960,8444,8312,16756,汐止,二等
2020-08-09,960,7536,8012,15548,汐止,二等
2020-08-10,960,10038,10567,20605,汐止,二等
2020-08-11,960,10044,10478,20522,汐止,二等
2020-08-12,960,10336,10610,20946,汐止,二等
2020-08-13,960,10485,10601,21086,汐止,二等
2020-08-14,960,10895,11045,21940,汐止,二等
2020-08-15,960,9233,9107,18340,汐止,二等
2020-08-16,960,7633,8044,15677,汐止,二等
2020-08-17,960,10172,10532,20704,汐止,二等
2020-08-18,960,10568,11010,21578,汐止,二等
2020-08-19,960,10747,11228,21975,汐止,二等
2020-08-20,960,10506,10717,21223,汐止,二等
2020-08-21,960,11032,11316,22348,汐止,二等
2020-08-22,960,8738,8601,17339,汐止,二等
2020-08-23,960,7203,7495,14698,汐止,二等
2020-08-24,960,10312,10559,20871,汐止,二等
2020-08-25,960,10706,11037,21743,汐止,二等
2020-08-26,960,10387,10698,21085,汐止,二等
2020-08-27,960,9940,10294,20234,汐止,二等
2020-08-28,960,10584,10688,21272,汐止,二等
2020-08-29,960,8735,8581,17316,汐止,二等
2020-08-30,960,7259,7724,14983,汐止,二等
2020-08-31,960,9952,10459,20411,汐止,二等
2020-09-01,960,10172,10543,20715,汐止,二等
2020-09-02,960,10296,10696,20992,汐止,二等
2020-09-03,960,10255,10542,20797,汐止,二等
2020-09-04,960,11186,11319,22505,汐止,二等
2020-09-05,960,8979,8783,17762,汐止,二等
2020-09-06,960,7358,7817,15175,汐止,二等
2020-09-07,960,10327,10744,21071,汐止,二等
2020-09-08,960,10375,10677,21052,汐止,二等
2020-09-09,960,10560,10921,21481,汐止,二等
2020-09-10,960,10330,10803,21133,汐止,二等
2020-09-11,960,11193,11468,22661,汐止,二等
2020-09-12,960,9326,8997,18323,汐止,二等
2020-09-13,960,6970,7127,14097,汐止,二等
2020-09-14,960,10402,10771,21173,汐止,二等
2020-09-15,960,10472,11032,21504,汐止,二等
2020-09-16,960,10546,11026,21572,汐止,二等
2020-09-17,960,10564,11072,21636,汐止,二等
2020-09-18,960,11258,11766,23024,汐止,二等
2020-09-19,960,9224,9186,18410,汐止,二等
2020-09-20,960,6711,7153,13864,汐止,二等
2020-09-21,960,10507,10879,21386,汐止,二等
2020-09-22,960,10581,11114,21695,汐止,二等
2020-09-23,960,10605,11121,21726,汐止,二等
2020-09-24,960,10477,11002,21479,汐止,二等
2020-09-25,960,10885,11441,22326,汐止,二等
2020-09-26,960,9789,10006,19795,汐止,二等
2020-09-27,960,6641,7002,13643,汐止,二等
2020-09-28,960,10426,10839,21265,汐止,二等
2020-09-29,960,10768,11343,22111,汐止,二等
2020-09-30,960,11224,12320,23544,汐止,二等
2020-10-01,960,8695,8086,16781,汐止,二等
2020-10-02,960,9010,8985,17995,汐止,二等
2020-10-03,960,8565,9204,17769,汐止,二等
2020-10-04,960,7586,7868,15454,汐止,二等
2020-10-05,960,10332,10870,21202,汐止,二等
2020-10-06,960,10396,10935,21331,汐止,二等
2020-10-07,960,10716,11272,21988,汐止,二等
2020-10-08,960,11405,12070,23475,汐止,二等
2020-10-09,960,9475,9143,18618,汐止,二等
2020-10-10,960,7975,7996,15971,汐止,二等
2020-10-11,960,6924,7327,14251,汐止,二等
2020-10-12,960,10452,10015,20467,汐止,二等
2020-10-13,960,10452,11033,21485,汐止,二等
2020-10-14,960,10777,11273,22050,汐止,二等
2020-10-15,960,10762,11374,22136,汐止,二等
2020-10-16,960,11396,12041,23437,汐止,二等
2020-10-17,960,9115,8971,18086,汐止,二等
2020-10-18,960,7741,7962,15703,汐止,二等
2020-10-19,960,10485,10246,20731,汐止,二等
2020-10-20,960,10747,11171,21918,汐止,二等
2020-10-21,960,10613,11070,21683,汐止,二等
2020-10-22,960,10474,11177,21651,汐止,二等
2020-10-23,960,11584,11743,23327,汐止,二等
2020-10-24,960,9713,9700,19413,汐止,二等
2020-10-25,960,7682,7959,15641,汐止,二等
2020-10-26,960,10741,11144,21885,汐止,二等
2020-10-27,960,10807,11231,22038,汐止,二等
2020-10-28,960,10778,11443,22221,汐止,二等
2020-10-29,960,10600,11123,21723,汐止,二等
2020-10-30,960,11386,11817,23203,汐止,二等
2020-10-31,960,9706,9398,19104,汐止,二等
2020-11-01,960,7683,7936,15619,汐止,二等
2020-11-02,960,10278,10958,21236,汐止,二等
2020-11-03,960,10601,10843,21444,汐止,二等
2020-11-04,960,10591,11167,21758,汐止,二等
2020-11-05,960,10809,11267,22076,汐止,二等
2020-11-06,960,11171,11845,23016,汐止,二等
2020-11-07,960,9963,9521,19484,汐止,二等
2020-11-08,960,7518,7712,15230,汐止,二等
2020-11-09,960,10577,10959,21536,汐止,二等
2020-11-10,960,10709,11059,21768,汐止,二等
2020-11-11,960,10805,11358,22163,汐止,二等
2020-11-12,960,10606,11162,21768,汐止,二等
2020-11-13,960,11311,12013,23324,汐止,二等
2020-11-14,960,9608,9580,19188,汐止,二等
2020-11-15,960,8649,8986,17635,汐止,二等
2020-11-16,960,10729,11028,21757,汐止,二等
2020-11-17,960,10812,11430,22242,汐止,二等
2020-11-18,960,10823,11729,22552,汐止,二等
2020-11-19,960,10968,11688,22656,汐止,二等
2020-11-20,960,11611,12164,23775,汐止,二等
2020-11-21,960,9097,9051,18148,汐止,二等
2020-11-22,960,8343,8656,16999,汐止,二等
2020-11-23,960,10535,10068,20603,汐止,二等
2020-11-24,960,10695,11220,21915,汐止,二等
2020-11-25,960,10879,11486,22365,汐止,二等
2020-11-26,960,10923,11583,22506,汐止,二等
2020-11-27,960,11484,12059,23543,汐止,二等
2020-11-28,960,9089,8886,17975,汐止,二等
2020-11-29,960,7260,7705,14965,汐止,二等
2020-11-30,960,10625,11054,21679,汐止,二等
2020-12-01,960,10444,10905,21349,汐止,二等
2020-12-02,960,10634,11156,21790,汐止,二等
2020-12-03,960,10584,11195,21779,汐止,二等
2020-12-04,960,11316,11662,22978,汐止,二等
2020-12-05,960,9005,9039,18044,汐止,二等
2020-12-06,960,7429,7783,15212,汐止,二等
2020-12-07,960,10572,10900,21472,汐止,二等
2020-12-08,960,10502,10971,21473,汐止,二等
2020-12-09,960,10485,10173,20658,汐止,二等
2020-12-10,960,10580,10949,21529,汐止,二等
2020-12-11,960,11646,12117,23763,汐止,二等
2020-12-12,960,9884,10068,19952,汐止,二等
2020-12-13,960,8516,8821,17337,汐止,二等
2020-12-14,960,10767,11074,21841,汐止,二等
2020-12-15,960,10551,11140,21691,汐止,二等
2020-12-16,960,10548,11266,21814,汐止,二等
2020-12-17,960,10945,11340,22285,汐止,二等
2020-12-18,960,11535,12298,23833,汐止,二等
2020-12-19,960,9216,9099,18315,汐止,二等
2020-12-20,960,7649,7932,15581,汐止,二等
2020-12-21,960,10635,11131,21766,汐止,二等
2020-12-22,960,10996,11433,22429,汐止,二等
2020-12-23,960,10604,11326,21930,汐止,二等
2020-12-24,960,10866,11211,22077,汐止,二等
2020-12-25,960,11659,12253,23912,汐止,二等
2020-12-26,960,9501,9427,18928,汐止,二等
2020-12-27,960,7879,7455,15334,汐止,二等
2020-12-28,960,10732,11138,21870,汐止,二等
2020-12-29,960,10925,11475,22400,汐止,二等
2020-12-30,960,10586,11000,21586,汐止,二等
2020-12-31,960,11670,11116,22786,汐止,二等
2020-01-01,970,5307,6020,11327,汐科,簡易
2020-01-02,970,11077,11257,22334,汐科,簡易
2020-01-03,970,11675,11591,23266,汐科,簡易
2020-01-04,970,6337,6162,12499,汐科,簡易
2020-01-05,970,5088,5378,10466,汐科,簡易
2020-01-06,970,11245,11374,22619,汐科,簡易
2020-01-07,970,11343,11369,22712,汐科,簡易
2020-01-08,970,11137,11300,22437,汐科,簡易
2020-01-09,970,11594,11756,23350,汐科,簡易
2020-01-10,970,11666,12012,23678,汐科,簡易
2020-01-11,970,6058,5719,11777,汐科,簡易
2020-01-12,970,4910,5618,10528,汐科,簡易
2020-01-13,970,11275,11516,22791,汐科,簡易
2020-01-14,970,11431,11530,22961,汐科,簡易
2020-01-15,970,9644,9125,18769,汐科,簡易
2020-01-16,970,11332,11995,23327,汐科,簡易
2020-01-17,970,11406,11628,23034,汐科,簡易
2020-01-18,970,6305,6324,12629,汐科,簡易
2020-01-19,970,5244,5501,10745,汐科,簡易
2020-01-20,970,11476,11725,23201,汐科,簡易
2020-01-21,970,10427,11565,21992,汐科,簡易
2020-01-22,970,10868,10889,21757,汐科,簡易
2020-01-23,970,4834,4088,8922,汐科,簡易
2020-01-24,970,3317,2799,6116,汐科,簡易
2020-01-25,970,3799,3780,7579,汐科,簡易
2020-01-26,970,3522,3647,7169,汐科,簡易
2020-01-27,970,4149,4290,8439,汐科,簡易
2020-01-28,970,4076,4779,8855,汐科,簡易
2020-01-29,970,4149,4685,8834,汐科,簡易
2020-01-30,970,9695,9903,19598,汐科,簡易
2020-01-31,970,10028,9941,19969,汐科,簡易
2020-02-01,970,4878,4899,9777,汐科,簡易
2020-02-02,970,4234,4604,8838,汐科,簡易
2020-02-03,970,10584,10606,21190,汐科,簡易
2020-02-04,970,10404,10263,20667,汐科,簡易
2020-02-05,970,10540,10315,20855,汐科,簡易
2020-02-06,970,10579,10198,20777,汐科,簡易
2020-02-07,970,10841,10320,21161,汐科,簡易
2020-02-08,970,4522,4210,8732,汐科,簡易
2020-02-09,970,3988,4101,8089,汐科,簡易
2020-02-10,970,10433,10360,20793,汐科,簡易
2020-02-11,970,10336,10062,20398,汐科,簡易
2020-02-12,970,10787,10350,21137,汐科,簡易
2020-02-13,970,10563,10078,20641,汐科,簡易
2020-02-14,970,11053,10513,21566,汐科,簡易
2020-02-15,970,7346,6917,14263,汐科,簡易
2020-02-16,970,3758,3837,7595,汐科,簡易
2020-02-17,970,9732,10119,19851,汐科,簡易
2020-02-18,970,10467,10285,20752,汐科,簡易
2020-02-19,970,10556,10399,20955,汐科,簡易
2020-02-20,970,10300,10180,20480,汐科,簡易
2020-02-21,970,11002,10435,21437,汐科,簡易
2020-02-22,970,4742,4474,9216,汐科,簡易
2020-02-23,970,3899,4010,7909,汐科,簡易
2020-02-24,970,10448,10437,20885,汐科,簡易
2020-02-25,970,10634,10372,21006,汐科,簡易
2020-02-26,970,10534,10114,20648,汐科,簡易
2020-02-27,970,11042,10562,21604,汐科,簡易
2020-02-28,970,4670,4361,9031,汐科,簡易
2020-02-29,970,3832,3910,7742,汐科,簡易
2020-03-01,970,3395,3867,7262,汐科,簡易
2020-03-02,970,10321,10465,20786,汐科,簡易
2020-03-03,970,10412,10366,20778,汐科,簡易
2020-03-04,970,10195,10344,20539,汐科,簡易
2020-03-05,970,10376,10589,20965,汐科,簡易
2020-03-06,970,10859,10759,21618,汐科,簡易
2020-03-07,970,4706,4619,9325,汐科,簡易
2020-03-08,970,3919,3946,7865,汐科,簡易
2020-03-09,970,10484,10441,20925,汐科,簡易
2020-03-10,970,10379,10257,20636,汐科,簡易
2020-03-11,970,10558,10659,21217,汐科,簡易
2020-03-12,970,10241,10340,20581,汐科,簡易
2020-03-13,970,10977,10823,21800,汐科,簡易
2020-03-14,970,4601,4260,8861,汐科,簡易
2020-03-15,970,3985,4125,8110,汐科,簡易
2020-03-16,970,10305,10331,20636,汐科,簡易
2020-03-17,970,10208,10236,20444,汐科,簡易
2020-03-18,970,10230,10347,20577,汐科,簡易
2020-03-19,970,10014,10189,20203,汐科,簡易
2020-03-20,970,10387,10182,20569,汐科,簡易
2020-03-21,970,4045,3977,8022,汐科,簡易
2020-03-22,970,3209,3337,6546,汐科,簡易
2020-03-23,970,9840,9798,19638,汐科,簡易
2020-03-24,970,9695,9882,19577,汐科,簡易
2020-03-25,970,9480,9631,19111,汐科,簡易
2020-03-26,970,9733,9772,19505,汐科,簡易
2020-03-27,970,10077,9965,20042,汐科,簡易
2020-03-28,970,3501,3516,7017,汐科,簡易
2020-03-29,970,3257,3292,6549,汐科,簡易
2020-03-30,970,9498,9758,19256,汐科,簡易
2020-03-31,970,9739,9906,19645,汐科,簡易
2020-04-01,970,9807,9832,19639,汐科,簡易
2020-04-02,970,3608,3385,6993,汐科,簡易
2020-04-03,970,3116,2452,5568,汐科,簡易
2020-04-04,970,2725,2794,5519,汐科,簡易
2020-04-05,970,2723,3104,5827,汐科,簡易
2020-04-06,970,9571,9670,19241,汐科,簡易
2020-04-07,970,9380,9542,18922,汐科,簡易
2020-04-08,970,9513,9627,19140,汐科,簡易
2020-04-09,970,9433,9621,19054,汐科,簡易
2020-04-10,970,9812,9752,19564,汐科,簡易
2020-04-11,970,3546,3557,7103,汐科,簡易
2020-04-12,970,2862,2955,5817,汐科,簡易
2020-04-13,970,9406,9507,18913,汐科,簡易
2020-04-14,970,9288,9522,18810,汐科,簡易
2020-04-15,970,9390,9542,18932,汐科,簡易
2020-04-16,970,9351,9504,18855,汐科,簡易
2020-04-17,970,9728,9778,19506,汐科,簡易
2020-04-18,970,3951,3795,7746,汐科,簡易
2020-04-19,970,3167,3277,6444,汐科,簡易
2020-04-20,970,9463,9756,19219,汐科,簡易
2020-04-21,970,9436,9587,19023,汐科,簡易
2020-04-22,970,9568,9760,19328,汐科,簡易
2020-04-23,970,9494,9691,19185,汐科,簡易
2020-04-24,970,9756,9908,19664,汐科,簡易
2020-04-25,970,3631,3572,7203,汐科,簡易
2020-04-26,970,2921,3158,6079,汐科,簡易
2020-04-27,970,9740,9910,19650,汐科,簡易
2020-04-28,970,9642,9796,19438,汐科,簡易
2020-04-29,970,9762,9937,19699,汐科,簡易
2020-04-30,970,10076,10030,20106,汐科,簡易
2020-05-01,970,4730,4829,9559,汐科,簡易
2020-05-02,970,3724,3870,7594,汐科,簡易
2020-05-03,970,3264,3785,7049,汐科,簡易
2020-05-04,970,9741,9935,19676,汐科,簡易
2020-05-05,970,9811,9895,19706,汐科,簡易
2020-05-06,970,9967,10041,20008,汐科,簡易
2020-05-07,970,9820,10139,19959,汐科,簡易
2020-05-08,970,10335,10426,20761,汐科,簡易
2020-05-09,970,4250,4339,8589,汐科,簡易
2020-05-10,970,3507,3839,7346,汐科,簡易
2020-05-11,970,9967,10133,20100,汐科,簡易
2020-05-12,970,9892,10088,19980,汐科,簡易
2020-05-13,970,10072,10299,20371,汐科,簡易
2020-05-14,970,9907,10109,20016,汐科,簡易
2020-05-15,970,10551,10603,21154,汐科,簡易
2020-05-16,970,4037,4053,8090,汐科,簡易
2020-05-17,970,3568,3941,7509,汐科,簡易
2020-05-18,970,9856,10191,20047,汐科,簡易
2020-05-19,970,9904,10113,20017,汐科,簡易
2020-05-20,970,10259,10333,20592,汐科,簡易
2020-05-21,970,10056,10415,20471,汐科,簡易
2020-05-22,970,10430,10374,20804,汐科,簡易
2020-05-23,970,4197,4111,8308,汐科,簡易
2020-05-24,970,3708,3969,7677,汐科,簡易
2020-05-25,970,10301,10461,20762,汐科,簡易
2020-05-26,970,10242,10403,20645,汐科,簡易
2020-05-27,970,10373,10604,20977,汐科,簡易
2020-05-28,970,10279,10361,20640,汐科,簡易
2020-05-29,970,10680,10683,21363,汐科,簡易
2020-05-30,970,4851,4594,9445,汐科,簡易
2020-05-31,970,3930,4305,8235,汐科,簡易
2020-06-01,970,10257,10494,20751,汐科,簡易
2020-06-02,970,10319,10279,20598,汐科,簡易
2020-06-03,970,10400,10514,20914,汐科,簡易
2020-06-04,970,9935,10506,20441,汐科,簡易
2020-06-05,970,10906,10564,21470,汐科,簡易
2020-06-06,970,5087,4937,10024,汐科,簡易
2020-06-07,970,3893,4245,8138,汐科,簡易
2020-06-08,970,10320,10491,20811,汐科,簡易
2020-06-09,970,10432,10543,20975,汐科,簡易
2020-06-10,970,10435,10612,21047,汐科,簡易
2020-06-11,970,10427,10581,21008,汐科,簡易
2020-06-12,970,10907,10702,21609,汐科,簡易
2020-06-13,970,5229,5046,10275,汐科,簡易
2020-06-14,970,4179,4554,8733,汐科,簡易
2020-06-15,970,10258,10440,20698,汐科,簡易
2020-06-16,970,10294,10637,20931,汐科,簡易
2020-06-17,970,10069,10541,20610,汐科,簡易
2020-06-18,970,10212,10570,20782,汐科,簡易
2020-06-19,970,10532,10551,21083,汐科,簡易
2020-06-20,970,6980,7245,14225,汐科,簡易
2020-06-21,970,3926,4158,8084,汐科,簡易
2020-06-22,970,10102,10608,20710,汐科,簡易
2020-06-23,970,10427,10550,20977,汐科,簡易
2020-06-24,970,11056,10467,21523,汐科,簡易
2020-06-25,970,4797,4225,9022,汐科,簡易
2020-06-26,970,4728,4699,9427,汐科,簡易
2020-06-27,970,4410,4508,8918,汐科,簡易
2020-06-28,970,3869,4527,8396,汐科,簡易
2020-06-29,970,10273,10639,20912,汐科,簡易
2020-06-30,970,10346,10554,20900,汐科,簡易
2020-07-01,970,10307,10470,20777,汐科,簡易
2020-07-02,970,10212,10452,20664,汐科,簡易
2020-07-03,970,10617,10890,21507,汐科,簡易
2020-07-04,970,5137,5089,10226,汐科,簡易
2020-07-05,970,4242,4586,8828,汐科,簡易
2020-07-06,970,10552,10724,21276,汐科,簡易
2020-07-07,970,10576,10698,21274,汐科,簡易
2020-07-08,970,10617,10688,21305,汐科,簡易
2020-07-09,970,10569,10563,21132,汐科,簡易
2020-07-10,970,11124,10845,21969,汐科,簡易
2020-07-11,970,5232,5167,10399,汐科,簡易
2020-07-12,970,4323,4660,8983,汐科,簡易
2020-07-13,970,10601,10585,21186,汐科,簡易
2020-07-14,970,10629,9926,20555,汐科,簡易
2020-07-15,970,10757,10842,21599,汐科,簡易
2020-07-16,970,10686,10824,21510,汐科,簡易
2020-07-17,970,11156,10898,22054,汐科,簡易
2020-07-18,970,5346,5292,10638,汐科,簡易
2020-07-19,970,4457,4672,9129,汐科,簡易
2020-07-20,970,10615,10672,21287,汐科,簡易
2020-07-21,970,10664,10329,20993,汐科,簡易
2020-07-22,970,10643,10726,21369,汐科,簡易
2020-07-23,970,10831,10657,21488,汐科,簡易
2020-07-24,970,11097,10685,21782,汐科,簡易
2020-07-25,970,5019,4903,9922,汐科,簡易
2020-07-26,970,4289,4750,9039,汐科,簡易
2020-07-27,970,10404,10605,21009,汐科,簡易
2020-07-28,970,10816,10770,21586,汐科,簡易
2020-07-29,970,10713,10748,21461,汐科,簡易
2020-07-30,970,10667,10821,21488,汐科,簡易
2020-07-31,970,11190,10811,22001,汐科,簡易
2020-08-01,970,5533,5449,10982,汐科,簡易
2020-08-02,970,4143,4590,8733,汐科,簡易
2020-08-03,970,9787,10121,19908,汐科,簡易
2020-08-04,970,10756,10793,21549,汐科,簡易
2020-08-05,970,10924,10877,21801,汐科,簡易
2020-08-06,970,10599,10759,21358,汐科,簡易
2020-08-07,970,11548,10946,22494,汐科,簡易
2020-08-08,970,5098,4875,9973,汐科,簡易
2020-08-09,970,4367,4841,9208,汐科,簡易
2020-08-10,970,10541,10817,21358,汐科,簡易
2020-08-11,970,10594,10692,21286,汐科,簡易
2020-08-12,970,10971,10804,21775,汐科,簡易
2020-08-13,970,11096,11067,22163,汐科,簡易
2020-08-14,970,11142,10765,21907,汐科,簡易
2020-08-15,970,5729,5617,11346,汐科,簡易
2020-08-16,970,4738,4949,9687,汐科,簡易
2020-08-17,970,10447,10714,21161,汐科,簡易
2020-08-18,970,10883,10952,21835,汐科,簡易
2020-08-19,970,10891,10916,21807,汐科,簡易
2020-08-20,970,10763,10883,21646,汐科,簡易
2020-08-21,970,11394,10857,22251,汐科,簡易
2020-08-22,970,5254,5102,10356,汐科,簡易
2020-08-23,970,4553,4831,9384,汐科,簡易
2020-08-24,970,10392,10645,21037,汐科,簡易
2020-08-25,970,10876,10876,21752,汐科,簡易
2020-08-26,970,11013,10981,21994,汐科,簡易
2020-08-27,970,10629,10765,21394,汐科,簡易
2020-08-28,970,11373,10787,22160,汐科,簡易
2020-08-29,970,5638,5377,11015,汐科,簡易
2020-08-30,970,4340,4729,9069,汐科,簡易
2020-08-31,970,10552,10678,21230,汐科,簡易
2020-09-01,970,10870,10900,21770,汐科,簡易
2020-09-02,970,11039,10990,22029,汐科,簡易
2020-09-03,970,10924,10958,21882,汐科,簡易
2020-09-04,970,11510,11189,22699,汐科,簡易
2020-09-05,970,5486,5224,10710,汐科,簡易
2020-09-06,970,4441,4651,9092,汐科,簡易
2020-09-07,970,10902,10958,21860,汐科,簡易
2020-09-08,970,10994,10995,21989,汐科,簡易
2020-09-09,970,11031,11032,22063,汐科,簡易
2020-09-10,970,10946,10935,21881,汐科,簡易
2020-09-11,970,11490,11344,22834,汐科,簡易
2020-09-12,970,5511,5201,10712,汐科,簡易
2020-09-13,970,4428,4584,9012,汐科,簡易
2020-09-14,970,10803,10897,21700,汐科,簡易
2020-09-15,970,10971,10853,21824,汐科,簡易
2020-09-16,970,11052,11006,22058,汐科,簡易
2020-09-17,970,10735,11063,21798,汐科,簡易
2020-09-18,970,11529,11153,22682,汐科,簡易
2020-09-19,970,5677,5499,11176,汐科,簡易
2020-09-20,970,4257,4478,8735,汐科,簡易
2020-09-21,970,10971,10892,21863,汐科,簡易
2020-09-22,970,11023,10928,21951,汐科,簡易
2020-09-23,970,11147,11216,22363,汐科,簡易
2020-09-24,970,11043,11168,22211,汐科,簡易
2020-09-25,970,11538,11345,22883,汐科,簡易
2020-09-26,970,7344,7815,15159,汐科,簡易
2020-09-27,970,4095,4317,8412,汐科,簡易
2020-09-28,970,11212,11123,22335,汐科,簡易
2020-09-29,970,11275,11203,22478,汐科,簡易
2020-09-30,970,12022,11792,23814,汐科,簡易
2020-10-01,970,5588,5063,10651,汐科,簡易
2020-10-02,970,5425,5253,10678,汐科,簡易
2020-10-03,970,5029,5407,10436,汐科,簡易
2020-10-04,970,4401,4864,9265,汐科,簡易
2020-10-05,970,11215,11312,22527,汐科,簡易
2020-10-06,970,11098,11252,22350,汐科,簡易
2020-10-07,970,11420,11398,22818,汐科,簡易
2020-10-08,970,11886,11765,23651,汐科,簡易
2020-10-09,970,5777,5510,11287,汐科,簡易
2020-10-10,970,4987,5108,10095,汐科,簡易
2020-10-11,970,4162,4462,8624,汐科,簡易
2020-10-12,970,11271,11260,22531,汐科,簡易
2020-10-13,970,11868,11503,23371,汐科,簡易
2020-10-14,970,11505,11532,23037,汐科,簡易
2020-10-15,970,11362,11387,22749,汐科,簡易
2020-10-16,970,12186,11856,24042,汐科,簡易
2020-10-17,970,5607,5522,11129,汐科,簡易
2020-10-18,970,4747,4866,9613,汐科,簡易
2020-10-19,970,11475,11408,22883,汐科,簡易
2020-10-20,970,11535,11564,23099,汐科,簡易
2020-10-21,970,11631,11650,23281,汐科,簡易
2020-10-22,970,11529,11391,22920,汐科,簡易
2020-10-23,970,12297,11945,24242,汐科,簡易
2020-10-24,970,5902,5799,11701,汐科,簡易
2020-10-25,970,4829,4959,9788,汐科,簡易
2020-10-26,970,11533,11405,22938,汐科,簡易
2020-10-27,970,11593,11510,23103,汐科,簡易
2020-10-28,970,11438,11294,22732,汐科,簡易
2020-10-29,970,11396,11245,22641,汐科,簡易
2020-10-30,970,12095,11783,23878,汐科,簡易
2020-10-31,970,5941,5712,11653,汐科,簡易
2020-11-01,970,4587,4900,9487,汐科,簡易
2020-11-02,970,11140,11189,22329,汐科,簡易
2020-11-03,970,11391,11332,22723,汐科,簡易
2020-11-04,970,11499,11374,22873,汐科,簡易
2020-11-05,970,11320,11198,22518,汐科,簡易
2020-11-06,970,11994,11543,23537,汐科,簡易
2020-11-07,970,5872,5809,11681,汐科,簡易
2020-11-08,970,4538,4768,9306,汐科,簡易
2020-11-09,970,11425,11481,22906,汐科,簡易
2020-11-10,970,11537,11468,23005,汐科,簡易
2020-11-11,970,11662,11572,23234,汐科,簡易
2020-11-12,970,11625,11636,23261,汐科,簡易
2020-11-13,970,12333,11910,24243,汐科,簡易
2020-11-14,970,5922,5731,11653,汐科,簡易
2020-11-15,970,5279,5493,10772,汐科,簡易
2020-11-16,970,11446,11449,22895,汐科,簡易
2020-11-17,970,11428,11230,22658,汐科,簡易
2020-11-18,970,11684,11702,23386,汐科,簡易
2020-11-19,970,11838,11828,23666,汐科,簡易
2020-11-20,970,12187,11641,23828,汐科,簡易
2020-11-21,970,5719,5585,11304,汐科,簡易
2020-11-22,970,5063,5306,10369,汐科,簡易
2020-11-23,970,11402,11376,22778,汐科,簡易
2020-11-24,970,11671,11571,23242,汐科,簡易
2020-11-25,970,11780,11639,23419,汐科,簡易
2020-11-26,970,11603,11532,23135,汐科,簡易
2020-11-27,970,12394,11959,24353,汐科,簡易
2020-11-28,970,5701,5537,11238,汐科,簡易
2020-11-29,970,4610,4936,9546,汐科,簡易
2020-11-30,970,11342,11510,22852,汐科,簡易
2020-12-01,970,11440,11428,22868,汐科,簡易
2020-12-02,970,11655,11643,23298,汐科,簡易
2020-12-03,970,11449,11480,22929,汐科,簡易
2020-12-04,970,12104,11918,24022,汐科,簡易
2020-12-05,970,5799,5730,11529,汐科,簡易
2020-12-06,970,4853,5045,9898,汐科,簡易
2020-12-07,970,11317,11484,22801,汐科,簡易
2020-12-08,970,11583,11596,23179,汐科,簡易
2020-12-09,970,11674,11673,23347,汐科,簡易
2020-12-10,970,11700,11617,23317,汐科,簡易
2020-12-11,970,12491,12010,24501,汐科,簡易
2020-12-12,970,6239,6077,12316,汐科,簡易
2020-12-13,970,5248,5387,10635,汐科,簡易
2020-12-14,970,11591,11657,23248,汐科,簡易
2020-12-15,970,11730,11642,23372,汐科,簡易
2020-12-16,970,11825,11939,23764,汐科,簡易
2020-12-17,970,11870,11820,23690,汐科,簡易
2020-12-18,970,12426,11997,24423,汐科,簡易
2020-12-19,970,5817,5762,11579,汐科,簡易
2020-12-20,970,4983,5166,10149,汐科,簡易
2020-12-21,970,11667,11732,23399,汐科,簡易
2020-12-22,970,11819,11750,23569,汐科,簡易
2020-12-23,970,11684,11713,23397,汐科,簡易
2020-12-24,970,11673,11737,23410,汐科,簡易
2020-12-25,970,12287,11914,24201,汐科,簡易
2020-12-26,970,6086,5714,11800,汐科,簡易
2020-12-27,970,4860,5057,9917,汐科,簡易
2020-12-28,970,11650,11650,23300,汐科,簡易
2020-12-29,970,11738,11789,23527,汐科,簡易
2020-12-30,970,11554,11614,23168,汐科,簡易
2020-12-31,970,12104,11241,23345,汐科,簡易
2020-01-01,980,10725,9562,20287,南港,一等
2020-01-02,980,12005,12514,24519,南港,一等
2020-01-03,980,13051,14132,27183,南港,一等
2020-01-04,980,10657,10990,21647,南港,一等
2020-01-05,980,8536,9139,17675,南港,一等
2020-01-06,980,11891,12495,24386,南港,一等
2020-01-07,980,11688,12252,23940,南港,一等
2020-01-08,980,11589,12338,23927,南港,一等
2020-01-09,980,12096,12855,24951,南港,一等
2020-01-10,980,14220,15532,29752,南港,一等
2020-01-11,980,9667,10048,19715,南港,一等
2020-01-12,980,9091,9372,18463,南港,一等
2020-01-13,980,12262,12817,25079,南港,一等
2020-01-14,980,12182,12640,24822,南港,一等
2020-01-15,980,11051,10017,21068,南港,一等
2020-01-16,980,12751,13183,25934,南港,一等
2020-01-17,980,12776,13783,26559,南港,一等
2020-01-18,980,9965,10594,20559,南港,一等
2020-01-19,980,9116,9415,18531,南港,一等
2020-01-20,980,11975,12508,24483,南港,一等
2020-01-21,980,11670,12790,24460,南港,一等
2020-01-22,980,12041,14353,26394,南港,一等
2020-01-23,980,7455,8738,16193,南港,一等
2020-01-24,980,5295,5662,10957,南港,一等
2020-01-25,980,6840,8019,14859,南港,一等
2020-01-26,980,7340,8264,15604,南港,一等
2020-01-27,980,8159,8442,16601,南港,一等
2020-01-28,980,8863,8424,17287,南港,一等
2020-01-29,980,8193,8205,16398,南港,一等
2020-01-30,980,10392,10813,21205,南港,一等
2020-01-31,980,11636,12518,24154,南港,一等
2020-02-01,980,8207,8491,16698,南港,一等
2020-02-02,980,7755,8330,16085,南港,一等
2020-02-03,980,10780,11725,22505,南港,一等
2020-02-04,980,10360,10978,21338,南港,一等
2020-02-05,980,10056,10804,20860,南港,一等
2020-02-06,980,9891,10868,20759,南港,一等
2020-02-07,980,10664,11787,22451,南港,一等
2020-02-08,980,7339,7591,14930,南港,一等
2020-02-09,980,6939,7467,14406,南港,一等
2020-02-10,980,10120,10935,21055,南港,一等
2020-02-11,980,9897,10474,20371,南港,一等
2020-02-12,980,10254,11115,21369,南港,一等
2020-02-13,980,10028,10839,20867,南港,一等
2020-02-14,980,10942,11974,22916,南港,一等
2020-02-15,980,9547,10030,19577,南港,一等
2020-02-16,980,6844,6973,13817,南港,一等
2020-02-17,980,9855,5609,15464,南港,一等
2020-02-18,980,9767,10540,20307,南港,一等
2020-02-19,980,10035,10617,20652,南港,一等
2020-02-20,980,9843,10651,20494,南港,一等
2020-02-21,980,10897,11961,22858,南港,一等
2020-02-22,980,7249,7307,14556,南港,一等
2020-02-23,980,6401,7082,13483,南港,一等
2020-02-24,980,10066,10862,20928,南港,一等
2020-02-25,980,10737,11485,22222,南港,一等
2020-02-26,980,10626,11153,21779,南港,一等
2020-02-27,980,12115,12958,25073,南港,一等
2020-02-28,980,8027,8341,16368,南港,一等
2020-02-29,980,6908,7102,14010,南港,一等
2020-03-01,980,6776,7114,13890,南港,一等
2020-03-02,980,10731,11354,22085,南港,一等
2020-03-03,980,10342,10971,21313,南港,一等
2020-03-04,980,10110,10802,20912,南港,一等
2020-03-05,980,10317,11013,21330,南港,一等
2020-03-06,980,11635,12657,24292,南港,一等
2020-03-07,980,7017,7226,14243,南港,一等
2020-03-08,980,6412,6904,13316,南港,一等
2020-03-09,980,10579,11206,21785,南港,一等
2020-03-10,980,10043,10841,20884,南港,一等
2020-03-11,980,10575,10984,21559,南港,一等
2020-03-12,980,10389,11030,21419,南港,一等
2020-03-13,980,11651,12490,24141,南港,一等
2020-03-14,980,6801,6868,13669,南港,一等
2020-03-15,980,6841,7136,13977,南港,一等
2020-03-16,980,10693,11140,21833,南港,一等
2020-03-17,980,10246,10728,20974,南港,一等
2020-03-18,980,9951,10516,20467,南港,一等
2020-03-19,980,10128,10517,20645,南港,一等
2020-03-20,980,10816,11742,22558,南港,一等
2020-03-21,980,6459,6350,12809,南港,一等
2020-03-22,980,5658,6204,11862,南港,一等
2020-03-23,980,9708,10421,20129,南港,一等
2020-03-24,980,9516,9956,19472,南港,一等
2020-03-25,980,9480,10044,19524,南港,一等
2020-03-26,980,9558,10163,19721,南港,一等
2020-03-27,980,10806,11249,22055,南港,一等
2020-03-28,980,5600,5604,11204,南港,一等
2020-03-29,980,5547,5814,11361,南港,一等
2020-03-30,980,9701,10178,19879,南港,一等
2020-03-31,980,9535,10385,19920,南港,一等
2020-04-01,980,10545,11760,22305,南港,一等
2020-04-02,980,5902,6081,11983,南港,一等
2020-04-03,980,5587,5831,11418,南港,一等
2020-04-04,980,4556,4844,9400,南港,一等
2020-04-05,980,5640,5935,11575,南港,一等
2020-04-06,980,10139,10229,20368,南港,一等
2020-04-07,980,9128,9551,18679,南港,一等
2020-04-08,980,8985,9478,18463,南港,一等
2020-04-09,980,8916,9535,18451,南港,一等
2020-04-10,980,10001,10632,20633,南港,一等
2020-04-11,980,5579,5611,11190,南港,一等
2020-04-12,980,4996,5127,10123,南港,一等
2020-04-13,980,9228,9608,18836,南港,一等
2020-04-14,980,9111,9540,18651,南港,一等
2020-04-15,980,9354,9599,18953,南港,一等
2020-04-16,980,9225,9743,18968,南港,一等
2020-04-17,980,10469,10974,21443,南港,一等
2020-04-18,980,6170,6201,12371,南港,一等
2020-04-19,980,5666,5919,11585,南港,一等
2020-04-20,980,9655,10089,19744,南港,一等
2020-04-21,980,9221,9592,18813,南港,一等
2020-04-22,980,9406,9787,19193,南港,一等
2020-04-23,980,9406,9834,19240,南港,一等
2020-04-24,980,10321,10921,21242,南港,一等
2020-04-25,980,5690,5597,11287,南港,一等
2020-04-26,980,4983,5302,10285,南港,一等
2020-04-27,980,9632,9994,19626,南港,一等
2020-04-28,980,9414,9927,19341,南港,一等
2020-04-29,980,9468,9973,19441,南港,一等
2020-04-30,980,10692,11165,21857,南港,一等
2020-05-01,980,8947,8771,17718,南港,一等
2020-05-02,980,6207,6634,12841,南港,一等
2020-05-03,980,6525,6865,13390,南港,一等
2020-05-04,980,9932,10265,20197,南港,一等
2020-05-05,980,9669,10135,19804,南港,一等
2020-05-06,980,9808,10280,20088,南港,一等
2020-05-07,980,9772,10341,20113,南港,一等
2020-05-08,980,11618,12305,23923,南港,一等
2020-05-09,980,7507,7305,14812,南港,一等
2020-05-10,980,6789,7085,13874,南港,一等
2020-05-11,980,10226,10844,21070,南港,一等
2020-05-12,980,9879,10316,20195,南港,一等
2020-05-13,980,10150,10597,20747,南港,一等
2020-05-14,980,10096,10605,20701,南港,一等
2020-05-15,980,11539,12380,23919,南港,一等
2020-05-16,980,6972,7172,14144,南港,一等
2020-05-17,980,6653,6837,13490,南港,一等
2020-05-18,980,10336,10589,20925,南港,一等
2020-05-19,980,9907,10208,20115,南港,一等
2020-05-20,980,10099,10405,20504,南港,一等
2020-05-21,980,10362,10728,21090,南港,一等
2020-05-22,980,11365,11837,23202,南港,一等
2020-05-23,980,6626,6678,13304,南港,一等
2020-05-24,980,6823,7231,14054,南港,一等
2020-05-25,980,10246,10901,21147,南港,一等
2020-05-26,980,10218,10760,20978,南港,一等
2020-05-27,980,10318,10701,21019,南港,一等
2020-05-28,980,10172,10829,21001,南港,一等
2020-05-29,980,11668,12506,24174,南港,一等
2020-05-30,980,8184,8117,16301,南港,一等
2020-05-31,980,7727,8099,15826,南港,一等
2020-06-01,980,10491,10965,21456,南港,一等
2020-06-02,980,10155,10935,21090,南港,一等
2020-06-03,980,10298,11086,21384,南港,一等
2020-06-04,980,10181,11011,21192,南港,一等
2020-06-05,980,11376,12593,23969,南港,一等
2020-06-06,980,8333,8661,16994,南港,一等
2020-06-07,980,7443,7654,15097,南港,一等
2020-06-08,980,10787,11153,21940,南港,一等
2020-06-09,980,10650,11172,21822,南港,一等
2020-06-10,980,10950,11375,22325,南港,一等
2020-06-11,980,10968,11500,22468,南港,一等
2020-06-12,980,12151,12883,25034,南港,一等
2020-06-13,980,8801,8990,17791,南港,一等
2020-06-14,980,7659,8229,15888,南港,一等
2020-06-15,980,10648,11212,21860,南港,一等
2020-06-16,980,10505,11191,21696,南港,一等
2020-06-17,980,10363,11066,21429,南港,一等
2020-06-18,980,10801,11296,22097,南港,一等
2020-06-19,980,11250,11968,23218,南港,一等
2020-06-20,980,10162,9269,19431,南港,一等
2020-06-21,980,7355,7765,15120,南港,一等
2020-06-22,980,10603,11231,21834,南港,一等
2020-06-23,980,10982,11480,22462,南港,一等
2020-06-24,980,12597,13136,25733,南港,一等
2020-06-25,980,8868,8505,17373,南港,一等
2020-06-26,980,9059,9480,18539,南港,一等
2020-06-27,980,8738,9324,18062,南港,一等
2020-06-28,980,8168,8746,16914,南港,一等
2020-06-29,980,11148,11476,22624,南港,一等
2020-06-30,980,10644,11269,21913,南港,一等
2020-07-01,980,10349,10992,21341,南港,一等
2020-07-02,980,10837,11197,22034,南港,一等
2020-07-03,980,11979,12898,24877,南港,一等
2020-07-04,980,8741,8942,17683,南港,一等
2020-07-05,980,8314,8454,16768,南港,一等
2020-07-06,980,10888,11509,22397,南港,一等
2020-07-07,980,10921,11424,22345,南港,一等
2020-07-08,980,10781,11399,22180,南港,一等
2020-07-09,980,10978,11626,22604,南港,一等
2020-07-10,980,12752,13485,26237,南港,一等
2020-07-11,980,9524,9748,19272,南港,一等
2020-07-12,980,8647,9295,17942,南港,一等
2020-07-13,980,11487,12078,23565,南港,一等
2020-07-14,980,11388,12112,23500,南港,一等
2020-07-15,980,11141,11685,22826,南港,一等
2020-07-16,980,11016,11775,22791,南港,一等
2020-07-17,980,12305,12969,25274,南港,一等
2020-07-18,980,9415,9828,19243,南港,一等
2020-07-19,980,8594,9050,17644,南港,一等
2020-07-20,980,11295,11809,23104,南港,一等
2020-07-21,980,10741,11636,22377,南港,一等
2020-07-22,980,11066,11783,22849,南港,一等
2020-07-23,980,11583,12245,23828,南港,一等
2020-07-24,980,12327,13529,25856,南港,一等
2020-07-25,980,9236,9545,18781,南港,一等
2020-07-26,980,8686,9028,17714,南港,一等
2020-07-27,980,11221,11900,23121,南港,一等
2020-07-28,980,10791,11335,22126,南港,一等
2020-07-29,980,11193,11836,23029,南港,一等
2020-07-30,980,11680,12484,24164,南港,一等
2020-07-31,980,12718,13905,26623,南港,一等
2020-08-01,980,10473,10969,21442,南港,一等
2020-08-02,980,8985,9772,18757,南港,一等
2020-08-03,980,9994,10761,20755,南港,一等
2020-08-04,980,10619,11216,21835,南港,一等
2020-08-05,980,10756,11980,22736,南港,一等
2020-08-06,980,10786,11779,22565,南港,一等
2020-08-07,980,12312,13268,25580,南港,一等
2020-08-08,980,8856,8987,17843,南港,一等
2020-08-09,980,8658,9130,17788,南港,一等
2020-08-10,980,11214,11619,22833,南港,一等
2020-08-11,980,10823,11565,22388,南港,一等
2020-08-12,980,10840,11740,22580,南港,一等
2020-08-13,980,11158,11868,23026,南港,一等
2020-08-14,980,12243,13168,25411,南港,一等
2020-08-15,980,9674,9964,19638,南港,一等
2020-08-16,980,8993,9342,18335,南港,一等
2020-08-17,980,10901,11508,22409,南港,一等
2020-08-18,980,11428,11997,23425,南港,一等
2020-08-19,980,11684,12567,24251,南港,一等
2020-08-20,980,11790,12440,24230,南港,一等
2020-08-21,980,12687,13779,26466,南港,一等
2020-08-22,980,9682,9875,19557,南港,一等
2020-08-23,980,8292,8394,16686,南港,一等
2020-08-24,980,11186,11687,22873,南港,一等
2020-08-25,980,11349,12044,23393,南港,一等
2020-08-26,980,11160,11785,22945,南港,一等
2020-08-27,980,11058,11595,22653,南港,一等
2020-08-28,980,11689,12727,24416,南港,一等
2020-08-29,980,8706,9137,17843,南港,一等
2020-08-30,980,8094,8457,16551,南港,一等
2020-08-31,980,10968,11567,22535,南港,一等
2020-09-01,980,11004,11931,22935,南港,一等
2020-09-02,980,10938,11724,22662,南港,一等
2020-09-03,980,11242,11848,23090,南港,一等
2020-09-04,980,12532,13279,25811,南港,一等
2020-09-05,980,9336,9793,19129,南港,一等
2020-09-06,980,8151,8513,16664,南港,一等
2020-09-07,980,11291,11936,23227,南港,一等
2020-09-08,980,11287,11902,23189,南港,一等
2020-09-09,980,11550,12004,23554,南港,一等
2020-09-10,980,11480,12042,23522,南港,一等
2020-09-11,980,13314,14120,27434,南港,一等
2020-09-12,980,9641,9744,19385,南港,一等
2020-09-13,980,8194,8541,16735,南港,一等
2020-09-14,980,11372,11908,23280,南港,一等
2020-09-15,980,10999,11616,22615,南港,一等
2020-09-16,980,11146,11811,22957,南港,一等
2020-09-17,980,11278,11920,23198,南港,一等
2020-09-18,980,13070,13969,27039,南港,一等
2020-09-19,980,10050,10255,20305,南港,一等
2020-09-20,980,8594,8328,16922,南港,一等
2020-09-21,980,11339,12069,23408,南港,一等
2020-09-22,980,11258,11724,22982,南港,一等
2020-09-23,980,11666,12231,23897,南港,一等
2020-09-24,980,11809,12419,24228,南港,一等
2020-09-25,980,12320,13309,25629,南港,一等
2020-09-26,980,10965,9151,20116,南港,一等
2020-09-27,980,7679,6272,13951,南港,一等
2020-09-28,980,11580,12284,23864,南港,一等
2020-09-29,980,11614,12113,23727,南港,一等
2020-09-30,980,13382,15375,28757,南港,一等
2020-10-01,980,9616,10549,20165,南港,一等
2020-10-02,980,9517,10196,19713,南港,一等
2020-10-03,980,12211,13350,25561,南港,一等
2020-10-04,980,10055,9686,19741,南港,一等
2020-10-05,980,11828,12127,23955,南港,一等
2020-10-06,980,11066,11912,22978,南港,一等
2020-10-07,980,11617,12215,23832,南港,一等
2020-10-08,980,13131,14222,27353,南港,一等
2020-10-09,980,10302,10882,21184,南港,一等
2020-10-10,980,9506,9857,19363,南港,一等
2020-10-11,980,9042,8910,17952,南港,一等
2020-10-12,980,11466,12240,23706,南港,一等
2020-10-13,980,11638,12187,23825,南港,一等
2020-10-14,980,11657,12352,24009,南港,一等
2020-10-15,980,11724,12563,24287,南港,一等
2020-10-16,980,13449,14213,27662,南港,一等
2020-10-17,980,9661,9645,19306,南港,一等
2020-10-18,980,8734,8889,17623,南港,一等
2020-10-19,980,11544,12419,23963,南港,一等
2020-10-20,980,11698,12190,23888,南港,一等
2020-10-21,980,11730,12459,24189,南港,一等
2020-10-22,980,11875,12577,24452,南港,一等
2020-10-23,980,13558,14610,28168,南港,一等
2020-10-24,980,10108,10339,20447,南港,一等
2020-10-25,980,8836,8894,17730,南港,一等
2020-10-26,980,11656,12369,24025,南港,一等
2020-10-27,980,11360,11977,23337,南港,一等
2020-10-28,980,11634,12196,23830,南港,一等
2020-10-29,980,11430,12204,23634,南港,一等
2020-10-30,980,13261,14488,27749,南港,一等
2020-10-31,980,10372,10924,21296,南港,一等
2020-11-01,980,9541,9871,19412,南港,一等
2020-11-02,980,11720,12363,24083,南港,一等
2020-11-03,980,11230,12016,23246,南港,一等
2020-11-04,980,11509,12025,23534,南港,一等
2020-11-05,980,11748,12519,24267,南港,一等
2020-11-06,980,13278,14366,27644,南港,一等
2020-11-07,980,10655,10973,21628,南港,一等
2020-11-08,980,9215,9423,18638,南港,一等
2020-11-09,980,11867,12542,24409,南港,一等
2020-11-10,980,11431,12161,23592,南港,一等
2020-11-11,980,11825,12394,24219,南港,一等
2020-11-12,980,11833,12573,24406,南港,一等
2020-11-13,980,13940,15320,29260,南港,一等
2020-11-14,980,11135,11983,23118,南港,一等
2020-11-15,980,10933,11342,22275,南港,一等
2020-11-16,980,12437,13006,25443,南港,一等
2020-11-17,980,11703,12375,24078,南港,一等
2020-11-18,980,12115,12382,24497,南港,一等
2020-11-19,980,12097,12691,24788,南港,一等
2020-11-20,980,13204,14386,27590,南港,一等
2020-11-21,980,9818,10121,19939,南港,一等
2020-11-22,980,9249,9594,18843,南港,一等
2020-11-23,980,11319,12309,23628,南港,一等
2020-11-24,980,11543,12074,23617,南港,一等
2020-11-25,980,11757,12270,24027,南港,一等
2020-11-26,980,11884,12676,24560,南港,一等
2020-11-27,980,13472,14689,28161,南港,一等
2020-11-28,980,9840,10112,19952,南港,一等
2020-11-29,980,8938,8984,17922,南港,一等
2020-11-30,980,11595,12234,23829,南港,一等
2020-12-01,980,11341,11903,23244,南港,一等
2020-12-02,980,11366,12182,23548,南港,一等
2020-12-03,980,11933,12630,24563,南港,一等
2020-12-04,980,13784,14802,28586,南港,一等
2020-12-05,980,9825,10077,19902,南港,一等
2020-12-06,980,9540,9510,19050,南港,一等
2020-12-07,980,11561,12204,23765,南港,一等
2020-12-08,980,11142,11839,22981,南港,一等
2020-12-09,980,11299,12039,23338,南港,一等
2020-12-10,980,11602,12426,24028,南港,一等
2020-12-11,980,13521,14729,28250,南港,一等
2020-12-12,980,10496,10757,21253,南港,一等
2020-12-13,980,9569,9828,19397,南港,一等
2020-12-14,980,11784,12565,24349,南港,一等
2020-12-15,980,11571,12183,23754,南港,一等
2020-12-16,980,11723,12500,24223,南港,一等
2020-12-17,980,12036,12945,24981,南港,一等
2020-12-18,980,13777,14986,28763,南港,一等
2020-12-19,980,10453,10699,21152,南港,一等
2020-12-20,980,9651,9908,19559,南港,一等
2020-12-21,980,11894,12556,24450,南港,一等
2020-12-22,980,11957,12455,24412,南港,一等
2020-12-23,980,11715,12377,24092,南港,一等
2020-12-24,980,11860,12725,24585,南港,一等
2020-12-25,980,13487,14729,28216,南港,一等
2020-12-26,980,9821,10359,20180,南港,一等
2020-12-27,980,9045,9542,18587,南港,一等
2020-12-28,980,11758,12460,24218,南港,一等
2020-12-29,980,11799,12319,24118,南港,一等
2020-12-30,980,11812,12518,24330,南港,一等
2020-12-31,980,13233,15612,28845,南港,一等
2020-01-01,990,14870,12208,27078,松山,一等
2020-01-02,990,18477,18536,37013,松山,一等
2020-01-03,990,19854,19646,39500,松山,一等
2020-01-04,990,14947,14113,29060,松山,一等
2020-01-05,990,12155,13259,25414,松山,一等
2020-01-06,990,18482,18732,37214,松山,一等
2020-01-07,990,18176,18525,36701,松山,一等
2020-01-08,990,17592,18200,35792,松山,一等
2020-01-09,990,18559,18766,37325,松山,一等
2020-01-10,990,21230,20517,41747,松山,一等
2020-01-11,990,15326,14609,29935,松山,一等
2020-01-12,990,12389,14573,26962,松山,一等
2020-01-13,990,18415,19013,37428,松山,一等
2020-01-14,990,18217,18364,36581,松山,一等
2020-01-15,990,17708,15814,33522,松山,一等
2020-01-16,990,18980,19330,38310,松山,一等
2020-01-17,990,18884,19360,38244,松山,一等
2020-01-18,990,14685,14098,28783,松山,一等
2020-01-19,990,12459,13486,25945,松山,一等
2020-01-20,990,19120,19604,38724,松山,一等
2020-01-21,990,19275,10964,30239,松山,一等
2020-01-22,990,20506,10863,31369,松山,一等
2020-01-23,990,13568,10290,23858,松山,一等
2020-01-24,990,9912,7217,17129,松山,一等
2020-01-25,990,11757,11055,22812,松山,一等
2020-01-26,990,10771,11047,21818,松山,一等
2020-01-27,990,12050,13568,25618,松山,一等
2020-01-28,990,11496,14028,25524,松山,一等
2020-01-29,990,9527,13282,22809,松山,一等
2020-01-30,990,16345,17834,34179,松山,一等
2020-01-31,990,16754,17365,34119,松山,一等
2020-02-01,990,11653,11553,23206,松山,一等
2020-02-02,990,10219,11169,21388,松山,一等
2020-02-03,990,16739,17254,33993,松山,一等
2020-02-04,990,15870,16123,31993,松山,一等
2020-02-05,990,16106,16240,32346,松山,一等
2020-02-06,990,16389,16735,33124,松山,一等
2020-02-07,990,17365,17300,34665,松山,一等
2020-02-08,990,11163,10421,21584,松山,一等
2020-02-09,990,9207,10458,19665,松山,一等
2020-02-10,990,16317,16722,33039,松山,一等
2020-02-11,990,15861,15980,31841,松山,一等
2020-02-12,990,16318,16582,32900,松山,一等
2020-02-13,990,16162,16347,32509,松山,一等
2020-02-14,990,17214,17330,34544,松山,一等
2020-02-15,990,14429,14243,28672,松山,一等
2020-02-16,990,9527,9581,19108,松山,一等
2020-02-17,990,15813,16326,32139,松山,一等
2020-02-18,990,16044,16374,32418,松山,一等
2020-02-19,990,16184,16383,32567,松山,一等
2020-02-20,990,16009,16273,32282,松山,一等
2020-02-21,990,17724,17304,35028,松山,一等
2020-02-22,990,10686,10103,20789,松山,一等
2020-02-23,990,9165,10460,19625,松山,一等
2020-02-24,990,16219,16678,32897,松山,一等
2020-02-25,990,16198,16378,32576,松山,一等
2020-02-26,990,16184,15828,32012,松山,一等
2020-02-27,990,18197,16937,35134,松山,一等
2020-02-28,990,12275,10550,22825,松山,一等
2020-02-29,990,9204,9885,19089,松山,一等
2020-03-01,990,8239,10930,19169,松山,一等
2020-03-02,990,15513,15618,31131,松山,一等
2020-03-03,990,15289,15452,30741,松山,一等
2020-03-04,990,14985,14990,29975,松山,一等
2020-03-05,990,14936,15157,30093,松山,一等
2020-03-06,990,17202,16816,34018,松山,一等
2020-03-07,990,10522,9758,20280,松山,一等
2020-03-08,990,8583,9416,17999,松山,一等
2020-03-09,990,15974,16170,32144,松山,一等
2020-03-10,990,14994,15139,30133,松山,一等
2020-03-11,990,15710,15637,31347,松山,一等
2020-03-12,990,15471,15515,30986,松山,一等
2020-03-13,990,16880,16455,33335,松山,一等
2020-03-14,990,9658,8872,18530,松山,一等
2020-03-15,990,9299,10320,19619,松山,一等
2020-03-16,990,15971,16188,32159,松山,一等
2020-03-17,990,15549,15366,30915,松山,一等
2020-03-18,990,15312,15263,30575,松山,一等
2020-03-19,990,14847,14788,29635,松山,一等
2020-03-20,990,16891,16227,33118,松山,一等
2020-03-21,990,9695,8820,18515,松山,一等
2020-03-22,990,7814,9198,17012,松山,一等
2020-03-23,990,14648,14889,29537,松山,一等
2020-03-24,990,14668,13397,28065,松山,一等
2020-03-25,990,14790,14352,29142,松山,一等
2020-03-26,990,14532,14486,29018,松山,一等
2020-03-27,990,15773,15646,31419,松山,一等
2020-03-28,990,7956,7061,15017,松山,一等
2020-03-29,990,7350,8534,15884,松山,一等
2020-03-30,990,14660,12976,27636,松山,一等
2020-03-31,990,14684,14421,29105,松山,一等
2020-04-01,990,16391,15115,31506,松山,一等
2020-04-02,990,10041,7330,17371,松山,一等
2020-04-03,990,7887,7395,15282,松山,一等
2020-04-04,990,5845,7651,13496,松山,一等
2020-04-05,990,6050,8963,15013,松山,一等
2020-04-06,990,14194,14893,29087,松山,一等
2020-04-07,990,13672,13694,27366,松山,一等
2020-04-08,990,13599,13428,27027,松山,一等
2020-04-09,990,13622,13610,27232,松山,一等
2020-04-10,990,15021,14902,29923,松山,一等
2020-04-11,990,7459,7036,14495,松山,一等
2020-04-12,990,6063,6616,12679,松山,一等
2020-04-13,990,14065,13942,28007,松山,一等
2020-04-14,990,13878,13890,27768,松山,一等
2020-04-15,990,14148,14073,28221,松山,一等
2020-04-16,990,14092,14069,28161,松山,一等
2020-04-17,990,15658,15072,30730,松山,一等
2020-04-18,990,8960,8491,17451,松山,一等
2020-04-19,990,7517,8358,15875,松山,一等
2020-04-20,990,14221,14330,28551,松山,一等
2020-04-21,990,13925,13838,27763,松山,一等
2020-04-22,990,13842,13735,27577,松山,一等
2020-04-23,990,13805,13910,27715,松山,一等
2020-04-24,990,15233,14638,29871,松山,一等
2020-04-25,990,7794,7275,15069,松山,一等
2020-04-26,990,6463,7096,13559,松山,一等
2020-04-27,990,14441,14569,29010,松山,一等
2020-04-28,990,14395,14312,28707,松山,一等
2020-04-29,990,14602,14439,29041,松山,一等
2020-04-30,990,15642,14969,30611,松山,一等
2020-05-01,990,11527,10369,21896,松山,一等
2020-05-02,990,8784,8590,17374,松山,一等
2020-05-03,990,7539,9490,17029,松山,一等
2020-05-04,990,14947,15346,30293,松山,一等
2020-05-05,990,14636,14548,29184,松山,一等
2020-05-06,990,14864,14705,29569,松山,一等
2020-05-07,990,14894,14739,29633,松山,一等
2020-05-08,990,17015,16348,33363,松山,一等
2020-05-09,990,10444,9357,19801,松山,一等
2020-05-10,990,8385,9738,18123,松山,一等
2020-05-11,990,15217,15776,30993,松山,一等
2020-05-12,990,14883,14809,29692,松山,一等
2020-05-13,990,15314,15358,30672,松山,一等
2020-05-14,990,15249,15106,30355,松山,一等
2020-05-15,990,17218,16785,34003,松山,一等
2020-05-16,990,9710,9248,18958,松山,一等
2020-05-17,990,8695,9704,18399,松山,一等
2020-05-18,990,15292,15594,30886,松山,一等
2020-05-19,990,14855,14712,29567,松山,一等
2020-05-20,990,15213,15143,30356,松山,一等
2020-05-21,990,14900,14815,29715,松山,一等
2020-05-22,990,15987,15502,31489,松山,一等
2020-05-23,990,9203,8585,17788,松山,一等
2020-05-24,990,9235,10363,19598,松山,一等
2020-05-25,990,15530,15972,31502,松山,一等
2020-05-26,990,15458,15203,30661,松山,一等
2020-05-27,990,15170,15147,30317,松山,一等
2020-05-28,990,14945,14855,29800,松山,一等
2020-05-29,990,17209,16684,33893,松山,一等
2020-05-30,990,11337,10478,21815,松山,一等
2020-05-31,990,9473,10822,20295,松山,一等
2020-06-01,990,15874,16085,31959,松山,一等
2020-06-02,990,15507,15714,31221,松山,一等
2020-06-03,990,15926,15861,31787,松山,一等
2020-06-04,990,15246,14279,29525,松山,一等
2020-06-05,990,17740,16993,34733,松山,一等
2020-06-06,990,12350,11305,23655,松山,一等
2020-06-07,990,9047,10443,19490,松山,一等
2020-06-08,990,16122,16547,32669,松山,一等
2020-06-09,990,16172,16035,32207,松山,一等
2020-06-10,990,16472,16514,32986,松山,一等
2020-06-11,990,16341,16266,32607,松山,一等
2020-06-12,990,18267,17953,36220,松山,一等
2020-06-13,990,12975,12030,25005,松山,一等
2020-06-14,990,10134,11218,21352,松山,一等
2020-06-15,990,16339,16906,33245,松山,一等
2020-06-16,990,16649,16482,33131,松山,一等
2020-06-17,990,16139,14391,30530,松山,一等
2020-06-18,990,16374,16569,32943,松山,一等
2020-06-19,990,17492,17102,34594,松山,一等
2020-06-20,990,14997,14312,29309,松山,一等
2020-06-21,990,10284,10907,21191,松山,一等
2020-06-22,990,16719,17355,34074,松山,一等
2020-06-23,990,16626,16613,33239,松山,一等
2020-06-24,990,19292,17817,37109,松山,一等
2020-06-25,990,14056,11137,25193,松山,一等
2020-06-26,990,12906,12903,25809,松山,一等
2020-06-27,990,11455,13649,25104,松山,一等
2020-06-28,990,9818,13313,23131,松山,一等
2020-06-29,990,16406,17600,34006,松山,一等
2020-06-30,990,16312,16622,32934,松山,一等
2020-07-01,990,16216,16297,32513,松山,一等
2020-07-02,990,16081,16292,32373,松山,一等
2020-07-03,990,17821,17897,35718,松山,一等
2020-07-04,990,12503,11724,24227,松山,一等
2020-07-05,990,10304,11231,21535,松山,一等
2020-07-06,990,17157,17362,34519,松山,一等
2020-07-07,990,16774,16845,33619,松山,一等
2020-07-08,990,16651,16847,33498,松山,一等
2020-07-09,990,17405,16916,34321,松山,一等
2020-07-10,990,18933,18459,37392,松山,一等
2020-07-11,990,13147,12444,25591,松山,一等
2020-07-12,990,11010,12036,23046,松山,一等
2020-07-13,990,17463,18174,35637,松山,一等
2020-07-14,990,17399,15596,32995,松山,一等
2020-07-15,990,17292,17145,34437,松山,一等
2020-07-16,990,17572,17395,34967,松山,一等
2020-07-17,990,18584,18467,37051,松山,一等
2020-07-18,990,13711,12823,26534,松山,一等
2020-07-19,990,11137,12308,23445,松山,一等
2020-07-20,990,17374,18104,35478,松山,一等
2020-07-21,990,16737,17225,33962,松山,一等
2020-07-22,990,17121,17425,34546,松山,一等
2020-07-23,990,17006,17343,34349,松山,一等
2020-07-24,990,19110,18512,37622,松山,一等
2020-07-25,990,12819,12163,24982,松山,一等
2020-07-26,990,11043,12528,23571,松山,一等
2020-07-27,990,16894,17447,34341,松山,一等
2020-07-28,990,17010,17254,34264,松山,一等
2020-07-29,990,16935,17278,34213,松山,一等
2020-07-30,990,17129,17154,34283,松山,一等
2020-07-31,990,18925,18455,37380,松山,一等
2020-08-01,990,13493,12728,26221,松山,一等
2020-08-02,990,10606,11118,21724,松山,一等
2020-08-03,990,15563,16067,31630,松山,一等
2020-08-04,990,16546,16769,33315,松山,一等
2020-08-05,990,16820,16947,33767,松山,一等
2020-08-06,990,17375,17171,34546,松山,一等
2020-08-07,990,19422,18235,37657,松山,一等
2020-08-08,990,13265,12012,25277,松山,一等
2020-08-09,990,11546,13212,24758,松山,一等
2020-08-10,990,16989,17769,34758,松山,一等
2020-08-11,990,16600,16760,33360,松山,一等
2020-08-12,990,16944,17092,34036,松山,一等
2020-08-13,990,17431,17796,35227,松山,一等
2020-08-14,990,18726,18196,36922,松山,一等
2020-08-15,990,14198,13168,27366,松山,一等
2020-08-16,990,11624,12803,24427,松山,一等
2020-08-17,990,17455,18061,35516,松山,一等
2020-08-18,990,17385,17712,35097,松山,一等
2020-08-19,990,17193,17441,34634,松山,一等
2020-08-20,990,17427,17263,34690,松山,一等
2020-08-21,990,19353,18912,38265,松山,一等
2020-08-22,990,12835,12312,25147,松山,一等
2020-08-23,990,11215,12487,23702,松山,一等
2020-08-24,990,17430,18297,35727,松山,一等
2020-08-25,990,17414,17705,35119,松山,一等
2020-08-26,990,17490,17584,35074,松山,一等
2020-08-27,990,16807,16839,33646,松山,一等
2020-08-28,990,18732,17925,36657,松山,一等
2020-08-29,990,12689,12229,24918,松山,一等
2020-08-30,990,10822,12091,22913,松山,一等
2020-08-31,990,16179,16712,32891,松山,一等
2020-09-01,990,16459,16298,32757,松山,一等
2020-09-02,990,16635,16655,33290,松山,一等
2020-09-03,990,16720,16640,33360,松山,一等
2020-09-04,990,18767,18005,36772,松山,一等
2020-09-05,990,13111,12170,25281,松山,一等
2020-09-06,990,10787,11951,22738,松山,一等
2020-09-07,990,16958,17425,34383,松山,一等
2020-09-08,990,16614,17041,33655,松山,一等
2020-09-09,990,16603,16934,33537,松山,一等
2020-09-10,990,16648,16785,33433,松山,一等
2020-09-11,990,19230,18355,37585,松山,一等
2020-09-12,990,13087,11954,25041,松山,一等
2020-09-13,990,10360,11582,21942,松山,一等
2020-09-14,990,16776,17132,33908,松山,一等
2020-09-15,990,16627,16851,33478,松山,一等
2020-09-16,990,16594,16915,33509,松山,一等
2020-09-17,990,17510,15880,33390,松山,一等
2020-09-18,990,19209,18660,37869,松山,一等
2020-09-19,990,13929,12916,26845,松山,一等
2020-09-20,990,10709,11745,22454,松山,一等
2020-09-21,990,16968,17346,34314,松山,一等
2020-09-22,990,16831,16815,33646,松山,一等
2020-09-23,990,16957,17135,34092,松山,一等
2020-09-24,990,16762,16956,33718,松山,一等
2020-09-25,990,17886,17679,35565,松山,一等
2020-09-26,990,14918,14752,29670,松山,一等
2020-09-27,990,9360,9873,19233,松山,一等
2020-09-28,990,17024,17089,34113,松山,一等
2020-09-29,990,17351,17077,34428,松山,一等
2020-09-30,990,19983,16274,36257,松山,一等
2020-10-01,990,15377,11778,27155,松山,一等
2020-10-02,990,13795,13811,27606,松山,一等
2020-10-03,990,12496,14355,26851,松山,一等
2020-10-04,990,10945,13330,24275,松山,一等
2020-10-05,990,16739,17776,34515,松山,一等
2020-10-06,990,16675,16875,33550,松山,一等
2020-10-07,990,16750,16965,33715,松山,一等
2020-10-08,990,19245,18695,37940,松山,一等
2020-10-09,990,14795,13524,28319,松山,一等
2020-10-10,990,11966,12260,24226,松山,一等
2020-10-11,990,10856,12574,23430,松山,一等
2020-10-12,990,16939,17770,34709,松山,一等
2020-10-13,990,16700,16962,33662,松山,一等
2020-10-14,990,17242,17152,34394,松山,一等
2020-10-15,990,17051,17130,34181,松山,一等
2020-10-16,990,18837,18544,37381,松山,一等
2020-10-17,990,12869,12079,24948,松山,一等
2020-10-18,990,11117,12171,23288,松山,一等
2020-10-19,990,16858,17463,34321,松山,一等
2020-10-20,990,16783,17214,33997,松山,一等
2020-10-21,990,16692,17109,33801,松山,一等
2020-10-22,990,17021,16758,33779,松山,一等
2020-10-23,990,18912,18607,37519,松山,一等
2020-10-24,990,14229,13093,27322,松山,一等
2020-10-25,990,11514,12431,23945,松山,一等
2020-10-26,990,17645,17939,35584,松山,一等
2020-10-27,990,17179,17368,34547,松山,一等
2020-10-28,990,16986,17176,34162,松山,一等
2020-10-29,990,16834,16888,33722,松山,一等
2020-10-30,990,18681,18384,37065,松山,一等
2020-10-31,990,14076,12611,26687,松山,一等
2020-11-01,990,11254,12500,23754,松山,一等
2020-11-02,990,16686,16156,32842,松山,一等
2020-11-03,990,16468,16555,33023,松山,一等
2020-11-04,990,16790,16838,33628,松山,一等
2020-11-05,990,16603,16791,33394,松山,一等
2020-11-06,990,19016,18607,37623,松山,一等
2020-11-07,990,13432,12387,25819,松山,一等
2020-11-08,990,10576,11719,22295,松山,一等
2020-11-09,990,16857,17449,34306,松山,一等
2020-11-10,990,16592,16963,33555,松山,一等
2020-11-11,990,16609,16895,33504,松山,一等
2020-11-12,990,16960,17007,33967,松山,一等
2020-11-13,990,18586,18440,37026,松山,一等
2020-11-14,990,13631,12635,26266,松山,一等
2020-11-15,990,12399,13791,26190,松山,一等
2020-11-16,990,17533,18025,35558,松山,一等
2020-11-17,990,17235,17602,34837,松山,一等
2020-11-18,990,17639,17647,35286,松山,一等
2020-11-19,990,18088,18161,36249,松山,一等
2020-11-20,990,19436,19091,38527,松山,一等
2020-11-21,990,13836,12748,26584,松山,一等
2020-11-22,990,12423,13370,25793,松山,一等
2020-11-23,990,16689,17770,34459,松山,一等
2020-11-24,990,17313,17565,34878,松山,一等
2020-11-25,990,17154,17551,34705,松山,一等
2020-11-26,990,17800,17525,35325,松山,一等
2020-11-27,990,19932,18918,38850,松山,一等
2020-11-28,990,12675,11755,24430,松山,一等
2020-11-29,990,10853,12690,23543,松山,一等
2020-11-30,990,16710,17507,34217,松山,一等
2020-12-01,990,16162,16346,32508,松山,一等
2020-12-02,990,16536,16738,33274,松山,一等
2020-12-03,990,16327,16877,33204,松山,一等
2020-12-04,990,18127,17886,36013,松山,一等
2020-12-05,990,12546,11709,24255,松山,一等
2020-12-06,990,10314,11014,21328,松山,一等
2020-12-07,990,16238,16642,32880,松山,一等
2020-12-08,990,15917,16122,32039,松山,一等
2020-12-09,990,15614,16014,31628,松山,一等
2020-12-10,990,16178,16419,32597,松山,一等
2020-12-11,990,17922,17573,35495,松山,一等
2020-12-12,990,13510,12725,26235,松山,一等
2020-12-13,990,11596,12097,23693,松山,一等
2020-12-14,990,16624,17133,33757,松山,一等
2020-12-15,990,16244,16718,32962,松山,一等
2020-12-16,990,16226,16271,32497,松山,一等
2020-12-17,990,16978,17394,34372,松山,一等
2020-12-18,990,19026,18765,37791,松山,一等
2020-12-19,990,12597,12065,24662,松山,一等
2020-12-20,990,11060,11581,22641,松山,一等
2020-12-21,990,16772,17331,34103,松山,一等
2020-12-22,990,16781,17114,33895,松山,一等
2020-12-23,990,16593,16906,33499,松山,一等
2020-12-24,990,16903,16892,33795,松山,一等
2020-12-25,990,18311,18238,36549,松山,一等
2020-12-26,990,13401,12404,25805,松山,一等
2020-12-27,990,10790,11865,22655,松山,一等
2020-12-28,990,16962,17504,34466,松山,一等
2020-12-29,990,17053,17083,34136,松山,一等
2020-12-30,990,16622,16465,33087,松山,一等
2020-12-31,990,18030,19206,37236,松山,一等
2020-01-01,1000,74444,57279,131723,臺北,特等
2020-01-02,1000,60656,60765,121421,臺北,特等
2020-01-03,1000,67692,65289,132981,臺北,特等
2020-01-04,1000,59475,58244,117719,臺北,特等
2020-01-05,1000,57014,59480,116494,臺北,特等
2020-01-06,1000,58573,58234,116807,臺北,特等
2020-01-07,1000,57128,56398,113526,臺北,特等
2020-01-08,1000,57239,56452,113691,臺北,特等
2020-01-09,1000,69466,67960,137426,臺北,特等
2020-01-10,1000,82586,71146,153732,臺北,特等
2020-01-11,1000,63942,59520,123462,臺北,特等
2020-01-12,1000,58723,68177,126900,臺北,特等
2020-01-13,1000,62437,62529,124966,臺北,特等
2020-01-14,1000,60036,59349,119385,臺北,特等
2020-01-15,1000,57218,53385,110603,臺北,特等
2020-01-16,1000,62129,62608,124737,臺北,特等
2020-01-17,1000,68363,66080,134443,臺北,特等
2020-01-18,1000,61584,62163,123747,臺北,特等
2020-01-19,1000,58644,60469,119113,臺北,特等
2020-01-20,1000,66295,63848,130143,臺北,特等
2020-01-21,1000,67240,62643,129883,臺北,特等
2020-01-22,1000,71853,62696,134549,臺北,特等
2020-01-23,1000,59488,42593,102081,臺北,特等
2020-01-24,1000,46607,32457,79064,臺北,特等
2020-01-25,1000,56570,52365,108935,臺北,特等
2020-01-26,1000,55498,54743,110241,臺北,特等
2020-01-27,1000,57837,63874,121711,臺北,特等
2020-01-28,1000,53455,65609,119064,臺北,特等
2020-01-29,1000,47482,60188,107670,臺北,特等
2020-01-30,1000,54856,61889,116745,臺北,特等
2020-01-31,1000,60054,63190,123244,臺北,特等
2020-02-01,1000,54509,55151,109660,臺北,特等
2020-02-02,1000,50780,52375,103155,臺北,特等
2020-02-03,1000,57079,57580,114659,臺北,特等
2020-02-04,1000,53481,51863,105344,臺北,特等
2020-02-05,1000,52435,52550,104985,臺北,特等
2020-02-06,1000,55065,55532,110597,臺北,特等
2020-02-07,1000,61420,59394,120814,臺北,特等
2020-02-08,1000,50767,46234,97001,臺北,特等
2020-02-09,1000,45142,48878,94020,臺北,特等
2020-02-10,1000,53644,53560,107204,臺北,特等
2020-02-11,1000,51127,50568,101695,臺北,特等
2020-02-12,1000,52466,52263,104729,臺北,特等
2020-02-13,1000,51404,51561,102965,臺北,特等
2020-02-14,1000,57200,56847,114047,臺北,特等
2020-02-15,1000,52374,50926,103300,臺北,特等
2020-02-16,1000,43981,45179,89160,臺北,特等
2020-02-17,1000,50087,50061,100148,臺北,特等
2020-02-18,1000,49822,49312,99134,臺北,特等
2020-02-19,1000,51803,50331,102134,臺北,特等
2020-02-20,1000,50218,50592,100810,臺北,特等
2020-02-21,1000,59592,56376,115968,臺北,特等
2020-02-22,1000,46950,44343,91293,臺北,特等
2020-02-23,1000,43481,46885,90366,臺北,特等
2020-02-24,1000,50803,51403,102206,臺北,特等
2020-02-25,1000,48673,48015,96688,臺北,特等
2020-02-26,1000,49020,47705,96725,臺北,特等
2020-02-27,1000,62487,55014,117501,臺北,特等
2020-02-28,1000,54395,43354,97749,臺北,特等
2020-02-29,1000,40006,42224,82230,臺北,特等
2020-03-01,1000,39180,54050,93230,臺北,特等
2020-03-02,1000,45841,48212,94053,臺北,特等
2020-03-03,1000,44327,44116,88443,臺北,特等
2020-03-04,1000,43759,43297,87056,臺北,特等
2020-03-05,1000,44479,43593,88072,臺北,特等
2020-03-06,1000,58123,52917,111040,臺北,特等
2020-03-07,1000,43531,39504,83035,臺北,特等
2020-03-08,1000,38118,42903,81021,臺北,特等
2020-03-09,1000,46809,47336,94145,臺北,特等
2020-03-10,1000,43712,43285,86997,臺北,特等
2020-03-11,1000,46471,45595,92066,臺北,特等
2020-03-12,1000,46018,44833,90851,臺北,特等
2020-03-13,1000,57967,52606,110573,臺北,特等
2020-03-14,1000,42219,38440,80659,臺北,特等
2020-03-15,1000,42113,46322,88435,臺北,特等
2020-03-16,1000,46999,48244,95243,臺北,特等
2020-03-17,1000,45546,45227,90773,臺北,特等
2020-03-18,1000,45304,43815,89119,臺北,特等
2020-03-19,1000,44150,42454,86604,臺北,特等
2020-03-20,1000,55815,50510,106325,臺北,特等
2020-03-21,1000,38420,34726,73146,臺北,特等
2020-03-22,1000,33471,38861,72332,臺北,特等
2020-03-23,1000,43090,43705,86795,臺北,特等
2020-03-24,1000,41994,41104,83098,臺北,特等
2020-03-25,1000,41654,40752,82406,臺北,特等
2020-03-26,1000,42485,41604,84089,臺北,特等
2020-03-27,1000,52543,47494,100037,臺北,特等
2020-03-28,1000,32244,28117,60361,臺北,特等
2020-03-29,1000,30974,34371,65345,臺北,特等
2020-03-30,1000,41757,42328,84085,臺北,特等
2020-03-31,1000,43407,41441,84848,臺北,特等
2020-04-01,1000,57013,47812,104825,臺北,特等
2020-04-02,1000,43353,28832,72185,臺北,特等
2020-04-03,1000,32504,28590,61094,臺北,特等
2020-04-04,1000,22890,31937,54827,臺北,特等
2020-04-05,1000,28827,46104,74931,臺北,特等
2020-04-06,1000,41477,45116,86593,臺北,特等
2020-04-07,1000,38451,38180,76631,臺北,特等
2020-04-08,1000,38293,37865,76158,臺北,特等
2020-04-09,1000,39117,37782,76899,臺北,特等
2020-04-10,1000,48008,44710,92718,臺北,特等
2020-04-11,1000,30282,27480,57762,臺北,特等
2020-04-12,1000,26298,29029,55327,臺北,特等
2020-04-13,1000,39569,40109,79678,臺北,特等
2020-04-14,1000,38712,38079,76791,臺北,特等
2020-04-15,1000,40254,39638,79892,臺北,特等
2020-04-16,1000,40885,39770,80655,臺北,特等
2020-04-17,1000,51666,47075,98741,臺北,特等
2020-04-18,1000,36953,33814,70767,臺北,特等
2020-04-19,1000,32424,36011,68435,臺北,特等
2020-04-20,1000,40744,42135,82879,臺北,特等
2020-04-21,1000,39158,38260,77418,臺北,特等
2020-04-22,1000,39032,38344,77376,臺北,特等
2020-04-23,1000,39976,39055,79031,臺北,特等
2020-04-24,1000,49015,44829,93844,臺北,特等
2020-04-25,1000,31451,28999,60450,臺北,特等
2020-04-26,1000,27505,31148,58653,臺北,特等
2020-04-27,1000,40012,41003,81015,臺北,特等
2020-04-28,1000,40418,39602,80020,臺北,特等
2020-04-29,1000,40933,39764,80697,臺北,特等
2020-04-30,1000,48396,43350,91746,臺北,特等
2020-05-01,1000,50092,39198,89290,臺北,特等
2020-05-02,1000,35153,32791,67944,臺北,特等
2020-05-03,1000,32495,42265,74760,臺北,特等
2020-05-04,1000,42156,44106,86262,臺北,特等
2020-05-05,1000,41250,40796,82046,臺北,特等
2020-05-06,1000,42309,41437,83746,臺北,特等
2020-05-07,1000,43586,41895,85481,臺北,特等
2020-05-08,1000,59521,51413,110934,臺北,特等
2020-05-09,1000,42767,35705,78472,臺北,特等
2020-05-10,1000,35143,42831,77974,臺北,特等
2020-05-11,1000,44232,47067,91299,臺北,特等
2020-05-12,1000,42232,42245,84477,臺北,特等
2020-05-13,1000,44490,43693,88183,臺北,特等
2020-05-14,1000,44824,43502,88326,臺北,特等
2020-05-15,1000,57382,52941,110323,臺北,特等
2020-05-16,1000,42310,39141,81451,臺北,特等
2020-05-17,1000,37914,41101,79015,臺北,特等
2020-05-18,1000,44254,45683,89937,臺北,特等
2020-05-19,1000,42108,41855,83963,臺北,特等
2020-05-20,1000,44654,43617,88271,臺北,特等
2020-05-21,1000,43973,43148,87121,臺北,特等
2020-05-22,1000,54718,49363,104081,臺北,特等
2020-05-23,1000,40245,36987,77232,臺北,特等
2020-05-24,1000,45512,49780,95292,臺北,特等
2020-05-25,1000,45893,47639,93532,臺北,特等
2020-05-26,1000,44365,44259,88624,臺北,特等
2020-05-27,1000,44402,43661,88063,臺北,特等
2020-05-28,1000,45181,43490,88671,臺北,特等
2020-05-29,1000,59592,53282,112874,臺北,特等
2020-05-30,1000,46632,44875,91507,臺北,特等
2020-05-31,1000,44280,49480,93760,臺北,特等
2020-06-01,1000,46657,47579,94236,臺北,特等
2020-06-02,1000,45539,45442,90981,臺北,特等
2020-06-03,1000,47045,46037,93082,臺北,特等
2020-06-04,1000,46751,46055,92806,臺北,特等
2020-06-05,1000,59916,55272,115188,臺北,特等
2020-06-06,1000,51642,47785,99427,臺北,特等
2020-06-07,1000,44695,49261,93956,臺北,特等
2020-06-08,1000,47600,49294,96894,臺北,特等
2020-06-09,1000,47571,47319,94890,臺北,特等
2020-06-10,1000,49056,48111,97167,臺北,特等
2020-06-11,1000,50363,48353,98716,臺北,特等
2020-06-12,1000,62485,58365,120850,臺北,特等
2020-06-13,1000,58177,52720,110897,臺北,特等
2020-06-14,1000,51508,53744,105252,臺北,特等
2020-06-15,1000,50052,51433,101485,臺北,特等
2020-06-16,1000,50023,49554,99577,臺北,特等
2020-06-17,1000,49704,49374,99078,臺北,特等
2020-06-18,1000,51080,49391,100471,臺北,特等
2020-06-19,1000,57869,53384,111253,臺北,特等
2020-06-20,1000,53796,50626,104422,臺北,特等
2020-06-21,1000,49129,49999,99128,臺北,特等
2020-06-22,1000,50964,52100,103064,臺北,特等
2020-06-23,1000,53265,50672,103937,臺北,特等
2020-06-24,1000,70368,59083,129451,臺北,特等
2020-06-25,1000,63485,46319,109804,臺北,特等
2020-06-26,1000,60053,57020,117073,臺北,特等
2020-06-27,1000,53892,62479,116371,臺北,特等
2020-06-28,1000,49962,67628,117590,臺北,特等
2020-06-29,1000,53608,57068,110676,臺北,特等
2020-06-30,1000,51274,52065,103339,臺北,特等
2020-07-01,1000,50047,48915,98962,臺北,特等
2020-07-02,1000,50712,49676,100388,臺北,特等
2020-07-03,1000,60465,54603,115068,臺北,特等
2020-07-04,1000,55422,50577,105999,臺北,特等
2020-07-05,1000,49869,52551,102420,臺北,特等
2020-07-06,1000,54483,52535,107018,臺北,特等
2020-07-07,1000,52766,51380,104146,臺北,特等
2020-07-08,1000,53339,52099,105438,臺北,特等
2020-07-09,1000,54655,53094,107749,臺北,特等
2020-07-10,1000,65167,61366,126533,臺北,特等
2020-07-11,1000,58009,53552,111561,臺北,特等
2020-07-12,1000,54600,59070,113670,臺北,特等
2020-07-13,1000,55227,56295,111522,臺北,特等
2020-07-14,1000,55420,55951,111371,臺北,特等
2020-07-15,1000,57762,56640,114402,臺北,特等
2020-07-16,1000,59059,57492,116551,臺北,特等
2020-07-17,1000,69248,64866,134114,臺北,特等
2020-07-18,1000,60863,57773,118636,臺北,特等
2020-07-19,1000,56997,60810,117807,臺北,特等
2020-07-20,1000,57610,58667,116277,臺北,特等
2020-07-21,1000,55622,55864,111486,臺北,特等
2020-07-22,1000,58170,56435,114605,臺北,特等
2020-07-23,1000,58643,56560,115203,臺北,特等
2020-07-24,1000,68281,63843,132124,臺北,特等
2020-07-25,1000,59399,56568,115967,臺北,特等
2020-07-26,1000,55176,59400,114576,臺北,特等
2020-07-27,1000,56658,57718,114376,臺北,特等
2020-07-28,1000,55102,54981,110083,臺北,特等
2020-07-29,1000,56753,56282,113035,臺北,特等
2020-07-30,1000,59519,57398,116917,臺北,特等
2020-07-31,1000,70030,65561,135591,臺北,特等
2020-08-01,1000,63817,58599,122416,臺北,特等
2020-08-02,1000,54817,58613,113430,臺北,特等
2020-08-03,1000,51419,52752,104171,臺北,特等
2020-08-04,1000,52494,52821,105315,臺北,特等
2020-08-05,1000,54069,54172,108241,臺北,特等
2020-08-06,1000,56769,56052,112821,臺北,特等
2020-08-07,1000,69217,63298,132515,臺北,特等
2020-08-08,1000,55866,50589,106455,臺北,特等
2020-08-09,1000,57293,62364,119657,臺北,特等
2020-08-10,1000,57909,60045,117954,臺北,特等
2020-08-11,1000,54180,54907,109087,臺北,特等
2020-08-12,1000,57591,56893,114484,臺北,特等
2020-08-13,1000,59820,58315,118135,臺北,特等
2020-08-14,1000,70133,66112,136245,臺北,特等
2020-08-15,1000,63966,60489,124455,臺北,特等
2020-08-16,1000,62943,66549,129492,臺北,特等
2020-08-17,1000,59940,61897,121837,臺北,特等
2020-08-18,1000,58176,59459,117635,臺北,特等
2020-08-19,1000,57645,58084,115729,臺北,特等
2020-08-20,1000,59947,58338,118285,臺北,特等
2020-08-21,1000,70428,66935,137363,臺北,特等
2020-08-22,1000,65261,62263,127524,臺北,特等
2020-08-23,1000,58142,61704,119846,臺北,特等
2020-08-24,1000,59284,62153,121437,臺北,特等
2020-08-25,1000,58724,59438,118162,臺北,特等
2020-08-26,1000,58664,58211,116875,臺北,特等
2020-08-27,1000,58103,56777,114880,臺北,特等
2020-08-28,1000,66841,62556,129397,臺北,特等
2020-08-29,1000,59581,56057,115638,臺北,特等
2020-08-30,1000,51740,56838,108578,臺北,特等
2020-08-31,1000,51418,53417,104835,臺北,特等
2020-09-01,1000,50885,49156,100041,臺北,特等
2020-09-02,1000,49929,49235,99164,臺北,特等
2020-09-03,1000,53392,52462,105854,臺北,特等
2020-09-04,1000,65256,60641,125897,臺北,特等
2020-09-05,1000,58950,55123,114073,臺北,特等
2020-09-06,1000,54210,58882,113092,臺北,特等
2020-09-07,1000,55135,56179,111314,臺北,特等
2020-09-08,1000,53392,52691,106083,臺北,特等
2020-09-09,1000,53224,53642,106866,臺北,特等
2020-09-10,1000,54691,54093,108784,臺北,特等
2020-09-11,1000,67332,62353,129685,臺北,特等
2020-09-12,1000,60027,56805,116832,臺北,特等
2020-09-13,1000,54974,61719,116693,臺北,特等
2020-09-14,1000,52019,54426,106445,臺北,特等
2020-09-15,1000,51662,50418,102080,臺北,特等
2020-09-16,1000,51528,50501,102029,臺北,特等
2020-09-17,1000,53730,51530,105260,臺北,特等
2020-09-18,1000,70721,62651,133372,臺北,特等
2020-09-19,1000,64373,58068,122441,臺北,特等
2020-09-20,1000,56364,62934,119298,臺北,特等
2020-09-21,1000,53227,56123,109350,臺北,特等
2020-09-22,1000,51946,52403,104349,臺北,特等
2020-09-23,1000,53343,52851,106194,臺北,特等
2020-09-24,1000,52736,52297,105033,臺北,特等
2020-09-25,1000,62019,57918,119937,臺北,特等
2020-09-26,1000,57097,54324,111421,臺北,特等
2020-09-27,1000,48530,51773,100303,臺北,特等
2020-09-28,1000,51398,53292,104690,臺北,特等
2020-09-29,1000,54658,51970,106628,臺北,特等
2020-09-30,1000,78172,64223,142395,臺北,特等
2020-10-01,1000,70547,49033,119580,臺北,特等
2020-10-02,1000,61260,58103,119363,臺北,特等
2020-10-03,1000,54344,63718,118062,臺北,特等
2020-10-04,1000,53906,72516,126422,臺北,特等
2020-10-05,1000,52200,57396,109596,臺北,特等
2020-10-06,1000,51241,48981,100222,臺北,特等
2020-10-07,1000,53040,51201,104241,臺北,特等
2020-10-08,1000,70796,61348,132144,臺北,特等
2020-10-09,1000,70317,59385,129702,臺北,特等
2020-10-10,1000,59561,59581,119142,臺北,特等
2020-10-11,1000,57481,69753,127234,臺北,特等
2020-10-12,1000,52827,55194,108021,臺北,特等
2020-10-13,1000,51376,51639,103015,臺北,特等
2020-10-14,1000,52469,51285,103754,臺北,特等
2020-10-15,1000,54365,52861,107226,臺北,特等
2020-10-16,1000,68841,62522,131363,臺北,特等
2020-10-17,1000,62242,57200,119442,臺北,特等
2020-10-18,1000,60082,64311,124393,臺北,特等
2020-10-19,1000,53344,55450,108794,臺北,特等
2020-10-20,1000,52160,52053,104213,臺北,特等
2020-10-21,1000,52606,51962,104568,臺北,特等
2020-10-22,1000,53474,52129,105603,臺北,特等
2020-10-23,1000,69951,63500,133451,臺北,特等
2020-10-24,1000,63791,58156,121947,臺北,特等
2020-10-25,1000,56797,62666,119463,臺北,特等
2020-10-26,1000,54170,57679,111849,臺北,特等
2020-10-27,1000,52448,53066,105514,臺北,特等
2020-10-28,1000,52295,51858,104153,臺北,特等
2020-10-29,1000,53304,51570,104874,臺北,特等
2020-10-30,1000,67538,62763,130301,臺北,特等
2020-10-31,1000,62156,58051,120207,臺北,特等
2020-11-01,1000,53690,57501,111191,臺北,特等
2020-11-02,1000,51617,54254,105871,臺北,特等
2020-11-03,1000,49190,49230,98420,臺北,特等
2020-11-04,1000,50747,50309,101056,臺北,特等
2020-11-05,1000,52382,51004,103386,臺北,特等
2020-11-06,1000,68971,61731,130702,臺北,特等
2020-11-07,1000,60628,57784,118412,臺北,特等
2020-11-08,1000,53221,58571,111792,臺北,特等
2020-11-09,1000,52905,54956,107861,臺北,特等
2020-11-10,1000,50599,50468,101067,臺北,特等
2020-11-11,1000,52188,51742,103930,臺北,特等
2020-11-12,1000,54460,52545,107005,臺北,特等
2020-11-13,1000,71337,64213,135550,臺北,特等
2020-11-14,1000,62335,58214,120549,臺北,特等
2020-11-15,1000,62667,68112,130779,臺北,特等
2020-11-16,1000,55623,58097,113720,臺北,特等
2020-11-17,1000,53203,52456,105659,臺北,特等
2020-11-18,1000,54695,53923,108618,臺北,特等
2020-11-19,1000,56824,55028,111852,臺北,特等
2020-11-20,1000,71865,65256,137121,臺北,特等
2020-11-21,1000,63151,60154,123305,臺北,特等
2020-11-22,1000,62345,67785,130130,臺北,特等
2020-11-23,1000,52773,56368,109141,臺北,特等
2020-11-24,1000,52029,52379,104408,臺北,特等
2020-11-25,1000,54021,53231,107252,臺北,特等
2020-11-26,1000,55719,53758,109477,臺北,特等
2020-11-27,1000,70490,64527,135017,臺北,特等
2020-11-28,1000,60355,56439,116794,臺北,特等
2020-11-29,1000,53582,59981,113563,臺北,特等
2020-11-30,1000,51383,55048,106431,臺北,特等
2020-12-01,1000,49076,48834,97910,臺北,特等
2020-12-02,1000,49806,49528,99334,臺北,特等
2020-12-03,1000,51577,49472,101049,臺北,特等
2020-12-04,1000,66890,61517,128407,臺北,特等
2020-12-05,1000,58191,56514,114705,臺北,特等
2020-12-06,1000,55645,57123,112768,臺北,特等
2020-12-07,1000,50661,52709,103370,臺北,特等
2020-12-08,1000,48030,48530,96560,臺北,特等
2020-12-09,1000,47180,46689,93869,臺北,特等
2020-12-10,1000,49408,48898,98306,臺北,特等
2020-12-11,1000,65757,61124,126881,臺北,特等
2020-12-12,1000,61113,60542,121655,臺北,特等
2020-12-13,1000,61607,61561,123168,臺北,特等
2020-12-14,1000,53722,54788,108510,臺北,特等
2020-12-15,1000,49931,50338,100269,臺北,特等
2020-12-16,1000,52102,50198,102300,臺北,特等
2020-12-17,1000,53762,52528,106290,臺北,特等
2020-12-18,1000,69220,66916,136136,臺北,特等
2020-12-19,1000,62348,61010,123358,臺北,特等
2020-12-20,1000,59083,61682,120765,臺北,特等
2020-12-21,1000,53442,54710,108152,臺北,特等
2020-12-22,1000,51685,51599,103284,臺北,特等
2020-12-23,1000,50612,50027,100639,臺北,特等
2020-12-24,1000,52202,51362,103564,臺北,特等
2020-12-25,1000,66064,63593,129657,臺北,特等
2020-12-26,1000,57974,55655,113629,臺北,特等
2020-12-27,1000,54851,56333,111184,臺北,特等
2020-12-28,1000,52775,53650,106425,臺北,特等
2020-12-29,1000,51769,50989,102758,臺北,特等
2020-12-30,1000,54802,50770,105572,臺北,特等
2020-12-31,1000,73157,69926,143083,臺北,特等
2020-01-01,1010,3941,3827,7768,萬華,一等
2020-01-02,1010,4914,4252,9166,萬華,一等
2020-01-03,1010,4919,5032,9951,萬華,一等
2020-01-04,1010,4258,4404,8662,萬華,一等
2020-01-05,1010,3744,3894,7638,萬華,一等
2020-01-06,1010,5072,4896,9968,萬華,一等
2020-01-07,1010,5049,4857,9906,萬華,一等
2020-01-08,1010,4946,4802,9748,萬華,一等
2020-01-09,1010,5109,4345,9454,萬華,一等
2020-01-10,1010,5166,5072,10238,萬華,一等
2020-01-11,1010,4411,4123,8534,萬華,一等
2020-01-12,1010,3876,3828,7704,萬華,一等
2020-01-13,1010,4956,4817,9773,萬華,一等
2020-01-14,1010,5018,4900,9918,萬華,一等
2020-01-15,1010,4710,5266,9976,萬華,一等
2020-01-16,1010,4991,4900,9891,萬華,一等
2020-01-17,1010,4871,4013,8884,萬華,一等
2020-01-18,1010,4072,3966,8038,萬華,一等
2020-01-19,1010,3589,3536,7125,萬華,一等
2020-01-20,1010,4795,4305,9100,萬華,一等
2020-01-21,1010,4637,4711,9348,萬華,一等
2020-01-22,1010,4613,4525,9138,萬華,一等
2020-01-23,1010,3208,2896,6104,萬華,一等
2020-01-24,1010,2928,2623,5551,萬華,一等
2020-01-25,1010,4264,3979,8243,萬華,一等
2020-01-26,1010,3284,3168,6452,萬華,一等
2020-01-27,1010,3801,3904,7705,萬華,一等
2020-01-28,1010,3577,3965,7542,萬華,一等
2020-01-29,1010,2914,3163,6077,萬華,一等
2020-01-30,1010,4118,4130,8248,萬華,一等
2020-01-31,1010,4083,4145,8228,萬華,一等
2020-02-01,1010,3352,3238,6590,萬華,一等
2020-02-02,1010,3326,3335,6661,萬華,一等
2020-02-03,1010,4146,4019,8165,萬華,一等
2020-02-04,1010,3783,3597,7380,萬華,一等
2020-02-05,1010,3831,3775,7606,萬華,一等
2020-02-06,1010,3864,3777,7641,萬華,一等
2020-02-07,1010,3840,3846,7686,萬華,一等
2020-02-08,1010,3089,3009,6098,萬華,一等
2020-02-09,1010,2735,2641,5376,萬華,一等
2020-02-10,1010,3942,3878,7820,萬華,一等
2020-02-11,1010,3891,3751,7642,萬華,一等
2020-02-12,1010,4086,3999,8085,萬華,一等
2020-02-13,1010,3838,3747,7585,萬華,一等
2020-02-14,1010,4012,3912,7924,萬華,一等
2020-02-15,1010,3640,3653,7293,萬華,一等
2020-02-16,1010,2602,2461,5063,萬華,一等
2020-02-17,1010,3600,3648,7248,萬華,一等
2020-02-18,1010,3789,3596,7385,萬華,一等
2020-02-19,1010,3819,3790,7609,萬華,一等
2020-02-20,1010,3788,3740,7528,萬華,一等
2020-02-21,1010,4192,3983,8175,萬華,一等
2020-02-22,1010,3099,3025,6124,萬華,一等
2020-02-23,1010,2743,2830,5573,萬華,一等
2020-02-24,1010,3965,3855,7820,萬華,一等
2020-02-25,1010,4252,4147,8399,萬華,一等
2020-02-26,1010,4230,3928,8158,萬華,一等
2020-02-27,1010,4275,4120,8395,萬華,一等
2020-02-28,1010,2962,2948,5910,萬華,一等
2020-02-29,1010,2608,2517,5125,萬華,一等
2020-03-01,1010,2621,2551,5172,萬華,一等
2020-03-02,1010,4017,3926,7943,萬華,一等
2020-03-03,1010,4029,3890,7919,萬華,一等
2020-03-04,1010,3858,3687,7545,萬華,一等
2020-03-05,1010,3799,3656,7455,萬華,一等
2020-03-06,1010,4327,4316,8643,萬華,一等
2020-03-07,1010,3008,2907,5915,萬華,一等
2020-03-08,1010,2695,2680,5375,萬華,一等
2020-03-09,1010,4151,3998,8149,萬華,一等
2020-03-10,1010,3625,3533,7158,萬華,一等
2020-03-11,1010,4119,4036,8155,萬華,一等
2020-03-12,1010,4089,4026,8115,萬華,一等
2020-03-13,1010,3908,3829,7737,萬華,一等
2020-03-14,1010,2632,2572,5204,萬華,一等
2020-03-15,1010,2891,2719,5610,萬華,一等
2020-03-16,1010,4298,4072,8370,萬華,一等
2020-03-17,1010,4048,3977,8025,萬華,一等
2020-03-18,1010,3959,3822,7781,萬華,一等
2020-03-19,1010,3651,3534,7185,萬華,一等
2020-03-20,1010,4059,4036,8095,萬華,一等
2020-03-21,1010,2694,2639,5333,萬華,一等
2020-03-22,1010,2556,2427,4983,萬華,一等
2020-03-23,1010,3853,3796,7649,萬華,一等
2020-03-24,1010,3886,3962,7848,萬華,一等
2020-03-25,1010,3913,3798,7711,萬華,一等
2020-03-26,1010,3855,3772,7627,萬華,一等
2020-03-27,1010,3851,3813,7664,萬華,一等
2020-03-28,1010,2199,1979,4178,萬華,一等
2020-03-29,1010,2403,2355,4758,萬華,一等
2020-03-30,1010,3848,3783,7631,萬華,一等
2020-03-31,1010,3859,3741,7600,萬華,一等
2020-04-01,1010,3760,3579,7339,萬華,一等
2020-04-02,1010,2320,2176,4496,萬華,一等
2020-04-03,1010,2249,2153,4402,萬華,一等
2020-04-04,1010,2013,1938,3951,萬華,一等
2020-04-05,1010,1867,1980,3847,萬華,一等
2020-04-06,1010,3662,3659,7321,萬華,一等
2020-04-07,1010,3574,3467,7041,萬華,一等
2020-04-08,1010,3713,3560,7273,萬華,一等
2020-04-09,1010,3752,3629,7381,萬華,一等
2020-04-10,1010,3958,3984,7942,萬華,一等
2020-04-11,1010,2340,2242,4582,萬華,一等
2020-04-12,1010,2003,1922,3925,萬華,一等
2020-04-13,1010,3885,3751,7636,萬華,一等
2020-04-14,1010,3907,3775,7682,萬華,一等
2020-04-15,1010,3952,3835,7787,萬華,一等
2020-04-16,1010,3921,3818,7739,萬華,一等
2020-04-17,1010,4016,4010,8026,萬華,一等
2020-04-18,1010,2792,2639,5431,萬華,一等
2020-04-19,1010,2390,2298,4688,萬華,一等
2020-04-20,1010,3942,3911,7853,萬華,一等
2020-04-21,1010,3822,3595,7417,萬華,一等
2020-04-22,1010,3835,3709,7544,萬華,一等
2020-04-23,1010,3653,3654,7307,萬華,一等
2020-04-24,1010,3742,3797,7539,萬華,一等
2020-04-25,1010,2508,2452,4960,萬華,一等
2020-04-26,1010,2315,2122,4437,萬華,一等
2020-04-27,1010,3830,3774,7604,萬華,一等
2020-04-28,1010,3996,3919,7915,萬華,一等
2020-04-29,1010,4065,3917,7982,萬華,一等
2020-04-30,1010,4002,3771,7773,萬華,一等
2020-05-01,1010,3722,3670,7392,萬華,一等
2020-05-02,1010,2838,2780,5618,萬華,一等
2020-05-03,1010,2547,2522,5069,萬華,一等
2020-05-04,1010,3954,4042,7996,萬華,一等
2020-05-05,1010,4020,3941,7961,萬華,一等
2020-05-06,1010,4116,4017,8133,萬華,一等
2020-05-07,1010,4074,3979,8053,萬華,一等
2020-05-08,1010,4371,4387,8758,萬華,一等
2020-05-09,1010,3096,2914,6010,萬華,一等
2020-05-10,1010,2657,2722,5379,萬華,一等
2020-05-11,1010,4172,3910,8082,萬華,一等
2020-05-12,1010,3943,3821,7764,萬華,一等
2020-05-13,1010,4326,4115,8441,萬華,一等
2020-05-14,1010,4133,4078,8211,萬華,一等
2020-05-15,1010,4361,4410,8771,萬華,一等
2020-05-16,1010,2853,2860,5713,萬華,一等
2020-05-17,1010,2685,2600,5285,萬華,一等
2020-05-18,1010,4139,4022,8161,萬華,一等
2020-05-19,1010,3787,3626,7413,萬華,一等
2020-05-20,1010,4126,4045,8171,萬華,一等
2020-05-21,1010,3810,3900,7710,萬華,一等
2020-05-22,1010,3772,3763,7535,萬華,一等
2020-05-23,1010,2612,2445,5057,萬華,一等
2020-05-24,1010,2936,2811,5747,萬華,一等
2020-05-25,1010,4314,4224,8538,萬華,一等
2020-05-26,1010,4255,4072,8327,萬華,一等
2020-05-27,1010,3985,3912,7897,萬華,一等
2020-05-28,1010,3706,3632,7338,萬華,一等
2020-05-29,1010,4267,4287,8554,萬華,一等
2020-05-30,1010,3278,3460,6738,萬華,一等
2020-05-31,1010,3061,2911,5972,萬華,一等
2020-06-01,1010,4317,4190,8507,萬華,一等
2020-06-02,1010,4235,4066,8301,萬華,一等
2020-06-03,1010,4405,4221,8626,萬華,一等
2020-06-04,1010,4030,4067,8097,萬華,一等
2020-06-05,1010,4378,4265,8643,萬華,一等
2020-06-06,1010,3296,3280,6576,萬華,一等
2020-06-07,1010,2702,2666,5368,萬華,一等
2020-06-08,1010,4242,4164,8406,萬華,一等
2020-06-09,1010,4295,4164,8459,萬華,一等
2020-06-10,1010,4538,4383,8921,萬華,一等
2020-06-11,1010,4412,4423,8835,萬華,一等
2020-06-12,1010,4537,4540,9077,萬華,一等
2020-06-13,1010,3543,3391,6934,萬華,一等
2020-06-14,1010,3040,2945,5985,萬華,一等
2020-06-15,1010,4249,4230,8479,萬華,一等
2020-06-16,1010,4343,4184,8527,萬華,一等
2020-06-17,1010,4176,4206,8382,萬華,一等
2020-06-18,1010,4231,4108,8339,萬華,一等
2020-06-19,1010,4419,4317,8736,萬華,一等
2020-06-20,1010,3785,3773,7558,萬華,一等
2020-06-21,1010,3098,2965,6063,萬華,一等
2020-06-22,1010,4378,4342,8720,萬華,一等
2020-06-23,1010,4398,4327,8725,萬華,一等
2020-06-24,1010,4477,4307,8784,萬華,一等
2020-06-25,1010,3571,3314,6885,萬華,一等
2020-06-26,1010,3684,3657,7341,萬華,一等
2020-06-27,1010,3363,3503,6866,萬華,一等
2020-06-28,1010,2954,3077,6031,萬華,一等
2020-06-29,1010,4332,4310,8642,萬華,一等
2020-06-30,1010,4284,4201,8485,萬華,一等
2020-07-01,1010,4257,4213,8470,萬華,一等
2020-07-02,1010,4031,3982,8013,萬華,一等
2020-07-03,1010,4345,4329,8674,萬華,一等
2020-07-04,1010,3482,3413,6895,萬華,一等
2020-07-05,1010,3232,3244,6476,萬華,一等
2020-07-06,1010,4357,4309,8666,萬華,一等
2020-07-07,1010,4304,4237,8541,萬華,一等
2020-07-08,1010,4419,4330,8749,萬華,一等
2020-07-09,1010,4284,4125,8409,萬華,一等
2020-07-10,1010,4721,4596,9317,萬華,一等
2020-07-11,1010,3677,3571,7248,萬華,一等
2020-07-12,1010,3270,3160,6430,萬華,一等
2020-07-13,1010,4303,4415,8718,萬華,一等
2020-07-14,1010,4204,4245,8449,萬華,一等
2020-07-15,1010,4278,4159,8437,萬華,一等
2020-07-16,1010,4267,4189,8456,萬華,一等
2020-07-17,1010,4457,4291,8748,萬華,一等
2020-07-18,1010,3583,3511,7094,萬華,一等
2020-07-19,1010,3187,3059,6246,萬華,一等
2020-07-20,1010,4314,4197,8511,萬華,一等
2020-07-21,1010,4090,4055,8145,萬華,一等
2020-07-22,1010,4458,4389,8847,萬華,一等
2020-07-23,1010,4234,4137,8371,萬華,一等
2020-07-24,1010,4460,4472,8932,萬華,一等
2020-07-25,1010,3766,3717,7483,萬華,一等
2020-07-26,1010,3332,3381,6713,萬華,一等
2020-07-27,1010,4367,4250,8617,萬華,一等
2020-07-28,1010,4246,4194,8440,萬華,一等
2020-07-29,1010,4377,4288,8665,萬華,一等
2020-07-30,1010,4319,4252,8571,萬華,一等
2020-07-31,1010,4443,4416,8859,萬華,一等
2020-08-01,1010,3620,3626,7246,萬華,一等
2020-08-02,1010,3085,3209,6294,萬華,一等
2020-08-03,1010,3656,3599,7255,萬華,一等
2020-08-04,1010,4036,3984,8020,萬華,一等
2020-08-05,1010,4220,4229,8449,萬華,一等
2020-08-06,1010,4281,3863,8144,萬華,一等
2020-08-07,1010,4537,4397,8934,萬華,一等
2020-08-08,1010,3689,3637,7326,萬華,一等
2020-08-09,1010,3306,3400,6706,萬華,一等
2020-08-10,1010,4131,4253,8384,萬華,一等
2020-08-11,1010,4011,3780,7791,萬華,一等
2020-08-12,1010,4393,4151,8544,萬華,一等
2020-08-13,1010,4432,4375,8807,萬華,一等
2020-08-14,1010,4468,4373,8841,萬華,一等
2020-08-15,1010,3899,3843,7742,萬華,一等
2020-08-16,1010,3410,3540,6950,萬華,一等
2020-08-17,1010,4431,4481,8912,萬華,一等
2020-08-18,1010,4315,4322,8637,萬華,一等
2020-08-19,1010,4535,4410,8945,萬華,一等
2020-08-20,1010,4468,4456,8924,萬華,一等
2020-08-21,1010,4719,4661,9380,萬華,一等
2020-08-22,1010,3418,3512,6930,萬華,一等
2020-08-23,1010,3196,3337,6533,萬華,一等
2020-08-24,1010,4361,4360,8721,萬華,一等
2020-08-25,1010,4330,4303,8633,萬華,一等
2020-08-26,1010,4377,4390,8767,萬華,一等
2020-08-27,1010,4115,4069,8184,萬華,一等
2020-08-28,1010,4291,4236,8527,萬華,一等
2020-08-29,1010,3483,3489,6972,萬華,一等
2020-08-30,1010,3161,3296,6457,萬華,一等
2020-08-31,1010,4208,4203,8411,萬華,一等
2020-09-01,1010,4270,4179,8449,萬華,一等
2020-09-02,1010,4328,4268,8596,萬華,一等
2020-09-03,1010,4416,4315,8731,萬華,一等
2020-09-04,1010,4662,4699,9361,萬華,一等
2020-09-05,1010,3662,3701,7363,萬華,一等
2020-09-06,1010,3379,3286,6665,萬華,一等
2020-09-07,1010,4562,4553,9115,萬華,一等
2020-09-08,1010,4411,4396,8807,萬華,一等
2020-09-09,1010,4448,4444,8892,萬華,一等
2020-09-10,1010,4490,4516,9006,萬華,一等
2020-09-11,1010,4764,4768,9532,萬華,一等
2020-09-12,1010,3592,3444,7036,萬華,一等
2020-09-13,1010,3345,3232,6577,萬華,一等
2020-09-14,1010,4498,4514,9012,萬華,一等
2020-09-15,1010,4494,4373,8867,萬華,一等
2020-09-16,1010,4401,4462,8863,萬華,一等
2020-09-17,1010,4502,4498,9000,萬華,一等
2020-09-18,1010,4679,4674,9353,萬華,一等
2020-09-19,1010,3816,3786,7602,萬華,一等
2020-09-20,1010,3064,3024,6088,萬華,一等
2020-09-21,1010,4655,4532,9187,萬華,一等
2020-09-22,1010,4574,4496,9070,萬華,一等
2020-09-23,1010,4652,4548,9200,萬華,一等
2020-09-24,1010,4226,4246,8472,萬華,一等
2020-09-25,1010,4644,4628,9272,萬華,一等
2020-09-26,1010,3934,4192,8126,萬華,一等
2020-09-27,1010,2839,2802,5641,萬華,一等
2020-09-28,1010,4397,4379,8776,萬華,一等
2020-09-29,1010,4658,4516,9174,萬華,一等
2020-09-30,1010,4780,4651,9431,萬華,一等
2020-10-01,1010,4406,3796,8202,萬華,一等
2020-10-02,1010,4331,4298,8629,萬華,一等
2020-10-03,1010,4000,3966,7966,萬華,一等
2020-10-04,1010,3411,3524,6935,萬華,一等
2020-10-05,1010,4379,4464,8843,萬華,一等
2020-10-06,1010,4512,4463,8975,萬華,一等
2020-10-07,1010,4598,4522,9120,萬華,一等
2020-10-08,1010,4733,4699,9432,萬華,一等
2020-10-09,1010,4207,4043,8250,萬華,一等
2020-10-10,1010,3780,3966,7746,萬華,一等
2020-10-11,1010,3441,3308,6749,萬華,一等
2020-10-12,1010,4547,4527,9074,萬華,一等
2020-10-13,1010,4347,4313,8660,萬華,一等
2020-10-14,1010,4626,4449,9075,萬華,一等
2020-10-15,1010,4631,4529,9160,萬華,一等
2020-10-16,1010,4757,4732,9489,萬華,一等
2020-10-17,1010,3872,3934,7806,萬華,一等
2020-10-18,1010,3521,3511,7032,萬華,一等
2020-10-19,1010,4558,4544,9102,萬華,一等
2020-10-20,1010,4495,4518,9013,萬華,一等
2020-10-21,1010,4546,4468,9014,萬華,一等
2020-10-22,1010,4566,4442,9008,萬華,一等
2020-10-23,1010,4584,4686,9270,萬華,一等
2020-10-24,1010,4513,4666,9179,萬華,一等
2020-10-25,1010,3624,3588,7212,萬華,一等
2020-10-26,1010,4636,4666,9302,萬華,一等
2020-10-27,1010,4562,4618,9180,萬華,一等
2020-10-28,1010,4574,4595,9169,萬華,一等
2020-10-29,1010,4583,4431,9014,萬華,一等
2020-10-30,1010,4721,4857,9578,萬華,一等
2020-10-31,1010,4092,4246,8338,萬華,一等
2020-11-01,1010,3508,3536,7044,萬華,一等
2020-11-02,1010,4530,4574,9104,萬華,一等
2020-11-03,1010,4339,4222,8561,萬華,一等
2020-11-04,1010,4681,4623,9304,萬華,一等
2020-11-05,1010,4440,4481,8921,萬華,一等
2020-11-06,1010,4716,4795,9511,萬華,一等
2020-11-07,1010,3833,3818,7651,萬華,一等
2020-11-08,1010,3359,3379,6738,萬華,一等
2020-11-09,1010,4658,4587,9245,萬華,一等
2020-11-10,1010,4404,4445,8849,萬華,一等
2020-11-11,1010,4705,4688,9393,萬華,一等
2020-11-12,1010,4553,4475,9028,萬華,一等
2020-11-13,1010,4554,4573,9127,萬華,一等
2020-11-14,1010,4281,4192,8473,萬華,一等
2020-11-15,1010,3943,3979,7922,萬華,一等
2020-11-16,1010,4799,4706,9505,萬華,一等
2020-11-17,1010,4676,4595,9271,萬華,一等
2020-11-18,1010,4790,4783,9573,萬華,一等
2020-11-19,1010,4670,4623,9293,萬華,一等
2020-11-20,1010,4837,4995,9832,萬華,一等
2020-11-21,1010,3986,4202,8188,萬華,一等
2020-11-22,1010,3897,3963,7860,萬華,一等
2020-11-23,1010,4543,4516,9059,萬華,一等
2020-11-24,1010,4622,4657,9279,萬華,一等
2020-11-25,1010,4783,4595,9378,萬華,一等
2020-11-26,1010,4699,4718,9417,萬華,一等
2020-11-27,1010,4899,4886,9785,萬華,一等
2020-11-28,1010,3849,3767,7616,萬華,一等
2020-11-29,1010,3829,4335,8164,萬華,一等
2020-11-30,1010,4514,4494,9008,萬華,一等
2020-12-01,1010,4258,4120,8378,萬華,一等
2020-12-02,1010,4409,4299,8708,萬華,一等
2020-12-03,1010,4286,4274,8560,萬華,一等
2020-12-04,1010,5075,5278,10353,萬華,一等
2020-12-05,1010,5024,5237,10261,萬華,一等
2020-12-06,1010,5265,5106,10371,萬華,一等
2020-12-07,1010,4585,4279,8864,萬華,一等
2020-12-08,1010,4306,4211,8517,萬華,一等
2020-12-09,1010,4146,4017,8163,萬華,一等
2020-12-10,1010,4463,4513,8976,萬華,一等
2020-12-11,1010,4700,4832,9532,萬華,一等
2020-12-12,1010,4417,4622,9039,萬華,一等
2020-12-13,1010,3906,3801,7707,萬華,一等
2020-12-14,1010,4610,4442,9052,萬華,一等
2020-12-15,1010,4302,4377,8679,萬華,一等
2020-12-16,1010,4378,4245,8623,萬華,一等
2020-12-17,1010,4686,4610,9296,萬華,一等
2020-12-18,1010,5058,5268,10326,萬華,一等
2020-12-19,1010,4159,4339,8498,萬華,一等
2020-12-20,1010,3795,3629,7424,萬華,一等
2020-12-21,1010,4605,4346,8951,萬華,一等
2020-12-22,1010,4687,4621,9308,萬華,一等
2020-12-23,1010,4343,4217,8560,萬華,一等
2020-12-24,1010,4431,4586,9017,萬華,一等
2020-12-25,1010,4972,4844,9816,萬華,一等
2020-12-26,1010,4033,4172,8205,萬華,一等
2020-12-27,1010,3531,3421,6952,萬華,一等
2020-12-28,1010,4729,4570,9299,萬華,一等
2020-12-29,1010,4752,4654,9406,萬華,一等
2020-12-30,1010,4268,4189,8457,萬華,一等
2020-12-31,1010,4335,4039,8374,萬華,一等
2020-01-01,1020,23186,21471,44657,板橋,一等
2020-01-02,1020,19587,19836,39423,板橋,一等
2020-01-03,1020,22059,22290,44349,板橋,一等
2020-01-04,1020,21737,20861,42598,板橋,一等
2020-01-05,1020,21767,20945,42712,板橋,一等
2020-01-06,1020,19961,20241,40202,板橋,一等
2020-01-07,1020,19492,19240,38732,板橋,一等
2020-01-08,1020,19226,16566,35792,板橋,一等
2020-01-09,1020,20046,20307,40353,板橋,一等
2020-01-10,1020,24816,25504,50320,板橋,一等
2020-01-11,1020,24657,24039,48696,板橋,一等
2020-01-12,1020,22710,25301,48011,板橋,一等
2020-01-13,1020,21286,21177,42463,板橋,一等
2020-01-14,1020,19864,19826,39690,板橋,一等
2020-01-15,1020,18345,21375,39720,板橋,一等
2020-01-16,1020,21194,21008,42202,板橋,一等
2020-01-17,1020,22385,18766,41151,板橋,一等
2020-01-18,1020,21793,20681,42474,板橋,一等
2020-01-19,1020,21383,22391,43774,板橋,一等
2020-01-20,1020,22167,21745,43912,板橋,一等
2020-01-21,1020,22705,21975,44680,板橋,一等
2020-01-22,1020,24242,22798,47040,板橋,一等
2020-01-23,1020,22610,16980,39590,板橋,一等
2020-01-24,1020,20082,14127,34209,板橋,一等
2020-01-25,1020,22996,20353,43349,板橋,一等
2020-01-26,1020,23317,21207,44524,板橋,一等
2020-01-27,1020,23502,26097,49599,板橋,一等
2020-01-28,1020,21109,25521,46630,板橋,一等
2020-01-29,1020,18616,21349,39965,板橋,一等
2020-01-30,1020,18735,20778,39513,板橋,一等
2020-01-31,1020,20451,21798,42249,板橋,一等
2020-02-01,1020,19071,19482,38553,板橋,一等
2020-02-02,1020,18124,19790,37914,板橋,一等
2020-02-03,1020,20069,20344,40413,板橋,一等
2020-02-04,1020,18614,18286,36900,板橋,一等
2020-02-05,1020,18080,18509,36589,板橋,一等
2020-02-06,1020,19122,19116,38238,板橋,一等
2020-02-07,1020,21331,21028,42359,板橋,一等
2020-02-08,1020,18668,17617,36285,板橋,一等
2020-02-09,1020,18586,20890,39476,板橋,一等
2020-02-10,1020,19228,19831,39059,板橋,一等
2020-02-11,1020,18487,18399,36886,板橋,一等
2020-02-12,1020,18578,18778,37356,板橋,一等
2020-02-13,1020,18164,18336,36500,板橋,一等
2020-02-14,1020,20859,21104,41963,板橋,一等
2020-02-15,1020,20480,19467,39947,板橋,一等
2020-02-16,1020,17220,18439,35659,板橋,一等
2020-02-17,1020,18272,18542,36814,板橋,一等
2020-02-18,1020,17935,16134,34069,板橋,一等
2020-02-19,1020,18837,18554,37391,板橋,一等
2020-02-20,1020,18352,18764,37116,板橋,一等
2020-02-21,1020,21575,21035,42610,板橋,一等
2020-02-22,1020,18992,18173,37165,板橋,一等
2020-02-23,1020,17415,19393,36808,板橋,一等
2020-02-24,1020,18824,19239,38063,板橋,一等
2020-02-25,1020,18289,17973,36262,板橋,一等
2020-02-26,1020,18124,17849,35973,板橋,一等
2020-02-27,1020,22839,21542,44381,板橋,一等
2020-02-28,1020,21119,17708,38827,板橋,一等
2020-02-29,1020,16164,17128,33292,板橋,一等
2020-03-01,1020,17152,20658,37810,板橋,一等
2020-03-02,1020,17735,18456,36191,板橋,一等
2020-03-03,1020,16932,16912,33844,板橋,一等
2020-03-04,1020,16777,16614,33391,板橋,一等
2020-03-05,1020,16806,16703,33509,板橋,一等
2020-03-06,1020,21532,21098,42630,板橋,一等
2020-03-07,1020,17599,16498,34097,板橋,一等
2020-03-08,1020,16765,18786,35551,板橋,一等
2020-03-09,1020,18519,18667,37186,板橋,一等
2020-03-10,1020,16782,16585,33367,板橋,一等
2020-03-11,1020,18369,17911,36280,板橋,一等
2020-03-12,1020,17920,17831,35751,板橋,一等
2020-03-13,1020,21361,21174,42535,板橋,一等
2020-03-14,1020,16867,15628,32495,板橋,一等
2020-03-15,1020,17866,18980,36846,板橋,一等
2020-03-16,1020,18386,18459,36845,板橋,一等
2020-03-17,1020,17160,17257,34417,板橋,一等
2020-03-18,1020,16833,16903,33736,板橋,一等
2020-03-19,1020,16480,16494,32974,板橋,一等
2020-03-20,1020,20829,20442,41271,板橋,一等
2020-03-21,1020,15972,14306,30278,板橋,一等
2020-03-22,1020,14421,16455,30876,板橋,一等
2020-03-23,1020,16793,17010,33803,板橋,一等
2020-03-24,1020,16126,15956,32082,板橋,一等
2020-03-25,1020,16105,15930,32035,板橋,一等
2020-03-26,1020,16415,16260,32675,板橋,一等
2020-03-27,1020,19625,19275,38900,板橋,一等
2020-03-28,1020,13541,12184,25725,板橋,一等
2020-03-29,1020,13470,14718,28188,板橋,一等
2020-03-30,1020,16028,16331,32359,板橋,一等
2020-03-31,1020,15860,15860,31720,板橋,一等
2020-04-01,1020,19922,19641,39563,板橋,一等
2020-04-02,1020,16137,12407,28544,板橋,一等
2020-04-03,1020,14089,12399,26488,板橋,一等
2020-04-04,1020,10886,13884,24770,板橋,一等
2020-04-05,1020,13498,17068,30566,板橋,一等
2020-04-06,1020,17273,17309,34582,板橋,一等
2020-04-07,1020,15108,15171,30279,板橋,一等
2020-04-08,1020,14956,14985,29941,板橋,一等
2020-04-09,1020,15130,14966,30096,板橋,一等
2020-04-10,1020,18404,18449,36853,板橋,一等
2020-04-11,1020,12779,11914,24693,板橋,一等
2020-04-12,1020,11952,12639,24591,板橋,一等
2020-04-13,1020,15760,15657,31417,板橋,一等
2020-04-14,1020,14825,14730,29555,板橋,一等
2020-04-15,1020,15446,15460,30906,板橋,一等
2020-04-16,1020,15776,15796,31572,板橋,一等
2020-04-17,1020,19223,19309,38532,板橋,一等
2020-04-18,1020,15222,14340,29562,板橋,一等
2020-04-19,1020,14544,15408,29952,板橋,一等
2020-04-20,1020,16645,16666,33311,板橋,一等
2020-04-21,1020,15412,15442,30854,板橋,一等
2020-04-22,1020,15670,15397,31067,板橋,一等
2020-04-23,1020,15581,15703,31284,板橋,一等
2020-04-24,1020,18641,18649,37290,板橋,一等
2020-04-25,1020,13364,12543,25907,板橋,一等
2020-04-26,1020,12319,13386,25705,板橋,一等
2020-04-27,1020,16298,16298,32596,板橋,一等
2020-04-28,1020,15847,15691,31538,板橋,一等
2020-04-29,1020,16177,15932,32109,板橋,一等
2020-04-30,1020,19006,17850,36856,板橋,一等
2020-05-01,1020,20081,18013,38094,板橋,一等
2020-05-02,1020,14918,14457,29375,板橋,一等
2020-05-03,1020,15152,18088,33240,板橋,一等
2020-05-04,1020,17336,17439,34775,板橋,一等
2020-05-05,1020,16763,16459,33222,板橋,一等
2020-05-06,1020,16823,16833,33656,板橋,一等
2020-05-07,1020,16928,17107,34035,板橋,一等
2020-05-08,1020,22575,22006,44581,板橋,一等
2020-05-09,1020,18760,16821,35581,板橋,一等
2020-05-10,1020,17272,19352,36624,板橋,一等
2020-05-11,1020,18173,18453,36626,板橋,一等
2020-05-12,1020,16796,16732,33528,板橋,一等
2020-05-13,1020,17351,17245,34596,板橋,一等
2020-05-14,1020,17837,17689,35526,板橋,一等
2020-05-15,1020,22076,22012,44088,板橋,一等
2020-05-16,1020,17322,16623,33945,板橋,一等
2020-05-17,1020,16762,18073,34835,板橋,一等
2020-05-18,1020,18013,18186,36199,板橋,一等
2020-05-19,1020,16686,16636,33322,板橋,一等
2020-05-20,1020,17699,17436,35135,板橋,一等
2020-05-21,1020,17105,17315,34420,板橋,一等
2020-05-22,1020,20642,20207,40849,板橋,一等
2020-05-23,1020,16305,15379,31684,板橋,一等
2020-05-24,1020,17868,18853,36721,板橋,一等
2020-05-25,1020,18596,18781,37377,板橋,一等
2020-05-26,1020,17654,17648,35302,板橋,一等
2020-05-27,1020,17392,17164,34556,板橋,一等
2020-05-28,1020,17184,16910,34094,板橋,一等
2020-05-29,1020,22139,21930,44069,板橋,一等
2020-05-30,1020,19210,18648,37858,板橋,一等
2020-05-31,1020,18732,20578,39310,板橋,一等
2020-06-01,1020,18604,18694,37298,板橋,一等
2020-06-02,1020,18032,16561,34593,板橋,一等
2020-06-03,1020,18194,18144,36338,板橋,一等
2020-06-04,1020,18086,18144,36230,板橋,一等
2020-06-05,1020,22513,22253,44766,板橋,一等
2020-06-06,1020,21184,20150,41334,板橋,一等
2020-06-07,1020,19207,20802,40009,板橋,一等
2020-06-08,1020,19031,19125,38156,板橋,一等
2020-06-09,1020,18377,18358,36735,板橋,一等
2020-06-10,1020,19584,19030,38614,板橋,一等
2020-06-11,1020,19495,19132,38627,板橋,一等
2020-06-12,1020,23429,23741,47170,板橋,一等
2020-06-13,1020,22973,21570,44543,板橋,一等
2020-06-14,1020,20665,22324,42989,板橋,一等
2020-06-15,1020,20393,20512,40905,板橋,一等
2020-06-16,1020,18861,19226,38087,板橋,一等
2020-06-17,1020,18734,18913,37647,板橋,一等
2020-06-18,1020,19303,19241,38544,板橋,一等
2020-06-19,1020,21327,21140,42467,板橋,一等
2020-06-20,1020,21466,20797,42263,板橋,一等
2020-06-21,1020,19432,20121,39553,板橋,一等
2020-06-22,1020,19517,20068,39585,板橋,一等
2020-06-23,1020,19750,19382,39132,板橋,一等
2020-06-24,1020,26018,23685,49703,板橋,一等
2020-06-25,1020,25752,20092,45844,板橋,一等
2020-06-26,1020,23625,23105,46730,板橋,一等
2020-06-27,1020,22040,25635,47675,板橋,一等
2020-06-28,1020,20755,25782,46537,板橋,一等
2020-06-29,1020,20368,21744,42112,板橋,一等
2020-06-30,1020,19029,19488,38517,板橋,一等
2020-07-01,1020,18431,18434,36865,板橋,一等
2020-07-02,1020,18428,18125,36553,板橋,一等
2020-07-03,1020,21977,21768,43745,板橋,一等
2020-07-04,1020,21865,20340,42205,板橋,一等
2020-07-05,1020,19676,21496,41172,板橋,一等
2020-07-06,1020,20083,19890,39973,板橋,一等
2020-07-07,1020,19055,19170,38225,板橋,一等
2020-07-08,1020,19404,19594,38998,板橋,一等
2020-07-09,1020,20078,19406,39484,板橋,一等
2020-07-10,1020,23972,23366,47338,板橋,一等
2020-07-11,1020,23285,21921,45206,板橋,一等
2020-07-12,1020,21824,23885,45709,板橋,一等
2020-07-13,1020,21299,22204,43503,板橋,一等
2020-07-14,1020,20656,21064,41720,板橋,一等
2020-07-15,1020,21731,21673,43404,板橋,一等
2020-07-16,1020,21639,21315,42954,板橋,一等
2020-07-17,1020,25142,24535,49677,板橋,一等
2020-07-18,1020,23932,22996,46928,板橋,一等
2020-07-19,1020,22096,24136,46232,板橋,一等
2020-07-20,1020,21080,21773,42853,板橋,一等
2020-07-21,1020,20433,20638,41071,板橋,一等
2020-07-22,1020,21029,20807,41836,板橋,一等
2020-07-23,1020,21402,21349,42751,板橋,一等
2020-07-24,1020,24595,24238,48833,板橋,一等
2020-07-25,1020,24175,23123,47298,板橋,一等
2020-07-26,1020,21194,23173,44367,板橋,一等
2020-07-27,1020,20962,21517,42479,板橋,一等
2020-07-28,1020,20322,20625,40947,板橋,一等
2020-07-29,1020,20843,20846,41689,板橋,一等
2020-07-30,1020,20837,20908,41745,板橋,一等
2020-07-31,1020,24223,23544,47767,板橋,一等
2020-08-01,1020,23375,20741,44116,板橋,一等
2020-08-02,1020,20672,22742,43414,板橋,一等
2020-08-03,1020,18460,17721,36181,板橋,一等
2020-08-04,1020,19175,19502,38677,板橋,一等
2020-08-05,1020,20018,20149,40167,板橋,一等
2020-08-06,1020,21417,21068,42485,板橋,一等
2020-08-07,1020,25234,24156,49390,板橋,一等
2020-08-08,1020,22890,20952,43842,板橋,一等
2020-08-09,1020,21905,24891,46796,板橋,一等
2020-08-10,1020,21330,22170,43500,板橋,一等
2020-08-11,1020,19894,20161,40055,板橋,一等
2020-08-12,1020,21151,21101,42252,板橋,一等
2020-08-13,1020,21759,21941,43700,板橋,一等
2020-08-14,1020,25202,24766,49968,板橋,一等
2020-08-15,1020,25094,23755,48849,板橋,一等
2020-08-16,1020,24015,25765,49780,板橋,一等
2020-08-17,1020,21868,22874,44742,板橋,一等
2020-08-18,1020,21110,21864,42974,板橋,一等
2020-08-19,1020,21248,21706,42954,板橋,一等
2020-08-20,1020,21581,21700,43281,板橋,一等
2020-08-21,1020,25596,24671,50267,板橋,一等
2020-08-22,1020,22560,22120,44680,板橋,一等
2020-08-23,1020,21284,23055,44339,板橋,一等
2020-08-24,1020,21194,22327,43521,板橋,一等
2020-08-25,1020,21276,21419,42695,板橋,一等
2020-08-26,1020,20501,21214,41715,板橋,一等
2020-08-27,1020,20744,20963,41707,板橋,一等
2020-08-28,1020,24051,23424,47475,板橋,一等
2020-08-29,1020,22723,21823,44546,板橋,一等
2020-08-30,1020,20219,22587,42806,板橋,一等
2020-08-31,1020,19435,20030,39465,板橋,一等
2020-09-01,1020,18803,18238,37041,板橋,一等
2020-09-02,1020,18791,19107,37898,板橋,一等
2020-09-03,1020,19719,19607,39326,板橋,一等
2020-09-04,1020,23221,22909,46130,板橋,一等
2020-09-05,1020,22483,19821,42304,板橋,一等
2020-09-06,1020,21609,23296,44905,板橋,一等
2020-09-07,1020,21084,21140,42224,板橋,一等
2020-09-08,1020,20434,19929,40363,板橋,一等
2020-09-09,1020,20303,19966,40269,板橋,一等
2020-09-10,1020,20101,20050,40151,板橋,一等
2020-09-11,1020,24981,24236,49217,板橋,一等
2020-09-12,1020,23908,22280,46188,板橋,一等
2020-09-13,1020,22628,23950,46578,板橋,一等
2020-09-14,1020,20448,21105,41553,板橋,一等
2020-09-15,1020,19807,19510,39317,板橋,一等
2020-09-16,1020,20082,19969,40051,板橋,一等
2020-09-17,1020,20404,20604,41008,板橋,一等
2020-09-18,1020,25608,24992,50600,板橋,一等
2020-09-19,1020,24625,23781,48406,板橋,一等
2020-09-20,1020,22932,24921,47853,板橋,一等
2020-09-21,1020,20657,21377,42034,板橋,一等
2020-09-22,1020,20273,19918,40191,板橋,一等
2020-09-23,1020,20167,20375,40542,板橋,一等
2020-09-24,1020,19930,19640,39570,板橋,一等
2020-09-25,1020,22212,22025,44237,板橋,一等
2020-09-26,1020,22871,20128,42999,板橋,一等
2020-09-27,1020,19428,20874,40302,板橋,一等
2020-09-28,1020,20615,20609,41224,板橋,一等
2020-09-29,1020,20831,20588,41419,板橋,一等
2020-09-30,1020,27410,26739,54149,板橋,一等
2020-10-01,1020,28536,22825,51361,板橋,一等
2020-10-02,1020,25057,25056,50113,板橋,一等
2020-10-03,1020,23208,27101,50309,板橋,一等
2020-10-04,1020,24585,27367,51952,板橋,一等
2020-10-05,1020,21303,22254,43557,板橋,一等
2020-10-06,1020,20233,19712,39945,板橋,一等
2020-10-07,1020,20827,20400,41227,板橋,一等
2020-10-08,1020,25526,25597,51123,板橋,一等
2020-10-09,1020,28414,25457,53871,板橋,一等
2020-10-10,1020,24425,25264,49689,板橋,一等
2020-10-11,1020,24043,26845,50888,板橋,一等
2020-10-12,1020,20799,21373,42172,板橋,一等
2020-10-13,1020,20045,19724,39769,板橋,一等
2020-10-14,1020,20060,20019,40079,板橋,一等
2020-10-15,1020,20566,19651,40217,板橋,一等
2020-10-16,1020,25015,24659,49674,板橋,一等
2020-10-17,1020,24772,23216,47988,板橋,一等
2020-10-18,1020,23703,25599,49302,板橋,一等
2020-10-19,1020,20773,21260,42033,板橋,一等
2020-10-20,1020,19739,19934,39673,板橋,一等
2020-10-21,1020,20199,20435,40634,板橋,一等
2020-10-22,1020,20418,20486,40904,板橋,一等
2020-10-23,1020,25156,25117,50273,板橋,一等
2020-10-24,1020,24668,23485,48153,板橋,一等
2020-10-25,1020,23418,24925,48343,板橋,一等
2020-10-26,1020,20921,21653,42574,板橋,一等
2020-10-27,1020,20260,20378,40638,板橋,一等
2020-10-28,1020,19770,19870,39640,板橋,一等
2020-10-29,1020,19994,19914,39908,板橋,一等
2020-10-30,1020,25105,25335,50440,板橋,一等
2020-10-31,1020,24381,24151,48532,板橋,一等
2020-11-01,1020,22500,24333,46833,板橋,一等
2020-11-02,1020,20304,20683,40987,板橋,一等
2020-11-03,1020,19234,19083,38317,板橋,一等
2020-11-04,1020,19711,19609,39320,板橋,一等
2020-11-05,1020,20192,20391,40583,板橋,一等
2020-11-06,1020,25300,24803,50103,板橋,一等
2020-11-07,1020,25115,23681,48796,板橋,一等
2020-11-08,1020,23670,25804,49474,板橋,一等
2020-11-09,1020,21057,21584,42641,板橋,一等
2020-11-10,1020,20091,19984,40075,板橋,一等
2020-11-11,1020,20861,20719,41580,板橋,一等
2020-11-12,1020,20933,20935,41868,板橋,一等
2020-11-13,1020,26939,26471,53410,板橋,一等
2020-11-14,1020,32957,30654,63611,板橋,一等
2020-11-15,1020,31524,33337,64861,板橋,一等
2020-11-16,1020,23681,23588,47269,板橋,一等
2020-11-17,1020,22356,21660,44016,板橋,一等
2020-11-18,1020,22549,22535,45084,板橋,一等
2020-11-19,1020,23737,23064,46801,板橋,一等
2020-11-20,1020,28525,28744,57269,板橋,一等
2020-11-21,1020,36280,34261,70541,板橋,一等
2020-11-22,1020,31697,32599,64296,板橋,一等
2020-11-23,1020,22314,23014,45328,板橋,一等
2020-11-24,1020,21712,21627,43339,板橋,一等
2020-11-25,1020,22480,22228,44708,板橋,一等
2020-11-26,1020,23320,22909,46229,板橋,一等
2020-11-27,1020,28424,28420,56844,板橋,一等
2020-11-28,1020,32417,30583,63000,板橋,一等
2020-11-29,1020,27837,29014,56851,板橋,一等
2020-11-30,1020,22284,22903,45187,板橋,一等
2020-12-01,1020,20094,19490,39584,板橋,一等
2020-12-02,1020,20586,20141,40727,板橋,一等
2020-12-03,1020,20514,20421,40935,板橋,一等
2020-12-04,1020,27246,27548,54794,板橋,一等
2020-12-05,1020,37078,35490,72568,板橋,一等
2020-12-06,1020,30649,30379,61028,板橋,一等
2020-12-07,1020,22607,22830,45437,板橋,一等
2020-12-08,1020,20606,20325,40931,板橋,一等
2020-12-09,1020,19684,19452,39136,板橋,一等
2020-12-10,1020,21508,21258,42766,板橋,一等
2020-12-11,1020,27644,28405,56049,板橋,一等
2020-12-12,1020,44998,45546,90544,板橋,一等
2020-12-13,1020,35698,35608,71306,板橋,一等
2020-12-14,1020,23746,23314,47060,板橋,一等
2020-12-15,1020,20710,20575,41285,板橋,一等
2020-12-16,1020,21383,20968,42351,板橋,一等
2020-12-17,1020,22931,22486,45417,板橋,一等
2020-12-18,1020,28733,29947,58680,板橋,一等
2020-12-19,1020,37503,35916,73419,板橋,一等
2020-12-20,1020,31517,32425,63942,板橋,一等
2020-12-21,1020,23408,23267,46675,板橋,一等
2020-12-22,1020,22201,22079,44280,板橋,一等
2020-12-23,1020,20807,20886,41693,板橋,一等
2020-12-24,1020,22588,22051,44639,板橋,一等
2020-12-25,1020,28663,29426,58089,板橋,一等
2020-12-26,1020,30335,28494,58829,板橋,一等
2020-12-27,1020,25738,26238,51976,板橋,一等
2020-12-28,1020,22145,22072,44217,板橋,一等
2020-12-29,1020,20978,20925,41903,板橋,一等
2020-12-30,1020,21139,20615,41754,板橋,一等
2020-12-31,1020,26773,27457,54230,板橋,一等
2020-01-01,1030,2216,2414,4630,浮洲,簡易
2020-01-02,1030,3239,3150,6389,浮洲,簡易
2020-01-03,1030,3376,3262,6638,浮洲,簡易
2020-01-04,1030,2851,2682,5533,浮洲,簡易
2020-01-05,1030,2291,2314,4605,浮洲,簡易
2020-01-06,1030,3213,3076,6289,浮洲,簡易
2020-01-07,1030,3214,3073,6287,浮洲,簡易
2020-01-08,1030,3194,3108,6302,浮洲,簡易
2020-01-09,1030,3405,3130,6535,浮洲,簡易
2020-01-10,1030,3638,2940,6578,浮洲,簡易
2020-01-11,1030,2580,2197,4777,浮洲,簡易
2020-01-12,1030,2178,2270,4448,浮洲,簡易
2020-01-13,1030,2989,2881,5870,浮洲,簡易
2020-01-14,1030,2949,2770,5719,浮洲,簡易
2020-01-15,1030,2632,2520,5152,浮洲,簡易
2020-01-16,1030,3132,2890,6022,浮洲,簡易
2020-01-17,1030,3156,2879,6035,浮洲,簡易
2020-01-18,1030,2585,2396,4981,浮洲,簡易
2020-01-19,1030,2269,2064,4333,浮洲,簡易
2020-01-20,1030,2747,2561,5308,浮洲,簡易
2020-01-21,1030,2625,2434,5059,浮洲,簡易
2020-01-22,1030,2648,2285,4933,浮洲,簡易
2020-01-23,1030,1904,1394,3298,浮洲,簡易
2020-01-24,1030,1456,1143,2599,浮洲,簡易
2020-01-25,1030,1643,1427,3070,浮洲,簡易
2020-01-26,1030,1587,1528,3115,浮洲,簡易
2020-01-27,1030,1718,1748,3466,浮洲,簡易
2020-01-28,1030,1685,1784,3469,浮洲,簡易
2020-01-29,1030,1563,1693,3256,浮洲,簡易
2020-01-30,1030,2303,2209,4512,浮洲,簡易
2020-01-31,1030,2281,2188,4469,浮洲,簡易
2020-02-01,1030,1838,1707,3545,浮洲,簡易
2020-02-02,1030,1715,1692,3407,浮洲,簡易
2020-02-03,1030,2490,2317,4807,浮洲,簡易
2020-02-04,1030,2514,2387,4901,浮洲,簡易
2020-02-05,1030,2512,2316,4828,浮洲,簡易
2020-02-06,1030,2410,2258,4668,浮洲,簡易
2020-02-07,1030,2529,2262,4791,浮洲,簡易
2020-02-08,1030,1872,1617,3489,浮洲,簡易
2020-02-09,1030,1714,1652,3366,浮洲,簡易
2020-02-10,1030,2407,2327,4734,浮洲,簡易
2020-02-11,1030,2383,2230,4613,浮洲,簡易
2020-02-12,1030,2457,2323,4780,浮洲,簡易
2020-02-13,1030,2366,2188,4554,浮洲,簡易
2020-02-14,1030,2564,2327,4891,浮洲,簡易
2020-02-15,1030,2245,1940,4185,浮洲,簡易
2020-02-16,1030,1658,1608,3266,浮洲,簡易
2020-02-17,1030,2271,2140,4411,浮洲,簡易
2020-02-18,1030,2266,2190,4456,浮洲,簡易
2020-02-19,1030,2424,2228,4652,浮洲,簡易
2020-02-20,1030,2427,2195,4622,浮洲,簡易
2020-02-21,1030,2493,2202,4695,浮洲,簡易
2020-02-22,1030,1907,1644,3551,浮洲,簡易
2020-02-23,1030,1659,1656,3315,浮洲,簡易
2020-02-24,1030,2451,2311,4762,浮洲,簡易
2020-02-25,1030,2602,2462,5064,浮洲,簡易
2020-02-26,1030,2408,2477,4885,浮洲,簡易
2020-02-27,1030,2801,2539,5340,浮洲,簡易
2020-02-28,1030,2077,1754,3831,浮洲,簡易
2020-02-29,1030,1813,1703,3516,浮洲,簡易
2020-03-01,1030,1731,1843,3574,浮洲,簡易
2020-03-02,1030,2903,2933,5836,浮洲,簡易
2020-03-03,1030,2838,2753,5591,浮洲,簡易
2020-03-04,1030,2922,2704,5626,浮洲,簡易
2020-03-05,1030,2983,2842,5825,浮洲,簡易
2020-03-06,1030,3206,2927,6133,浮洲,簡易
2020-03-07,1030,2224,1944,4168,浮洲,簡易
2020-03-08,1030,1840,1856,3696,浮洲,簡易
2020-03-09,1030,2977,2956,5933,浮洲,簡易
2020-03-10,1030,2956,2813,5769,浮洲,簡易
2020-03-11,1030,2951,2822,5773,浮洲,簡易
2020-03-12,1030,3008,2854,5862,浮洲,簡易
2020-03-13,1030,3330,3080,6410,浮洲,簡易
2020-03-14,1030,2210,1990,4200,浮洲,簡易
2020-03-15,1030,2012,1980,3992,浮洲,簡易
2020-03-16,1030,2981,2928,5909,浮洲,簡易
2020-03-17,1030,2963,2831,5794,浮洲,簡易
2020-03-18,1030,2963,2868,5831,浮洲,簡易
2020-03-19,1030,2867,2766,5633,浮洲,簡易
2020-03-20,1030,3281,2952,6233,浮洲,簡易
2020-03-21,1030,2051,1807,3858,浮洲,簡易
2020-03-22,1030,1731,1767,3498,浮洲,簡易
2020-03-23,1030,2824,2804,5628,浮洲,簡易
2020-03-24,1030,2749,2673,5422,浮洲,簡易
2020-03-25,1030,2821,2729,5550,浮洲,簡易
2020-03-26,1030,2787,2686,5473,浮洲,簡易
2020-03-27,1030,3031,2837,5868,浮洲,簡易
2020-03-28,1030,1903,1725,3628,浮洲,簡易
2020-03-29,1030,1846,1744,3590,浮洲,簡易
2020-03-30,1030,2785,2721,5506,浮洲,簡易
2020-03-31,1030,2816,2488,5304,浮洲,簡易
2020-04-01,1030,2824,2410,5234,浮洲,簡易
2020-04-02,1030,1724,1312,3036,浮洲,簡易
2020-04-03,1030,1441,1289,2730,浮洲,簡易
2020-04-04,1030,1148,1157,2305,浮洲,簡易
2020-04-05,1030,1320,1577,2897,浮洲,簡易
2020-04-06,1030,2647,2851,5498,浮洲,簡易
2020-04-07,1030,2712,2621,5333,浮洲,簡易
2020-04-08,1030,2643,2562,5205,浮洲,簡易
2020-04-09,1030,2710,2620,5330,浮洲,簡易
2020-04-10,1030,2976,2796,5772,浮洲,簡易
2020-04-11,1030,1893,1760,3653,浮洲,簡易
2020-04-12,1030,1497,1504,3001,浮洲,簡易
2020-04-13,1030,2660,2656,5316,浮洲,簡易
2020-04-14,1030,2716,2614,5330,浮洲,簡易
2020-04-15,1030,2739,2692,5431,浮洲,簡易
2020-04-16,1030,2844,2676,5520,浮洲,簡易
2020-04-17,1030,3153,2881,6034,浮洲,簡易
2020-04-18,1030,2054,1826,3880,浮洲,簡易
2020-04-19,1030,1737,1747,3484,浮洲,簡易
2020-04-20,1030,2666,2688,5354,浮洲,簡易
2020-04-21,1030,2736,2651,5387,浮洲,簡易
2020-04-22,1030,2722,2604,5326,浮洲,簡易
2020-04-23,1030,2754,2579,5333,浮洲,簡易
2020-04-24,1030,3011,2731,5742,浮洲,簡易
2020-04-25,1030,1837,1658,3495,浮洲,簡易
2020-04-26,1030,1483,1521,3004,浮洲,簡易
2020-04-27,1030,2714,2717,5431,浮洲,簡易
2020-04-28,1030,2770,2643,5413,浮洲,簡易
2020-04-29,1030,2813,2584,5397,浮洲,簡易
2020-04-30,1030,2789,2684,5473,浮洲,簡易
2020-05-01,1030,2629,2422,5051,浮洲,簡易
2020-05-02,1030,1963,1741,3704,浮洲,簡易
2020-05-03,1030,1560,1671,3231,浮洲,簡易
2020-05-04,1030,2788,2825,5613,浮洲,簡易
2020-05-05,1030,2803,2723,5526,浮洲,簡易
2020-05-06,1030,2842,2677,5519,浮洲,簡易
2020-05-07,1030,2887,2729,5616,浮洲,簡易
2020-05-08,1030,3257,2851,6108,浮洲,簡易
2020-05-09,1030,2215,1942,4157,浮洲,簡易
2020-05-10,1030,1861,1953,3814,浮洲,簡易
2020-05-11,1030,2855,2897,5752,浮洲,簡易
2020-05-12,1030,2811,2703,5514,浮洲,簡易
2020-05-13,1030,2915,2782,5697,浮洲,簡易
2020-05-14,1030,2872,2784,5656,浮洲,簡易
2020-05-15,1030,3235,3046,6281,浮洲,簡易
2020-05-16,1030,2137,1860,3997,浮洲,簡易
2020-05-17,1030,1885,1932,3817,浮洲,簡易
2020-05-18,1030,2844,2881,5725,浮洲,簡易
2020-05-19,1030,2889,2827,5716,浮洲,簡易
2020-05-20,1030,2910,2812,5722,浮洲,簡易
2020-05-21,1030,2858,2884,5742,浮洲,簡易
2020-05-22,1030,3201,2999,6200,浮洲,簡易
2020-05-23,1030,2355,2023,4378,浮洲,簡易
2020-05-24,1030,1898,1925,3823,浮洲,簡易
2020-05-25,1030,2887,2958,5845,浮洲,簡易
2020-05-26,1030,2947,2830,5777,浮洲,簡易
2020-05-27,1030,2997,2919,5916,浮洲,簡易
2020-05-28,1030,2928,2742,5670,浮洲,簡易
2020-05-29,1030,3248,2981,6229,浮洲,簡易
2020-05-30,1030,2247,1983,4230,浮洲,簡易
2020-05-31,1030,1933,1976,3909,浮洲,簡易
2020-06-01,1030,2945,2921,5866,浮洲,簡易
2020-06-02,1030,2891,2774,5665,浮洲,簡易
2020-06-03,1030,2927,2865,5792,浮洲,簡易
2020-06-04,1030,2942,2804,5746,浮洲,簡易
2020-06-05,1030,3256,2912,6168,浮洲,簡易
2020-06-06,1030,2323,2141,4464,浮洲,簡易
2020-06-07,1030,1875,1937,3812,浮洲,簡易
2020-06-08,1030,2830,2895,5725,浮洲,簡易
2020-06-09,1030,2982,2818,5800,浮洲,簡易
2020-06-10,1030,3073,3005,6078,浮洲,簡易
2020-06-11,1030,2965,2806,5771,浮洲,簡易
2020-06-12,1030,3249,2941,6190,浮洲,簡易
2020-06-13,1030,2523,2212,4735,浮洲,簡易
2020-06-14,1030,1973,2001,3974,浮洲,簡易
2020-06-15,1030,2894,2854,5748,浮洲,簡易
2020-06-16,1030,2892,2760,5652,浮洲,簡易
2020-06-17,1030,2846,2774,5620,浮洲,簡易
2020-06-18,1030,2859,2767,5626,浮洲,簡易
2020-06-19,1030,3124,2914,6038,浮洲,簡易
2020-06-20,1030,2728,2444,5172,浮洲,簡易
2020-06-21,1030,2002,2018,4020,浮洲,簡易
2020-06-22,1030,2845,2811,5656,浮洲,簡易
2020-06-23,1030,2901,2730,5631,浮洲,簡易
2020-06-24,1030,3299,2825,6124,浮洲,簡易
2020-06-25,1030,2273,1748,4021,浮洲,簡易
2020-06-26,1030,2162,1879,4041,浮洲,簡易
2020-06-27,1030,2038,1979,4017,浮洲,簡易
2020-06-28,1030,1769,2071,3840,浮洲,簡易
2020-06-29,1030,2870,2904,5774,浮洲,簡易
2020-06-30,1030,2868,2737,5605,浮洲,簡易
2020-07-01,1030,2752,2651,5403,浮洲,簡易
2020-07-02,1030,2751,2750,5501,浮洲,簡易
2020-07-03,1030,3273,3056,6329,浮洲,簡易
2020-07-04,1030,2536,2180,4716,浮洲,簡易
2020-07-05,1030,2094,2059,4153,浮洲,簡易
2020-07-06,1030,2659,2546,5205,浮洲,簡易
2020-07-07,1030,2732,2521,5253,浮洲,簡易
2020-07-08,1030,2716,2578,5294,浮洲,簡易
2020-07-09,1030,2707,2523,5230,浮洲,簡易
2020-07-10,1030,3010,2534,5544,浮洲,簡易
2020-07-11,1030,2079,1911,3990,浮洲,簡易
2020-07-12,1030,1929,1936,3865,浮洲,簡易
2020-07-13,1030,2759,2568,5327,浮洲,簡易
2020-07-14,1030,2730,2556,5286,浮洲,簡易
2020-07-15,1030,2692,2464,5156,浮洲,簡易
2020-07-16,1030,2806,2578,5384,浮洲,簡易
2020-07-17,1030,2796,2506,5302,浮洲,簡易
2020-07-18,1030,2143,1897,4040,浮洲,簡易
2020-07-19,1030,2125,2107,4232,浮洲,簡易
2020-07-20,1030,2657,2502,5159,浮洲,簡易
2020-07-21,1030,2690,2466,5156,浮洲,簡易
2020-07-22,1030,2620,2454,5074,浮洲,簡易
2020-07-23,1030,2620,2480,5100,浮洲,簡易
2020-07-24,1030,2730,2433,5163,浮洲,簡易
2020-07-25,1030,2149,1864,4013,浮洲,簡易
2020-07-26,1030,1913,1876,3789,浮洲,簡易
2020-07-27,1030,2540,2513,5053,浮洲,簡易
2020-07-28,1030,2592,2369,4961,浮洲,簡易
2020-07-29,1030,2624,2485,5109,浮洲,簡易
2020-07-30,1030,2748,2531,5279,浮洲,簡易
2020-07-31,1030,2924,2512,5436,浮洲,簡易
2020-08-01,1030,2190,1993,4183,浮洲,簡易
2020-08-02,1030,1887,1813,3700,浮洲,簡易
2020-08-03,1030,2356,2391,4747,浮洲,簡易
2020-08-04,1030,2497,2380,4877,浮洲,簡易
2020-08-05,1030,2632,2442,5074,浮洲,簡易
2020-08-06,1030,2646,2472,5118,浮洲,簡易
2020-08-07,1030,2875,2450,5325,浮洲,簡易
2020-08-08,1030,2021,1697,3718,浮洲,簡易
2020-08-09,1030,1890,1890,3780,浮洲,簡易
2020-08-10,1030,2528,2490,5018,浮洲,簡易
2020-08-11,1030,2488,2330,4818,浮洲,簡易
2020-08-12,1030,2545,2394,4939,浮洲,簡易
2020-08-13,1030,2602,2543,5145,浮洲,簡易
2020-08-14,1030,2727,2478,5205,浮洲,簡易
2020-08-15,1030,2217,1932,4149,浮洲,簡易
2020-08-16,1030,2094,2078,4172,浮洲,簡易
2020-08-17,1030,2536,2433,4969,浮洲,簡易
2020-08-18,1030,2539,2402,4941,浮洲,簡易
2020-08-19,1030,2666,2511,5177,浮洲,簡易
2020-08-20,1030,2599,2410,5009,浮洲,簡易
2020-08-21,1030,2691,2472,5163,浮洲,簡易
2020-08-22,1030,2265,1972,4237,浮洲,簡易
2020-08-23,1030,1950,1942,3892,浮洲,簡易
2020-08-24,1030,2595,2434,5029,浮洲,簡易
2020-08-25,1030,2702,2443,5145,浮洲,簡易
2020-08-26,1030,2560,2479,5039,浮洲,簡易
2020-08-27,1030,2488,2438,4926,浮洲,簡易
2020-08-28,1030,2673,2392,5065,浮洲,簡易
2020-08-29,1030,2093,1820,3913,浮洲,簡易
2020-08-30,1030,1892,1938,3830,浮洲,簡易
2020-08-31,1030,2643,2541,5184,浮洲,簡易
2020-09-01,1030,2711,2505,5216,浮洲,簡易
2020-09-02,1030,2702,2471,5173,浮洲,簡易
2020-09-03,1030,2674,2493,5167,浮洲,簡易
2020-09-04,1030,2885,2582,5467,浮洲,簡易
2020-09-05,1030,2096,1942,4038,浮洲,簡易
2020-09-06,1030,2054,2002,4056,浮洲,簡易
2020-09-07,1030,2723,2595,5318,浮洲,簡易
2020-09-08,1030,2759,2569,5328,浮洲,簡易
2020-09-09,1030,2790,2709,5499,浮洲,簡易
2020-09-10,1030,2971,2792,5763,浮洲,簡易
2020-09-11,1030,3400,3049,6449,浮洲,簡易
2020-09-12,1030,2466,2148,4614,浮洲,簡易
2020-09-13,1030,2183,2154,4337,浮洲,簡易
2020-09-14,1030,3123,3110,6233,浮洲,簡易
2020-09-15,1030,3192,3033,6225,浮洲,簡易
2020-09-16,1030,3255,3149,6404,浮洲,簡易
2020-09-17,1030,3174,3059,6233,浮洲,簡易
2020-09-18,1030,3535,3280,6815,浮洲,簡易
2020-09-19,1030,2723,2487,5210,浮洲,簡易
2020-09-20,1030,2118,2134,4252,浮洲,簡易
2020-09-21,1030,3147,3084,6231,浮洲,簡易
2020-09-22,1030,3165,3083,6248,浮洲,簡易
2020-09-23,1030,3265,3097,6362,浮洲,簡易
2020-09-24,1030,3163,3181,6344,浮洲,簡易
2020-09-25,1030,3434,3139,6573,浮洲,簡易
2020-09-26,1030,2939,2637,5576,浮洲,簡易
2020-09-27,1030,2068,2121,4189,浮洲,簡易
2020-09-28,1030,3120,3106,6226,浮洲,簡易
2020-09-29,1030,3348,3138,6486,浮洲,簡易
2020-09-30,1030,3948,3312,7260,浮洲,簡易
2020-10-01,1030,2586,2025,4611,浮洲,簡易
2020-10-02,1030,2334,2167,4501,浮洲,簡易
2020-10-03,1030,2379,2312,4691,浮洲,簡易
2020-10-04,1030,2138,2473,4611,浮洲,簡易
2020-10-05,1030,3087,3263,6350,浮洲,簡易
2020-10-06,1030,3219,3099,6318,浮洲,簡易
2020-10-07,1030,3290,3152,6442,浮洲,簡易
2020-10-08,1030,3594,3215,6809,浮洲,簡易
2020-10-09,1030,3287,2978,6265,浮洲,簡易
2020-10-10,1030,2793,2681,5474,浮洲,簡易
2020-10-11,1030,2620,2740,5360,浮洲,簡易
2020-10-12,1030,3130,3119,6249,浮洲,簡易
2020-10-13,1030,3208,3091,6299,浮洲,簡易
2020-10-14,1030,3267,3165,6432,浮洲,簡易
2020-10-15,1030,3111,3015,6126,浮洲,簡易
2020-10-16,1030,3577,3320,6897,浮洲,簡易
2020-10-17,1030,3115,2827,5942,浮洲,簡易
2020-10-18,1030,2443,2534,4977,浮洲,簡易
2020-10-19,1030,3110,3127,6237,浮洲,簡易
2020-10-20,1030,3090,3081,6171,浮洲,簡易
2020-10-21,1030,3234,3139,6373,浮洲,簡易
2020-10-22,1030,3241,3105,6346,浮洲,簡易
2020-10-23,1030,3592,3299,6891,浮洲,簡易
2020-10-24,1030,3106,2722,5828,浮洲,簡易
2020-10-25,1030,2332,2341,4673,浮洲,簡易
2020-10-26,1030,3115,3114,6229,浮洲,簡易
2020-10-27,1030,3210,3139,6349,浮洲,簡易
2020-10-28,1030,3223,3055,6278,浮洲,簡易
2020-10-29,1030,3237,3081,6318,浮洲,簡易
2020-10-30,1030,3459,3145,6604,浮洲,簡易
2020-10-31,1030,3057,2671,5728,浮洲,簡易
2020-11-01,1030,2232,2319,4551,浮洲,簡易
2020-11-02,1030,3058,3058,6116,浮洲,簡易
2020-11-03,1030,3123,2947,6070,浮洲,簡易
2020-11-04,1030,3094,2982,6076,浮洲,簡易
2020-11-05,1030,3071,3022,6093,浮洲,簡易
2020-11-06,1030,3557,3246,6803,浮洲,簡易
2020-11-07,1030,2741,2374,5115,浮洲,簡易
2020-11-08,1030,2309,2365,4674,浮洲,簡易
2020-11-09,1030,3072,3120,6192,浮洲,簡易
2020-11-10,1030,3174,2994,6168,浮洲,簡易
2020-11-11,1030,3170,3019,6189,浮洲,簡易
2020-11-12,1030,3094,2997,6091,浮洲,簡易
2020-11-13,1030,3640,3320,6960,浮洲,簡易
2020-11-14,1030,2940,2651,5591,浮洲,簡易
2020-11-15,1030,2543,2505,5048,浮洲,簡易
2020-11-16,1030,3165,3165,6330,浮洲,簡易
2020-11-17,1030,3204,3094,6298,浮洲,簡易
2020-11-18,1030,3175,3038,6213,浮洲,簡易
2020-11-19,1030,3192,3068,6260,浮洲,簡易
2020-11-20,1030,3587,3244,6831,浮洲,簡易
2020-11-21,1030,2917,2599,5516,浮洲,簡易
2020-11-22,1030,2496,2487,4983,浮洲,簡易
2020-11-23,1030,2990,3069,6059,浮洲,簡易
2020-11-24,1030,3255,3076,6331,浮洲,簡易
2020-11-25,1030,3204,3148,6352,浮洲,簡易
2020-11-26,1030,3103,3010,6113,浮洲,簡易
2020-11-27,1030,3639,3258,6897,浮洲,簡易
2020-11-28,1030,2914,2604,5518,浮洲,簡易
2020-11-29,1030,2307,2339,4646,浮洲,簡易
2020-11-30,1030,2986,3162,6148,浮洲,簡易
2020-12-01,1030,3227,3037,6264,浮洲,簡易
2020-12-02,1030,3275,3011,6286,浮洲,簡易
2020-12-03,1030,3137,3080,6217,浮洲,簡易
2020-12-04,1030,3709,3213,6922,浮洲,簡易
2020-12-05,1030,2994,2709,5703,浮洲,簡易
2020-12-06,1030,2386,2424,4810,浮洲,簡易
2020-12-07,1030,3189,3198,6387,浮洲,簡易
2020-12-08,1030,3121,3111,6232,浮洲,簡易
2020-12-09,1030,3241,3080,6321,浮洲,簡易
2020-12-10,1030,3205,3053,6258,浮洲,簡易
2020-12-11,1030,3573,3291,6864,浮洲,簡易
2020-12-12,1030,3124,2773,5897,浮洲,簡易
2020-12-13,1030,2531,2484,5015,浮洲,簡易
2020-12-14,1030,3162,3141,6303,浮洲,簡易
2020-12-15,1030,3135,3041,6176,浮洲,簡易
2020-12-16,1030,3196,3095,6291,浮洲,簡易
2020-12-17,1030,3214,3120,6334,浮洲,簡易
2020-12-18,1030,3711,3384,7095,浮洲,簡易
2020-12-19,1030,3008,2579,5587,浮洲,簡易
2020-12-20,1030,2530,2456,4986,浮洲,簡易
2020-12-21,1030,3128,3113,6241,浮洲,簡易
2020-12-22,1030,3211,3063,6274,浮洲,簡易
2020-12-23,1030,3124,3083,6207,浮洲,簡易
2020-12-24,1030,3142,2981,6123,浮洲,簡易
2020-12-25,1030,3570,3115,6685,浮洲,簡易
2020-12-26,1030,2796,2520,5316,浮洲,簡易
2020-12-27,1030,2381,2359,4740,浮洲,簡易
2020-12-28,1030,3158,3116,6274,浮洲,簡易
2020-12-29,1030,3172,3084,6256,浮洲,簡易
2020-12-30,1030,3180,2980,6160,浮洲,簡易
2020-12-31,1030,3682,2933,6615,浮洲,簡易
2020-01-01,1040,13395,15180,28575,樹林,一等
2020-01-02,1040,14923,15035,29958,樹林,一等
2020-01-03,1040,16298,16602,32900,樹林,一等
2020-01-04,1040,14436,14450,28886,樹林,一等
2020-01-05,1040,13980,14553,28533,樹林,一等
2020-01-06,1040,15184,15445,30629,樹林,一等
2020-01-07,1040,14842,15021,29863,樹林,一等
2020-01-08,1040,14559,15051,29610,樹林,一等
2020-01-09,1040,15478,15607,31085,樹林,一等
2020-01-10,1040,17447,13045,30492,樹林,一等
2020-01-11,1040,15914,15814,31728,樹林,一等
2020-01-12,1040,14778,15475,30253,樹林,一等
2020-01-13,1040,15424,15631,31055,樹林,一等
2020-01-14,1040,15363,15115,30478,樹林,一等
2020-01-15,1040,14785,15175,29960,樹林,一等
2020-01-16,1040,15732,16125,31857,樹林,一等
2020-01-17,1040,15175,15791,30966,樹林,一等
2020-01-18,1040,14480,10623,25103,樹林,一等
2020-01-19,1040,14284,11854,26138,樹林,一等
2020-01-20,1040,15557,15649,31206,樹林,一等
2020-01-21,1040,16082,15756,31838,樹林,一等
2020-01-22,1040,17223,16271,33494,樹林,一等
2020-01-23,1040,15487,12931,28418,樹林,一等
2020-01-24,1040,13225,10918,24143,樹林,一等
2020-01-25,1040,15254,13775,29029,樹林,一等
2020-01-26,1040,13773,13817,27590,樹林,一等
2020-01-27,1040,14278,16087,30365,樹林,一等
2020-01-28,1040,12863,16089,28952,樹林,一等
2020-01-29,1040,11987,13655,25642,樹林,一等
2020-01-30,1040,13595,14714,28309,樹林,一等
2020-01-31,1040,14369,15203,29572,樹林,一等
2020-02-01,1040,11468,12420,23888,樹林,一等
2020-02-02,1040,11537,12288,23825,樹林,一等
2020-02-03,1040,13789,14080,27869,樹林,一等
2020-02-04,1040,13172,13193,26365,樹林,一等
2020-02-05,1040,13058,13274,26332,樹林,一等
2020-02-06,1040,13740,13725,27465,樹林,一等
2020-02-07,1040,14321,14356,28677,樹林,一等
2020-02-08,1040,11376,11127,22503,樹林,一等
2020-02-09,1040,11866,12698,24564,樹林,一等
2020-02-10,1040,13575,13869,27444,樹林,一等
2020-02-11,1040,13140,13300,26440,樹林,一等
2020-02-12,1040,13313,13428,26741,樹林,一等
2020-02-13,1040,13011,13061,26072,樹林,一等
2020-02-14,1040,14365,14299,28664,樹林,一等
2020-02-15,1040,13261,13007,26268,樹林,一等
2020-02-16,1040,11029,11536,22565,樹林,一等
2020-02-17,1040,12944,13188,26132,樹林,一等
2020-02-18,1040,12646,13133,25779,樹林,一等
2020-02-19,1040,13197,13190,26387,樹林,一等
2020-02-20,1040,13086,11840,24926,樹林,一等
2020-02-21,1040,14388,14531,28919,樹林,一等
2020-02-22,1040,11583,11562,23145,樹林,一等
2020-02-23,1040,11566,12062,23628,樹林,一等
2020-02-24,1040,13542,13702,27244,樹林,一等
2020-02-25,1040,13620,13874,27494,樹林,一等
2020-02-26,1040,13561,13758,27319,樹林,一等
2020-02-27,1040,15327,15119,30446,樹林,一等
2020-02-28,1040,11543,10318,21861,樹林,一等
2020-02-29,1040,9329,9474,18803,樹林,一等
2020-03-01,1040,9764,10901,20665,樹林,一等
2020-03-02,1040,13335,13693,27028,樹林,一等
2020-03-03,1040,12848,12380,25228,樹林,一等
2020-03-04,1040,12910,12925,25835,樹林,一等
2020-03-05,1040,12802,12929,25731,樹林,一等
2020-03-06,1040,14612,15259,29871,樹林,一等
2020-03-07,1040,10782,10641,21423,樹林,一等
2020-03-08,1040,10518,10688,21206,樹林,一等
2020-03-09,1040,13641,13839,27480,樹林,一等
2020-03-10,1040,12747,13049,25796,樹林,一等
2020-03-11,1040,13476,13571,27047,樹林,一等
2020-03-12,1040,13057,13298,26355,樹林,一等
2020-03-13,1040,14214,15141,29355,樹林,一等
2020-03-14,1040,10418,10096,20514,樹林,一等
2020-03-15,1040,11052,11392,22444,樹林,一等
2020-03-16,1040,13633,13748,27381,樹林,一等
2020-03-17,1040,13192,13526,26718,樹林,一等
2020-03-18,1040,12789,13079,25868,樹林,一等
2020-03-19,1040,12330,12682,25012,樹林,一等
2020-03-20,1040,14204,14595,28799,樹林,一等
2020-03-21,1040,9650,9779,19429,樹林,一等
2020-03-22,1040,8968,9392,18360,樹林,一等
2020-03-23,1040,12814,12905,25719,樹林,一等
2020-03-24,1040,12496,12541,25037,樹林,一等
2020-03-25,1040,12439,12640,25079,樹林,一等
2020-03-26,1040,12373,12637,25010,樹林,一等
2020-03-27,1040,13525,13844,27369,樹林,一等
2020-03-28,1040,7921,7857,15778,樹林,一等
2020-03-29,1040,8248,8516,16764,樹林,一等
2020-03-30,1040,12404,12708,25112,樹林,一等
2020-03-31,1040,12250,12474,24724,樹林,一等
2020-04-01,1040,13894,14051,27945,樹林,一等
2020-04-02,1040,10173,8612,18785,樹林,一等
2020-04-03,1040,9208,8337,17545,樹林,一等
2020-04-04,1040,7000,8590,15590,樹林,一等
2020-04-05,1040,8196,9928,18124,樹林,一等
2020-04-06,1040,12646,13029,25675,樹林,一等
2020-04-07,1040,11613,11977,23590,樹林,一等
2020-04-08,1040,11702,11766,23468,樹林,一等
2020-04-09,1040,11635,11922,23557,樹林,一等
2020-04-10,1040,12923,13389,26312,樹林,一等
2020-04-11,1040,8323,8268,16591,樹林,一等
2020-04-12,1040,8063,8051,16114,樹林,一等
2020-04-13,1040,12100,12241,24341,樹林,一等
2020-04-14,1040,11470,11085,22555,樹林,一等
2020-04-15,1040,11969,12084,24053,樹林,一等
2020-04-16,1040,11888,12049,23937,樹林,一等
2020-04-17,1040,13337,13787,27124,樹林,一等
2020-04-18,1040,9561,9479,19040,樹林,一等
2020-04-19,1040,9026,9176,18202,樹林,一等
2020-04-20,1040,12461,12611,25072,樹林,一等
2020-04-21,1040,11686,11973,23659,樹林,一等
2020-04-22,1040,11961,11802,23763,樹林,一等
2020-04-23,1040,11738,12013,23751,樹林,一等
2020-04-24,1040,12684,13319,26003,樹林,一等
2020-04-25,1040,8422,8289,16711,樹林,一等
2020-04-26,1040,7907,7959,15866,樹林,一等
2020-04-27,1040,12266,12346,24612,樹林,一等
2020-04-28,1040,12195,12320,24515,樹林,一等
2020-04-29,1040,12099,12266,24365,樹林,一等
2020-04-30,1040,13030,13105,26135,樹林,一等
2020-05-01,1040,12422,12397,24819,樹林,一等
2020-05-02,1040,9473,9658,19131,樹林,一等
2020-05-03,1040,9401,10232,19633,樹林,一等
2020-05-04,1040,12706,13042,25748,樹林,一等
2020-05-05,1040,12557,12556,25113,樹林,一等
2020-05-06,1040,12528,12678,25206,樹林,一等
2020-05-07,1040,12515,12854,25369,樹林,一等
2020-05-08,1040,14451,15171,29622,樹林,一等
2020-05-09,1040,11119,10964,22083,樹林,一等
2020-05-10,1040,10909,10906,21815,樹林,一等
2020-05-11,1040,13217,13416,26633,樹林,一等
2020-05-12,1040,12484,12735,25219,樹林,一等
2020-05-13,1040,12898,13093,25991,樹林,一等
2020-05-14,1040,12805,13036,25841,樹林,一等
2020-05-15,1040,14706,15096,29802,樹林,一等
2020-05-16,1040,10405,10324,20729,樹林,一等
2020-05-17,1040,10563,10803,21366,樹林,一等
2020-05-18,1040,12982,13065,26047,樹林,一等
2020-05-19,1040,12302,12551,24853,樹林,一等
2020-05-20,1040,12782,13007,25789,樹林,一等
2020-05-21,1040,12333,12708,25041,樹林,一等
2020-05-22,1040,13322,13882,27204,樹林,一等
2020-05-23,1040,9796,9876,19672,樹林,一等
2020-05-24,1040,11568,11607,23175,樹林,一等
2020-05-25,1040,13473,13617,27090,樹林,一等
2020-05-26,1040,13004,13155,26159,樹林,一等
2020-05-27,1040,12632,12941,25573,樹林,一等
2020-05-28,1040,12219,12642,24861,樹林,一等
2020-05-29,1040,14441,14742,29183,樹林,一等
2020-05-30,1040,11845,11106,22951,樹林,一等
2020-05-31,1040,11304,11874,23178,樹林,一等
2020-06-01,1040,13512,13619,27131,樹林,一等
2020-06-02,1040,12821,13123,25944,樹林,一等
2020-06-03,1040,13016,13232,26248,樹林,一等
2020-06-04,1040,12896,13223,26119,樹林,一等
2020-06-05,1040,14671,15089,29760,樹林,一等
2020-06-06,1040,12960,12740,25700,樹林,一等
2020-06-07,1040,11377,11706,23083,樹林,一等
2020-06-08,1040,13575,13808,27383,樹林,一等
2020-06-09,1040,13227,13497,26724,樹林,一等
2020-06-10,1040,13673,13805,27478,樹林,一等
2020-06-11,1040,13804,14071,27875,樹林,一等
2020-06-12,1040,15294,15452,30746,樹林,一等
2020-06-13,1040,13474,13074,26548,樹林,一等
2020-06-14,1040,12059,12783,24842,樹林,一等
2020-06-15,1040,14057,13748,27805,樹林,一等
2020-06-16,1040,13381,13681,27062,樹林,一等
2020-06-17,1040,13219,13625,26844,樹林,一等
2020-06-18,1040,13440,13606,27046,樹林,一等
2020-06-19,1040,14287,14321,28608,樹林,一等
2020-06-20,1040,13450,13291,26741,樹林,一等
2020-06-21,1040,11794,12099,23893,樹林,一等
2020-06-22,1040,13842,13369,27211,樹林,一等
2020-06-23,1040,13685,13687,27372,樹林,一等
2020-06-24,1040,16203,14782,30985,樹林,一等
2020-06-25,1040,14006,12171,26177,樹林,一等
2020-06-26,1040,14216,14011,28227,樹林,一等
2020-06-27,1040,12950,14395,27345,樹林,一等
2020-06-28,1040,12597,14693,27290,樹林,一等
2020-06-29,1040,13976,14775,28751,樹林,一等
2020-06-30,1040,13346,13836,27182,樹林,一等
2020-07-01,1040,13073,13346,26419,樹林,一等
2020-07-02,1040,12981,13222,26203,樹林,一等
2020-07-03,1040,14544,14940,29484,樹林,一等
2020-07-04,1040,13051,12373,25424,樹林,一等
2020-07-05,1040,11814,12801,24615,樹林,一等
2020-07-06,1040,13421,14256,27677,樹林,一等
2020-07-07,1040,13726,14108,27834,樹林,一等
2020-07-08,1040,13421,13742,27163,樹林,一等
2020-07-09,1040,13691,13816,27507,樹林,一等
2020-07-10,1040,15828,15687,31515,樹林,一等
2020-07-11,1040,13872,13402,27274,樹林,一等
2020-07-12,1040,13348,14269,27617,樹林,一等
2020-07-13,1040,14505,14856,29361,樹林,一等
2020-07-14,1040,14021,14317,28338,樹林,一等
2020-07-15,1040,14308,14214,28522,樹林,一等
2020-07-16,1040,14460,14226,28686,樹林,一等
2020-07-17,1040,15797,15720,31517,樹林,一等
2020-07-18,1040,14330,13844,28174,樹林,一等
2020-07-19,1040,12957,14073,27030,樹林,一等
2020-07-20,1040,14135,14772,28907,樹林,一等
2020-07-21,1040,13859,14038,27897,樹林,一等
2020-07-22,1040,14124,14255,28379,樹林,一等
2020-07-23,1040,14158,14267,28425,樹林,一等
2020-07-24,1040,15859,15536,31395,樹林,一等
2020-07-25,1040,13977,13467,27444,樹林,一等
2020-07-26,1040,12508,13707,26215,樹林,一等
2020-07-27,1040,13787,14337,28124,樹林,一等
2020-07-28,1040,14013,14162,28175,樹林,一等
2020-07-29,1040,13923,14273,28196,樹林,一等
2020-07-30,1040,14061,14213,28274,樹林,一等
2020-07-31,1040,15660,15436,31096,樹林,一等
2020-08-01,1040,13366,13198,26564,樹林,一等
2020-08-02,1040,11937,13092,25029,樹林,一等
2020-08-03,1040,12605,12277,24882,樹林,一等
2020-08-04,1040,13336,12678,26014,樹林,一等
2020-08-05,1040,13936,12915,26851,樹林,一等
2020-08-06,1040,14377,14161,28538,樹林,一等
2020-08-07,1040,15970,15929,31899,樹林,一等
2020-08-08,1040,13389,13114,26503,樹林,一等
2020-08-09,1040,13642,14263,27905,樹林,一等
2020-08-10,1040,14261,13652,27913,樹林,一等
2020-08-11,1040,13375,12675,26050,樹林,一等
2020-08-12,1040,14188,14309,28497,樹林,一等
2020-08-13,1040,14760,14412,29172,樹林,一等
2020-08-14,1040,15875,15600,31475,樹林,一等
2020-08-15,1040,14658,14444,29102,樹林,一等
2020-08-16,1040,14011,14262,28273,樹林,一等
2020-08-17,1040,14562,14390,28952,樹林,一等
2020-08-18,1040,14131,14236,28367,樹林,一等
2020-08-19,1040,14188,13882,28070,樹林,一等
2020-08-20,1040,14357,13495,27852,樹林,一等
2020-08-21,1040,15901,14975,30876,樹林,一等
2020-08-22,1040,13749,12513,26262,樹林,一等
2020-08-23,1040,12628,13565,26193,樹林,一等
2020-08-24,1040,14150,14223,28373,樹林,一等
2020-08-25,1040,14035,14418,28453,樹林,一等
2020-08-26,1040,14030,14000,28030,樹林,一等
2020-08-27,1040,13886,13672,27558,樹林,一等
2020-08-28,1040,15050,14969,30019,樹林,一等
2020-08-29,1040,13203,12602,25805,樹林,一等
2020-08-30,1040,12181,12497,24678,樹林,一等
2020-08-31,1040,13624,13904,27528,樹林,一等
2020-09-01,1040,13296,13379,26675,樹林,一等
2020-09-02,1040,13094,13657,26751,樹林,一等
2020-09-03,1040,13679,13838,27517,樹林,一等
2020-09-04,1040,15652,15640,31292,樹林,一等
2020-09-05,1040,13410,13157,26567,樹林,一等
2020-09-06,1040,12860,13582,26442,樹林,一等
2020-09-07,1040,14356,14584,28940,樹林,一等
2020-09-08,1040,13972,14186,28158,樹林,一等
2020-09-09,1040,13891,14104,27995,樹林,一等
2020-09-10,1040,13917,13974,27891,樹林,一等
2020-09-11,1040,15742,15821,31563,樹林,一等
2020-09-12,1040,14401,13586,27987,樹林,一等
2020-09-13,1040,14083,14451,28534,樹林,一等
2020-09-14,1040,14151,14796,28947,樹林,一等
2020-09-15,1040,13888,14217,28105,樹林,一等
2020-09-16,1040,14466,14132,28598,樹林,一等
2020-09-17,1040,14103,14306,28409,樹林,一等
2020-09-18,1040,15925,16736,32661,樹林,一等
2020-09-19,1040,14092,14144,28236,樹林,一等
2020-09-20,1040,12771,13312,26083,樹林,一等
2020-09-21,1040,14380,14587,28967,樹林,一等
2020-09-22,1040,14085,14386,28471,樹林,一等
2020-09-23,1040,14097,14295,28392,樹林,一等
2020-09-24,1040,14023,13509,27532,樹林,一等
2020-09-25,1040,14869,14152,29021,樹林,一等
2020-09-26,1040,13575,13546,27121,樹林,一等
2020-09-27,1040,10851,10392,21243,樹林,一等
2020-09-28,1040,14109,14196,28305,樹林,一等
2020-09-29,1040,14234,14411,28645,樹林,一等
2020-09-30,1040,16707,17510,34217,樹林,一等
2020-10-01,1040,15513,13669,29182,樹林,一等
2020-10-02,1040,14835,13407,28242,樹林,一等
2020-10-03,1040,13492,15128,28620,樹林,一等
2020-10-04,1040,13858,15584,29442,樹林,一等
2020-10-05,1040,14609,14906,29515,樹林,一等
2020-10-06,1040,13687,14239,27926,樹林,一等
2020-10-07,1040,14084,14202,28286,樹林,一等
2020-10-08,1040,16238,16933,33171,樹林,一等
2020-10-09,1040,15107,13988,29095,樹林,一等
2020-10-10,1040,13971,14325,28296,樹林,一等
2020-10-11,1040,14041,15321,29362,樹林,一等
2020-10-12,1040,14588,15021,29609,樹林,一等
2020-10-13,1040,13868,14129,27997,樹林,一等
2020-10-14,1040,14151,14330,28481,樹林,一等
2020-10-15,1040,13998,14371,28369,樹林,一等
2020-10-16,1040,16135,16328,32463,樹林,一等
2020-10-17,1040,14415,13878,28293,樹林,一等
2020-10-18,1040,13992,14655,28647,樹林,一等
2020-10-19,1040,14287,14789,29076,樹林,一等
2020-10-20,1040,14317,14641,28958,樹林,一等
2020-10-21,1040,14066,14372,28438,樹林,一等
2020-10-22,1040,13882,14120,28002,樹林,一等
2020-10-23,1040,15771,16263,32034,樹林,一等
2020-10-24,1040,14213,13792,28005,樹林,一等
2020-10-25,1040,13553,14349,27902,樹林,一等
2020-10-26,1040,14494,14944,29438,樹林,一等
2020-10-27,1040,14159,14359,28518,樹林,一等
2020-10-28,1040,13935,14157,28092,樹林,一等
2020-10-29,1040,13909,14118,28027,樹林,一等
2020-10-30,1040,15741,16214,31955,樹林,一等
2020-10-31,1040,13953,13610,27563,樹林,一等
2020-11-01,1040,13336,14128,27464,樹林,一等
2020-11-02,1040,14243,14513,28756,樹林,一等
2020-11-03,1040,13552,13860,27412,樹林,一等
2020-11-04,1040,13828,13963,27791,樹林,一等
2020-11-05,1040,14217,14479,28696,樹林,一等
2020-11-06,1040,15872,16336,32208,樹林,一等
2020-11-07,1040,14683,14198,28881,樹林,一等
2020-11-08,1040,13690,14297,27987,樹林,一等
2020-11-09,1040,14348,14682,29030,樹林,一等
2020-11-10,1040,14075,14282,28357,樹林,一等
2020-11-11,1040,14276,14455,28731,樹林,一等
2020-11-12,1040,14255,14550,28805,樹林,一等
2020-11-13,1040,15999,16526,32525,樹林,一等
2020-11-14,1040,15319,15097,30416,樹林,一等
2020-11-15,1040,15325,16085,31410,樹林,一等
2020-11-16,1040,15125,15195,30320,樹林,一等
2020-11-17,1040,14430,14627,29057,樹林,一等
2020-11-18,1040,14383,14556,28939,樹林,一等
2020-11-19,1040,14568,14703,29271,樹林,一等
2020-11-20,1040,16546,17002,33548,樹林,一等
2020-11-21,1040,14957,15155,30112,樹林,一等
2020-11-22,1040,15264,15363,30627,樹林,一等
2020-11-23,1040,14450,14617,29067,樹林,一等
2020-11-24,1040,13941,14473,28414,樹林,一等
2020-11-25,1040,14146,14376,28522,樹林,一等
2020-11-26,1040,14601,14578,29179,樹林,一等
2020-11-27,1040,16156,16775,32931,樹林,一等
2020-11-28,1040,14235,13977,28212,樹林,一等
2020-11-29,1040,13179,14109,27288,樹林,一等
2020-11-30,1040,14291,13453,27744,樹林,一等
2020-12-01,1040,13166,13545,26711,樹林,一等
2020-12-02,1040,13631,13755,27386,樹林,一等
2020-12-03,1040,13636,13923,27559,樹林,一等
2020-12-04,1040,15391,16095,31486,樹林,一等
2020-12-05,1040,14343,13786,28129,樹林,一等
2020-12-06,1040,13574,13759,27333,樹林,一等
2020-12-07,1040,13766,13913,27679,樹林,一等
2020-12-08,1040,13343,13438,26781,樹林,一等
2020-12-09,1040,12666,12914,25580,樹林,一等
2020-12-10,1040,13275,13530,26805,樹林,一等
2020-12-11,1040,15002,15449,30451,樹林,一等
2020-12-12,1040,15003,14264,29267,樹林,一等
2020-12-13,1040,14337,14415,28752,樹林,一等
2020-12-14,1040,14071,14084,28155,樹林,一等
2020-12-15,1040,13577,13747,27324,樹林,一等
2020-12-16,1040,13470,13593,27063,樹林,一等
2020-12-17,1040,14021,14193,28214,樹林,一等
2020-12-18,1040,15906,16378,32284,樹林,一等
2020-12-19,1040,14477,14182,28659,樹林,一等
2020-12-20,1040,13844,14290,28134,樹林,一等
2020-12-21,1040,14089,14317,28406,樹林,一等
2020-12-22,1040,13835,13986,27821,樹林,一等
2020-12-23,1040,13247,13587,26834,樹林,一等
2020-12-24,1040,13919,14121,28040,樹林,一等
2020-12-25,1040,15658,16194,31852,樹林,一等
2020-12-26,1040,13687,13806,27493,樹林,一等
2020-12-27,1040,12804,13517,26321,樹林,一等
2020-12-28,1040,14323,14420,28743,樹林,一等
2020-12-29,1040,14067,14272,28339,樹林,一等
2020-12-30,1040,13891,14037,27928,樹林,一等
2020-12-31,1040,16889,15953,32842,樹林,一等
2020-01-01,1050,984,1223,2207,南樹林,簡易
2020-01-02,1050,1187,1133,2320,南樹林,簡易
2020-01-03,1050,1229,1273,2502,南樹林,簡易
2020-01-04,1050,1222,1227,2449,南樹林,簡易
2020-01-05,1050,1031,1121,2152,南樹林,簡易
2020-01-06,1050,1237,1221,2458,南樹林,簡易
2020-01-07,1050,1205,1180,2385,南樹林,簡易
2020-01-08,1050,1171,1158,2329,南樹林,簡易
2020-01-09,1050,1294,1320,2614,南樹林,簡易
2020-01-10,1050,1340,1395,2735,南樹林,簡易
2020-01-11,1050,1215,1179,2394,南樹林,簡易
2020-01-12,1050,1116,1185,2301,南樹林,簡易
2020-01-13,1050,1241,1145,2386,南樹林,簡易
2020-01-14,1050,1269,1208,2477,南樹林,簡易
2020-01-15,1050,1037,1063,2100,南樹林,簡易
2020-01-16,1050,1172,1155,2327,南樹林,簡易
2020-01-17,1050,1214,1260,2474,南樹林,簡易
2020-01-18,1050,1238,1187,2425,南樹林,簡易
2020-01-19,1050,1106,1153,2259,南樹林,簡易
2020-01-20,1050,1182,1129,2311,南樹林,簡易
2020-01-21,1050,1214,1182,2396,南樹林,簡易
2020-01-22,1050,1223,1201,2424,南樹林,簡易
2020-01-23,1050,1022,919,1941,南樹林,簡易
2020-01-24,1050,814,762,1576,南樹林,簡易
2020-01-25,1050,1017,918,1935,南樹林,簡易
2020-01-26,1050,824,800,1624,南樹林,簡易
2020-01-27,1050,872,950,1822,南樹林,簡易
2020-01-28,1050,951,1003,1954,南樹林,簡易
2020-01-29,1050,828,848,1676,南樹林,簡易
2020-01-30,1050,1004,959,1963,南樹林,簡易
2020-01-31,1050,990,1007,1997,南樹林,簡易
2020-02-01,1050,909,925,1834,南樹林,簡易
2020-02-02,1050,933,965,1898,南樹林,簡易
2020-02-03,1050,1062,1001,2063,南樹林,簡易
2020-02-04,1050,1018,1020,2038,南樹林,簡易
2020-02-05,1050,1011,987,1998,南樹林,簡易
2020-02-06,1050,1043,1016,2059,南樹林,簡易
2020-02-07,1050,1093,1079,2172,南樹林,簡易
2020-02-08,1050,887,834,1721,南樹林,簡易
2020-02-09,1050,929,970,1899,南樹林,簡易
2020-02-10,1050,1040,992,2032,南樹林,簡易
2020-02-11,1050,1100,1010,2110,南樹林,簡易
2020-02-12,1050,1073,1015,2088,南樹林,簡易
2020-02-13,1050,1024,968,1992,南樹林,簡易
2020-02-14,1050,1106,1090,2196,南樹林,簡易
2020-02-15,1050,1021,957,1978,南樹林,簡易
2020-02-16,1050,869,892,1761,南樹林,簡易
2020-02-17,1050,1027,1020,2047,南樹林,簡易
2020-02-18,1050,1022,1015,2037,南樹林,簡易
2020-02-19,1050,1050,1027,2077,南樹林,簡易
2020-02-20,1050,1025,996,2021,南樹林,簡易
2020-02-21,1050,1069,1093,2162,南樹林,簡易
2020-02-22,1050,978,944,1922,南樹林,簡易
2020-02-23,1050,919,909,1828,南樹林,簡易
2020-02-24,1050,1013,970,1983,南樹林,簡易
2020-02-25,1050,1055,1059,2114,南樹林,簡易
2020-02-26,1050,994,1041,2035,南樹林,簡易
2020-02-27,1050,1173,1198,2371,南樹林,簡易
2020-02-28,1050,807,773,1580,南樹林,簡易
2020-02-29,1050,795,764,1559,南樹林,簡易
2020-03-01,1050,735,734,1469,南樹林,簡易
2020-03-02,1050,1095,1032,2127,南樹林,簡易
2020-03-03,1050,1071,1067,2138,南樹林,簡易
2020-03-04,1050,1030,971,2001,南樹林,簡易
2020-03-05,1050,1036,1037,2073,南樹林,簡易
2020-03-06,1050,1127,1220,2347,南樹林,簡易
2020-03-07,1050,900,868,1768,南樹林,簡易
2020-03-08,1050,886,815,1701,南樹林,簡易
2020-03-09,1050,1083,1014,2097,南樹林,簡易
2020-03-10,1050,1069,1014,2083,南樹林,簡易
2020-03-11,1050,1057,1018,2075,南樹林,簡易
2020-03-12,1050,1074,1055,2129,南樹林,簡易
2020-03-13,1050,1072,1148,2220,南樹林,簡易
2020-03-14,1050,795,758,1553,南樹林,簡易
2020-03-15,1050,934,913,1847,南樹林,簡易
2020-03-16,1050,1119,1056,2175,南樹林,簡易
2020-03-17,1050,1088,1081,2169,南樹林,簡易
2020-03-18,1050,1037,1004,2041,南樹林,簡易
2020-03-19,1050,1010,1005,2015,南樹林,簡易
2020-03-20,1050,1060,1127,2187,南樹林,簡易
2020-03-21,1050,732,742,1474,南樹林,簡易
2020-03-22,1050,694,688,1382,南樹林,簡易
2020-03-23,1050,1018,993,2011,南樹林,簡易
2020-03-24,1050,1002,976,1978,南樹林,簡易
2020-03-25,1050,991,966,1957,南樹林,簡易
2020-03-26,1050,1000,990,1990,南樹林,簡易
2020-03-27,1050,975,1076,2051,南樹林,簡易
2020-03-28,1050,615,636,1251,南樹林,簡易
2020-03-29,1050,673,608,1281,南樹林,簡易
2020-03-30,1050,1003,930,1933,南樹林,簡易
2020-03-31,1050,986,995,1981,南樹林,簡易
2020-04-01,1050,1024,1053,2077,南樹林,簡易
2020-04-02,1050,637,569,1206,南樹林,簡易
2020-04-03,1050,674,607,1281,南樹林,簡易
2020-04-04,1050,528,548,1076,南樹林,簡易
2020-04-05,1050,662,649,1311,南樹林,簡易
2020-04-06,1050,973,922,1895,南樹林,簡易
2020-04-07,1050,980,938,1918,南樹林,簡易
2020-04-08,1050,972,958,1930,南樹林,簡易
2020-04-09,1050,990,1018,2008,南樹林,簡易
2020-04-10,1050,978,1048,2026,南樹林,簡易
2020-04-11,1050,722,706,1428,南樹林,簡易
2020-04-12,1050,653,627,1280,南樹林,簡易
2020-04-13,1050,987,970,1957,南樹林,簡易
2020-04-14,1050,1016,963,1979,南樹林,簡易
2020-04-15,1050,967,970,1937,南樹林,簡易
2020-04-16,1050,986,1019,2005,南樹林,簡易
2020-04-17,1050,1044,1116,2160,南樹林,簡易
2020-04-18,1050,728,742,1470,南樹林,簡易
2020-04-19,1050,783,764,1547,南樹林,簡易
2020-04-20,1050,1016,1017,2033,南樹林,簡易
2020-04-21,1050,985,990,1975,南樹林,簡易
2020-04-22,1050,973,990,1963,南樹林,簡易
2020-04-23,1050,1000,990,1990,南樹林,簡易
2020-04-24,1050,1011,1092,2103,南樹林,簡易
2020-04-25,1050,720,744,1464,南樹林,簡易
2020-04-26,1050,625,624,1249,南樹林,簡易
2020-04-27,1050,1014,1012,2026,南樹林,簡易
2020-04-28,1050,1041,1053,2094,南樹林,簡易
2020-04-29,1050,1039,1012,2051,南樹林,簡易
2020-04-30,1050,1063,1057,2120,南樹林,簡易
2020-05-01,1050,928,979,1907,南樹林,簡易
2020-05-02,1050,741,792,1533,南樹林,簡易
2020-05-03,1050,714,764,1478,南樹林,簡易
2020-05-04,1050,1046,1013,2059,南樹林,簡易
2020-05-05,1050,1112,1083,2195,南樹林,簡易
2020-05-06,1050,1060,1045,2105,南樹林,簡易
2020-05-07,1050,1040,1037,2077,南樹林,簡易
2020-05-08,1050,1101,1185,2286,南樹林,簡易
2020-05-09,1050,860,875,1735,南樹林,簡易
2020-05-10,1050,876,809,1685,南樹林,簡易
2020-05-11,1050,1103,1041,2144,南樹林,簡易
2020-05-12,1050,1055,1024,2079,南樹林,簡易
2020-05-13,1050,1067,1053,2120,南樹林,簡易
2020-05-14,1050,1114,1133,2247,南樹林,簡易
2020-05-15,1050,1125,1171,2296,南樹林,簡易
2020-05-16,1050,793,819,1612,南樹林,簡易
2020-05-17,1050,864,795,1659,南樹林,簡易
2020-05-18,1050,1079,1044,2123,南樹林,簡易
2020-05-19,1050,1037,1063,2100,南樹林,簡易
2020-05-20,1050,1134,1094,2228,南樹林,簡易
2020-05-21,1050,1053,1041,2094,南樹林,簡易
2020-05-22,1050,1075,1122,2197,南樹林,簡易
2020-05-23,1050,788,772,1560,南樹林,簡易
2020-05-24,1050,908,876,1784,南樹林,簡易
2020-05-25,1050,1117,1085,2202,南樹林,簡易
2020-05-26,1050,1075,1087,2162,南樹林,簡易
2020-05-27,1050,1061,1078,2139,南樹林,簡易
2020-05-28,1050,1042,1027,2069,南樹林,簡易
2020-05-29,1050,1162,1156,2318,南樹林,簡易
2020-05-30,1050,874,817,1691,南樹林,簡易
2020-05-31,1050,894,915,1809,南樹林,簡易
2020-06-01,1050,1084,1071,2155,南樹林,簡易
2020-06-02,1050,1055,1067,2122,南樹林,簡易
2020-06-03,1050,1066,1063,2129,南樹林,簡易
2020-06-04,1050,1052,1046,2098,南樹林,簡易
2020-06-05,1050,1130,1208,2338,南樹林,簡易
2020-06-06,1050,1040,989,2029,南樹林,簡易
2020-06-07,1050,892,903,1795,南樹林,簡易
2020-06-08,1050,1130,1102,2232,南樹林,簡易
2020-06-09,1050,1089,1098,2187,南樹林,簡易
2020-06-10,1050,1121,1084,2205,南樹林,簡易
2020-06-11,1050,1165,1132,2297,南樹林,簡易
2020-06-12,1050,1197,1279,2476,南樹林,簡易
2020-06-13,1050,1051,1029,2080,南樹林,簡易
2020-06-14,1050,919,961,1880,南樹林,簡易
2020-06-15,1050,1111,1115,2226,南樹林,簡易
2020-06-16,1050,1090,1111,2201,南樹林,簡易
2020-06-17,1050,1026,1059,2085,南樹林,簡易
2020-06-18,1050,1073,1053,2126,南樹林,簡易
2020-06-19,1050,1129,1178,2307,南樹林,簡易
2020-06-20,1050,1048,1076,2124,南樹林,簡易
2020-06-21,1050,903,957,1860,南樹林,簡易
2020-06-22,1050,1057,1119,2176,南樹林,簡易
2020-06-23,1050,1088,1098,2186,南樹林,簡易
2020-06-24,1050,1212,1177,2389,南樹林,簡易
2020-06-25,1050,957,832,1789,南樹林,簡易
2020-06-26,1050,935,871,1806,南樹林,簡易
2020-06-27,1050,939,946,1885,南樹林,簡易
2020-06-28,1050,876,928,1804,南樹林,簡易
2020-06-29,1050,1075,1115,2190,南樹林,簡易
2020-06-30,1050,1067,1060,2127,南樹林,簡易
2020-07-01,1050,1076,1048,2124,南樹林,簡易
2020-07-02,1050,1034,1056,2090,南樹林,簡易
2020-07-03,1050,1111,1169,2280,南樹林,簡易
2020-07-04,1050,1014,928,1942,南樹林,簡易
2020-07-05,1050,960,1005,1965,南樹林,簡易
2020-07-06,1050,1034,1067,2101,南樹林,簡易
2020-07-07,1050,1104,1081,2185,南樹林,簡易
2020-07-08,1050,1069,1071,2140,南樹林,簡易
2020-07-09,1050,1186,1133,2319,南樹林,簡易
2020-07-10,1050,1282,1307,2589,南樹林,簡易
2020-07-11,1050,1013,1031,2044,南樹林,簡易
2020-07-12,1050,987,976,1963,南樹林,簡易
2020-07-13,1050,1084,1110,2194,南樹林,簡易
2020-07-14,1050,1091,1113,2204,南樹林,簡易
2020-07-15,1050,1060,1037,2097,南樹林,簡易
2020-07-16,1050,1076,1052,2128,南樹林,簡易
2020-07-17,1050,1181,1133,2314,南樹林,簡易
2020-07-18,1050,1032,970,2002,南樹林,簡易
2020-07-19,1050,963,967,1930,南樹林,簡易
2020-07-20,1050,1054,1084,2138,南樹林,簡易
2020-07-21,1050,1079,1041,2120,南樹林,簡易
2020-07-22,1050,1109,1037,2146,南樹林,簡易
2020-07-23,1050,1058,1021,2079,南樹林,簡易
2020-07-24,1050,1164,1156,2320,南樹林,簡易
2020-07-25,1050,1019,841,1860,南樹林,簡易
2020-07-26,1050,906,926,1832,南樹林,簡易
2020-07-27,1050,1020,1037,2057,南樹林,簡易
2020-07-28,1050,1098,1066,2164,南樹林,簡易
2020-07-29,1050,1058,1020,2078,南樹林,簡易
2020-07-30,1050,1106,1118,2224,南樹林,簡易
2020-07-31,1050,1156,1119,2275,南樹林,簡易
2020-08-01,1050,909,865,1774,南樹林,簡易
2020-08-02,1050,851,918,1769,南樹林,簡易
2020-08-03,1050,962,998,1960,南樹林,簡易
2020-08-04,1050,1033,1007,2040,南樹林,簡易
2020-08-05,1050,1118,1086,2204,南樹林,簡易
2020-08-06,1050,1112,1064,2176,南樹林,簡易
2020-08-07,1050,1185,1144,2329,南樹林,簡易
2020-08-08,1050,1045,994,2039,南樹林,簡易
2020-08-09,1050,1020,1040,2060,南樹林,簡易
2020-08-10,1050,1112,1124,2236,南樹林,簡易
2020-08-11,1050,1125,1099,2224,南樹林,簡易
2020-08-12,1050,1144,1122,2266,南樹林,簡易
2020-08-13,1050,1117,1134,2251,南樹林,簡易
2020-08-14,1050,1163,1065,2228,南樹林,簡易
2020-08-15,1050,1096,997,2093,南樹林,簡易
2020-08-16,1050,1064,1141,2205,南樹林,簡易
2020-08-17,1050,1050,1104,2154,南樹林,簡易
2020-08-18,1050,1112,1114,2226,南樹林,簡易
2020-08-19,1050,1190,1198,2388,南樹林,簡易
2020-08-20,1050,1176,1156,2332,南樹林,簡易
2020-08-21,1050,1176,1188,2364,南樹林,簡易
2020-08-22,1050,1092,1061,2153,南樹林,簡易
2020-08-23,1050,924,983,1907,南樹林,簡易
2020-08-24,1050,1013,1028,2041,南樹林,簡易
2020-08-25,1050,1092,1019,2111,南樹林,簡易
2020-08-26,1050,1103,1078,2181,南樹林,簡易
2020-08-27,1050,1037,1004,2041,南樹林,簡易
2020-08-28,1050,1085,1097,2182,南樹林,簡易
2020-08-29,1050,1101,1013,2114,南樹林,簡易
2020-08-30,1050,902,938,1840,南樹林,簡易
2020-08-31,1050,1113,1100,2213,南樹林,簡易
2020-09-01,1050,1037,1041,2078,南樹林,簡易
2020-09-02,1050,1069,1059,2128,南樹林,簡易
2020-09-03,1050,1144,1082,2226,南樹林,簡易
2020-09-04,1050,1253,1272,2525,南樹林,簡易
2020-09-05,1050,993,987,1980,南樹林,簡易
2020-09-06,1050,977,966,1943,南樹林,簡易
2020-09-07,1050,1189,1209,2398,南樹林,簡易
2020-09-08,1050,1145,1146,2291,南樹林,簡易
2020-09-09,1050,1187,1129,2316,南樹林,簡易
2020-09-10,1050,1153,1134,2287,南樹林,簡易
2020-09-11,1050,1280,1276,2556,南樹林,簡易
2020-09-12,1050,1012,1068,2080,南樹林,簡易
2020-09-13,1050,975,1044,2019,南樹林,簡易
2020-09-14,1050,1204,1191,2395,南樹林,簡易
2020-09-15,1050,1205,1212,2417,南樹林,簡易
2020-09-16,1050,1174,1158,2332,南樹林,簡易
2020-09-17,1050,1200,1148,2348,南樹林,簡易
2020-09-18,1050,1209,1293,2502,南樹林,簡易
2020-09-19,1050,996,1006,2002,南樹林,簡易
2020-09-20,1050,945,936,1881,南樹林,簡易
2020-09-21,1050,1138,1155,2293,南樹林,簡易
2020-09-22,1050,1152,1127,2279,南樹林,簡易
2020-09-23,1050,1148,1147,2295,南樹林,簡易
2020-09-24,1050,1119,1139,2258,南樹林,簡易
2020-09-25,1050,1174,1212,2386,南樹林,簡易
2020-09-26,1050,1078,1168,2246,南樹林,簡易
2020-09-27,1050,885,906,1791,南樹林,簡易
2020-09-28,1050,1133,1147,2280,南樹林,簡易
2020-09-29,1050,1217,1207,2424,南樹林,簡易
2020-09-30,1050,1303,1447,2750,南樹林,簡易
2020-10-01,1050,1173,1064,2237,南樹林,簡易
2020-10-02,1050,1064,1072,2136,南樹林,簡易
2020-10-03,1050,1056,1123,2179,南樹林,簡易
2020-10-04,1050,1014,1016,2030,南樹林,簡易
2020-10-05,1050,1192,1165,2357,南樹林,簡易
2020-10-06,1050,1213,1228,2441,南樹林,簡易
2020-10-07,1050,1192,1197,2389,南樹林,簡易
2020-10-08,1050,1303,1315,2618,南樹林,簡易
2020-10-09,1050,1177,1074,2251,南樹林,簡易
2020-10-10,1050,1150,1164,2314,南樹林,簡易
2020-10-11,1050,1102,1060,2162,南樹林,簡易
2020-10-12,1050,1209,1204,2413,南樹林,簡易
2020-10-13,1050,1200,1132,2332,南樹林,簡易
2020-10-14,1050,1187,1184,2371,南樹林,簡易
2020-10-15,1050,1183,1173,2356,南樹林,簡易
2020-10-16,1050,1293,1279,2572,南樹林,簡易
2020-10-17,1050,1116,1059,2175,南樹林,簡易
2020-10-18,1050,1040,991,2031,南樹林,簡易
2020-10-19,1050,1227,1180,2407,南樹林,簡易
2020-10-20,1050,1254,1219,2473,南樹林,簡易
2020-10-21,1050,1199,1195,2394,南樹林,簡易
2020-10-22,1050,1218,1183,2401,南樹林,簡易
2020-10-23,1050,1274,1381,2655,南樹林,簡易
2020-10-24,1050,1093,1078,2171,南樹林,簡易
2020-10-25,1050,1088,1108,2196,南樹林,簡易
2020-10-26,1050,1181,1158,2339,南樹林,簡易
2020-10-27,1050,1223,1187,2410,南樹林,簡易
2020-10-28,1050,1202,1185,2387,南樹林,簡易
2020-10-29,1050,1217,1123,2340,南樹林,簡易
2020-10-30,1050,1311,1348,2659,南樹林,簡易
2020-10-31,1050,1085,1083,2168,南樹林,簡易
2020-11-01,1050,1109,1012,2121,南樹林,簡易
2020-11-02,1050,1188,1122,2310,南樹林,簡易
2020-11-03,1050,1180,1167,2347,南樹林,簡易
2020-11-04,1050,1195,1175,2370,南樹林,簡易
2020-11-05,1050,1228,1202,2430,南樹林,簡易
2020-11-06,1050,1274,1299,2573,南樹林,簡易
2020-11-07,1050,1181,1151,2332,南樹林,簡易
2020-11-08,1050,1133,1158,2291,南樹林,簡易
2020-11-09,1050,1187,1154,2341,南樹林,簡易
2020-11-10,1050,1182,1204,2386,南樹林,簡易
2020-11-11,1050,1267,1228,2495,南樹林,簡易
2020-11-12,1050,1208,1187,2395,南樹林,簡易
2020-11-13,1050,1312,1357,2669,南樹林,簡易
2020-11-14,1050,1265,1296,2561,南樹林,簡易
2020-11-15,1050,1332,1270,2602,南樹林,簡易
2020-11-16,1050,1226,1205,2431,南樹林,簡易
2020-11-17,1050,1259,1212,2471,南樹林,簡易
2020-11-18,1050,1285,1254,2539,南樹林,簡易
2020-11-19,1050,1305,1300,2605,南樹林,簡易
2020-11-20,1050,1307,1348,2655,南樹林,簡易
2020-11-21,1050,1130,1194,2324,南樹林,簡易
2020-11-22,1050,1124,1194,2318,南樹林,簡易
2020-11-23,1050,1153,1177,2330,南樹林,簡易
2020-11-24,1050,1232,1151,2383,南樹林,簡易
2020-11-25,1050,1220,1179,2399,南樹林,簡易
2020-11-26,1050,1182,1169,2351,南樹林,簡易
2020-11-27,1050,1290,1364,2654,南樹林,簡易
2020-11-28,1050,1062,1083,2145,南樹林,簡易
2020-11-29,1050,1117,1144,2261,南樹林,簡易
2020-11-30,1050,1149,1113,2262,南樹林,簡易
2020-12-01,1050,1209,1135,2344,南樹林,簡易
2020-12-02,1050,1189,1149,2338,南樹林,簡易
2020-12-03,1050,1138,1123,2261,南樹林,簡易
2020-12-04,1050,1283,1406,2689,南樹林,簡易
2020-12-05,1050,1224,1223,2447,南樹林,簡易
2020-12-06,1050,1184,1196,2380,南樹林,簡易
2020-12-07,1050,1198,1201,2399,南樹林,簡易
2020-12-08,1050,1215,1185,2400,南樹林,簡易
2020-12-09,1050,1174,1201,2375,南樹林,簡易
2020-12-10,1050,1191,1176,2367,南樹林,簡易
2020-12-11,1050,1335,1375,2710,南樹林,簡易
2020-12-12,1050,1304,1268,2572,南樹林,簡易
2020-12-13,1050,1274,1266,2540,南樹林,簡易
2020-12-14,1050,1266,1175,2441,南樹林,簡易
2020-12-15,1050,1187,1230,2417,南樹林,簡易
2020-12-16,1050,1172,1161,2333,南樹林,簡易
2020-12-17,1050,1207,1176,2383,南樹林,簡易
2020-12-18,1050,1297,1303,2600,南樹林,簡易
2020-12-19,1050,1155,1128,2283,南樹林,簡易
2020-12-20,1050,1087,1058,2145,南樹林,簡易
2020-12-21,1050,1225,1154,2379,南樹林,簡易
2020-12-22,1050,1245,1184,2429,南樹林,簡易
2020-12-23,1050,1110,1162,2272,南樹林,簡易
2020-12-24,1050,1159,1165,2324,南樹林,簡易
2020-12-25,1050,1298,1335,2633,南樹林,簡易
2020-12-26,1050,1110,1098,2208,南樹林,簡易
2020-12-27,1050,1085,1079,2164,南樹林,簡易
2020-12-28,1050,1210,1064,2274,南樹林,簡易
2020-12-29,1050,1245,1209,2454,南樹林,簡易
2020-12-30,1050,1179,1179,2358,南樹林,簡易
2020-12-31,1050,1381,1265,2646,南樹林,簡易
2020-01-01,1060,1558,1780,3338,山佳,三等
2020-01-02,1060,1621,1667,3288,山佳,三等
2020-01-03,1060,1654,1707,3361,山佳,三等
2020-01-04,1060,1627,1566,3193,山佳,三等
2020-01-05,1060,1600,1578,3178,山佳,三等
2020-01-06,1060,1668,1709,3377,山佳,三等
2020-01-07,1060,1681,1731,3412,山佳,三等
2020-01-08,1060,1605,1730,3335,山佳,三等
2020-01-09,1060,1612,1675,3287,山佳,三等
2020-01-10,1060,1760,1902,3662,山佳,三等
2020-01-11,1060,1805,1687,3492,山佳,三等
2020-01-12,1060,1589,1652,3241,山佳,三等
2020-01-13,1060,1621,1744,3365,山佳,三等
2020-01-14,1060,1648,1685,3333,山佳,三等
2020-01-15,1060,1459,1756,3215,山佳,三等
2020-01-16,1060,1700,1771,3471,山佳,三等
2020-01-17,1060,1610,1696,3306,山佳,三等
2020-01-18,1060,1546,1597,3143,山佳,三等
2020-01-19,1060,1501,1582,3083,山佳,三等
2020-01-20,1060,1693,1728,3421,山佳,三等
2020-01-21,1060,1628,1682,3310,山佳,三等
2020-01-22,1060,1715,1670,3385,山佳,三等
2020-01-23,1060,1468,1427,2895,山佳,三等
2020-01-24,1060,1376,1393,2769,山佳,三等
2020-01-25,1060,1715,1511,3226,山佳,三等
2020-01-26,1060,1399,1273,2672,山佳,三等
2020-01-27,1060,1552,1579,3131,山佳,三等
2020-01-28,1060,1479,1501,2980,山佳,三等
2020-01-29,1060,1242,1200,2442,山佳,三等
2020-01-30,1060,1373,1382,2755,山佳,三等
2020-01-31,1060,1468,1494,2962,山佳,三等
2020-02-01,1060,1275,1293,2568,山佳,三等
2020-02-02,1060,1297,1316,2613,山佳,三等
2020-02-03,1060,1465,1485,2950,山佳,三等
2020-02-04,1060,1369,1403,2772,山佳,三等
2020-02-05,1060,1400,1417,2817,山佳,三等
2020-02-06,1060,1407,1439,2846,山佳,三等
2020-02-07,1060,1513,1567,3080,山佳,三等
2020-02-08,1060,1319,1223,2542,山佳,三等
2020-02-09,1060,1312,1309,2621,山佳,三等
2020-02-10,1060,1471,1448,2919,山佳,三等
2020-02-11,1060,1425,1417,2842,山佳,三等
2020-02-12,1060,1447,1462,2909,山佳,三等
2020-02-13,1060,1377,1409,2786,山佳,三等
2020-02-14,1060,1495,1515,3010,山佳,三等
2020-02-15,1060,1498,1443,2941,山佳,三等
2020-02-16,1060,1163,1285,2448,山佳,三等
2020-02-17,1060,1399,1416,2815,山佳,三等
2020-02-18,1060,1351,1423,2774,山佳,三等
2020-02-19,1060,1425,1475,2900,山佳,三等
2020-02-20,1060,1485,1488,2973,山佳,三等
2020-02-21,1060,1529,1535,3064,山佳,三等
2020-02-22,1060,1241,1194,2435,山佳,三等
2020-02-23,1060,1332,1296,2628,山佳,三等
2020-02-24,1060,1503,1490,2993,山佳,三等
2020-02-25,1060,1533,1546,3079,山佳,三等
2020-02-26,1060,1269,1494,2763,山佳,三等
2020-02-27,1060,1520,1621,3141,山佳,三等
2020-02-28,1060,1300,1218,2518,山佳,三等
2020-02-29,1060,1212,1102,2314,山佳,三等
2020-03-01,1060,1156,1156,2312,山佳,三等
2020-03-02,1060,1499,1495,2994,山佳,三等
2020-03-03,1060,1467,1495,2962,山佳,三等
2020-03-04,1060,1433,1438,2871,山佳,三等
2020-03-05,1060,1395,1464,2859,山佳,三等
2020-03-06,1060,1556,1626,3182,山佳,三等
2020-03-07,1060,1262,1249,2511,山佳,三等
2020-03-08,1060,1245,1252,2497,山佳,三等
2020-03-09,1060,1521,1526,3047,山佳,三等
2020-03-10,1060,1373,1431,2804,山佳,三等
2020-03-11,1060,1448,1496,2944,山佳,三等
2020-03-12,1060,1480,1510,2990,山佳,三等
2020-03-13,1060,1492,1588,3080,山佳,三等
2020-03-14,1060,1206,1203,2409,山佳,三等
2020-03-15,1060,1396,1308,2704,山佳,三等
2020-03-16,1060,1487,1476,2963,山佳,三等
2020-03-17,1060,1441,1507,2948,山佳,三等
2020-03-18,1060,1380,1433,2813,山佳,三等
2020-03-19,1060,1336,1383,2719,山佳,三等
2020-03-20,1060,1498,1564,3062,山佳,三等
2020-03-21,1060,1156,1085,2241,山佳,三等
2020-03-22,1060,999,989,1988,山佳,三等
2020-03-23,1060,1400,1417,2817,山佳,三等
2020-03-24,1060,1351,1405,2756,山佳,三等
2020-03-25,1060,1343,1401,2744,山佳,三等
2020-03-26,1060,1323,1420,2743,山佳,三等
2020-03-27,1060,1371,1501,2872,山佳,三等
2020-03-28,1060,841,864,1705,山佳,三等
2020-03-29,1060,908,871,1779,山佳,三等
2020-03-30,1060,1370,1375,2745,山佳,三等
2020-03-31,1060,1276,1378,2654,山佳,三等
2020-04-01,1060,1300,1415,2715,山佳,三等
2020-04-02,1060,892,919,1811,山佳,三等
2020-04-03,1060,870,894,1764,山佳,三等
2020-04-04,1060,844,850,1694,山佳,三等
2020-04-05,1060,897,904,1801,山佳,三等
2020-04-06,1060,1334,1362,2696,山佳,三等
2020-04-07,1060,1322,1339,2661,山佳,三等
2020-04-08,1060,1273,1340,2613,山佳,三等
2020-04-09,1060,1264,1325,2589,山佳,三等
2020-04-10,1060,1355,1428,2783,山佳,三等
2020-04-11,1060,964,1008,1972,山佳,三等
2020-04-12,1060,896,935,1831,山佳,三等
2020-04-13,1060,1350,1394,2744,山佳,三等
2020-04-14,1060,1365,1368,2733,山佳,三等
2020-04-15,1060,1330,1347,2677,山佳,三等
2020-04-16,1060,1348,1408,2756,山佳,三等
2020-04-17,1060,1414,1549,2963,山佳,三等
2020-04-18,1060,1138,1165,2303,山佳,三等
2020-04-19,1060,1102,1082,2184,山佳,三等
2020-04-20,1060,1344,1382,2726,山佳,三等
2020-04-21,1060,1325,1374,2699,山佳,三等
2020-04-22,1060,1318,1364,2682,山佳,三等
2020-04-23,1060,1284,1346,2630,山佳,三等
2020-04-24,1060,1332,1432,2764,山佳,三等
2020-04-25,1060,994,936,1930,山佳,三等
2020-04-26,1060,958,926,1884,山佳,三等
2020-04-27,1060,1345,1378,2723,山佳,三等
2020-04-28,1060,1334,1410,2744,山佳,三等
2020-04-29,1060,1371,1372,2743,山佳,三等
2020-04-30,1060,1402,1423,2825,山佳,三等
2020-05-01,1060,1379,1407,2786,山佳,三等
2020-05-02,1060,1188,1230,2418,山佳,三等
2020-05-03,1060,1125,1043,2168,山佳,三等
2020-05-04,1060,1385,1406,2791,山佳,三等
2020-05-05,1060,1381,1402,2783,山佳,三等
2020-05-06,1060,1370,1439,2809,山佳,三等
2020-05-07,1060,1395,1434,2829,山佳,三等
2020-05-08,1060,1500,1601,3101,山佳,三等
2020-05-09,1060,1183,1192,2375,山佳,三等
2020-05-10,1060,1276,1273,2549,山佳,三等
2020-05-11,1060,1483,1490,2973,山佳,三等
2020-05-12,1060,1377,1471,2848,山佳,三等
2020-05-13,1060,1426,1467,2893,山佳,三等
2020-05-14,1060,1388,1413,2801,山佳,三等
2020-05-15,1060,1515,1663,3178,山佳,三等
2020-05-16,1060,1326,1265,2591,山佳,三等
2020-05-17,1060,1282,1225,2507,山佳,三等
2020-05-18,1060,1455,1498,2953,山佳,三等
2020-05-19,1060,1416,1440,2856,山佳,三等
2020-05-20,1060,1448,1500,2948,山佳,三等
2020-05-21,1060,1402,1452,2854,山佳,三等
2020-05-22,1060,1452,1508,2960,山佳,三等
2020-05-23,1060,1051,1025,2076,山佳,三等
2020-05-24,1060,1370,1407,2777,山佳,三等
2020-05-25,1060,1486,1508,2994,山佳,三等
2020-05-26,1060,1433,1495,2928,山佳,三等
2020-05-27,1060,1396,1474,2870,山佳,三等
2020-05-28,1060,1367,1379,2746,山佳,三等
2020-05-29,1060,1530,1631,3161,山佳,三等
2020-05-30,1060,1294,1273,2567,山佳,三等
2020-05-31,1060,1259,1235,2494,山佳,三等
2020-06-01,1060,1476,1491,2967,山佳,三等
2020-06-02,1060,1452,1548,3000,山佳,三等
2020-06-03,1060,1421,1489,2910,山佳,三等
2020-06-04,1060,1372,1465,2837,山佳,三等
2020-06-05,1060,1585,1668,3253,山佳,三等
2020-06-06,1060,1531,1488,3019,山佳,三等
2020-06-07,1060,1349,1340,2689,山佳,三等
2020-06-08,1060,1564,1557,3121,山佳,三等
2020-06-09,1060,1594,1546,3140,山佳,三等
2020-06-10,1060,1527,1529,3056,山佳,三等
2020-06-11,1060,1496,1533,3029,山佳,三等
2020-06-12,1060,1597,1659,3256,山佳,三等
2020-06-13,1060,1417,1429,2846,山佳,三等
2020-06-14,1060,1393,1416,2809,山佳,三等
2020-06-15,1060,1555,1591,3146,山佳,三等
2020-06-16,1060,1489,1503,2992,山佳,三等
2020-06-17,1060,1418,1489,2907,山佳,三等
2020-06-18,1060,1444,1490,2934,山佳,三等
2020-06-19,1060,1490,1559,3049,山佳,三等
2020-06-20,1060,1522,1539,3061,山佳,三等
2020-06-21,1060,1342,1423,2765,山佳,三等
2020-06-22,1060,1550,1576,3126,山佳,三等
2020-06-23,1060,1503,1514,3017,山佳,三等
2020-06-24,1060,1577,1624,3201,山佳,三等
2020-06-25,1060,1304,1291,2595,山佳,三等
2020-06-26,1060,1466,1466,2932,山佳,三等
2020-06-27,1060,1429,1316,2745,山佳,三等
2020-06-28,1060,1424,1436,2860,山佳,三等
2020-06-29,1060,1522,1523,3045,山佳,三等
2020-06-30,1060,1453,1487,2940,山佳,三等
2020-07-01,1060,1392,1439,2831,山佳,三等
2020-07-02,1060,1434,1478,2912,山佳,三等
2020-07-03,1060,1559,1560,3119,山佳,三等
2020-07-04,1060,1430,1390,2820,山佳,三等
2020-07-05,1060,1316,1365,2681,山佳,三等
2020-07-06,1060,1511,1591,3102,山佳,三等
2020-07-07,1060,1573,1560,3133,山佳,三等
2020-07-08,1060,1534,1520,3054,山佳,三等
2020-07-09,1060,1460,1513,2973,山佳,三等
2020-07-10,1060,1660,1659,3319,山佳,三等
2020-07-11,1060,1608,1495,3103,山佳,三等
2020-07-12,1060,1562,1610,3172,山佳,三等
2020-07-13,1060,1569,1593,3162,山佳,三等
2020-07-14,1060,1622,1673,3295,山佳,三等
2020-07-15,1060,1574,1549,3123,山佳,三等
2020-07-16,1060,1537,1518,3055,山佳,三等
2020-07-17,1060,1657,1683,3340,山佳,三等
2020-07-18,1060,1584,1478,3062,山佳,三等
2020-07-19,1060,1416,1413,2829,山佳,三等
2020-07-20,1060,1495,1558,3053,山佳,三等
2020-07-21,1060,1554,1562,3116,山佳,三等
2020-07-22,1060,1578,1565,3143,山佳,三等
2020-07-23,1060,1515,1511,3026,山佳,三等
2020-07-24,1060,1634,1614,3248,山佳,三等
2020-07-25,1060,1506,1392,2898,山佳,三等
2020-07-26,1060,1446,1422,2868,山佳,三等
2020-07-27,1060,1469,1489,2958,山佳,三等
2020-07-28,1060,1532,1493,3025,山佳,三等
2020-07-29,1060,1527,1503,3030,山佳,三等
2020-07-30,1060,1504,1486,2990,山佳,三等
2020-07-31,1060,1632,1633,3265,山佳,三等
2020-08-01,1060,1474,1494,2968,山佳,三等
2020-08-02,1060,1375,1429,2804,山佳,三等
2020-08-03,1060,1374,1417,2791,山佳,三等
2020-08-04,1060,1522,1491,3013,山佳,三等
2020-08-05,1060,1484,1509,2993,山佳,三等
2020-08-06,1060,1521,1510,3031,山佳,三等
2020-08-07,1060,1622,1570,3192,山佳,三等
2020-08-08,1060,1478,1437,2915,山佳,三等
2020-08-09,1060,1536,1560,3096,山佳,三等
2020-08-10,1060,1508,1553,3061,山佳,三等
2020-08-11,1060,1435,1463,2898,山佳,三等
2020-08-12,1060,1513,1549,3062,山佳,三等
2020-08-13,1060,1525,1506,3031,山佳,三等
2020-08-14,1060,1615,1646,3261,山佳,三等
2020-08-15,1060,1553,1445,2998,山佳,三等
2020-08-16,1060,1467,1523,2990,山佳,三等
2020-08-17,1060,1558,1540,3098,山佳,三等
2020-08-18,1060,1553,1584,3137,山佳,三等
2020-08-19,1060,1527,1542,3069,山佳,三等
2020-08-20,1060,1520,1561,3081,山佳,三等
2020-08-21,1060,1661,1706,3367,山佳,三等
2020-08-22,1060,1408,1384,2792,山佳,三等
2020-08-23,1060,1508,1496,3004,山佳,三等
2020-08-24,1060,1602,1561,3163,山佳,三等
2020-08-25,1060,1597,1611,3208,山佳,三等
2020-08-26,1060,1530,1529,3059,山佳,三等
2020-08-27,1060,1470,1468,2938,山佳,三等
2020-08-28,1060,1612,1616,3228,山佳,三等
2020-08-29,1060,1405,1435,2840,山佳,三等
2020-08-30,1060,1348,1345,2693,山佳,三等
2020-08-31,1060,1485,1500,2985,山佳,三等
2020-09-01,1060,1464,1445,2909,山佳,三等
2020-09-02,1060,1468,1542,3010,山佳,三等
2020-09-03,1060,1451,1493,2944,山佳,三等
2020-09-04,1060,1652,1699,3351,山佳,三等
2020-09-05,1060,1548,1468,3016,山佳,三等
2020-09-06,1060,1557,1560,3117,山佳,三等
2020-09-07,1060,1588,1629,3217,山佳,三等
2020-09-08,1060,1620,1588,3208,山佳,三等
2020-09-09,1060,1539,1634,3173,山佳,三等
2020-09-10,1060,1460,1561,3021,山佳,三等
2020-09-11,1060,1688,1734,3422,山佳,三等
2020-09-12,1060,1517,1513,3030,山佳,三等
2020-09-13,1060,1611,1495,3106,山佳,三等
2020-09-14,1060,1589,1617,3206,山佳,三等
2020-09-15,1060,1596,1642,3238,山佳,三等
2020-09-16,1060,1504,1560,3064,山佳,三等
2020-09-17,1060,1560,1561,3121,山佳,三等
2020-09-18,1060,1698,1767,3465,山佳,三等
2020-09-19,1060,1606,1548,3154,山佳,三等
2020-09-20,1060,1371,1321,2692,山佳,三等
2020-09-21,1060,1556,1597,3153,山佳,三等
2020-09-22,1060,1602,1613,3215,山佳,三等
2020-09-23,1060,1554,1595,3149,山佳,三等
2020-09-24,1060,1473,1551,3024,山佳,三等
2020-09-25,1060,1628,1636,3264,山佳,三等
2020-09-26,1060,1458,1555,3013,山佳,三等
2020-09-27,1060,1196,1264,2460,山佳,三等
2020-09-28,1060,1624,1593,3217,山佳,三等
2020-09-29,1060,1565,1614,3179,山佳,三等
2020-09-30,1060,1663,1736,3399,山佳,三等
2020-10-01,1060,1651,1619,3270,山佳,三等
2020-10-02,1060,1668,1692,3360,山佳,三等
2020-10-03,1060,1631,1662,3293,山佳,三等
2020-10-04,1060,1551,1503,3054,山佳,三等
2020-10-05,1060,1616,1611,3227,山佳,三等
2020-10-06,1060,1539,1578,3117,山佳,三等
2020-10-07,1060,1592,1647,3239,山佳,三等
2020-10-08,1060,1658,1825,3483,山佳,三等
2020-10-09,1060,1631,1678,3309,山佳,三等
2020-10-10,1060,1626,1613,3239,山佳,三等
2020-10-11,1060,1667,1651,3318,山佳,三等
2020-10-12,1060,1617,1566,3183,山佳,三等
2020-10-13,1060,1569,1605,3174,山佳,三等
2020-10-14,1060,1553,1657,3210,山佳,三等
2020-10-15,1060,1500,1584,3084,山佳,三等
2020-10-16,1060,1685,1753,3438,山佳,三等
2020-10-17,1060,1536,1523,3059,山佳,三等
2020-10-18,1060,1654,1546,3200,山佳,三等
2020-10-19,1060,1620,1567,3187,山佳,三等
2020-10-20,1060,1530,1576,3106,山佳,三等
2020-10-21,1060,1608,1627,3235,山佳,三等
2020-10-22,1060,1510,1569,3079,山佳,三等
2020-10-23,1060,1681,1794,3475,山佳,三等
2020-10-24,1060,1643,1527,3170,山佳,三等
2020-10-25,1060,1623,1642,3265,山佳,三等
2020-10-26,1060,1686,1674,3360,山佳,三等
2020-10-27,1060,1636,1639,3275,山佳,三等
2020-10-28,1060,1611,1651,3262,山佳,三等
2020-10-29,1060,1545,1579,3124,山佳,三等
2020-10-30,1060,1719,1808,3527,山佳,三等
2020-10-31,1060,1616,1656,3272,山佳,三等
2020-11-01,1060,1538,1474,3012,山佳,三等
2020-11-02,1060,1550,1616,3166,山佳,三等
2020-11-03,1060,1542,1605,3147,山佳,三等
2020-11-04,1060,1571,1652,3223,山佳,三等
2020-11-05,1060,1583,1645,3228,山佳,三等
2020-11-06,1060,1735,1873,3608,山佳,三等
2020-11-07,1060,1638,1640,3278,山佳,三等
2020-11-08,1060,1589,1616,3205,山佳,三等
2020-11-09,1060,1751,1770,3521,山佳,三等
2020-11-10,1060,1620,1667,3287,山佳,三等
2020-11-11,1060,1659,1712,3371,山佳,三等
2020-11-12,1060,1639,1663,3302,山佳,三等
2020-11-13,1060,1695,1809,3504,山佳,三等
2020-11-14,1060,1764,1722,3486,山佳,三等
2020-11-15,1060,1796,1681,3477,山佳,三等
2020-11-16,1060,1704,1686,3390,山佳,三等
2020-11-17,1060,1601,1627,3228,山佳,三等
2020-11-18,1060,1669,1695,3364,山佳,三等
2020-11-19,1060,1582,1630,3212,山佳,三等
2020-11-20,1060,1770,1872,3642,山佳,三等
2020-11-21,1060,1725,1689,3414,山佳,三等
2020-11-22,1060,1803,1725,3528,山佳,三等
2020-11-23,1060,1611,1586,3197,山佳,三等
2020-11-24,1060,1608,1621,3229,山佳,三等
2020-11-25,1060,1588,1710,3298,山佳,三等
2020-11-26,1060,1623,1651,3274,山佳,三等
2020-11-27,1060,1767,1901,3668,山佳,三等
2020-11-28,1060,1548,1562,3110,山佳,三等
2020-11-29,1060,1542,1519,3061,山佳,三等
2020-11-30,1060,1562,1582,3144,山佳,三等
2020-12-01,1060,1528,1519,3047,山佳,三等
2020-12-02,1060,1534,1575,3109,山佳,三等
2020-12-03,1060,1541,1621,3162,山佳,三等
2020-12-04,1060,1695,1830,3525,山佳,三等
2020-12-05,1060,1725,1695,3420,山佳,三等
2020-12-06,1060,1745,1632,3377,山佳,三等
2020-12-07,1060,1656,1742,3398,山佳,三等
2020-12-08,1060,1530,1595,3125,山佳,三等
2020-12-09,1060,1516,1635,3151,山佳,三等
2020-12-10,1060,1608,1561,3169,山佳,三等
2020-12-11,1060,1719,1821,3540,山佳,三等
2020-12-12,1060,1811,1805,3616,山佳,三等
2020-12-13,1060,1840,1755,3595,山佳,三等
2020-12-14,1060,1597,1557,3154,山佳,三等
2020-12-15,1060,1530,1604,3134,山佳,三等
2020-12-16,1060,1565,1583,3148,山佳,三等
2020-12-17,1060,1632,1658,3290,山佳,三等
2020-12-18,1060,1738,1821,3559,山佳,三等
2020-12-19,1060,1569,1491,3060,山佳,三等
2020-12-20,1060,1495,1504,2999,山佳,三等
2020-12-21,1060,1620,1610,3230,山佳,三等
2020-12-22,1060,1635,1701,3336,山佳,三等
2020-12-23,1060,1530,1630,3160,山佳,三等
2020-12-24,1060,1624,1650,3274,山佳,三等
2020-12-25,1060,1674,1782,3456,山佳,三等
2020-12-26,1060,1583,1513,3096,山佳,三等
2020-12-27,1060,1595,1495,3090,山佳,三等
2020-12-28,1060,1684,1677,3361,山佳,三等
2020-12-29,1060,1676,1684,3360,山佳,三等
2020-12-30,1060,1518,1494,3012,山佳,三等
2020-12-31,1060,1781,1733,3514,山佳,三等
2020-01-01,1070,8314,9315,17629,鶯歌,二等
2020-01-02,1070,9225,9198,18423,鶯歌,二等
2020-01-03,1070,9962,9903,19865,鶯歌,二等
2020-01-04,1070,8625,8644,17269,鶯歌,二等
2020-01-05,1070,8177,8038,16215,鶯歌,二等
2020-01-06,1070,9106,9103,18209,鶯歌,二等
2020-01-07,1070,8977,9025,18002,鶯歌,二等
2020-01-08,1070,8704,9221,17925,鶯歌,二等
2020-01-09,1070,9089,9374,18463,鶯歌,二等
2020-01-10,1070,10062,10431,20493,鶯歌,二等
2020-01-11,1070,8249,8099,16348,鶯歌,二等
2020-01-12,1070,8045,7688,15733,鶯歌,二等
2020-01-13,1070,8946,8871,17817,鶯歌,二等
2020-01-14,1070,9071,9231,18302,鶯歌,二等
2020-01-15,1070,8675,8987,17662,鶯歌,二等
2020-01-16,1070,9901,9741,19642,鶯歌,二等
2020-01-17,1070,8717,8913,17630,鶯歌,二等
2020-01-18,1070,7807,8019,15826,鶯歌,二等
2020-01-19,1070,7540,7591,15131,鶯歌,二等
2020-01-20,1070,9201,9073,18274,鶯歌,二等
2020-01-21,1070,9019,9048,18067,鶯歌,二等
2020-01-22,1070,9052,8950,18002,鶯歌,二等
2020-01-23,1070,6323,6309,12632,鶯歌,二等
2020-01-24,1070,4678,4757,9435,鶯歌,二等
2020-01-25,1070,6645,6217,12862,鶯歌,二等
2020-01-26,1070,5647,5472,11119,鶯歌,二等
2020-01-27,1070,7290,7361,14651,鶯歌,二等
2020-01-28,1070,7542,7497,15039,鶯歌,二等
2020-01-29,1070,6392,6400,12792,鶯歌,二等
2020-01-30,1070,7892,7862,15754,鶯歌,二等
2020-01-31,1070,8522,8149,16671,鶯歌,二等
2020-02-01,1070,6731,6803,13534,鶯歌,二等
2020-02-02,1070,6505,6738,13243,鶯歌,二等
2020-02-03,1070,8102,7949,16051,鶯歌,二等
2020-02-04,1070,7438,7381,14819,鶯歌,二等
2020-02-05,1070,7425,7502,14927,鶯歌,二等
2020-02-06,1070,7744,7809,15553,鶯歌,二等
2020-02-07,1070,7968,7762,15730,鶯歌,二等
2020-02-08,1070,5877,5982,11859,鶯歌,二等
2020-02-09,1070,6381,6273,12654,鶯歌,二等
2020-02-10,1070,7724,7642,15366,鶯歌,二等
2020-02-11,1070,7496,7583,15079,鶯歌,二等
2020-02-12,1070,7789,7716,15505,鶯歌,二等
2020-02-13,1070,7519,7580,15099,鶯歌,二等
2020-02-14,1070,8045,7988,16033,鶯歌,二等
2020-02-15,1070,7216,7177,14393,鶯歌,二等
2020-02-16,1070,6675,6503,13178,鶯歌,二等
2020-02-17,1070,7074,7218,14292,鶯歌,二等
2020-02-18,1070,7284,7499,14783,鶯歌,二等
2020-02-19,1070,7812,7811,15623,鶯歌,二等
2020-02-20,1070,7530,7604,15134,鶯歌,二等
2020-02-21,1070,8343,8269,16612,鶯歌,二等
2020-02-22,1070,6514,6577,13091,鶯歌,二等
2020-02-23,1070,6526,6301,12827,鶯歌,二等
2020-02-24,1070,7796,7567,15363,鶯歌,二等
2020-02-25,1070,8204,8342,16546,鶯歌,二等
2020-02-26,1070,7762,8121,15883,鶯歌,二等
2020-02-27,1070,8891,8964,17855,鶯歌,二等
2020-02-28,1070,6801,6579,13380,鶯歌,二等
2020-02-29,1070,5799,5780,11579,鶯歌,二等
2020-03-01,1070,5652,5328,10980,鶯歌,二等
2020-03-02,1070,8002,8168,16170,鶯歌,二等
2020-03-03,1070,7785,8067,15852,鶯歌,二等
2020-03-04,1070,7862,7921,15783,鶯歌,二等
2020-03-05,1070,7590,7827,15417,鶯歌,二等
2020-03-06,1070,8744,8993,17737,鶯歌,二等
2020-03-07,1070,6361,6460,12821,鶯歌,二等
2020-03-08,1070,6153,5896,12049,鶯歌,二等
2020-03-09,1070,8207,8265,16472,鶯歌,二等
2020-03-10,1070,7514,7798,15312,鶯歌,二等
2020-03-11,1070,8203,8383,16586,鶯歌,二等
2020-03-12,1070,7773,8068,15841,鶯歌,二等
2020-03-13,1070,8363,8617,16980,鶯歌,二等
2020-03-14,1070,5483,5540,11023,鶯歌,二等
2020-03-15,1070,6599,6343,12942,鶯歌,二等
2020-03-16,1070,8400,8378,16778,鶯歌,二等
2020-03-17,1070,7898,8075,15973,鶯歌,二等
2020-03-18,1070,7746,7922,15668,鶯歌,二等
2020-03-19,1070,7448,7632,15080,鶯歌,二等
2020-03-20,1070,8431,8580,17011,鶯歌,二等
2020-03-21,1070,5402,5412,10814,鶯歌,二等
2020-03-22,1070,5262,4990,10252,鶯歌,二等
2020-03-23,1070,7653,7707,15360,鶯歌,二等
2020-03-24,1070,7514,7724,15238,鶯歌,二等
2020-03-25,1070,7486,7664,15150,鶯歌,二等
2020-03-26,1070,7673,7740,15413,鶯歌,二等
2020-03-27,1070,8053,8327,16380,鶯歌,二等
2020-03-28,1070,4158,4069,8227,鶯歌,二等
2020-03-29,1070,4808,4540,9348,鶯歌,二等
2020-03-30,1070,7274,7466,14740,鶯歌,二等
2020-03-31,1070,7381,7622,15003,鶯歌,二等
2020-04-01,1070,7845,8049,15894,鶯歌,二等
2020-04-02,1070,4770,4631,9401,鶯歌,二等
2020-04-03,1070,4863,4892,9755,鶯歌,二等
2020-04-04,1070,3712,3678,7390,鶯歌,二等
2020-04-05,1070,4344,3918,8262,鶯歌,二等
2020-04-06,1070,7357,7390,14747,鶯歌,二等
2020-04-07,1070,7040,7270,14310,鶯歌,二等
2020-04-08,1070,7091,7390,14481,鶯歌,二等
2020-04-09,1070,7134,7252,14386,鶯歌,二等
2020-04-10,1070,7866,8186,16052,鶯歌,二等
2020-04-11,1070,4786,4848,9634,鶯歌,二等
2020-04-12,1070,4260,4069,8329,鶯歌,二等
2020-04-13,1070,7304,7334,14638,鶯歌,二等
2020-04-14,1070,7166,7410,14576,鶯歌,二等
2020-04-15,1070,7317,7506,14823,鶯歌,二等
2020-04-16,1070,7339,7468,14807,鶯歌,二等
2020-04-17,1070,7998,8247,16245,鶯歌,二等
2020-04-18,1070,5593,5561,11154,鶯歌,二等
2020-04-19,1070,5284,4919,10203,鶯歌,二等
2020-04-20,1070,7327,7531,14858,鶯歌,二等
2020-04-21,1070,7225,7379,14604,鶯歌,二等
2020-04-22,1070,7198,7343,14541,鶯歌,二等
2020-04-23,1070,7075,7377,14452,鶯歌,二等
2020-04-24,1070,7582,7884,15466,鶯歌,二等
2020-04-25,1070,4867,4876,9743,鶯歌,二等
2020-04-26,1070,4525,4344,8869,鶯歌,二等
2020-04-27,1070,7389,7437,14826,鶯歌,二等
2020-04-28,1070,7410,7643,15053,鶯歌,二等
2020-04-29,1070,7474,7675,15149,鶯歌,二等
2020-04-30,1070,7655,7935,15590,鶯歌,二等
2020-05-01,1070,7468,7657,15125,鶯歌,二等
2020-05-02,1070,5860,5888,11748,鶯歌,二等
2020-05-03,1070,5521,5160,10681,鶯歌,二等
2020-05-04,1070,7718,7741,15459,鶯歌,二等
2020-05-05,1070,7577,7924,15501,鶯歌,二等
2020-05-06,1070,7729,7870,15599,鶯歌,二等
2020-05-07,1070,7716,7887,15603,鶯歌,二等
2020-05-08,1070,8626,9017,17643,鶯歌,二等
2020-05-09,1070,6146,6238,12384,鶯歌,二等
2020-05-10,1070,5876,5467,11343,鶯歌,二等
2020-05-11,1070,7848,7839,15687,鶯歌,二等
2020-05-12,1070,7629,7842,15471,鶯歌,二等
2020-05-13,1070,7921,8136,16057,鶯歌,二等
2020-05-14,1070,7796,8070,15866,鶯歌,二等
2020-05-15,1070,8755,9048,17803,鶯歌,二等
2020-05-16,1070,6016,6021,12037,鶯歌,二等
2020-05-17,1070,5983,5660,11643,鶯歌,二等
2020-05-18,1070,7873,7954,15827,鶯歌,二等
2020-05-19,1070,7480,7737,15217,鶯歌,二等
2020-05-20,1070,7901,8050,15951,鶯歌,二等
2020-05-21,1070,7648,7981,15629,鶯歌,二等
2020-05-22,1070,7942,8386,16328,鶯歌,二等
2020-05-23,1070,5402,5429,10831,鶯歌,二等
2020-05-24,1070,6499,6344,12843,鶯歌,二等
2020-05-25,1070,8102,8159,16261,鶯歌,二等
2020-05-26,1070,7780,8019,15799,鶯歌,二等
2020-05-27,1070,7738,7904,15642,鶯歌,二等
2020-05-28,1070,7407,7661,15068,鶯歌,二等
2020-05-29,1070,8568,9052,17620,鶯歌,二等
2020-05-30,1070,6980,6732,13712,鶯歌,二等
2020-05-31,1070,6820,6554,13374,鶯歌,二等
2020-06-01,1070,8102,8064,16166,鶯歌,二等
2020-06-02,1070,7811,8243,16054,鶯歌,二等
2020-06-03,1070,8076,8226,16302,鶯歌,二等
2020-06-04,1070,7951,8051,16002,鶯歌,二等
2020-06-05,1070,8758,8950,17708,鶯歌,二等
2020-06-06,1070,7209,7210,14419,鶯歌,二等
2020-06-07,1070,6075,6011,12086,鶯歌,二等
2020-06-08,1070,8102,8075,16177,鶯歌,二等
2020-06-09,1070,8098,8229,16327,鶯歌,二等
2020-06-10,1070,8266,8518,16784,鶯歌,二等
2020-06-11,1070,8385,8505,16890,鶯歌,二等
2020-06-12,1070,8996,9228,18224,鶯歌,二等
2020-06-13,1070,7682,7575,15257,鶯歌,二等
2020-06-14,1070,6939,6551,13490,鶯歌,二等
2020-06-15,1070,8647,8483,17130,鶯歌,二等
2020-06-16,1070,8218,8318,16536,鶯歌,二等
2020-06-17,1070,8050,8208,16258,鶯歌,二等
2020-06-18,1070,8009,8198,16207,鶯歌,二等
2020-06-19,1070,8476,8766,17242,鶯歌,二等
2020-06-20,1070,7772,7812,15584,鶯歌,二等
2020-06-21,1070,6489,6465,12954,鶯歌,二等
2020-06-22,1070,8180,8224,16404,鶯歌,二等
2020-06-23,1070,8152,8255,16407,鶯歌,二等
2020-06-24,1070,8799,9001,17800,鶯歌,二等
2020-06-25,1070,6717,6652,13369,鶯歌,二等
2020-06-26,1070,8166,8006,16172,鶯歌,二等
2020-06-27,1070,7284,7195,14479,鶯歌,二等
2020-06-28,1070,6716,6496,13212,鶯歌,二等
2020-06-29,1070,8334,8249,16583,鶯歌,二等
2020-06-30,1070,8091,8240,16331,鶯歌,二等
2020-07-01,1070,7849,7941,15790,鶯歌,二等
2020-07-02,1070,7716,7785,15501,鶯歌,二等
2020-07-03,1070,8444,8545,16989,鶯歌,二等
2020-07-04,1070,7065,6990,14055,鶯歌,二等
2020-07-05,1070,6726,6657,13383,鶯歌,二等
2020-07-06,1070,7916,7992,15908,鶯歌,二等
2020-07-07,1070,7892,8131,16023,鶯歌,二等
2020-07-08,1070,8027,8179,16206,鶯歌,二等
2020-07-09,1070,8113,8220,16333,鶯歌,二等
2020-07-10,1070,9211,9245,18456,鶯歌,二等
2020-07-11,1070,7670,7361,15031,鶯歌,二等
2020-07-12,1070,7100,7267,14367,鶯歌,二等
2020-07-13,1070,8282,8192,16474,鶯歌,二等
2020-07-14,1070,8572,8602,17174,鶯歌,二等
2020-07-15,1070,8300,8248,16548,鶯歌,二等
2020-07-16,1070,8218,8170,16388,鶯歌,二等
2020-07-17,1070,8798,8699,17497,鶯歌,二等
2020-07-18,1070,7533,7256,14789,鶯歌,二等
2020-07-19,1070,6912,6900,13812,鶯歌,二等
2020-07-20,1070,8032,7962,15994,鶯歌,二等
2020-07-21,1070,8055,8045,16100,鶯歌,二等
2020-07-22,1070,8408,8503,16911,鶯歌,二等
2020-07-23,1070,8199,8131,16330,鶯歌,二等
2020-07-24,1070,8516,8626,17142,鶯歌,二等
2020-07-25,1070,7319,7101,14420,鶯歌,二等
2020-07-26,1070,6600,6730,13330,鶯歌,二等
2020-07-27,1070,7833,7966,15799,鶯歌,二等
2020-07-28,1070,8065,8025,16090,鶯歌,二等
2020-07-29,1070,8343,8420,16763,鶯歌,二等
2020-07-30,1070,8349,8269,16618,鶯歌,二等
2020-07-31,1070,8744,8601,17345,鶯歌,二等
2020-08-01,1070,7444,7501,14945,鶯歌,二等
2020-08-02,1070,6590,6476,13066,鶯歌,二等
2020-08-03,1070,6899,6965,13864,鶯歌,二等
2020-08-04,1070,7759,7881,15640,鶯歌,二等
2020-08-05,1070,8132,8025,16157,鶯歌,二等
2020-08-06,1070,8129,8260,16389,鶯歌,二等
2020-08-07,1070,8721,8756,17477,鶯歌,二等
2020-08-08,1070,6985,7040,14025,鶯歌,二等
2020-08-09,1070,7383,7170,14553,鶯歌,二等
2020-08-10,1070,7981,7981,15962,鶯歌,二等
2020-08-11,1070,7869,7884,15753,鶯歌,二等
2020-08-12,1070,8133,8207,16340,鶯歌,二等
2020-08-13,1070,8371,8305,16676,鶯歌,二等
2020-08-14,1070,8793,8805,17598,鶯歌,二等
2020-08-15,1070,7570,7650,15220,鶯歌,二等
2020-08-16,1070,7750,7686,15436,鶯歌,二等
2020-08-17,1070,8280,8272,16552,鶯歌,二等
2020-08-18,1070,8468,8333,16801,鶯歌,二等
2020-08-19,1070,8416,8633,17049,鶯歌,二等
2020-08-20,1070,8661,8544,17205,鶯歌,二等
2020-08-21,1070,8939,8739,17678,鶯歌,二等
2020-08-22,1070,7406,7168,14574,鶯歌,二等
2020-08-23,1070,6800,6865,13665,鶯歌,二等
2020-08-24,1070,8330,8220,16550,鶯歌,二等
2020-08-25,1070,8333,8350,16683,鶯歌,二等
2020-08-26,1070,8276,8383,16659,鶯歌,二等
2020-08-27,1070,8040,7989,16029,鶯歌,二等
2020-08-28,1070,8224,8156,16380,鶯歌,二等
2020-08-29,1070,7106,6913,14019,鶯歌,二等
2020-08-30,1070,6451,6512,12963,鶯歌,二等
2020-08-31,1070,7994,8245,16239,鶯歌,二等
2020-09-01,1070,7731,7900,15631,鶯歌,二等
2020-09-02,1070,8050,8036,16086,鶯歌,二等
2020-09-03,1070,8165,8508,16673,鶯歌,二等
2020-09-04,1070,9068,9092,18160,鶯歌,二等
2020-09-05,1070,7407,7260,14667,鶯歌,二等
2020-09-06,1070,7171,7343,14514,鶯歌,二等
2020-09-07,1070,8615,8593,17208,鶯歌,二等
2020-09-08,1070,8710,8805,17515,鶯歌,二等
2020-09-09,1070,8325,8534,16859,鶯歌,二等
2020-09-10,1070,8471,8482,16953,鶯歌,二等
2020-09-11,1070,9094,9341,18435,鶯歌,二等
2020-09-12,1070,7732,7556,15288,鶯歌,二等
2020-09-13,1070,7175,7108,14283,鶯歌,二等
2020-09-14,1070,8775,8768,17543,鶯歌,二等
2020-09-15,1070,8703,8754,17457,鶯歌,二等
2020-09-16,1070,8555,8646,17201,鶯歌,二等
2020-09-17,1070,8615,8661,17276,鶯歌,二等
2020-09-18,1070,9590,9681,19271,鶯歌,二等
2020-09-19,1070,8096,7861,15957,鶯歌,二等
2020-09-20,1070,6855,6918,13773,鶯歌,二等
2020-09-21,1070,8628,8572,17200,鶯歌,二等
2020-09-22,1070,8667,8806,17473,鶯歌,二等
2020-09-23,1070,8692,8854,17546,鶯歌,二等
2020-09-24,1070,8490,8820,17310,鶯歌,二等
2020-09-25,1070,8941,9126,18067,鶯歌,二等
2020-09-26,1070,7832,8244,16076,鶯歌,二等
2020-09-27,1070,6170,5995,12165,鶯歌,二等
2020-09-28,1070,8489,8441,16930,鶯歌,二等
2020-09-29,1070,8667,8812,17479,鶯歌,二等
2020-09-30,1070,9564,9990,19554,鶯歌,二等
2020-10-01,1070,7939,8052,15991,鶯歌,二等
2020-10-02,1070,9003,8812,17815,鶯歌,二等
2020-10-03,1070,8027,8074,16101,鶯歌,二等
2020-10-04,1070,7472,7153,14625,鶯歌,二等
2020-10-05,1070,8542,8546,17088,鶯歌,二等
2020-10-06,1070,8497,8701,17198,鶯歌,二等
2020-10-07,1070,8651,8758,17409,鶯歌,二等
2020-10-08,1070,9613,9700,19313,鶯歌,二等
2020-10-09,1070,8832,8777,17609,鶯歌,二等
2020-10-10,1070,8557,8382,16939,鶯歌,二等
2020-10-11,1070,8090,7963,16053,鶯歌,二等
2020-10-12,1070,8674,8711,17385,鶯歌,二等
2020-10-13,1070,8628,8826,17454,鶯歌,二等
2020-10-14,1070,8714,8826,17540,鶯歌,二等
2020-10-15,1070,8547,8720,17267,鶯歌,二等
2020-10-16,1070,9578,9805,19383,鶯歌,二等
2020-10-17,1070,8101,7862,15963,鶯歌,二等
2020-10-18,1070,7872,7874,15746,鶯歌,二等
2020-10-19,1070,8561,8492,17053,鶯歌,二等
2020-10-20,1070,8715,8704,17419,鶯歌,二等
2020-10-21,1070,8957,9039,17996,鶯歌,二等
2020-10-22,1070,8353,8449,16802,鶯歌,二等
2020-10-23,1070,9506,9738,19244,鶯歌,二等
2020-10-24,1070,8027,7858,15885,鶯歌,二等
2020-10-25,1070,7696,7413,15109,鶯歌,二等
2020-10-26,1070,8811,8842,17653,鶯歌,二等
2020-10-27,1070,8749,8920,17669,鶯歌,二等
2020-10-28,1070,8828,8911,17739,鶯歌,二等
2020-10-29,1070,8500,8661,17161,鶯歌,二等
2020-10-30,1070,9616,9735,19351,鶯歌,二等
2020-10-31,1070,8226,8082,16308,鶯歌,二等
2020-11-01,1070,7918,7756,15674,鶯歌,二等
2020-11-02,1070,8620,8563,17183,鶯歌,二等
2020-11-03,1070,8346,8492,16838,鶯歌,二等
2020-11-04,1070,8705,8826,17531,鶯歌,二等
2020-11-05,1070,8717,8813,17530,鶯歌,二等
2020-11-06,1070,9671,9802,19473,鶯歌,二等
2020-11-07,1070,8100,8078,16178,鶯歌,二等
2020-11-08,1070,7503,7364,14867,鶯歌,二等
2020-11-09,1070,8913,8933,17846,鶯歌,二等
2020-11-10,1070,8600,8721,17321,鶯歌,二等
2020-11-11,1070,9043,9107,18150,鶯歌,二等
2020-11-12,1070,8768,8855,17623,鶯歌,二等
2020-11-13,1070,9499,9544,19043,鶯歌,二等
2020-11-14,1070,8622,8546,17168,鶯歌,二等
2020-11-15,1070,8497,8453,16950,鶯歌,二等
2020-11-16,1070,9187,9124,18311,鶯歌,二等
2020-11-17,1070,8938,9029,17967,鶯歌,二等
2020-11-18,1070,9080,9208,18288,鶯歌,二等
2020-11-19,1070,8844,8900,17744,鶯歌,二等
2020-11-20,1070,9956,10078,20034,鶯歌,二等
2020-11-21,1070,8547,8568,17115,鶯歌,二等
2020-11-22,1070,8683,8447,17130,鶯歌,二等
2020-11-23,1070,8866,8819,17685,鶯歌,二等
2020-11-24,1070,8770,8861,17631,鶯歌,二等
2020-11-25,1070,8965,8971,17936,鶯歌,二等
2020-11-26,1070,9000,9080,18080,鶯歌,二等
2020-11-27,1070,9876,10020,19896,鶯歌,二等
2020-11-28,1070,7853,7858,15711,鶯歌,二等
2020-11-29,1070,7280,7384,14664,鶯歌,二等
2020-11-30,1070,8687,8775,17462,鶯歌,二等
2020-12-01,1070,8270,8342,16612,鶯歌,二等
2020-12-02,1070,8436,8485,16921,鶯歌,二等
2020-12-03,1070,8366,8589,16955,鶯歌,二等
2020-12-04,1070,9484,9678,19162,鶯歌,二等
2020-12-05,1070,8374,8394,16768,鶯歌,二等
2020-12-06,1070,8213,8074,16287,鶯歌,二等
2020-12-07,1070,8801,8773,17574,鶯歌,二等
2020-12-08,1070,8496,8675,17171,鶯歌,二等
2020-12-09,1070,8227,8308,16535,鶯歌,二等
2020-12-10,1070,8523,8635,17158,鶯歌,二等
2020-12-11,1070,9712,9895,19607,鶯歌,二等
2020-12-12,1070,9066,8868,17934,鶯歌,二等
2020-12-13,1070,8718,8398,17116,鶯歌,二等
2020-12-14,1070,8784,8643,17427,鶯歌,二等
2020-12-15,1070,8508,7942,16450,鶯歌,二等
2020-12-16,1070,8468,8658,17126,鶯歌,二等
2020-12-17,1070,8741,8852,17593,鶯歌,二等
2020-12-18,1070,9858,9936,19794,鶯歌,二等
2020-12-19,1070,7703,7765,15468,鶯歌,二等
2020-12-20,1070,7799,7542,15341,鶯歌,二等
2020-12-21,1070,8557,8472,17029,鶯歌,二等
2020-12-22,1070,8687,8778,17465,鶯歌,二等
2020-12-23,1070,8477,8560,17037,鶯歌,二等
2020-12-24,1070,8501,8547,17048,鶯歌,二等
2020-12-25,1070,9903,9860,19763,鶯歌,二等
2020-12-26,1070,8154,8035,16189,鶯歌,二等
2020-12-27,1070,7060,6981,14041,鶯歌,二等
2020-12-28,1070,8772,8794,17566,鶯歌,二等
2020-12-29,1070,8678,8798,17476,鶯歌,二等
2020-12-30,1070,8257,8315,16572,鶯歌,二等
2020-12-31,1070,9578,9009,18587,鶯歌,二等
2020-01-01,1080,29182,32516,61698,桃園,一等
2020-01-02,1080,27625,27826,55451,桃園,一等
2020-01-03,1080,29675,31098,60773,桃園,一等
2020-01-04,1080,27715,28774,56489,桃園,一等
2020-01-05,1080,30877,31111,61988,桃園,一等
2020-01-06,1080,27632,27868,55500,桃園,一等
2020-01-07,1080,26549,27305,53854,桃園,一等
2020-01-08,1080,26022,27386,53408,桃園,一等
2020-01-09,1080,29086,29560,58646,桃園,一等
2020-01-10,1080,32845,35962,68807,桃園,一等
2020-01-11,1080,30575,32686,63261,桃園,一等
2020-01-12,1080,34339,33849,68188,桃園,一等
2020-01-13,1080,28389,28443,56832,桃園,一等
2020-01-14,1080,26972,27829,54801,桃園,一等
2020-01-15,1080,26804,27882,54686,桃園,一等
2020-01-16,1080,29114,30832,59946,桃園,一等
2020-01-17,1080,29017,30603,59620,桃園,一等
2020-01-18,1080,28039,29573,57612,桃園,一等
2020-01-19,1080,29796,30313,60109,桃園,一等
2020-01-20,1080,29688,30091,59779,桃園,一等
2020-01-21,1080,30138,29867,60005,桃園,一等
2020-01-22,1080,31362,30981,62343,桃園,一等
2020-01-23,1080,26381,25213,51594,桃園,一等
2020-01-24,1080,24327,23137,47464,桃園,一等
2020-01-25,1080,25984,26432,52416,桃園,一等
2020-01-26,1080,25163,25903,51066,桃園,一等
2020-01-27,1080,26149,26754,52903,桃園,一等
2020-01-28,1080,24309,26156,50465,桃園,一等
2020-01-29,1080,20195,22760,42955,桃園,一等
2020-01-30,1080,24080,25150,49230,桃園,一等
2020-01-31,1080,25758,26563,52321,桃園,一等
2020-02-01,1080,22202,23280,45482,桃園,一等
2020-02-02,1080,23803,22040,45843,桃園,一等
2020-02-03,1080,25681,25729,51410,桃園,一等
2020-02-04,1080,23030,23528,46558,桃園,一等
2020-02-05,1080,23489,23950,47439,桃園,一等
2020-02-06,1080,25157,25402,50559,桃園,一等
2020-02-07,1080,26011,26466,52477,桃園,一等
2020-02-08,1080,22976,23136,46112,桃園,一等
2020-02-09,1080,25977,26517,52494,桃園,一等
2020-02-10,1080,25244,25405,50649,桃園,一等
2020-02-11,1080,24252,24518,48770,桃園,一等
2020-02-12,1080,24298,25023,49321,桃園,一等
2020-02-13,1080,23624,24071,47695,桃園,一等
2020-02-14,1080,27126,27395,54521,桃園,一等
2020-02-15,1080,25784,26737,52521,桃園,一等
2020-02-16,1080,24586,24704,49290,桃園,一等
2020-02-17,1080,23646,23541,47187,桃園,一等
2020-02-18,1080,22697,23488,46185,桃園,一等
2020-02-19,1080,23627,24154,47781,桃園,一等
2020-02-20,1080,23549,24536,48085,桃園,一等
2020-02-21,1080,26896,27449,54345,桃園,一等
2020-02-22,1080,22681,23631,46312,桃園,一等
2020-02-23,1080,24750,25099,49849,桃園,一等
2020-02-24,1080,24232,24296,48528,桃園,一等
2020-02-25,1080,23523,24270,47793,桃園,一等
2020-02-26,1080,23409,24270,47679,桃園,一等
2020-02-27,1080,27151,28085,55236,桃園,一等
2020-02-28,1080,22885,22474,45359,桃園,一等
2020-02-29,1080,20025,20962,40987,桃園,一等
2020-03-01,1080,22225,23067,45292,桃園,一等
2020-03-02,1080,23263,23560,46823,桃園,一等
2020-03-03,1080,22184,23083,45267,桃園,一等
2020-03-04,1080,21821,22678,44499,桃園,一等
2020-03-05,1080,21471,22486,43957,桃園,一等
2020-03-06,1080,27320,28673,55993,桃園,一等
2020-03-07,1080,21829,22331,44160,桃園,一等
2020-03-08,1080,24274,24000,48274,桃園,一等
2020-03-09,1080,23751,24272,48023,桃園,一等
2020-03-10,1080,21473,22086,43559,桃園,一等
2020-03-11,1080,23393,24439,47832,桃園,一等
2020-03-12,1080,22743,23660,46403,桃園,一等
2020-03-13,1080,25950,27398,53348,桃園,一等
2020-03-14,1080,21074,22251,43325,桃園,一等
2020-03-15,1080,25592,25434,51026,桃園,一等
2020-03-16,1080,24064,24645,48709,桃園,一等
2020-03-17,1080,22515,23425,45940,桃園,一等
2020-03-18,1080,21809,22797,44606,桃園,一等
2020-03-19,1080,21139,22174,43313,桃園,一等
2020-03-20,1080,25696,27227,52923,桃園,一等
2020-03-21,1080,18717,19095,37812,桃園,一等
2020-03-22,1080,19392,19542,38934,桃園,一等
2020-03-23,1080,21715,22430,44145,桃園,一等
2020-03-24,1080,20706,21431,42137,桃園,一等
2020-03-25,1080,20785,21672,42457,桃園,一等
2020-03-26,1080,20931,21869,42800,桃園,一等
2020-03-27,1080,24067,25401,49468,桃園,一等
2020-03-28,1080,15367,15471,30838,桃園,一等
2020-03-29,1080,16452,17290,33742,桃園,一等
2020-03-30,1080,20853,21524,42377,桃園,一等
2020-03-31,1080,21381,21660,43041,桃園,一等
2020-04-01,1080,24025,25211,49236,桃園,一等
2020-04-02,1080,16095,15306,31401,桃園,一等
2020-04-03,1080,15941,15075,31016,桃園,一等
2020-04-04,1080,12796,14350,27146,桃園,一等
2020-04-05,1080,16940,17226,34166,桃園,一等
2020-04-06,1080,20677,22569,43246,桃園,一等
2020-04-07,1080,19452,20182,39634,桃園,一等
2020-04-08,1080,19770,20359,40129,桃園,一等
2020-04-09,1080,19491,20520,40011,桃園,一等
2020-04-10,1080,23011,24269,47280,桃園,一等
2020-04-11,1080,16288,16889,33177,桃園,一等
2020-04-12,1080,17552,17499,35051,桃園,一等
2020-04-13,1080,20775,21538,42313,桃園,一等
2020-04-14,1080,20086,20614,40700,桃園,一等
2020-04-15,1080,20131,21123,41254,桃園,一等
2020-04-16,1080,20578,21303,41881,桃園,一等
2020-04-17,1080,23925,25616,49541,桃園,一等
2020-04-18,1080,18791,19396,38187,桃園,一等
2020-04-19,1080,19595,19748,39343,桃園,一等
2020-04-20,1080,21137,21484,42621,桃園,一等
2020-04-21,1080,19144,19891,39035,桃園,一等
2020-04-22,1080,19393,20091,39484,桃園,一等
2020-04-23,1080,19210,20193,39403,桃園,一等
2020-04-24,1080,22515,23688,46203,桃園,一等
2020-04-25,1080,15602,16118,31720,桃園,一等
2020-04-26,1080,16164,16389,32553,桃園,一等
2020-04-27,1080,20424,21104,41528,桃園,一等
2020-04-28,1080,20099,20929,41028,桃園,一等
2020-04-29,1080,20274,21173,41447,桃園,一等
2020-04-30,1080,22437,22928,45365,桃園,一等
2020-05-01,1080,22108,22939,45047,桃園,一等
2020-05-02,1080,17664,18522,36186,桃園,一等
2020-05-03,1080,19391,20136,39527,桃園,一等
2020-05-04,1080,21449,22337,43786,桃園,一等
2020-05-05,1080,21045,21763,42808,桃園,一等
2020-05-06,1080,21256,22089,43345,桃園,一等
2020-05-07,1080,21493,22609,44102,桃園,一等
2020-05-08,1080,26667,28330,54997,桃園,一等
2020-05-09,1080,21970,22582,44552,桃園,一等
2020-05-10,1080,23964,23583,47547,桃園,一等
2020-05-11,1080,23045,23529,46574,桃園,一等
2020-05-12,1080,21217,21911,43128,桃園,一等
2020-05-13,1080,22095,23048,45143,桃園,一等
2020-05-14,1080,22244,22822,45066,桃園,一等
2020-05-15,1080,27702,29652,57354,桃園,一等
2020-05-16,1080,20995,21209,42204,桃園,一等
2020-05-17,1080,22078,23018,45096,桃園,一等
2020-05-18,1080,22269,22540,44809,桃園,一等
2020-05-19,1080,20452,21221,41673,桃園,一等
2020-05-20,1080,22082,22954,45036,桃園,一等
2020-05-21,1080,21444,19378,40822,桃園,一等
2020-05-22,1080,24028,25284,49312,桃園,一等
2020-05-23,1080,19514,20157,39671,桃園,一等
2020-05-24,1080,25064,25431,50495,桃園,一等
2020-05-25,1080,22931,23618,46549,桃園,一等
2020-05-26,1080,22313,22840,45153,桃園,一等
2020-05-27,1080,21525,22318,43843,桃園,一等
2020-05-28,1080,21126,21877,43003,桃園,一等
2020-05-29,1080,26624,27713,54337,桃園,一等
2020-05-30,1080,23227,23880,47107,桃園,一等
2020-05-31,1080,24288,25022,49310,桃園,一等
2020-06-01,1080,23692,23921,47613,桃園,一等
2020-06-02,1080,22309,23298,45607,桃園,一等
2020-06-03,1080,22709,23788,46497,桃園,一等
2020-06-04,1080,22626,23425,46051,桃園,一等
2020-06-05,1080,27049,28553,55602,桃園,一等
2020-06-06,1080,25964,26752,52716,桃園,一等
2020-06-07,1080,25796,25646,51442,桃園,一等
2020-06-08,1080,23712,24236,47948,桃園,一等
2020-06-09,1080,22785,23955,46740,桃園,一等
2020-06-10,1080,23873,24907,48780,桃園,一等
2020-06-11,1080,24499,24963,49462,桃園,一等
2020-06-12,1080,27928,28991,56919,桃園,一等
2020-06-13,1080,26748,29257,56005,桃園,一等
2020-06-14,1080,30009,29492,59501,桃園,一等
2020-06-15,1080,24894,25940,50834,桃園,一等
2020-06-16,1080,24201,24976,49177,桃園,一等
2020-06-17,1080,23234,24922,48156,桃園,一等
2020-06-18,1080,24380,25086,49466,桃園,一等
2020-06-19,1080,26194,26623,52817,桃園,一等
2020-06-20,1080,25633,26555,52188,桃園,一等
2020-06-21,1080,25522,25479,51001,桃園,一等
2020-06-22,1080,24773,23816,48589,桃園,一等
2020-06-23,1080,24430,24989,49419,桃園,一等
2020-06-24,1080,28789,29592,58381,桃園,一等
2020-06-25,1080,24317,23537,47854,桃園,一等
2020-06-26,1080,24990,25815,50805,桃園,一等
2020-06-27,1080,24556,26860,51416,桃園,一等
2020-06-28,1080,26337,27500,53837,桃園,一等
2020-06-29,1080,25647,26652,52299,桃園,一等
2020-06-30,1080,24105,25013,49118,桃園,一等
2020-07-01,1080,23764,23953,47717,桃園,一等
2020-07-02,1080,23047,23713,46760,桃園,一等
2020-07-03,1080,26913,27792,54705,桃園,一等
2020-07-04,1080,24748,25270,50018,桃園,一等
2020-07-05,1080,26289,27140,53429,桃園,一等
2020-07-06,1080,24670,25932,50602,桃園,一等
2020-07-07,1080,24406,25203,49609,桃園,一等
2020-07-08,1080,24517,25089,49606,桃園,一等
2020-07-09,1080,24109,24969,49078,桃園,一等
2020-07-10,1080,28710,29447,58157,桃園,一等
2020-07-11,1080,26942,28340,55282,桃園,一等
2020-07-12,1080,29546,29717,59263,桃園,一等
2020-07-13,1080,26432,26524,52956,桃園,一等
2020-07-14,1080,26177,27461,53638,桃園,一等
2020-07-15,1080,26801,27193,53994,桃園,一等
2020-07-16,1080,26472,26662,53134,桃園,一等
2020-07-17,1080,29701,30030,59731,桃園,一等
2020-07-18,1080,27175,28527,55702,桃園,一等
2020-07-19,1080,28929,29219,58148,桃園,一等
2020-07-20,1080,26015,26193,52208,桃園,一等
2020-07-21,1080,24590,25304,49894,桃園,一等
2020-07-22,1080,25536,26040,51576,桃園,一等
2020-07-23,1080,25236,26122,51358,桃園,一等
2020-07-24,1080,28552,28830,57382,桃園,一等
2020-07-25,1080,26049,27091,53140,桃園,一等
2020-07-26,1080,27146,27265,54411,桃園,一等
2020-07-27,1080,24850,25572,50422,桃園,一等
2020-07-28,1080,24353,24776,49129,桃園,一等
2020-07-29,1080,24431,24929,49360,桃園,一等
2020-07-30,1080,24353,25294,49647,桃園,一等
2020-07-31,1080,28178,28823,57001,桃園,一等
2020-08-01,1080,24843,25654,50497,桃園,一等
2020-08-02,1080,24064,24110,48174,桃園,一等
2020-08-03,1080,21587,22569,44156,桃園,一等
2020-08-04,1080,23325,24272,47597,桃園,一等
2020-08-05,1080,24425,25096,49521,桃園,一等
2020-08-06,1080,25500,26162,51662,桃園,一等
2020-08-07,1080,29520,30167,59687,桃園,一等
2020-08-08,1080,24169,25370,49539,桃園,一等
2020-08-09,1080,29517,29434,58951,桃園,一等
2020-08-10,1080,25651,26141,51792,桃園,一等
2020-08-11,1080,23550,24294,47844,桃園,一等
2020-08-12,1080,25573,26027,51600,桃園,一等
2020-08-13,1080,25857,26729,52586,桃園,一等
2020-08-14,1080,29412,29810,59222,桃園,一等
2020-08-15,1080,28376,29324,57700,桃園,一等
2020-08-16,1080,30422,30792,61214,桃園,一等
2020-08-17,1080,26953,27294,54247,桃園,一等
2020-08-18,1080,26047,26846,52893,桃園,一等
2020-08-19,1080,25865,24328,50193,桃園,一等
2020-08-20,1080,26048,26827,52875,桃園,一等
2020-08-21,1080,29825,30513,60338,桃園,一等
2020-08-22,1080,26453,27005,53458,桃園,一等
2020-08-23,1080,27729,28368,56097,桃園,一等
2020-08-24,1080,26554,26988,53542,桃園,一等
2020-08-25,1080,26340,27148,53488,桃園,一等
2020-08-26,1080,25909,26398,52307,桃園,一等
2020-08-27,1080,25438,26061,51499,桃園,一等
2020-08-28,1080,28220,28828,57048,桃園,一等
2020-08-29,1080,25174,25859,51033,桃園,一等
2020-08-30,1080,24614,25906,50520,桃園,一等
2020-08-31,1080,24231,24514,48745,桃園,一等
2020-09-01,1080,22984,23539,46523,桃園,一等
2020-09-02,1080,23008,22900,45908,桃園,一等
2020-09-03,1080,23803,25025,48828,桃園,一等
2020-09-04,1080,28156,28924,57080,桃園,一等
2020-09-05,1080,26525,27510,54035,桃園,一等
2020-09-06,1080,28401,28625,57026,桃園,一等
2020-09-07,1080,25998,26454,52452,桃園,一等
2020-09-08,1080,25172,25782,50954,桃園,一等
2020-09-09,1080,25014,26101,51115,桃園,一等
2020-09-10,1080,24933,26095,51028,桃園,一等
2020-09-11,1080,29914,30868,60782,桃園,一等
2020-09-12,1080,28298,29500,57798,桃園,一等
2020-09-13,1080,31391,31710,63101,桃園,一等
2020-09-14,1080,25697,26414,52111,桃園,一等
2020-09-15,1080,24672,25458,50130,桃園,一等
2020-09-16,1080,24495,25596,50091,桃園,一等
2020-09-17,1080,24887,25772,50659,桃園,一等
2020-09-18,1080,29974,31627,61601,桃園,一等
2020-09-19,1080,27956,28912,56868,桃園,一等
2020-09-20,1080,28695,28311,57006,桃園,一等
2020-09-21,1080,25328,26111,51439,桃園,一等
2020-09-22,1080,24754,26043,50797,桃園,一等
2020-09-23,1080,25291,26361,51652,桃園,一等
2020-09-24,1080,24801,26076,50877,桃園,一等
2020-09-25,1080,27662,28900,56562,桃園,一等
2020-09-26,1080,26355,28342,54697,桃園,一等
2020-09-27,1080,24269,24460,48729,桃園,一等
2020-09-28,1080,25017,25208,50225,桃園,一等
2020-09-29,1080,25308,25711,51019,桃園,一等
2020-09-30,1080,31157,33476,64633,桃園,一等
2020-10-01,1080,27904,27669,55573,桃園,一等
2020-10-02,1080,27897,26813,54710,桃園,一等
2020-10-03,1080,27422,27685,55107,桃園,一等
2020-10-04,1080,29728,29497,59225,桃園,一等
2020-10-05,1080,25554,26663,52217,桃園,一等
2020-10-06,1080,24720,25902,50622,桃園,一等
2020-10-07,1080,24935,26020,50955,桃園,一等
2020-10-08,1080,30361,31621,61982,桃園,一等
2020-10-09,1080,29201,29202,58403,桃園,一等
2020-10-10,1080,28716,30072,58788,桃園,一等
2020-10-11,1080,32603,32473,65076,桃園,一等
2020-10-12,1080,26014,27243,53257,桃園,一等
2020-10-13,1080,24839,25874,50713,桃園,一等
2020-10-14,1080,25334,26398,51732,桃園,一等
2020-10-15,1080,25342,26669,52011,桃園,一等
2020-10-16,1080,30475,32039,62514,桃園,一等
2020-10-17,1080,28123,29333,57456,桃園,一等
2020-10-18,1080,32053,31940,63993,桃園,一等
2020-10-19,1080,25542,26751,52293,桃園,一等
2020-10-20,1080,25160,24951,50111,桃園,一等
2020-10-21,1080,24995,26116,51111,桃園,一等
2020-10-22,1080,24678,25620,50298,桃園,一等
2020-10-23,1080,30035,31494,61529,桃園,一等
2020-10-24,1080,28402,29130,57532,桃園,一等
2020-10-25,1080,30606,30747,61353,桃園,一等
2020-10-26,1080,25902,27421,53323,桃園,一等
2020-10-27,1080,25137,26197,51334,桃園,一等
2020-10-28,1080,25142,25964,51106,桃園,一等
2020-10-29,1080,24820,26078,50898,桃園,一等
2020-10-30,1080,30443,32268,62711,桃園,一等
2020-10-31,1080,28090,28794,56884,桃園,一等
2020-11-01,1080,28692,29088,57780,桃園,一等
2020-11-02,1080,25574,25558,51132,桃園,一等
2020-11-03,1080,24007,24801,48808,桃園,一等
2020-11-04,1080,24559,25700,50259,桃園,一等
2020-11-05,1080,25480,26394,51874,桃園,一等
2020-11-06,1080,30749,32042,62791,桃園,一等
2020-11-07,1080,29368,30277,59645,桃園,一等
2020-11-08,1080,31807,31673,63480,桃園,一等
2020-11-09,1080,26468,27339,53807,桃園,一等
2020-11-10,1080,25101,25925,51026,桃園,一等
2020-11-11,1080,26368,26778,53146,桃園,一等
2020-11-12,1080,26284,27081,53365,桃園,一等
2020-11-13,1080,30443,32439,62882,桃園,一等
2020-11-14,1080,30666,32489,63155,桃園,一等
2020-11-15,1080,35565,36196,71761,桃園,一等
2020-11-16,1080,26616,27592,54208,桃園,一等
2020-11-17,1080,25730,26731,52461,桃園,一等
2020-11-18,1080,25864,26748,52612,桃園,一等
2020-11-19,1080,26114,27259,53373,桃園,一等
2020-11-20,1080,31536,33124,64660,桃園,一等
2020-11-21,1080,30723,31664,62387,桃園,一等
2020-11-22,1080,33216,33214,66430,桃園,一等
2020-11-23,1080,26443,24712,51155,桃園,一等
2020-11-24,1080,25349,26428,51777,桃園,一等
2020-11-25,1080,25850,26744,52594,桃園,一等
2020-11-26,1080,26367,27279,53646,桃園,一等
2020-11-27,1080,30867,32492,63359,桃園,一等
2020-11-28,1080,28346,28824,57170,桃園,一等
2020-11-29,1080,29419,26447,55866,桃園,一等
2020-11-30,1080,24918,26596,51514,桃園,一等
2020-12-01,1080,23542,24711,48253,桃園,一等
2020-12-02,1080,24490,25371,49861,桃園,一等
2020-12-03,1080,24105,25259,49364,桃園,一等
2020-12-04,1080,30532,32080,62612,桃園,一等
2020-12-05,1080,31096,32048,63144,桃園,一等
2020-12-06,1080,32354,32634,64988,桃園,一等
2020-12-07,1080,25869,26830,52699,桃園,一等
2020-12-08,1080,24612,25776,50388,桃園,一等
2020-12-09,1080,23976,25259,49235,桃園,一等
2020-12-10,1080,25276,26709,51985,桃園,一等
2020-12-11,1080,31424,33307,64731,桃園,一等
2020-12-12,1080,34841,35833,70674,桃園,一等
2020-12-13,1080,36476,36501,72977,桃園,一等
2020-12-14,1080,26322,27371,53693,桃園,一等
2020-12-15,1080,24883,25890,50773,桃園,一等
2020-12-16,1080,25042,25942,50984,桃園,一等
2020-12-17,1080,26251,26951,53202,桃園,一等
2020-12-18,1080,31582,32706,64288,桃園,一等
2020-12-19,1080,30751,31667,62418,桃園,一等
2020-12-20,1080,32250,32025,64275,桃園,一等
2020-12-21,1080,25673,26483,52156,桃園,一等
2020-12-22,1080,25427,26332,51759,桃園,一等
2020-12-23,1080,23977,25001,48978,桃園,一等
2020-12-24,1080,25306,26580,51886,桃園,一等
2020-12-25,1080,31135,32428,63563,桃園,一等
2020-12-26,1080,28140,29137,57277,桃園,一等
2020-12-27,1080,28316,28233,56549,桃園,一等
2020-12-28,1080,25410,26447,51857,桃園,一等
2020-12-29,1080,25108,25845,50953,桃園,一等
2020-12-30,1080,24673,25314,49987,桃園,一等
2020-12-31,1080,32645,32116,64761,桃園,一等
2020-01-01,1090,7684,9783,17467,內壢,三等
2020-01-02,1090,9696,9546,19242,內壢,三等
2020-01-03,1090,10587,10147,20734,內壢,三等
2020-01-04,1090,8961,8764,17725,內壢,三等
2020-01-05,1090,8194,8357,16551,內壢,三等
2020-01-06,1090,9745,9454,19199,內壢,三等
2020-01-07,1090,9611,9468,19079,內壢,三等
2020-01-08,1090,9483,9378,18861,內壢,三等
2020-01-09,1090,10320,10120,20440,內壢,三等
2020-01-10,1090,11869,11595,23464,內壢,三等
2020-01-11,1090,9212,9022,18234,內壢,三等
2020-01-12,1090,8692,8681,17373,內壢,三等
2020-01-13,1090,9710,9659,19369,內壢,三等
2020-01-14,1090,9669,9305,18974,內壢,三等
2020-01-15,1090,9197,9274,18471,內壢,三等
2020-01-16,1090,10584,10172,20756,內壢,三等
2020-01-17,1090,9839,9700,19539,內壢,三等
2020-01-18,1090,8695,8628,17323,內壢,三等
2020-01-19,1090,7997,8240,16237,內壢,三等
2020-01-20,1090,9364,9192,18556,內壢,三等
2020-01-21,1090,9200,9259,18459,內壢,三等
2020-01-22,1090,9133,9222,18355,內壢,三等
2020-01-23,1090,6976,6716,13692,內壢,三等
2020-01-24,1090,5811,5713,11524,內壢,三等
2020-01-25,1090,5984,6000,11984,內壢,三等
2020-01-26,1090,5585,5783,11368,內壢,三等
2020-01-27,1090,6136,6280,12416,內壢,三等
2020-01-28,1090,6356,6571,12927,內壢,三等
2020-01-29,1090,5841,5663,11504,內壢,三等
2020-01-30,1090,7527,7382,14909,內壢,三等
2020-01-31,1090,8184,8141,16325,內壢,三等
2020-02-01,1090,6616,6897,13513,內壢,三等
2020-02-02,1090,6530,6776,13306,內壢,三等
2020-02-03,1090,8247,8109,16356,內壢,三等
2020-02-04,1090,7654,7597,15251,內壢,三等
2020-02-05,1090,7673,7611,15284,內壢,三等
2020-02-06,1090,7803,7945,15748,內壢,三等
2020-02-07,1090,8314,8228,16542,內壢,三等
2020-02-08,1090,6613,6585,13198,內壢,三等
2020-02-09,1090,6911,7180,14091,內壢,三等
2020-02-10,1090,8114,7962,16076,內壢,三等
2020-02-11,1090,7846,7868,15714,內壢,三等
2020-02-12,1090,8091,7985,16076,內壢,三等
2020-02-13,1090,7768,7722,15490,內壢,三等
2020-02-14,1090,8914,8542,17456,內壢,三等
2020-02-15,1090,7655,7588,15243,內壢,三等
2020-02-16,1090,5868,6246,12114,內壢,三等
2020-02-17,1090,7542,7362,14904,內壢,三等
2020-02-18,1090,7745,7746,15491,內壢,三等
2020-02-19,1090,8209,7970,16179,內壢,三等
2020-02-20,1090,7752,7804,15556,內壢,三等
2020-02-21,1090,8880,8691,17571,內壢,三等
2020-02-22,1090,6700,6647,13347,內壢,三等
2020-02-23,1090,6614,6687,13301,內壢,三等
2020-02-24,1090,7929,7795,15724,內壢,三等
2020-02-25,1090,8718,8332,17050,內壢,三等
2020-02-26,1090,8672,8471,17143,內壢,三等
2020-02-27,1090,9597,9488,19085,內壢,三等
2020-02-28,1090,6781,6675,13456,內壢,三等
2020-02-29,1090,5873,6126,11999,內壢,三等
2020-03-01,1090,6118,6366,12484,內壢,三等
2020-03-02,1090,8919,8627,17546,內壢,三等
2020-03-03,1090,8667,8358,17025,內壢,三等
2020-03-04,1090,8592,8276,16868,內壢,三等
2020-03-05,1090,8438,8158,16596,內壢,三等
2020-03-06,1090,10632,9618,20250,內壢,三等
2020-03-07,1090,6772,6747,13519,內壢,三等
2020-03-08,1090,6723,7154,13877,內壢,三等
2020-03-09,1090,8938,8763,17701,內壢,三等
2020-03-10,1090,8256,7912,16168,內壢,三等
2020-03-11,1090,8929,8539,17468,內壢,三等
2020-03-12,1090,8758,8459,17217,內壢,三等
2020-03-13,1090,9995,9249,19244,內壢,三等
2020-03-14,1090,6606,6554,13160,內壢,三等
2020-03-15,1090,7068,7553,14621,內壢,三等
2020-03-16,1090,8989,8747,17736,內壢,三等
2020-03-17,1090,8551,8294,16845,內壢,三等
2020-03-18,1090,8488,8061,16549,內壢,三等
2020-03-19,1090,8216,7917,16133,內壢,三等
2020-03-20,1090,9918,9128,19046,內壢,三等
2020-03-21,1090,5956,5847,11803,內壢,三等
2020-03-22,1090,5684,6005,11689,內壢,三等
2020-03-23,1090,8313,8104,16417,內壢,三等
2020-03-24,1090,7843,7620,15463,內壢,三等
2020-03-25,1090,8162,7797,15959,內壢,三等
2020-03-26,1090,8097,7872,15969,內壢,三等
2020-03-27,1090,9260,8543,17803,內壢,三等
2020-03-28,1090,4709,4799,9508,內壢,三等
2020-03-29,1090,5226,5474,10700,內壢,三等
2020-03-30,1090,7949,7846,15795,內壢,三等
2020-03-31,1090,7944,7623,15567,內壢,三等
2020-04-01,1090,9554,8603,18157,內壢,三等
2020-04-02,1090,5201,4992,10193,內壢,三等
2020-04-03,1090,4563,4457,9020,內壢,三等
2020-04-04,1090,3845,4064,7909,內壢,三等
2020-04-05,1090,4684,5231,9915,內壢,三等
2020-04-06,1090,7884,7848,15732,內壢,三等
2020-04-07,1090,7449,7391,14840,內壢,三等
2020-04-08,1090,7737,7549,15286,內壢,三等
2020-04-09,1090,7650,7386,15036,內壢,三等
2020-04-10,1090,9075,8501,17576,內壢,三等
2020-04-11,1090,5286,5207,10493,內壢,三等
2020-04-12,1090,4893,5213,10106,內壢,三等
2020-04-13,1090,8013,7926,15939,內壢,三等
2020-04-14,1090,7732,7555,15287,內壢,三等
2020-04-15,1090,7895,7604,15499,內壢,三等
2020-04-16,1090,8108,7692,15800,內壢,三等
2020-04-17,1090,9335,8787,18122,內壢,三等
2020-04-18,1090,6066,6109,12175,內壢,三等
2020-04-19,1090,6110,6296,12406,內壢,三等
2020-04-20,1090,8128,7957,16085,內壢,三等
2020-04-21,1090,7469,7288,14757,內壢,三等
2020-04-22,1090,7690,7395,15085,內壢,三等
2020-04-23,1090,7524,7355,14879,內壢,三等
2020-04-24,1090,8443,8169,16612,內壢,三等
2020-04-25,1090,5112,5168,10280,內壢,三等
2020-04-26,1090,5087,5055,10142,內壢,三等
2020-04-27,1090,7945,7747,15692,內壢,三等
2020-04-28,1090,7713,7528,15241,內壢,三等
2020-04-29,1090,7874,7617,15491,內壢,三等
2020-04-30,1090,8580,8203,16783,內壢,三等
2020-05-01,1090,8675,7924,16599,內壢,三等
2020-05-02,1090,5940,6028,11968,內壢,三等
2020-05-03,1090,5880,6396,12276,內壢,三等
2020-05-04,1090,8337,8147,16484,內壢,三等
2020-05-05,1090,8132,7920,16052,內壢,三等
2020-05-06,1090,8250,7959,16209,內壢,三等
2020-05-07,1090,8377,8165,16542,內壢,三等
2020-05-08,1090,10328,9520,19848,內壢,三等
2020-05-09,1090,6753,6932,13685,內壢,三等
2020-05-10,1090,6629,7053,13682,內壢,三等
2020-05-11,1090,8558,8565,17123,內壢,三等
2020-05-12,1090,8104,7465,15569,內壢,三等
2020-05-13,1090,8654,8402,17056,內壢,三等
2020-05-14,1090,8548,8230,16778,內壢,三等
2020-05-15,1090,10642,9913,20555,內壢,三等
2020-05-16,1090,6510,6478,12988,內壢,三等
2020-05-17,1090,6435,6770,13205,內壢,三等
2020-05-18,1090,8289,8178,16467,內壢,三等
2020-05-19,1090,7793,7770,15563,內壢,三等
2020-05-20,1090,8399,8152,16551,內壢,三等
2020-05-21,1090,7969,8029,15998,內壢,三等
2020-05-22,1090,9271,8649,17920,內壢,三等
2020-05-23,1090,6043,6141,12184,內壢,三等
2020-05-24,1090,7140,7571,14711,內壢,三等
2020-05-25,1090,8701,8580,17281,內壢,三等
2020-05-26,1090,8311,8127,16438,內壢,三等
2020-05-27,1090,8086,7973,16059,內壢,三等
2020-05-28,1090,7964,7938,15902,內壢,三等
2020-05-29,1090,9950,9320,19270,內壢,三等
2020-05-30,1090,7582,7624,15206,內壢,三等
2020-05-31,1090,6878,7270,14148,內壢,三等
2020-06-01,1090,8773,8815,17588,內壢,三等
2020-06-02,1090,8319,8186,16505,內壢,三等
2020-06-03,1090,8526,8256,16782,內壢,三等
2020-06-04,1090,8410,8412,16822,內壢,三等
2020-06-05,1090,10214,9430,19644,內壢,三等
2020-06-06,1090,7599,7415,15014,內壢,三等
2020-06-07,1090,6635,7161,13796,內壢,三等
2020-06-08,1090,8503,8483,16986,內壢,三等
2020-06-09,1090,8609,8430,17039,內壢,三等
2020-06-10,1090,8985,8720,17705,內壢,三等
2020-06-11,1090,9007,8705,17712,內壢,三等
2020-06-12,1090,10462,9910,20372,內壢,三等
2020-06-13,1090,8399,8520,16919,內壢,三等
2020-06-14,1090,7347,7730,15077,內壢,三等
2020-06-15,1090,9133,9025,18158,內壢,三等
2020-06-16,1090,8697,8598,17295,內壢,三等
2020-06-17,1090,8454,8368,16822,內壢,三等
2020-06-18,1090,8755,8469,17224,內壢,三等
2020-06-19,1090,9425,8925,18350,內壢,三等
2020-06-20,1090,8089,8080,16169,內壢,三等
2020-06-21,1090,6904,7211,14115,內壢,三等
2020-06-22,1090,8563,8604,17167,內壢,三等
2020-06-23,1090,8601,8496,17097,內壢,三等
2020-06-24,1090,10330,9516,19846,內壢,三等
2020-06-25,1090,7250,6912,14162,內壢,三等
2020-06-26,1090,7383,7109,14492,內壢,三等
2020-06-27,1090,6832,7133,13965,內壢,三等
2020-06-28,1090,6521,7168,13689,內壢,三等
2020-06-29,1090,8941,9115,18056,內壢,三等
2020-06-30,1090,8828,8670,17498,內壢,三等
2020-07-01,1090,8772,8486,17258,內壢,三等
2020-07-02,1090,8481,8322,16803,內壢,三等
2020-07-03,1090,9469,9388,18857,內壢,三等
2020-07-04,1090,7457,7547,15004,內壢,三等
2020-07-05,1090,7033,7186,14219,內壢,三等
2020-07-06,1090,8593,8601,17194,內壢,三等
2020-07-07,1090,8540,8421,16961,內壢,三等
2020-07-08,1090,8688,8539,17227,內壢,三等
2020-07-09,1090,8781,8587,17368,內壢,三等
2020-07-10,1090,9906,9696,19602,內壢,三等
2020-07-11,1090,7594,7742,15336,內壢,三等
2020-07-12,1090,7417,7542,14959,內壢,三等
2020-07-13,1090,8866,8732,17598,內壢,三等
2020-07-14,1090,9243,9076,18319,內壢,三等
2020-07-15,1090,8973,8662,17635,內壢,三等
2020-07-16,1090,8623,8297,16920,內壢,三等
2020-07-17,1090,9466,9231,18697,內壢,三等
2020-07-18,1090,7839,7807,15646,內壢,三等
2020-07-19,1090,7665,7829,15494,內壢,三等
2020-07-20,1090,8425,8420,16845,內壢,三等
2020-07-21,1090,8529,8276,16805,內壢,三等
2020-07-22,1090,8776,8548,17324,內壢,三等
2020-07-23,1090,8715,8472,17187,內壢,三等
2020-07-24,1090,9230,9008,18238,內壢,三等
2020-07-25,1090,7727,7561,15288,內壢,三等
2020-07-26,1090,7217,7259,14476,內壢,三等
2020-07-27,1090,8326,8346,16672,內壢,三等
2020-07-28,1090,8282,8288,16570,內壢,三等
2020-07-29,1090,8476,8330,16806,內壢,三等
2020-07-30,1090,8554,8397,16951,內壢,三等
2020-07-31,1090,9257,9082,18339,內壢,三等
2020-08-01,1090,7465,7740,15205,內壢,三等
2020-08-02,1090,6810,7024,13834,內壢,三等
2020-08-03,1090,7547,7610,15157,內壢,三等
2020-08-04,1090,8774,8444,17218,內壢,三等
2020-08-05,1090,9093,8651,17744,內壢,三等
2020-08-06,1090,8888,8774,17662,內壢,三等
2020-08-07,1090,9814,9602,19416,內壢,三等
2020-08-08,1090,7404,7352,14756,內壢,三等
2020-08-09,1090,7560,7800,15360,內壢,三等
2020-08-10,1090,8666,8690,17356,內壢,三等
2020-08-11,1090,8321,8240,16561,內壢,三等
2020-08-12,1090,9046,8596,17642,內壢,三等
2020-08-13,1090,8929,8704,17633,內壢,三等
2020-08-14,1090,9929,9675,19604,內壢,三等
2020-08-15,1090,8258,8299,16557,內壢,三等
2020-08-16,1090,7869,7847,15716,內壢,三等
2020-08-17,1090,9223,9050,18273,內壢,三等
2020-08-18,1090,9147,8982,18129,內壢,三等
2020-08-19,1090,9312,9224,18536,內壢,三等
2020-08-20,1090,8922,8726,17648,內壢,三等
2020-08-21,1090,9633,9386,19019,內壢,三等
2020-08-22,1090,7750,7683,15433,內壢,三等
2020-08-23,1090,7579,7851,15430,內壢,三等
2020-08-24,1090,8620,8481,17101,內壢,三等
2020-08-25,1090,8685,8702,17387,內壢,三等
2020-08-26,1090,8756,8616,17372,內壢,三等
2020-08-27,1090,8527,8443,16970,內壢,三等
2020-08-28,1090,9029,8961,17990,內壢,三等
2020-08-29,1090,7427,7465,14892,內壢,三等
2020-08-30,1090,6939,7183,14122,內壢,三等
2020-08-31,1090,8851,8644,17495,內壢,三等
2020-09-01,1090,8750,8440,17190,內壢,三等
2020-09-02,1090,8777,8521,17298,內壢,三等
2020-09-03,1090,8829,8518,17347,內壢,三等
2020-09-04,1090,10024,9524,19548,內壢,三等
2020-09-05,1090,7785,7745,15530,內壢,三等
2020-09-06,1090,7677,7855,15532,內壢,三等
2020-09-07,1090,9654,9266,18920,內壢,三等
2020-09-08,1090,9253,8812,18065,內壢,三等
2020-09-09,1090,9310,8947,18257,內壢,三等
2020-09-10,1090,9439,9037,18476,內壢,三等
2020-09-11,1090,10830,10276,21106,內壢,三等
2020-09-12,1090,8295,8224,16519,內壢,三等
2020-09-13,1090,8198,8593,16791,內壢,三等
2020-09-14,1090,9505,9314,18819,內壢,三等
2020-09-15,1090,9435,9020,18455,內壢,三等
2020-09-16,1090,9489,8988,18477,內壢,三等
2020-09-17,1090,9472,9052,18524,內壢,三等
2020-09-18,1090,11492,10542,22034,內壢,三等
2020-09-19,1090,8475,8544,17019,內壢,三等
2020-09-20,1090,7514,8199,15713,內壢,三等
2020-09-21,1090,9515,9282,18797,內壢,三等
2020-09-22,1090,9528,9097,18625,內壢,三等
2020-09-23,1090,9616,9161,18777,內壢,三等
2020-09-24,1090,9247,8986,18233,內壢,三等
2020-09-25,1090,10486,9926,20412,內壢,三等
2020-09-26,1090,9325,9119,18444,內壢,三等
2020-09-27,1090,7032,7367,14399,內壢,三等
2020-09-28,1090,9326,8987,18313,內壢,三等
2020-09-29,1090,9609,9182,18791,內壢,三等
2020-09-30,1090,11947,10808,22755,內壢,三等
2020-10-01,1090,8355,8068,16423,內壢,三等
2020-10-02,1090,7876,7842,15718,內壢,三等
2020-10-03,1090,7612,7761,15373,內壢,三等
2020-10-04,1090,7646,8318,15964,內壢,三等
2020-10-05,1090,9515,9329,18844,內壢,三等
2020-10-06,1090,9219,9004,18223,內壢,三等
2020-10-07,1090,9442,9024,18466,內壢,三等
2020-10-08,1090,11386,10488,21874,內壢,三等
2020-10-09,1090,8946,8386,17332,內壢,三等
2020-10-10,1090,7750,8040,15790,內壢,三等
2020-10-11,1090,7940,8594,16534,內壢,三等
2020-10-12,1090,9602,9435,19037,內壢,三等
2020-10-13,1090,9315,9034,18349,內壢,三等
2020-10-14,1090,9762,9285,19047,內壢,三等
2020-10-15,1090,9744,9292,19036,內壢,三等
2020-10-16,1090,11439,10455,21894,內壢,三等
2020-10-17,1090,8926,8695,17621,內壢,三等
2020-10-18,1090,8364,8933,17297,內壢,三等
2020-10-19,1090,9740,9457,19197,內壢,三等
2020-10-20,1090,9358,9071,18429,內壢,三等
2020-10-21,1090,9584,9137,18721,內壢,三等
2020-10-22,1090,9394,9035,18429,內壢,三等
2020-10-23,1090,11478,10583,22061,內壢,三等
2020-10-24,1090,8715,8510,17225,內壢,三等
2020-10-25,1090,8252,8783,17035,內壢,三等
2020-10-26,1090,9669,9513,19182,內壢,三等
2020-10-27,1090,9543,9212,18755,內壢,三等
2020-10-28,1090,9477,8970,18447,內壢,三等
2020-10-29,1090,9413,9018,18431,內壢,三等
2020-10-30,1090,11644,10646,22290,內壢,三等
2020-10-31,1090,10570,9963,20533,內壢,三等
2020-11-01,1090,8232,8805,17037,內壢,三等
2020-11-02,1090,9691,9498,19189,內壢,三等
2020-11-03,1090,9170,8829,17999,內壢,三等
2020-11-04,1090,9395,9022,18417,內壢,三等
2020-11-05,1090,9642,9265,18907,內壢,三等
2020-11-06,1090,11272,10616,21888,內壢,三等
2020-11-07,1090,8889,9076,17965,內壢,三等
2020-11-08,1090,8261,8432,16693,內壢,三等
2020-11-09,1090,9658,9315,18973,內壢,三等
2020-11-10,1090,9593,9137,18730,內壢,三等
2020-11-11,1090,9664,9379,19043,內壢,三等
2020-11-12,1090,9898,9311,19209,內壢,三等
2020-11-13,1090,11809,10732,22541,內壢,三等
2020-11-14,1090,9338,9159,18497,內壢,三等
2020-11-15,1090,9569,10244,19813,內壢,三等
2020-11-16,1090,10011,9830,19841,內壢,三等
2020-11-17,1090,9769,9482,19251,內壢,三等
2020-11-18,1090,9675,9426,19101,內壢,三等
2020-11-19,1090,10014,9642,19656,內壢,三等
2020-11-20,1090,12047,10915,22962,內壢,三等
2020-11-21,1090,9451,9219,18670,內壢,三等
2020-11-22,1090,8836,9582,18418,內壢,三等
2020-11-23,1090,9471,9395,18866,內壢,三等
2020-11-24,1090,9754,9404,19158,內壢,三等
2020-11-25,1090,9820,9438,19258,內壢,三等
2020-11-26,1090,9967,9533,19500,內壢,三等
2020-11-27,1090,11883,10931,22814,內壢,三等
2020-11-28,1090,8551,8362,16913,內壢,三等
2020-11-29,1090,8074,8678,16752,內壢,三等
2020-11-30,1090,9459,9425,18884,內壢,三等
2020-12-01,1090,9063,8795,17858,內壢,三等
2020-12-02,1090,9472,9093,18565,內壢,三等
2020-12-03,1090,9468,9034,18502,內壢,三等
2020-12-04,1090,11473,10634,22107,內壢,三等
2020-12-05,1090,10015,9684,19699,內壢,三等
2020-12-06,1090,9174,9574,18748,內壢,三等
2020-12-07,1090,9635,9426,19061,內壢,三等
2020-12-08,1090,9331,9076,18407,內壢,三等
2020-12-09,1090,9111,8940,18051,內壢,三等
2020-12-10,1090,9696,9362,19058,內壢,三等
2020-12-11,1090,11859,10874,22733,內壢,三等
2020-12-12,1090,10254,9915,20169,內壢,三等
2020-12-13,1090,9178,9858,19036,內壢,三等
2020-12-14,1090,9844,9505,19349,內壢,三等
2020-12-15,1090,9421,9073,18494,內壢,三等
2020-12-16,1090,9567,9093,18660,內壢,三等
2020-12-17,1090,9917,9467,19384,內壢,三等
2020-12-18,1090,12002,10814,22816,內壢,三等
2020-12-19,1090,9176,9127,18303,內壢,三等
2020-12-20,1090,8890,9505,18395,內壢,三等
2020-12-21,1090,9826,9502,19328,內壢,三等
2020-12-22,1090,9660,9305,18965,內壢,三等
2020-12-23,1090,9390,9048,18438,內壢,三等
2020-12-24,1090,9684,9192,18876,內壢,三等
2020-12-25,1090,11907,10751,22658,內壢,三等
2020-12-26,1090,8694,8828,17522,內壢,三等
2020-12-27,1090,8023,8463,16486,內壢,三等
2020-12-28,1090,9646,9365,19011,內壢,三等
2020-12-29,1090,9566,9187,18753,內壢,三等
2020-12-30,1090,9431,8912,18343,內壢,三等
2020-12-31,1090,11700,9893,21593,內壢,三等
2020-01-01,1100,29229,33242,62471,中壢,一等
2020-01-02,1100,24362,24753,49115,中壢,一等
2020-01-03,1100,28381,28310,56691,中壢,一等
2020-01-04,1100,28799,29356,58155,中壢,一等
2020-01-05,1100,32324,32827,65151,中壢,一等
2020-01-06,1100,23998,25274,49272,中壢,一等
2020-01-07,1100,23360,23668,47028,中壢,一等
2020-01-08,1100,23371,24169,47540,中壢,一等
2020-01-09,1100,25815,25732,51547,中壢,一等
2020-01-10,1100,32632,32395,65027,中壢,一等
2020-01-11,1100,31654,32410,64064,中壢,一等
2020-01-12,1100,35024,35263,70287,中壢,一等
2020-01-13,1100,25122,25989,51111,中壢,一等
2020-01-14,1100,23876,24559,48435,中壢,一等
2020-01-15,1100,24593,24457,49050,中壢,一等
2020-01-16,1100,27925,28662,56587,中壢,一等
2020-01-17,1100,26734,26703,53437,中壢,一等
2020-01-18,1100,27572,28297,55869,中壢,一等
2020-01-19,1100,29947,31022,60969,中壢,一等
2020-01-20,1100,26219,26220,52439,中壢,一等
2020-01-21,1100,26197,25564,51761,中壢,一等
2020-01-22,1100,28270,27513,55783,中壢,一等
2020-01-23,1100,25149,25212,50361,中壢,一等
2020-01-24,1100,23634,22936,46570,中壢,一等
2020-01-25,1100,24851,24309,49160,中壢,一等
2020-01-26,1100,24454,25231,49685,中壢,一等
2020-01-27,1100,24458,24777,49235,中壢,一等
2020-01-28,1100,23457,23424,46881,中壢,一等
2020-01-29,1100,21078,20872,41950,中壢,一等
2020-01-30,1100,21472,22355,43827,中壢,一等
2020-01-31,1100,23531,23775,47306,中壢,一等
2020-02-01,1100,22179,22764,44943,中壢,一等
2020-02-02,1100,23244,26046,49290,中壢,一等
2020-02-03,1100,25281,23593,48874,中壢,一等
2020-02-04,1100,19388,19620,39008,中壢,一等
2020-02-05,1100,20441,20865,41306,中壢,一等
2020-02-06,1100,21821,22310,44131,中壢,一等
2020-02-07,1100,23429,23184,46613,中壢,一等
2020-02-08,1100,23127,23693,46820,中壢,一等
2020-02-09,1100,27690,29170,56860,中壢,一等
2020-02-10,1100,22567,22965,45532,中壢,一等
2020-02-11,1100,21294,21681,42975,中壢,一等
2020-02-12,1100,22053,22122,44175,中壢,一等
2020-02-13,1100,20300,20595,40895,中壢,一等
2020-02-14,1100,24042,23868,47910,中壢,一等
2020-02-15,1100,23423,23925,47348,中壢,一等
2020-02-16,1100,24485,25030,49515,中壢,一等
2020-02-17,1100,19883,20370,40253,中壢,一等
2020-02-18,1100,19258,19743,39001,中壢,一等
2020-02-19,1100,20645,21157,41802,中壢,一等
2020-02-20,1100,20248,20563,40811,中壢,一等
2020-02-21,1100,23930,23384,47314,中壢,一等
2020-02-22,1100,22020,22040,44060,中壢,一等
2020-02-23,1100,25500,26375,51875,中壢,一等
2020-02-24,1100,21080,21397,42477,中壢,一等
2020-02-25,1100,21325,21797,43122,中壢,一等
2020-02-26,1100,21178,21622,42800,中壢,一等
2020-02-27,1100,26394,25569,51963,中壢,一等
2020-02-28,1100,22449,22301,44750,中壢,一等
2020-02-29,1100,20040,20519,40559,中壢,一等
2020-03-01,1100,22642,24590,47232,中壢,一等
2020-03-02,1100,21049,21898,42947,中壢,一等
2020-03-03,1100,19714,19972,39686,中壢,一等
2020-03-04,1100,19432,19949,39381,中壢,一等
2020-03-05,1100,20189,19970,40159,中壢,一等
2020-03-06,1100,27663,26238,53901,中壢,一等
2020-03-07,1100,22943,23434,46377,中壢,一等
2020-03-08,1100,25317,27413,52730,中壢,一等
2020-03-09,1100,21338,22203,43541,中壢,一等
2020-03-10,1100,18742,19116,37858,中壢,一等
2020-03-11,1100,20903,21552,42455,中壢,一等
2020-03-12,1100,20254,20456,40710,中壢,一等
2020-03-13,1100,25712,24292,50004,中壢,一等
2020-03-14,1100,21651,21523,43174,中壢,一等
2020-03-15,1100,26561,28630,55191,中壢,一等
2020-03-16,1100,21301,22342,43643,中壢,一等
2020-03-17,1100,20041,20228,40269,中壢,一等
2020-03-18,1100,19514,19969,39483,中壢,一等
2020-03-19,1100,18755,18918,37673,中壢,一等
2020-03-20,1100,25153,24041,49194,中壢,一等
2020-03-21,1100,18917,19059,37976,中壢,一等
2020-03-22,1100,19706,21577,41283,中壢,一等
2020-03-23,1100,19338,20109,39447,中壢,一等
2020-03-24,1100,18046,18595,36641,中壢,一等
2020-03-25,1100,18705,19085,37790,中壢,一等
2020-03-26,1100,18546,18647,37193,中壢,一等
2020-03-27,1100,23360,22114,45474,中壢,一等
2020-03-28,1100,14523,14863,29386,中壢,一等
2020-03-29,1100,16392,18445,34837,中壢,一等
2020-03-30,1100,18246,19252,37498,中壢,一等
2020-03-31,1100,18377,18707,37084,中壢,一等
2020-04-01,1100,25240,22560,47800,中壢,一等
2020-04-02,1100,16218,15100,31318,中壢,一等
2020-04-03,1100,14987,14545,29532,中壢,一等
2020-04-04,1100,12628,13542,26170,中壢,一等
2020-04-05,1100,17714,19732,37446,中壢,一等
2020-04-06,1100,18645,20458,39103,中壢,一等
2020-04-07,1100,17040,17403,34443,中壢,一等
2020-04-08,1100,17638,18216,35854,中壢,一等
2020-04-09,1100,17747,17908,35655,中壢,一等
2020-04-10,1100,22134,21605,43739,中壢,一等
2020-04-11,1100,16683,16762,33445,中壢,一等
2020-04-12,1100,18134,19239,37373,中壢,一等
2020-04-13,1100,18696,19827,38523,中壢,一等
2020-04-14,1100,17599,17850,35449,中壢,一等
2020-04-15,1100,17982,18244,36226,中壢,一等
2020-04-16,1100,17976,18243,36219,中壢,一等
2020-04-17,1100,23470,22446,45916,中壢,一等
2020-04-18,1100,19668,19639,39307,中壢,一等
2020-04-19,1100,21096,22112,43208,中壢,一等
2020-04-20,1100,18287,19202,37489,中壢,一等
2020-04-21,1100,16644,16921,33565,中壢,一等
2020-04-22,1100,17274,17772,35046,中壢,一等
2020-04-23,1100,17386,17369,34755,中壢,一等
2020-04-24,1100,21933,21140,43073,中壢,一等
2020-04-25,1100,16107,16265,32372,中壢,一等
2020-04-26,1100,16614,17824,34438,中壢,一等
2020-04-27,1100,18360,18977,37337,中壢,一等
2020-04-28,1100,17937,18095,36032,中壢,一等
2020-04-29,1100,18245,18576,36821,中壢,一等
2020-04-30,1100,20483,20382,40865,中壢,一等
2020-05-01,1100,23839,22545,46384,中壢,一等
2020-05-02,1100,18908,18539,37447,中壢,一等
2020-05-03,1100,20159,21841,42000,中壢,一等
2020-05-04,1100,19399,20481,39880,中壢,一等
2020-05-05,1100,18920,19263,38183,中壢,一等
2020-05-06,1100,19337,19759,39096,中壢,一等
2020-05-07,1100,19784,19868,39652,中壢,一等
2020-05-08,1100,27523,26147,53670,中壢,一等
2020-05-09,1100,22896,23050,45946,中壢,一等
2020-05-10,1100,26037,27480,53517,中壢,一等
2020-05-11,1100,20720,21792,42512,中壢,一等
2020-05-12,1100,18584,19037,37621,中壢,一等
2020-05-13,1100,20020,20390,40410,中壢,一等
2020-05-14,1100,19903,19965,39868,中壢,一等
2020-05-15,1100,28384,26196,54580,中壢,一等
2020-05-16,1100,21212,21414,42626,中壢,一等
2020-05-17,1100,23926,25635,49561,中壢,一等
2020-05-18,1100,19489,20309,39798,中壢,一等
2020-05-19,1100,17871,18200,36071,中壢,一等
2020-05-20,1100,19456,19915,39371,中壢,一等
2020-05-21,1100,18538,19409,37947,中壢,一等
2020-05-22,1100,23187,22114,45301,中壢,一等
2020-05-23,1100,20141,19906,40047,中壢,一等
2020-05-24,1100,26490,27717,54207,中壢,一等
2020-05-25,1100,21104,21863,42967,中壢,一等
2020-05-26,1100,19184,19636,38820,中壢,一等
2020-05-27,1100,18864,19308,38172,中壢,一等
2020-05-28,1100,18782,18488,37270,中壢,一等
2020-05-29,1100,26171,24944,51115,中壢,一等
2020-05-30,1100,23741,22788,46529,中壢,一等
2020-05-31,1100,24487,26054,50541,中壢,一等
2020-06-01,1100,21186,22174,43360,中壢,一等
2020-06-02,1100,19688,20237,39925,中壢,一等
2020-06-03,1100,20950,21059,42009,中壢,一等
2020-06-04,1100,20290,20296,40586,中壢,一等
2020-06-05,1100,27566,26626,54192,中壢,一等
2020-06-06,1100,26989,27365,54354,中壢,一等
2020-06-07,1100,27415,28259,55674,中壢,一等
2020-06-08,1100,21328,22164,43492,中壢,一等
2020-06-09,1100,20558,20806,41364,中壢,一等
2020-06-10,1100,22085,22520,44605,中壢,一等
2020-06-11,1100,22154,21941,44095,中壢,一等
2020-06-12,1100,28027,26735,54762,中壢,一等
2020-06-13,1100,28047,28464,56511,中壢,一等
2020-06-14,1100,30446,31582,62028,中壢,一等
2020-06-15,1100,23119,23693,46812,中壢,一等
2020-06-16,1100,21518,21679,43197,中壢,一等
2020-06-17,1100,21127,18904,40031,中壢,一等
2020-06-18,1100,22087,21674,43761,中壢,一等
2020-06-19,1100,24079,23563,47642,中壢,一等
2020-06-20,1100,24542,25181,49723,中壢,一等
2020-06-21,1100,26279,26667,52946,中壢,一等
2020-06-22,1100,21810,22696,44506,中壢,一等
2020-06-23,1100,21927,21779,43706,中壢,一等
2020-06-24,1100,28664,27155,55819,中壢,一等
2020-06-25,1100,24409,23448,47857,中壢,一等
2020-06-26,1100,24718,24918,49636,中壢,一等
2020-06-27,1100,24642,25948,50590,中壢,一等
2020-06-28,1100,27625,28802,56427,中壢,一等
2020-06-29,1100,23014,24379,47393,中壢,一等
2020-06-30,1100,21356,21940,43296,中壢,一等
2020-07-01,1100,20970,21861,42831,中壢,一等
2020-07-02,1100,20806,21052,41858,中壢,一等
2020-07-03,1100,25402,24806,50208,中壢,一等
2020-07-04,1100,25209,24191,49400,中壢,一等
2020-07-05,1100,27851,28168,56019,中壢,一等
2020-07-06,1100,23423,23892,47315,中壢,一等
2020-07-07,1100,22208,22840,45048,中壢,一等
2020-07-08,1100,22370,22696,45066,中壢,一等
2020-07-09,1100,22343,22638,44981,中壢,一等
2020-07-10,1100,26963,26925,53888,中壢,一等
2020-07-11,1100,26852,27640,54492,中壢,一等
2020-07-12,1100,31309,31590,62899,中壢,一等
2020-07-13,1100,24377,25005,49382,中壢,一等
2020-07-14,1100,25166,25949,51115,中壢,一等
2020-07-15,1100,23988,24489,48477,中壢,一等
2020-07-16,1100,23410,23922,47332,中壢,一等
2020-07-17,1100,27401,27169,54570,中壢,一等
2020-07-18,1100,26859,27178,54037,中壢,一等
2020-07-19,1100,29095,29922,59017,中壢,一等
2020-07-20,1100,23293,23127,46420,中壢,一等
2020-07-21,1100,22000,22405,44405,中壢,一等
2020-07-22,1100,22963,23407,46370,中壢,一等
2020-07-23,1100,23006,23078,46084,中壢,一等
2020-07-24,1100,26437,25968,52405,中壢,一等
2020-07-25,1100,25511,25867,51378,中壢,一等
2020-07-26,1100,27224,27879,55103,中壢,一等
2020-07-27,1100,22512,23079,45591,中壢,一等
2020-07-28,1100,21248,21872,43120,中壢,一等
2020-07-29,1100,22077,22226,44303,中壢,一等
2020-07-30,1100,22158,22216,44374,中壢,一等
2020-07-31,1100,25983,25330,51313,中壢,一等
2020-08-01,1100,24486,24787,49273,中壢,一等
2020-08-02,1100,23513,24372,47885,中壢,一等
2020-08-03,1100,19193,20071,39264,中壢,一等
2020-08-04,1100,20488,21251,41739,中壢,一等
2020-08-05,1100,22069,22333,44402,中壢,一等
2020-08-06,1100,22994,23317,46311,中壢,一等
2020-08-07,1100,27147,26817,53964,中壢,一等
2020-08-08,1100,24746,25179,49925,中壢,一等
2020-08-09,1100,30466,30614,61080,中壢,一等
2020-08-10,1100,23263,23406,46669,中壢,一等
2020-08-11,1100,21005,21649,42654,中壢,一等
2020-08-12,1100,22709,23093,45802,中壢,一等
2020-08-13,1100,23104,23308,46412,中壢,一等
2020-08-14,1100,26832,26836,53668,中壢,一等
2020-08-15,1100,27347,28182,55529,中壢,一等
2020-08-16,1100,31003,31700,62703,中壢,一等
2020-08-17,1100,23888,24460,48348,中壢,一等
2020-08-18,1100,23274,23666,46940,中壢,一等
2020-08-19,1100,22873,24225,47098,中壢,一等
2020-08-20,1100,23192,23383,46575,中壢,一等
2020-08-21,1100,27468,27085,54553,中壢,一等
2020-08-22,1100,25391,26071,51462,中壢,一等
2020-08-23,1100,28382,28837,57219,中壢,一等
2020-08-24,1100,23709,24316,48025,中壢,一等
2020-08-25,1100,23776,24142,47918,中壢,一等
2020-08-26,1100,23328,23925,47253,中壢,一等
2020-08-27,1100,23002,23225,46227,中壢,一等
2020-08-28,1100,26137,25733,51870,中壢,一等
2020-08-29,1100,24306,24810,49116,中壢,一等
2020-08-30,1100,25593,26261,51854,中壢,一等
2020-08-31,1100,21425,22448,43873,中壢,一等
2020-09-01,1100,20827,21181,42008,中壢,一等
2020-09-02,1100,20632,21352,41984,中壢,一等
2020-09-03,1100,22095,22019,44114,中壢,一等
2020-09-04,1100,26336,25775,52111,中壢,一等
2020-09-05,1100,26021,27019,53040,中壢,一等
2020-09-06,1100,29284,30905,60189,中壢,一等
2020-09-07,1100,24102,24697,48799,中壢,一等
2020-09-08,1100,22639,23171,45810,中壢,一等
2020-09-09,1100,23571,23561,47132,中壢,一等
2020-09-10,1100,23615,23585,47200,中壢,一等
2020-09-11,1100,28929,28480,57409,中壢,一等
2020-09-12,1100,28160,28782,56942,中壢,一等
2020-09-13,1100,33558,34252,67810,中壢,一等
2020-09-14,1100,23194,22694,45888,中壢,一等
2020-09-15,1100,22093,22378,44471,中壢,一等
2020-09-16,1100,21705,22459,44164,中壢,一等
2020-09-17,1100,22254,22370,44624,中壢,一等
2020-09-18,1100,29747,28389,58136,中壢,一等
2020-09-19,1100,28314,28063,56377,中壢,一等
2020-09-20,1100,29655,31353,61008,中壢,一等
2020-09-21,1100,22895,23697,46592,中壢,一等
2020-09-22,1100,21946,22404,44350,中壢,一等
2020-09-23,1100,22277,23087,45364,中壢,一等
2020-09-24,1100,21669,22053,43722,中壢,一等
2020-09-25,1100,25367,25386,50753,中壢,一等
2020-09-26,1100,25985,26873,52858,中壢,一等
2020-09-27,1100,25124,25802,50926,中壢,一等
2020-09-28,1100,21903,22244,44147,中壢,一等
2020-09-29,1100,22624,22790,45414,中壢,一等
2020-09-30,1100,32204,30041,62245,中壢,一等
2020-10-01,1100,27237,27072,54309,中壢,一等
2020-10-02,1100,27050,27287,54337,中壢,一等
2020-10-03,1100,26783,27882,54665,中壢,一等
2020-10-04,1100,30882,32985,63867,中壢,一等
2020-10-05,1100,23154,24261,47415,中壢,一等
2020-10-06,1100,21780,22378,44158,中壢,一等
2020-10-07,1100,22579,22906,45485,中壢,一等
2020-10-08,1100,30384,28870,59254,中壢,一等
2020-10-09,1100,29467,29140,58607,中壢,一等
2020-10-10,1100,28866,29373,58239,中壢,一等
2020-10-11,1100,34391,36326,70717,中壢,一等
2020-10-12,1100,23405,24078,47483,中壢,一等
2020-10-13,1100,22247,22418,44665,中壢,一等
2020-10-14,1100,22949,23783,46732,中壢,一等
2020-10-15,1100,23010,23346,46356,中壢,一等
2020-10-16,1100,29027,28506,57533,中壢,一等
2020-10-17,1100,28561,29261,57822,中壢,一等
2020-10-18,1100,32233,33387,65620,中壢,一等
2020-10-19,1100,23178,23830,47008,中壢,一等
2020-10-20,1100,21901,22273,44174,中壢,一等
2020-10-21,1100,22362,22919,45281,中壢,一等
2020-10-22,1100,21440,21594,43034,中壢,一等
2020-10-23,1100,29197,27857,57054,中壢,一等
2020-10-24,1100,28956,28546,57502,中壢,一等
2020-10-25,1100,30893,32860,63753,中壢,一等
2020-10-26,1100,23349,22733,46082,中壢,一等
2020-10-27,1100,22099,22687,44786,中壢,一等
2020-10-28,1100,22263,22814,45077,中壢,一等
2020-10-29,1100,22569,22420,44989,中壢,一等
2020-10-30,1100,29657,28586,58243,中壢,一等
2020-10-31,1100,28503,29137,57640,中壢,一等
2020-11-01,1100,29142,30736,59878,中壢,一等
2020-11-02,1100,22239,23286,45525,中壢,一等
2020-11-03,1100,21176,21591,42767,中壢,一等
2020-11-04,1100,22001,22694,44695,中壢,一等
2020-11-05,1100,23182,23412,46594,中壢,一等
2020-11-06,1100,30153,29264,59417,中壢,一等
2020-11-07,1100,30243,30628,60871,中壢,一等
2020-11-08,1100,33025,33922,66947,中壢,一等
2020-11-09,1100,23534,24403,47937,中壢,一等
2020-11-10,1100,22469,22756,45225,中壢,一等
2020-11-11,1100,23739,24505,48244,中壢,一等
2020-11-12,1100,23707,23707,47414,中壢,一等
2020-11-13,1100,31044,29682,60726,中壢,一等
2020-11-14,1100,31984,30272,62256,中壢,一等
2020-11-15,1100,37619,39357,76976,中壢,一等
2020-11-16,1100,23634,24614,48248,中壢,一等
2020-11-17,1100,22876,23082,45958,中壢,一等
2020-11-18,1100,23504,23973,47477,中壢,一等
2020-11-19,1100,23805,23958,47763,中壢,一等
2020-11-20,1100,30707,29425,60132,中壢,一等
2020-11-21,1100,29873,30038,59911,中壢,一等
2020-11-22,1100,32501,34558,67059,中壢,一等
2020-11-23,1100,22909,24055,46964,中壢,一等
2020-11-24,1100,22041,21802,43843,中壢,一等
2020-11-25,1100,22567,23258,45825,中壢,一等
2020-11-26,1100,23360,23394,46754,中壢,一等
2020-11-27,1100,30497,28676,59173,中壢,一等
2020-11-28,1100,27524,27775,55299,中壢,一等
2020-11-29,1100,28772,31678,60450,中壢,一等
2020-11-30,1100,22965,21767,44732,中壢,一等
2020-12-01,1100,20838,21429,42267,中壢,一等
2020-12-02,1100,21647,22412,44059,中壢,一等
2020-12-03,1100,21936,21454,43390,中壢,一等
2020-12-04,1100,30034,28659,58693,中壢,一等
2020-12-05,1100,30382,31402,61784,中壢,一等
2020-12-06,1100,34020,36123,70143,中壢,一等
2020-12-07,1100,23252,24221,47473,中壢,一等
2020-12-08,1100,21420,22211,43631,中壢,一等
2020-12-09,1100,21318,22103,43421,中壢,一等
2020-12-10,1100,22742,23150,45892,中壢,一等
2020-12-11,1100,30924,29429,60353,中壢,一等
2020-12-12,1100,33832,33774,67606,中壢,一等
2020-12-13,1100,36124,38084,74208,中壢,一等
2020-12-14,1100,23572,24288,47860,中壢,一等
2020-12-15,1100,21360,21747,43107,中壢,一等
2020-12-16,1100,21862,22634,44496,中壢,一等
2020-12-17,1100,23162,23376,46538,中壢,一等
2020-12-18,1100,30728,29152,59880,中壢,一等
2020-12-19,1100,29842,29882,59724,中壢,一等
2020-12-20,1100,32993,34778,67771,中壢,一等
2020-12-21,1100,23055,23874,46929,中壢,一等
2020-12-22,1100,22588,22974,45562,中壢,一等
2020-12-23,1100,21597,21658,43255,中壢,一等
2020-12-24,1100,23446,23594,47040,中壢,一等
2020-12-25,1100,30738,29534,60272,中壢,一等
2020-12-26,1100,27269,27696,54965,中壢,一等
2020-12-27,1100,28750,30542,59292,中壢,一等
2020-12-28,1100,22873,23757,46630,中壢,一等
2020-12-29,1100,21621,21927,43548,中壢,一等
2020-12-30,1100,22333,22505,44838,中壢,一等
2020-12-31,1100,33084,30372,63456,中壢,一等
2020-01-01,1110,4717,5362,10079,埔心,三等
2020-01-02,1110,6029,5860,11889,埔心,三等
2020-01-03,1110,6527,6389,12916,埔心,三等
2020-01-04,1110,6733,5883,12616,埔心,三等
2020-01-05,1110,5074,4851,9925,埔心,三等
2020-01-06,1110,6513,6011,12524,埔心,三等
2020-01-07,1110,6274,5999,12273,埔心,三等
2020-01-08,1110,6535,5994,12529,埔心,三等
2020-01-09,1110,6499,6306,12805,埔心,三等
2020-01-10,1110,7350,7321,14671,埔心,三等
2020-01-11,1110,5689,5669,11358,埔心,三等
2020-01-12,1110,5487,5194,10681,埔心,三等
2020-01-13,1110,6769,6118,12887,埔心,三等
2020-01-14,1110,6848,6043,12891,埔心,三等
2020-01-15,1110,6939,6217,13156,埔心,三等
2020-01-16,1110,8212,6677,14889,埔心,三等
2020-01-17,1110,5196,5096,10292,埔心,三等
2020-01-18,1110,5246,5314,10560,埔心,三等
2020-01-19,1110,4683,4802,9485,埔心,三等
2020-01-20,1110,5375,5029,10404,埔心,三等
2020-01-21,1110,5292,5128,10420,埔心,三等
2020-01-22,1110,5404,5180,10584,埔心,三等
2020-01-23,1110,4126,4400,8526,埔心,三等
2020-01-24,1110,3542,3729,7271,埔心,三等
2020-01-25,1110,3862,3575,7437,埔心,三等
2020-01-26,1110,3333,3406,6739,埔心,三等
2020-01-27,1110,4106,4113,8219,埔心,三等
2020-01-28,1110,4231,4019,8250,埔心,三等
2020-01-29,1110,3685,3531,7216,埔心,三等
2020-01-30,1110,4316,4087,8403,埔心,三等
2020-01-31,1110,4700,4571,9271,埔心,三等
2020-02-01,1110,4085,3926,8011,埔心,三等
2020-02-02,1110,3846,3946,7792,埔心,三等
2020-02-03,1110,4739,4505,9244,埔心,三等
2020-02-04,1110,4073,3928,8001,埔心,三等
2020-02-05,1110,4417,4148,8565,埔心,三等
2020-02-06,1110,4593,4468,9061,埔心,三等
2020-02-07,1110,4754,4533,9287,埔心,三等
2020-02-08,1110,4018,4068,8086,埔心,三等
2020-02-09,1110,4219,4213,8432,埔心,三等
2020-02-10,1110,4685,4462,9147,埔心,三等
2020-02-11,1110,4380,4165,8545,埔心,三等
2020-02-12,1110,4538,4346,8884,埔心,三等
2020-02-13,1110,4285,4129,8414,埔心,三等
2020-02-14,1110,4957,4634,9591,埔心,三等
2020-02-15,1110,4103,4153,8256,埔心,三等
2020-02-16,1110,3649,3482,7131,埔心,三等
2020-02-17,1110,4173,4030,8203,埔心,三等
2020-02-18,1110,4158,4186,8344,埔心,三等
2020-02-19,1110,4471,4233,8704,埔心,三等
2020-02-20,1110,4350,4200,8550,埔心,三等
2020-02-21,1110,4889,4760,9649,埔心,三等
2020-02-22,1110,4105,3868,7973,埔心,三等
2020-02-23,1110,4116,4067,8183,埔心,三等
2020-02-24,1110,4608,4348,8956,埔心,三等
2020-02-25,1110,6263,5835,12098,埔心,三等
2020-02-26,1110,6014,5680,11694,埔心,三等
2020-02-27,1110,6486,6221,12707,埔心,三等
2020-02-28,1110,5101,4713,9814,埔心,三等
2020-02-29,1110,3722,3644,7366,埔心,三等
2020-03-01,1110,3878,3603,7481,埔心,三等
2020-03-02,1110,5943,5608,11551,埔心,三等
2020-03-03,1110,5657,5347,11004,埔心,三等
2020-03-04,1110,5936,5343,11279,埔心,三等
2020-03-05,1110,5606,5257,10863,埔心,三等
2020-03-06,1110,6535,6335,12870,埔心,三等
2020-03-07,1110,4581,4280,8861,埔心,三等
2020-03-08,1110,3962,3924,7886,埔心,三等
2020-03-09,1110,6028,5576,11604,埔心,三等
2020-03-10,1110,5362,5092,10454,埔心,三等
2020-03-11,1110,6205,5607,11812,埔心,三等
2020-03-12,1110,5610,5335,10945,埔心,三等
2020-03-13,1110,5932,5972,11904,埔心,三等
2020-03-14,1110,4196,3860,8056,埔心,三等
2020-03-15,1110,4523,4317,8840,埔心,三等
2020-03-16,1110,5929,5573,11502,埔心,三等
2020-03-17,1110,5750,5461,11211,埔心,三等
2020-03-18,1110,5839,5284,11123,埔心,三等
2020-03-19,1110,5336,5205,10541,埔心,三等
2020-03-20,1110,6171,6028,12199,埔心,三等
2020-03-21,1110,4142,3816,7958,埔心,三等
2020-03-22,1110,3627,3462,7089,埔心,三等
2020-03-23,1110,5583,5195,10778,埔心,三等
2020-03-24,1110,5303,5048,10351,埔心,三等
2020-03-25,1110,5550,5099,10649,埔心,三等
2020-03-26,1110,5253,5101,10354,埔心,三等
2020-03-27,1110,5855,5742,11597,埔心,三等
2020-03-28,1110,3104,2988,6092,埔心,三等
2020-03-29,1110,3055,2874,5929,埔心,三等
2020-03-30,1110,5370,5038,10408,埔心,三等
2020-03-31,1110,5074,4980,10054,埔心,三等
2020-04-01,1110,6054,5637,11691,埔心,三等
2020-04-02,1110,2944,3213,6157,埔心,三等
2020-04-03,1110,3064,3020,6084,埔心,三等
2020-04-04,1110,2366,2300,4666,埔心,三等
2020-04-05,1110,3511,3058,6569,埔心,三等
2020-04-06,1110,5353,4960,10313,埔心,三等
2020-04-07,1110,4986,4764,9750,埔心,三等
2020-04-08,1110,5357,4929,10286,埔心,三等
2020-04-09,1110,5197,4868,10065,埔心,三等
2020-04-10,1110,6011,5544,11555,埔心,三等
2020-04-11,1110,3563,3385,6948,埔心,三等
2020-04-12,1110,3153,3084,6237,埔心,三等
2020-04-13,1110,5833,5106,10939,埔心,三等
2020-04-14,1110,5013,4877,9890,埔心,三等
2020-04-15,1110,5466,5043,10509,埔心,三等
2020-04-16,1110,5137,4950,10087,埔心,三等
2020-04-17,1110,5825,5583,11408,埔心,三等
2020-04-18,1110,3910,3702,7612,埔心,三等
2020-04-19,1110,3604,3396,7000,埔心,三等
2020-04-20,1110,5323,5015,10338,埔心,三等
2020-04-21,1110,4972,4739,9711,埔心,三等
2020-04-22,1110,5273,4789,10062,埔心,三等
2020-04-23,1110,4901,4735,9636,埔心,三等
2020-04-24,1110,5365,5353,10718,埔心,三等
2020-04-25,1110,3407,3208,6615,埔心,三等
2020-04-26,1110,3433,3127,6560,埔心,三等
2020-04-27,1110,5281,4935,10216,埔心,三等
2020-04-28,1110,5118,4858,9976,埔心,三等
2020-04-29,1110,5324,4870,10194,埔心,三等
2020-04-30,1110,5383,5198,10581,埔心,三等
2020-05-01,1110,5390,5399,10789,埔心,三等
2020-05-02,1110,3725,3686,7411,埔心,三等
2020-05-03,1110,3648,3243,6891,埔心,三等
2020-05-04,1110,5454,5130,10584,埔心,三等
2020-05-05,1110,5240,4994,10234,埔心,三等
2020-05-06,1110,5496,5094,10590,埔心,三等
2020-05-07,1110,5240,5087,10327,埔心,三等
2020-05-08,1110,6017,6230,12247,埔心,三等
2020-05-09,1110,4426,4578,9004,埔心,三等
2020-05-10,1110,4386,3814,8200,埔心,三等
2020-05-11,1110,5787,5222,11009,埔心,三等
2020-05-12,1110,5210,5065,10275,埔心,三等
2020-05-13,1110,5826,5371,11197,埔心,三等
2020-05-14,1110,5383,5207,10590,埔心,三等
2020-05-15,1110,6192,6148,12340,埔心,三等
2020-05-16,1110,3875,3899,7774,埔心,三等
2020-05-17,1110,3894,3686,7580,埔心,三等
2020-05-18,1110,5266,5046,10312,埔心,三等
2020-05-19,1110,5053,4760,9813,埔心,三等
2020-05-20,1110,5657,5137,10794,埔心,三等
2020-05-21,1110,4965,5055,10020,埔心,三等
2020-05-22,1110,5317,5448,10765,埔心,三等
2020-05-23,1110,3890,3709,7599,埔心,三等
2020-05-24,1110,4240,4051,8291,埔心,三等
2020-05-25,1110,5677,5230,10907,埔心,三等
2020-05-26,1110,5342,5128,10470,埔心,三等
2020-05-27,1110,5444,4905,10349,埔心,三等
2020-05-28,1110,5116,4897,10013,埔心,三等
2020-05-29,1110,5918,5844,11762,埔心,三等
2020-05-30,1110,4720,4475,9195,埔心,三等
2020-05-31,1110,4381,4042,8423,埔心,三等
2020-06-01,1110,5892,5327,11219,埔心,三等
2020-06-02,1110,5578,5236,10814,埔心,三等
2020-06-03,1110,5937,5308,11245,埔心,三等
2020-06-04,1110,5242,5118,10360,埔心,三等
2020-06-05,1110,6239,6104,12343,埔心,三等
2020-06-06,1110,5051,4848,9899,埔心,三等
2020-06-07,1110,4196,4009,8205,埔心,三等
2020-06-08,1110,5467,5219,10686,埔心,三等
2020-06-09,1110,5465,5209,10674,埔心,三等
2020-06-10,1110,6000,5387,11387,埔心,三等
2020-06-11,1110,5641,5462,11103,埔心,三等
2020-06-12,1110,6478,6168,12646,埔心,三等
2020-06-13,1110,5174,4899,10073,埔心,三等
2020-06-14,1110,4618,4602,9220,埔心,三等
2020-06-15,1110,5944,5610,11554,埔心,三等
2020-06-16,1110,5534,5339,10873,埔心,三等
2020-06-17,1110,5541,5308,10849,埔心,三等
2020-06-18,1110,5261,5551,10812,埔心,三等
2020-06-19,1110,5642,5495,11137,埔心,三等
2020-06-20,1110,5767,5315,11082,埔心,三等
2020-06-21,1110,4608,4458,9066,埔心,三等
2020-06-22,1110,5427,5217,10644,埔心,三等
2020-06-23,1110,5410,5123,10533,埔心,三等
2020-06-24,1110,6409,6095,12504,埔心,三等
2020-06-25,1110,4153,4397,8550,埔心,三等
2020-06-26,1110,4686,4560,9246,埔心,三等
2020-06-27,1110,4366,4227,8593,埔心,三等
2020-06-28,1110,4351,4233,8584,埔心,三等
2020-06-29,1110,5874,5492,11366,埔心,三等
2020-06-30,1110,5419,5160,10579,埔心,三等
2020-07-01,1110,5727,5192,10919,埔心,三等
2020-07-02,1110,5410,4982,10392,埔心,三等
2020-07-03,1110,6225,5818,12043,埔心,三等
2020-07-04,1110,4893,4755,9648,埔心,三等
2020-07-05,1110,4731,4771,9502,埔心,三等
2020-07-06,1110,5928,5295,11223,埔心,三等
2020-07-07,1110,5812,5273,11085,埔心,三等
2020-07-08,1110,5966,5312,11278,埔心,三等
2020-07-09,1110,5873,5501,11374,埔心,三等
2020-07-10,1110,6878,6273,13151,埔心,三等
2020-07-11,1110,5076,4771,9847,埔心,三等
2020-07-12,1110,4598,4842,9440,埔心,三等
2020-07-13,1110,6380,5482,11862,埔心,三等
2020-07-14,1110,7070,5833,12903,埔心,三等
2020-07-15,1110,6015,5214,11229,埔心,三等
2020-07-16,1110,5680,5141,10821,埔心,三等
2020-07-17,1110,6463,5921,12384,埔心,三等
2020-07-18,1110,5068,4764,9832,埔心,三等
2020-07-19,1110,4807,4952,9759,埔心,三等
2020-07-20,1110,5584,5224,10808,埔心,三等
2020-07-21,1110,5540,5072,10612,埔心,三等
2020-07-22,1110,5593,5077,10670,埔心,三等
2020-07-23,1110,5499,5174,10673,埔心,三等
2020-07-24,1110,5882,5441,11323,埔心,三等
2020-07-25,1110,4716,4597,9313,埔心,三等
2020-07-26,1110,4541,4648,9189,埔心,三等
2020-07-27,1110,5645,5265,10910,埔心,三等
2020-07-28,1110,5330,4963,10293,埔心,三等
2020-07-29,1110,5437,5108,10545,埔心,三等
2020-07-30,1110,5470,5090,10560,埔心,三等
2020-07-31,1110,6113,5608,11721,埔心,三等
2020-08-01,1110,5475,5232,10707,埔心,三等
2020-08-02,1110,4187,4409,8596,埔心,三等
2020-08-03,1110,4845,4688,9533,埔心,三等
2020-08-04,1110,5627,5177,10804,埔心,三等
2020-08-05,1110,5384,5231,10615,埔心,三等
2020-08-06,1110,5463,5207,10670,埔心,三等
2020-08-07,1110,6100,5977,12077,埔心,三等
2020-08-08,1110,4844,4626,9470,埔心,三等
2020-08-09,1110,5066,4986,10052,埔心,三等
2020-08-10,1110,5524,5253,10777,埔心,三等
2020-08-11,1110,5360,5126,10486,埔心,三等
2020-08-12,1110,4942,4795,9737,埔心,三等
2020-08-13,1110,4975,4749,9724,埔心,三等
2020-08-14,1110,5657,5259,10916,埔心,三等
2020-08-15,1110,5024,4966,9990,埔心,三等
2020-08-16,1110,4958,5044,10002,埔心,三等
2020-08-17,1110,5041,4810,9851,埔心,三等
2020-08-18,1110,4961,4783,9744,埔心,三等
2020-08-19,1110,5352,4991,10343,埔心,三等
2020-08-20,1110,5308,4904,10212,埔心,三等
2020-08-21,1110,5888,5466,11354,埔心,三等
2020-08-22,1110,4727,4621,9348,埔心,三等
2020-08-23,1110,4620,4677,9297,埔心,三等
2020-08-24,1110,5395,5050,10445,埔心,三等
2020-08-25,1110,5464,5109,10573,埔心,三等
2020-08-26,1110,5678,5174,10852,埔心,三等
2020-08-27,1110,4932,4701,9633,埔心,三等
2020-08-28,1110,5318,5092,10410,埔心,三等
2020-08-29,1110,4411,4440,8851,埔心,三等
2020-08-30,1110,4226,4217,8443,埔心,三等
2020-08-31,1110,6156,5731,11887,埔心,三等
2020-09-01,1110,6079,5559,11638,埔心,三等
2020-09-02,1110,6105,5162,11267,埔心,三等
2020-09-03,1110,6153,5655,11808,埔心,三等
2020-09-04,1110,7089,6533,13622,埔心,三等
2020-09-05,1110,4787,4844,9631,埔心,三等
2020-09-06,1110,4755,4749,9504,埔心,三等
2020-09-07,1110,6360,6005,12365,埔心,三等
2020-09-08,1110,6200,5841,12041,埔心,三等
2020-09-09,1110,6418,6013,12431,埔心,三等
2020-09-10,1110,6118,5850,11968,埔心,三等
2020-09-11,1110,6992,6648,13640,埔心,三等
2020-09-12,1110,5727,5371,11098,埔心,三等
2020-09-13,1110,5166,5072,10238,埔心,三等
2020-09-14,1110,6087,5924,12011,埔心,三等
2020-09-15,1110,6010,5723,11733,埔心,三等
2020-09-16,1110,6362,5828,12190,埔心,三等
2020-09-17,1110,6032,5739,11771,埔心,三等
2020-09-18,1110,6669,6649,13318,埔心,三等
2020-09-19,1110,5161,5285,10446,埔心,三等
2020-09-20,1110,4728,4584,9312,埔心,三等
2020-09-21,1110,6282,5836,12118,埔心,三等
2020-09-22,1110,6144,5823,11967,埔心,三等
2020-09-23,1110,6649,5983,12632,埔心,三等
2020-09-24,1110,6013,5811,11824,埔心,三等
2020-09-25,1110,6423,6311,12734,埔心,三等
2020-09-26,1110,6521,6013,12534,埔心,三等
2020-09-27,1110,4267,4123,8390,埔心,三等
2020-09-28,1110,6070,5703,11773,埔心,三等
2020-09-29,1110,6083,5745,11828,埔心,三等
2020-09-30,1110,7419,7169,14588,埔心,三等
2020-10-01,1110,4905,5347,10252,埔心,三等
2020-10-02,1110,5365,5305,10670,埔心,三等
2020-10-03,1110,4959,4954,9913,埔心,三等
2020-10-04,1110,5450,5022,10472,埔心,三等
2020-10-05,1110,6281,5787,12068,埔心,三等
2020-10-06,1110,6207,5907,12114,埔心,三等
2020-10-07,1110,6594,5987,12581,埔心,三等
2020-10-08,1110,7034,6816,13850,埔心,三等
2020-10-09,1110,5234,5350,10584,埔心,三等
2020-10-10,1110,5097,4794,9891,埔心,三等
2020-10-11,1110,5853,5497,11350,埔心,三等
2020-10-12,1110,6658,5962,12620,埔心,三等
2020-10-13,1110,6304,5893,12197,埔心,三等
2020-10-14,1110,6908,6189,13097,埔心,三等
2020-10-15,1110,6184,5962,12146,埔心,三等
2020-10-16,1110,6992,6740,13732,埔心,三等
2020-10-17,1110,5744,5526,11270,埔心,三等
2020-10-18,1110,5289,5133,10422,埔心,三等
2020-10-19,1110,6458,5982,12440,埔心,三等
2020-10-20,1110,5857,5870,11727,埔心,三等
2020-10-21,1110,6454,5726,12180,埔心,三等
2020-10-22,1110,5867,5612,11479,埔心,三等
2020-10-23,1110,6935,6752,13687,埔心,三等
2020-10-24,1110,5818,5604,11422,埔心,三等
2020-10-25,1110,5169,5087,10256,埔心,三等
2020-10-26,1110,6430,6033,12463,埔心,三等
2020-10-27,1110,6445,5995,12440,埔心,三等
2020-10-28,1110,6519,6057,12576,埔心,三等
2020-10-29,1110,6146,5897,12043,埔心,三等
2020-10-30,1110,7073,6739,13812,埔心,三等
2020-10-31,1110,5843,5670,11513,埔心,三等
2020-11-01,1110,4994,4873,9867,埔心,三等
2020-11-02,1110,6240,5948,12188,埔心,三等
2020-11-03,1110,6084,5720,11804,埔心,三等
2020-11-04,1110,6530,5942,12472,埔心,三等
2020-11-05,1110,6275,5958,12233,埔心,三等
2020-11-06,1110,7340,6978,14318,埔心,三等
2020-11-07,1110,6095,5805,11900,埔心,三等
2020-11-08,1110,5063,5068,10131,埔心,三等
2020-11-09,1110,6436,5993,12429,埔心,三等
2020-11-10,1110,6165,5892,12057,埔心,三等
2020-11-11,1110,6771,6229,13000,埔心,三等
2020-11-12,1110,6321,6036,12357,埔心,三等
2020-11-13,1110,6970,6951,13921,埔心,三等
2020-11-14,1110,5790,5609,11399,埔心,三等
2020-11-15,1110,6312,5976,12288,埔心,三等
2020-11-16,1110,6728,6246,12974,埔心,三等
2020-11-17,1110,6276,6016,12292,埔心,三等
2020-11-18,1110,6792,6100,12892,埔心,三等
2020-11-19,1110,6363,6094,12457,埔心,三等
2020-11-20,1110,7200,7018,14218,埔心,三等
2020-11-21,1110,6264,5958,12222,埔心,三等
2020-11-22,1110,5500,5382,10882,埔心,三等
2020-11-23,1110,6138,6081,12219,埔心,三等
2020-11-24,1110,5811,5789,11600,埔心,三等
2020-11-25,1110,6284,5718,12002,埔心,三等
2020-11-26,1110,6029,5776,11805,埔心,三等
2020-11-27,1110,6938,6776,13714,埔心,三等
2020-11-28,1110,5336,5228,10564,埔心,三等
2020-11-29,1110,5536,5422,10958,埔心,三等
2020-11-30,1110,6538,6015,12553,埔心,三等
2020-12-01,1110,6250,5773,12023,埔心,三等
2020-12-02,1110,6810,6031,12841,埔心,三等
2020-12-03,1110,5817,5703,11520,埔心,三等
2020-12-04,1110,6908,6850,13758,埔心,三等
2020-12-05,1110,6084,5779,11863,埔心,三等
2020-12-06,1110,5860,5665,11525,埔心,三等
2020-12-07,1110,6541,5976,12517,埔心,三等
2020-12-08,1110,5982,5832,11814,埔心,三等
2020-12-09,1110,6372,5842,12214,埔心,三等
2020-12-10,1110,6077,5869,11946,埔心,三等
2020-12-11,1110,7229,7018,14247,埔心,三等
2020-12-12,1110,6183,5980,12163,埔心,三等
2020-12-13,1110,5667,5581,11248,埔心,三等
2020-12-14,1110,6335,5869,12204,埔心,三等
2020-12-15,1110,6101,5749,11850,埔心,三等
2020-12-16,1110,6552,6065,12617,埔心,三等
2020-12-17,1110,6356,6028,12384,埔心,三等
2020-12-18,1110,7273,6965,14238,埔心,三等
2020-12-19,1110,5870,5536,11406,埔心,三等
2020-12-20,1110,5320,5151,10471,埔心,三等
2020-12-21,1110,6390,5934,12324,埔心,三等
2020-12-22,1110,6335,6046,12381,埔心,三等
2020-12-23,1110,6098,5807,11905,埔心,三等
2020-12-24,1110,6513,5882,12395,埔心,三等
2020-12-25,1110,7091,6952,14043,埔心,三等
2020-12-26,1110,5365,5433,10798,埔心,三等
2020-12-27,1110,4847,4592,9439,埔心,三等
2020-12-28,1110,6378,5894,12272,埔心,三等
2020-12-29,1110,6181,5898,12079,埔心,三等
2020-12-30,1110,6318,5659,11977,埔心,三等
2020-12-31,1110,7207,6745,13952,埔心,三等
2020-01-01,1120,5114,5963,11077,楊梅,三等
2020-01-02,1120,5424,5116,10540,楊梅,三等
2020-01-03,1120,6606,5536,12142,楊梅,三等
2020-01-04,1120,5262,4999,10261,楊梅,三等
2020-01-05,1120,4863,5115,9978,楊梅,三等
2020-01-06,1120,5580,5211,10791,楊梅,三等
2020-01-07,1120,5432,5074,10506,楊梅,三等
2020-01-08,1120,5433,5168,10601,楊梅,三等
2020-01-09,1120,5663,5365,11028,楊梅,三等
2020-01-10,1120,6754,6562,13316,楊梅,三等
2020-01-11,1120,5532,5581,11113,楊梅,三等
2020-01-12,1120,5345,5288,10633,楊梅,三等
2020-01-13,1120,5554,5308,10862,楊梅,三等
2020-01-14,1120,5395,5417,10812,楊梅,三等
2020-01-15,1120,5370,5259,10629,楊梅,三等
2020-01-16,1120,6277,5945,12222,楊梅,三等
2020-01-17,1120,5941,5347,11288,楊梅,三等
2020-01-18,1120,4875,5040,9915,楊梅,三等
2020-01-19,1120,4700,5200,9900,楊梅,三等
2020-01-20,1120,5529,5327,10856,楊梅,三等
2020-01-21,1120,5397,5284,10681,楊梅,三等
2020-01-22,1120,5930,5242,11172,楊梅,三等
2020-01-23,1120,3928,4266,8194,楊梅,三等
2020-01-24,1120,3211,3629,6840,楊梅,三等
2020-01-25,1120,3550,3275,6825,楊梅,三等
2020-01-26,1120,3446,3524,6970,楊梅,三等
2020-01-27,1120,4048,3788,7836,楊梅,三等
2020-01-28,1120,3986,3834,7820,楊梅,三等
2020-01-29,1120,3685,3796,7481,楊梅,三等
2020-01-30,1120,4473,4247,8720,楊梅,三等
2020-01-31,1120,4848,4476,9324,楊梅,三等
2020-02-01,1120,3874,3732,7606,楊梅,三等
2020-02-02,1120,3664,4167,7831,楊梅,三等
2020-02-03,1120,4630,4481,9111,楊梅,三等
2020-02-04,1120,4010,4023,8033,楊梅,三等
2020-02-05,1120,4252,4075,8327,楊梅,三等
2020-02-06,1120,4592,4473,9065,楊梅,三等
2020-02-07,1120,5135,4530,9665,楊梅,三等
2020-02-08,1120,3891,3887,7778,楊梅,三等
2020-02-09,1120,4116,4420,8536,楊梅,三等
2020-02-10,1120,4502,4586,9088,楊梅,三等
2020-02-11,1120,4310,4184,8494,楊梅,三等
2020-02-12,1120,4509,4377,8886,楊梅,三等
2020-02-13,1120,4236,4120,8356,楊梅,三等
2020-02-14,1120,5023,4539,9562,楊梅,三等
2020-02-15,1120,4461,4277,8738,楊梅,三等
2020-02-16,1120,3515,3796,7311,楊梅,三等
2020-02-17,1120,4079,4088,8167,楊梅,三等
2020-02-18,1120,4002,3964,7966,楊梅,三等
2020-02-19,1120,4440,4305,8745,楊梅,三等
2020-02-20,1120,4522,4310,8832,楊梅,三等
2020-02-21,1120,5054,4603,9657,楊梅,三等
2020-02-22,1120,3949,3905,7854,楊梅,三等
2020-02-23,1120,4150,4412,8562,楊梅,三等
2020-02-24,1120,4311,4288,8599,楊梅,三等
2020-02-25,1120,5040,4717,9757,楊梅,三等
2020-02-26,1120,4942,4653,9595,楊梅,三等
2020-02-27,1120,5994,5190,11184,楊梅,三等
2020-02-28,1120,4158,4242,8400,楊梅,三等
2020-02-29,1120,3566,3492,7058,楊梅,三等
2020-03-01,1120,3662,3822,7484,楊梅,三等
2020-03-02,1120,5040,4464,9504,楊梅,三等
2020-03-03,1120,4688,4454,9142,楊梅,三等
2020-03-04,1120,4609,4259,8868,楊梅,三等
2020-03-05,1120,4634,4285,8919,楊梅,三等
2020-03-06,1120,5767,5370,11137,楊梅,三等
2020-03-07,1120,4016,3941,7957,楊梅,三等
2020-03-08,1120,3969,4059,8028,楊梅,三等
2020-03-09,1120,4973,4633,9606,楊梅,三等
2020-03-10,1120,4463,4173,8636,楊梅,三等
2020-03-11,1120,4849,4607,9456,楊梅,三等
2020-03-12,1120,4712,4382,9094,楊梅,三等
2020-03-13,1120,5531,4926,10457,楊梅,三等
2020-03-14,1120,3610,3620,7230,楊梅,三等
2020-03-15,1120,4406,4443,8849,楊梅,三等
2020-03-16,1120,5003,4680,9683,楊梅,三等
2020-03-17,1120,4653,4438,9091,楊梅,三等
2020-03-18,1120,4599,4359,8958,楊梅,三等
2020-03-19,1120,4410,4168,8578,楊梅,三等
2020-03-20,1120,5684,4952,10636,楊梅,三等
2020-03-21,1120,3340,3344,6684,楊梅,三等
2020-03-22,1120,3240,3435,6675,楊梅,三等
2020-03-23,1120,4707,4283,8990,楊梅,三等
2020-03-24,1120,4353,4058,8411,楊梅,三等
2020-03-25,1120,4486,4204,8690,楊梅,三等
2020-03-26,1120,4450,4194,8644,楊梅,三等
2020-03-27,1120,5252,4682,9934,楊梅,三等
2020-03-28,1120,2609,2568,5177,楊梅,三等
2020-03-29,1120,2858,2997,5855,楊梅,三等
2020-03-30,1120,4510,4164,8674,楊梅,三等
2020-03-31,1120,4193,4075,8268,楊梅,三等
2020-04-01,1120,5055,4582,9637,楊梅,三等
2020-04-02,1120,2713,2914,5627,楊梅,三等
2020-04-03,1120,2673,2865,5538,楊梅,三等
2020-04-04,1120,2200,2096,4296,楊梅,三等
2020-04-05,1120,2845,2835,5680,楊梅,三等
2020-04-06,1120,4572,4070,8642,楊梅,三等
2020-04-07,1120,4099,3867,7966,楊梅,三等
2020-04-08,1120,4307,4067,8374,楊梅,三等
2020-04-09,1120,4247,4044,8291,楊梅,三等
2020-04-10,1120,5162,4694,9856,楊梅,三等
2020-04-11,1120,2849,2899,5748,楊梅,三等
2020-04-12,1120,2773,2900,5673,楊梅,三等
2020-04-13,1120,4450,4150,8600,楊梅,三等
2020-04-14,1120,4176,4083,8259,楊梅,三等
2020-04-15,1120,4380,4089,8469,楊梅,三等
2020-04-16,1120,4415,4105,8520,楊梅,三等
2020-04-17,1120,5251,4919,10170,楊梅,三等
2020-04-18,1120,3148,3339,6487,楊梅,三等
2020-04-19,1120,3216,3311,6527,楊梅,三等
2020-04-20,1120,4501,4110,8611,楊梅,三等
2020-04-21,1120,4106,3898,8004,楊梅,三等
2020-04-22,1120,4140,3946,8086,楊梅,三等
2020-04-23,1120,4172,3865,8037,楊梅,三等
2020-04-24,1120,5068,4441,9509,楊梅,三等
2020-04-25,1120,2850,2929,5779,楊梅,三等
2020-04-26,1120,2727,2880,5607,楊梅,三等
2020-04-27,1120,4384,4053,8437,楊梅,三等
2020-04-28,1120,4303,4041,8344,楊梅,三等
2020-04-29,1120,4217,3979,8196,楊梅,三等
2020-04-30,1120,4494,4279,8773,楊梅,三等
2020-05-01,1120,4728,4520,9248,楊梅,三等
2020-05-02,1120,3192,3320,6512,楊梅,三等
2020-05-03,1120,3264,3158,6422,楊梅,三等
2020-05-04,1120,4563,4172,8735,楊梅,三等
2020-05-05,1120,4464,4255,8719,楊梅,三等
2020-05-06,1120,4493,4251,8744,楊梅,三等
2020-05-07,1120,4486,4153,8639,楊梅,三等
2020-05-08,1120,5456,5392,10848,楊梅,三等
2020-05-09,1120,3763,4048,7811,楊梅,三等
2020-05-10,1120,4043,3798,7841,楊梅,三等
2020-05-11,1120,4705,4349,9054,楊梅,三等
2020-05-12,1120,4294,4129,8423,楊梅,三等
2020-05-13,1120,4602,4331,8933,楊梅,三等
2020-05-14,1120,4550,4271,8821,楊梅,三等
2020-05-15,1120,6107,5393,11500,楊梅,三等
2020-05-16,1120,3529,3518,7047,楊梅,三等
2020-05-17,1120,3539,3710,7249,楊梅,三等
2020-05-18,1120,4478,4263,8741,楊梅,三等
2020-05-19,1120,4167,3931,8098,楊梅,三等
2020-05-20,1120,4460,4231,8691,楊梅,三等
2020-05-21,1120,4371,4165,8536,楊梅,三等
2020-05-22,1120,5120,4546,9666,楊梅,三等
2020-05-23,1120,3216,3200,6416,楊梅,三等
2020-05-24,1120,3923,3885,7808,楊梅,三等
2020-05-25,1120,4823,4512,9335,楊梅,三等
2020-05-26,1120,4606,4292,8898,楊梅,三等
2020-05-27,1120,4316,4107,8423,楊梅,三等
2020-05-28,1120,4269,4063,8332,楊梅,三等
2020-05-29,1120,5594,5009,10603,楊梅,三等
2020-05-30,1120,3947,3924,7871,楊梅,三等
2020-05-31,1120,3777,3936,7713,楊梅,三等
2020-06-01,1120,4853,4520,9373,楊梅,三等
2020-06-02,1120,4593,4388,8981,楊梅,三等
2020-06-03,1120,4616,4479,9095,楊梅,三等
2020-06-04,1120,4732,4364,9096,楊梅,三等
2020-06-05,1120,5691,5103,10794,楊梅,三等
2020-06-06,1120,4169,4268,8437,楊梅,三等
2020-06-07,1120,3824,3958,7782,楊梅,三等
2020-06-08,1120,4743,4371,9114,楊梅,三等
2020-06-09,1120,4689,4485,9174,楊梅,三等
2020-06-10,1120,4932,4631,9563,楊梅,三等
2020-06-11,1120,4950,4626,9576,楊梅,三等
2020-06-12,1120,5913,5264,11177,楊梅,三等
2020-06-13,1120,4548,4574,9122,楊梅,三等
2020-06-14,1120,4366,4539,8905,楊梅,三等
2020-06-15,1120,5189,4818,10007,楊梅,三等
2020-06-16,1120,4716,4603,9319,楊梅,三等
2020-06-17,1120,4494,4522,9016,楊梅,三等
2020-06-18,1120,4835,4590,9425,楊梅,三等
2020-06-19,1120,5092,4834,9926,楊梅,三等
2020-06-20,1120,5227,4609,9836,楊梅,三等
2020-06-21,1120,4022,4249,8271,楊梅,三等
2020-06-22,1120,4809,4616,9425,楊梅,三等
2020-06-23,1120,4899,4621,9520,楊梅,三等
2020-06-24,1120,5735,5332,11067,楊梅,三等
2020-06-25,1120,3890,4215,8105,楊梅,三等
2020-06-26,1120,4345,4274,8619,楊梅,三等
2020-06-27,1120,4160,3870,8030,楊梅,三等
2020-06-28,1120,4144,4260,8404,楊梅,三等
2020-06-29,1120,5010,4698,9708,楊梅,三等
2020-06-30,1120,4640,4389,9029,楊梅,三等
2020-07-01,1120,4504,4249,8753,楊梅,三等
2020-07-02,1120,4519,4209,8728,楊梅,三等
2020-07-03,1120,5696,4881,10577,楊梅,三等
2020-07-04,1120,4074,3986,8060,楊梅,三等
2020-07-05,1120,3954,4336,8290,楊梅,三等
2020-07-06,1120,4975,4721,9696,楊梅,三等
2020-07-07,1120,4753,4582,9335,楊梅,三等
2020-07-08,1120,4732,4501,9233,楊梅,三等
2020-07-09,1120,4823,4546,9369,楊梅,三等
2020-07-10,1120,6136,5499,11635,楊梅,三等
2020-07-11,1120,4580,4380,8960,楊梅,三等
2020-07-12,1120,4524,4706,9230,楊梅,三等
2020-07-13,1120,4882,4641,9523,楊梅,三等
2020-07-14,1120,5249,5104,10353,楊梅,三等
2020-07-15,1120,4637,4573,9210,楊梅,三等
2020-07-16,1120,4490,4457,8947,楊梅,三等
2020-07-17,1120,5895,5190,11085,楊梅,三等
2020-07-18,1120,4486,4246,8732,楊梅,三等
2020-07-19,1120,4520,4655,9175,楊梅,三等
2020-07-20,1120,4553,4632,9185,楊梅,三等
2020-07-21,1120,4463,4439,8902,楊梅,三等
2020-07-22,1120,4625,4509,9134,楊梅,三等
2020-07-23,1120,4550,4428,8978,楊梅,三等
2020-07-24,1120,5480,5146,10626,楊梅,三等
2020-07-25,1120,4383,4207,8590,楊梅,三等
2020-07-26,1120,4190,4380,8570,楊梅,三等
2020-07-27,1120,4616,4587,9203,楊梅,三等
2020-07-28,1120,4481,4419,8900,楊梅,三等
2020-07-29,1120,4592,4636,9228,楊梅,三等
2020-07-30,1120,4622,4504,9126,楊梅,三等
2020-07-31,1120,5435,5105,10540,楊梅,三等
2020-08-01,1120,4131,4182,8313,楊梅,三等
2020-08-02,1120,3797,4062,7859,楊梅,三等
2020-08-03,1120,4356,4069,8425,楊梅,三等
2020-08-04,1120,4750,4465,9215,楊梅,三等
2020-08-05,1120,4826,4607,9433,楊梅,三等
2020-08-06,1120,4954,4683,9637,楊梅,三等
2020-08-07,1120,5696,5475,11171,楊梅,三等
2020-08-08,1120,4302,4343,8645,楊梅,三等
2020-08-09,1120,4775,4649,9424,楊梅,三等
2020-08-10,1120,4954,4630,9584,楊梅,三等
2020-08-11,1120,4696,4410,9106,楊梅,三等
2020-08-12,1120,4777,4547,9324,楊梅,三等
2020-08-13,1120,5032,4672,9704,楊梅,三等
2020-08-14,1120,5685,5154,10839,楊梅,三等
2020-08-15,1120,4640,4493,9133,楊梅,三等
2020-08-16,1120,4728,4892,9620,楊梅,三等
2020-08-17,1120,4942,4792,9734,楊梅,三等
2020-08-18,1120,4923,4703,9626,楊梅,三等
2020-08-19,1120,4817,4855,9672,楊梅,三等
2020-08-20,1120,4789,4680,9469,楊梅,三等
2020-08-21,1120,5744,5250,10994,楊梅,三等
2020-08-22,1120,4395,4352,8747,楊梅,三等
2020-08-23,1120,4314,4385,8699,楊梅,三等
2020-08-24,1120,4701,4628,9329,楊梅,三等
2020-08-25,1120,4740,4722,9462,楊梅,三等
2020-08-26,1120,4964,4742,9706,楊梅,三等
2020-08-27,1120,4908,4670,9578,楊梅,三等
2020-08-28,1120,5294,4951,10245,楊梅,三等
2020-08-29,1120,4290,4221,8511,楊梅,三等
2020-08-30,1120,4121,4172,8293,楊梅,三等
2020-08-31,1120,4908,4669,9577,楊梅,三等
2020-09-01,1120,4782,4532,9314,楊梅,三等
2020-09-02,1120,4854,4685,9539,楊梅,三等
2020-09-03,1120,4961,4697,9658,楊梅,三等
2020-09-04,1120,6045,5369,11414,楊梅,三等
2020-09-05,1120,4493,4432,8925,楊梅,三等
2020-09-06,1120,4488,4506,8994,楊梅,三等
2020-09-07,1120,5088,4882,9970,楊梅,三等
2020-09-08,1120,4937,4792,9729,楊梅,三等
2020-09-09,1120,4911,4766,9677,楊梅,三等
2020-09-10,1120,5229,4711,9940,楊梅,三等
2020-09-11,1120,5986,5535,11521,楊梅,三等
2020-09-12,1120,5015,4915,9930,楊梅,三等
2020-09-13,1120,4792,4729,9521,楊梅,三等
2020-09-14,1120,4911,4811,9722,楊梅,三等
2020-09-15,1120,5079,4772,9851,楊梅,三等
2020-09-16,1120,5100,4372,9472,楊梅,三等
2020-09-17,1120,4979,4673,9652,楊梅,三等
2020-09-18,1120,5699,5551,11250,楊梅,三等
2020-09-19,1120,4644,4816,9460,楊梅,三等
2020-09-20,1120,4515,4296,8811,楊梅,三等
2020-09-21,1120,5079,4752,9831,楊梅,三等
2020-09-22,1120,5117,4735,9852,楊梅,三等
2020-09-23,1120,5152,4831,9983,楊梅,三等
2020-09-24,1120,5037,4639,9676,楊梅,三等
2020-09-25,1120,5380,5236,10616,楊梅,三等
2020-09-26,1120,4991,4804,9795,楊梅,三等
2020-09-27,1120,3642,3725,7367,楊梅,三等
2020-09-28,1120,4967,4561,9528,楊梅,三等
2020-09-29,1120,5094,4786,9880,楊梅,三等
2020-09-30,1120,6009,6103,12112,楊梅,三等
2020-10-01,1120,4497,5173,9670,楊梅,三等
2020-10-02,1120,4952,5111,10063,楊梅,三等
2020-10-03,1120,4554,4439,8993,楊梅,三等
2020-10-04,1120,4963,4462,9425,楊梅,三等
2020-10-05,1120,5236,4790,10026,楊梅,三等
2020-10-06,1120,5107,4776,9883,楊梅,三等
2020-10-07,1120,5133,4838,9971,楊梅,三等
2020-10-08,1120,6234,5855,12089,楊梅,三等
2020-10-09,1120,4831,5073,9904,楊梅,三等
2020-10-10,1120,4440,4257,8697,楊梅,三等
2020-10-11,1120,5062,4973,10035,楊梅,三等
2020-10-12,1120,5216,4939,10155,楊梅,三等
2020-10-13,1120,5040,4812,9852,楊梅,三等
2020-10-14,1120,5267,4969,10236,楊梅,三等
2020-10-15,1120,5149,4885,10034,楊梅,三等
2020-10-16,1120,6102,5687,11789,楊梅,三等
2020-10-17,1120,5011,4576,9587,楊梅,三等
2020-10-18,1120,4833,4917,9750,楊梅,三等
2020-10-19,1120,5329,4961,10290,楊梅,三等
2020-10-20,1120,5073,4740,9813,楊梅,三等
2020-10-21,1120,5068,4747,9815,楊梅,三等
2020-10-22,1120,4866,4587,9453,楊梅,三等
2020-10-23,1120,6463,5632,12095,楊梅,三等
2020-10-24,1120,4829,4951,9780,楊梅,三等
2020-10-25,1120,5094,4958,10052,楊梅,三等
2020-10-26,1120,5361,4935,10296,楊梅,三等
2020-10-27,1120,5175,4858,10033,楊梅,三等
2020-10-28,1120,5192,4818,10010,楊梅,三等
2020-10-29,1120,4987,4631,9618,楊梅,三等
2020-10-30,1120,6688,5810,12498,楊梅,三等
2020-10-31,1120,5435,5527,10962,楊梅,三等
2020-11-01,1120,5138,5116,10254,楊梅,三等
2020-11-02,1120,5253,4849,10102,楊梅,三等
2020-11-03,1120,4946,4588,9534,楊梅,三等
2020-11-04,1120,5209,4939,10148,楊梅,三等
2020-11-05,1120,5374,4937,10311,楊梅,三等
2020-11-06,1120,6807,5968,12775,楊梅,三等
2020-11-07,1120,5548,5489,11037,楊梅,三等
2020-11-08,1120,5254,5160,10414,楊梅,三等
2020-11-09,1120,5430,5052,10482,楊梅,三等
2020-11-10,1120,5180,4834,10014,楊梅,三等
2020-11-11,1120,5278,4959,10237,楊梅,三等
2020-11-12,1120,5296,5133,10429,楊梅,三等
2020-11-13,1120,6557,5704,12261,楊梅,三等
2020-11-14,1120,5176,5255,10431,楊梅,三等
2020-11-15,1120,5653,5694,11347,楊梅,三等
2020-11-16,1120,5395,4826,10221,楊梅,三等
2020-11-17,1120,5173,4890,10063,楊梅,三等
2020-11-18,1120,5263,4955,10218,楊梅,三等
2020-11-19,1120,5170,4872,10042,楊梅,三等
2020-11-20,1120,6664,5780,12444,楊梅,三等
2020-11-21,1120,5127,5024,10151,楊梅,三等
2020-11-22,1120,4985,5027,10012,楊梅,三等
2020-11-23,1120,5200,4788,9988,楊梅,三等
2020-11-24,1120,5085,4684,9769,楊梅,三等
2020-11-25,1120,5122,4888,10010,楊梅,三等
2020-11-26,1120,5172,4885,10057,楊梅,三等
2020-11-27,1120,6644,5653,12297,楊梅,三等
2020-11-28,1120,5123,5084,10207,楊梅,三等
2020-11-29,1120,5199,5359,10558,楊梅,三等
2020-11-30,1120,5126,4843,9969,楊梅,三等
2020-12-01,1120,4858,4605,9463,楊梅,三等
2020-12-02,1120,4967,4749,9716,楊梅,三等
2020-12-03,1120,4841,4516,9357,楊梅,三等
2020-12-04,1120,6416,5614,12030,楊梅,三等
2020-12-05,1120,5536,5481,11017,楊梅,三等
2020-12-06,1120,5673,5493,11166,楊梅,三等
2020-12-07,1120,5167,4741,9908,楊梅,三等
2020-12-08,1120,4959,4625,9584,楊梅,三等
2020-12-09,1120,4781,4447,9228,楊梅,三等
2020-12-10,1120,4890,4678,9568,楊梅,三等
2020-12-11,1120,6536,5724,12260,楊梅,三等
2020-12-12,1120,5566,5640,11206,楊梅,三等
2020-12-13,1120,5699,5773,11472,楊梅,三等
2020-12-14,1120,5188,4690,9878,楊梅,三等
2020-12-15,1120,4814,4475,9289,楊梅,三等
2020-12-16,1120,4952,4726,9678,楊梅,三等
2020-12-17,1120,5144,4865,10009,楊梅,三等
2020-12-18,1120,6401,5629,12030,楊梅,三等
2020-12-19,1120,4746,4771,9517,楊梅,三等
2020-12-20,1120,4835,4662,9497,楊梅,三等
2020-12-21,1120,5146,4676,9822,楊梅,三等
2020-12-22,1120,4993,4650,9643,楊梅,三等
2020-12-23,1120,4808,4240,9048,楊梅,三等
2020-12-24,1120,4859,4699,9558,楊梅,三等
2020-12-25,1120,6376,5592,11968,楊梅,三等
2020-12-26,1120,4537,4585,9122,楊梅,三等
2020-12-27,1120,4533,4638,9171,楊梅,三等
2020-12-28,1120,5207,4652,9859,楊梅,三等
2020-12-29,1120,4958,4603,9561,楊梅,三等
2020-12-30,1120,4875,4551,9426,楊梅,三等
2020-12-31,1120,6282,5429,11711,楊梅,三等
2020-01-01,1130,1786,2019,3805,富岡,三等
2020-01-02,1130,1760,1761,3521,富岡,三等
2020-01-03,1130,1741,1966,3707,富岡,三等
2020-01-04,1130,1708,1908,3616,富岡,三等
2020-01-05,1130,1930,1912,3842,富岡,三等
2020-01-06,1130,1885,1866,3751,富岡,三等
2020-01-07,1130,1752,1797,3549,富岡,三等
2020-01-08,1130,1720,1753,3473,富岡,三等
2020-01-09,1130,1768,1821,3589,富岡,三等
2020-01-10,1130,1907,2314,4221,富岡,三等
2020-01-11,1130,2129,2095,4224,富岡,三等
2020-01-12,1130,2184,1993,4177,富岡,三等
2020-01-13,1130,1870,1880,3750,富岡,三等
2020-01-14,1130,1687,1767,3454,富岡,三等
2020-01-15,1130,1739,1754,3493,富岡,三等
2020-01-16,1130,1742,1859,3601,富岡,三等
2020-01-17,1130,1693,1683,3376,富岡,三等
2020-01-18,1130,1681,1733,3414,富岡,三等
2020-01-19,1130,1723,1691,3414,富岡,三等
2020-01-20,1130,1732,1686,3418,富岡,三等
2020-01-21,1130,1620,1563,3183,富岡,三等
2020-01-22,1130,1810,1891,3701,富岡,三等
2020-01-23,1130,1705,1859,3564,富岡,三等
2020-01-24,1130,1509,1837,3346,富岡,三等
2020-01-25,1130,1824,1702,3526,富岡,三等
2020-01-26,1130,1554,1485,3039,富岡,三等
2020-01-27,1130,1729,1650,3379,富岡,三等
2020-01-28,1130,1583,1534,3117,富岡,三等
2020-01-29,1130,1344,1298,2642,富岡,三等
2020-01-30,1130,1449,1390,2839,富岡,三等
2020-01-31,1130,1409,1411,2820,富岡,三等
2020-02-01,1130,1417,1409,2826,富岡,三等
2020-02-02,1130,1466,1408,2874,富岡,三等
2020-02-03,1130,1430,1392,2822,富岡,三等
2020-02-04,1130,1276,1253,2529,富岡,三等
2020-02-05,1130,1357,1311,2668,富岡,三等
2020-02-06,1130,1457,1418,2875,富岡,三等
2020-02-07,1130,1447,1457,2904,富岡,三等
2020-02-08,1130,1406,1389,2795,富岡,三等
2020-02-09,1130,1677,1599,3276,富岡,三等
2020-02-10,1130,1563,1522,3085,富岡,三等
2020-02-11,1130,1351,1303,2654,富岡,三等
2020-02-12,1130,1432,1354,2786,富岡,三等
2020-02-13,1130,1352,1267,2619,富岡,三等
2020-02-14,1130,1541,1485,3026,富岡,三等
2020-02-15,1130,1515,1429,2944,富岡,三等
2020-02-16,1130,1435,1426,2861,富岡,三等
2020-02-17,1130,1339,1278,2617,富岡,三等
2020-02-18,1130,1316,1243,2559,富岡,三等
2020-02-19,1130,1391,1334,2725,富岡,三等
2020-02-20,1130,1354,1345,2699,富岡,三等
2020-02-21,1130,1507,1489,2996,富岡,三等
2020-02-22,1130,1329,1438,2767,富岡,三等
2020-02-23,1130,1707,1620,3327,富岡,三等
2020-02-24,1130,1469,1306,2775,富岡,三等
2020-02-25,1130,1596,1613,3209,富岡,三等
2020-02-26,1130,1533,1620,3153,富岡,三等
2020-02-27,1130,1659,1835,3494,富岡,三等
2020-02-28,1130,1451,1483,2934,富岡,三等
2020-02-29,1130,1296,1238,2534,富岡,三等
2020-03-01,1130,1464,1303,2767,富岡,三等
2020-03-02,1130,1619,1600,3219,富岡,三等
2020-03-03,1130,1449,1500,2949,富岡,三等
2020-03-04,1130,1481,1515,2996,富岡,三等
2020-03-05,1130,1474,1538,3012,富岡,三等
2020-03-06,1130,1707,1887,3594,富岡,三等
2020-03-07,1130,1438,1440,2878,富岡,三等
2020-03-08,1130,1614,1488,3102,富岡,三等
2020-03-09,1130,1668,1669,3337,富岡,三等
2020-03-10,1130,1468,1502,2970,富岡,三等
2020-03-11,1130,1534,1617,3151,富岡,三等
2020-03-12,1130,1475,1553,3028,富岡,三等
2020-03-13,1130,1590,1809,3399,富岡,三等
2020-03-14,1130,1296,1358,2654,富岡,三等
2020-03-15,1130,1826,1673,3499,富岡,三等
2020-03-16,1130,1661,1621,3282,富岡,三等
2020-03-17,1130,1519,1531,3050,富岡,三等
2020-03-18,1130,1467,1535,3002,富岡,三等
2020-03-19,1130,1401,1501,2902,富岡,三等
2020-03-20,1130,1562,1805,3367,富岡,三等
2020-03-21,1130,1194,1201,2395,富岡,三等
2020-03-22,1130,1357,1203,2560,富岡,三等
2020-03-23,1130,1568,1498,3066,富岡,三等
2020-03-24,1130,1390,1421,2811,富岡,三等
2020-03-25,1130,1370,1473,2843,富岡,三等
2020-03-26,1130,1376,1437,2813,富岡,三等
2020-03-27,1130,1532,1716,3248,富岡,三等
2020-03-28,1130,906,933,1839,富岡,三等
2020-03-29,1130,1201,1038,2239,富岡,三等
2020-03-30,1130,1458,1463,2921,富岡,三等
2020-03-31,1130,1360,1468,2828,富岡,三等
2020-04-01,1130,1465,1699,3164,富岡,三等
2020-04-02,1130,956,1137,2093,富岡,三等
2020-04-03,1130,1060,1079,2139,富岡,三等
2020-04-04,1130,959,981,1940,富岡,三等
2020-04-05,1130,1326,1068,2394,富岡,三等
2020-04-06,1130,1589,1483,3072,富岡,三等
2020-04-07,1130,1368,1364,2732,富岡,三等
2020-04-08,1130,1373,1446,2819,富岡,三等
2020-04-09,1130,1412,1456,2868,富岡,三等
2020-04-10,1130,1538,1705,3243,富岡,三等
2020-04-11,1130,1054,1116,2170,富岡,三等
2020-04-12,1130,1235,1110,2345,富岡,三等
2020-04-13,1130,1495,1489,2984,富岡,三等
2020-04-14,1130,1405,1457,2862,富岡,三等
2020-04-15,1130,1339,1410,2749,富岡,三等
2020-04-16,1130,1427,1521,2948,富岡,三等
2020-04-17,1130,1601,1737,3338,富岡,三等
2020-04-18,1130,1160,1196,2356,富岡,三等
2020-04-19,1130,1343,1233,2576,富岡,三等
2020-04-20,1130,1498,1478,2976,富岡,三等
2020-04-21,1130,1369,1401,2770,富岡,三等
2020-04-22,1130,1317,1364,2681,富岡,三等
2020-04-23,1130,1349,1413,2762,富岡,三等
2020-04-24,1130,1428,1586,3014,富岡,三等
2020-04-25,1130,1037,1103,2140,富岡,三等
2020-04-26,1130,1223,1032,2255,富岡,三等
2020-04-27,1130,1496,1483,2979,富岡,三等
2020-04-28,1130,1448,1451,2899,富岡,三等
2020-04-29,1130,1388,1460,2848,富岡,三等
2020-04-30,1130,1514,1554,3068,富岡,三等
2020-05-01,1130,1429,1712,3141,富岡,三等
2020-05-02,1130,1195,1312,2507,富岡,三等
2020-05-03,1130,1406,1244,2650,富岡,三等
2020-05-04,1130,1576,1521,3097,富岡,三等
2020-05-05,1130,1479,1443,2922,富岡,三等
2020-05-06,1130,1500,1505,3005,富岡,三等
2020-05-07,1130,1469,1537,3006,富岡,三等
2020-05-08,1130,1685,2012,3697,富岡,三等
2020-05-09,1130,1467,1599,3066,富岡,三等
2020-05-10,1130,1806,1544,3350,富岡,三等
2020-05-11,1130,1675,1584,3259,富岡,三等
2020-05-12,1130,1456,1459,2915,富岡,三等
2020-05-13,1130,1503,1514,3017,富岡,三等
2020-05-14,1130,1500,1547,3047,富岡,三等
2020-05-15,1130,1667,1918,3585,富岡,三等
2020-05-16,1130,1322,1365,2687,富岡,三等
2020-05-17,1130,1465,1388,2853,富岡,三等
2020-05-18,1130,1490,1476,2966,富岡,三等
2020-05-19,1130,1314,1393,2707,富岡,三等
2020-05-20,1130,1437,1522,2959,富岡,三等
2020-05-21,1130,1369,1485,2854,富岡,三等
2020-05-22,1130,1454,1596,3050,富岡,三等
2020-05-23,1130,1209,1278,2487,富岡,三等
2020-05-24,1130,1650,1624,3274,富岡,三等
2020-05-25,1130,1593,1559,3152,富岡,三等
2020-05-26,1130,1512,1563,3075,富岡,三等
2020-05-27,1130,1421,1456,2877,富岡,三等
2020-05-28,1130,1400,1467,2867,富岡,三等
2020-05-29,1130,1609,1843,3452,富岡,三等
2020-05-30,1130,1480,1487,2967,富岡,三等
2020-05-31,1130,1666,1515,3181,富岡,三等
2020-06-01,1130,1552,1540,3092,富岡,三等
2020-06-02,1130,1493,1551,3044,富岡,三等
2020-06-03,1130,1531,1562,3093,富岡,三等
2020-06-04,1130,1443,1557,3000,富岡,三等
2020-06-05,1130,1763,1936,3699,富岡,三等
2020-06-06,1130,1600,1677,3277,富岡,三等
2020-06-07,1130,1591,1430,3021,富岡,三等
2020-06-08,1130,1634,1644,3278,富岡,三等
2020-06-09,1130,1509,1558,3067,富岡,三等
2020-06-10,1130,1576,1565,3141,富岡,三等
2020-06-11,1130,1508,1621,3129,富岡,三等
2020-06-12,1130,1747,1913,3660,富岡,三等
2020-06-13,1130,1620,1618,3238,富岡,三等
2020-06-14,1130,1756,1688,3444,富岡,三等
2020-06-15,1130,1643,1619,3262,富岡,三等
2020-06-16,1130,1535,1557,3092,富岡,三等
2020-06-17,1130,1488,1530,3018,富岡,三等
2020-06-18,1130,1445,1465,2910,富岡,三等
2020-06-19,1130,1507,1571,3078,富岡,三等
2020-06-20,1130,1619,1662,3281,富岡,三等
2020-06-21,1130,1609,1639,3248,富岡,三等
2020-06-22,1130,1593,1578,3171,富岡,三等
2020-06-23,1130,1454,1542,2996,富岡,三等
2020-06-24,1130,1673,1923,3596,富岡,三等
2020-06-25,1130,1655,1876,3531,富岡,三等
2020-06-26,1130,1709,1659,3368,富岡,三等
2020-06-27,1130,1715,1669,3384,富岡,三等
2020-06-28,1130,1687,1578,3265,富岡,三等
2020-06-29,1130,1556,1574,3130,富岡,三等
2020-06-30,1130,1529,1488,3017,富岡,三等
2020-07-01,1130,1379,1398,2777,富岡,三等
2020-07-02,1130,1405,1460,2865,富岡,三等
2020-07-03,1130,1634,1666,3300,富岡,三等
2020-07-04,1130,1490,1550,3040,富岡,三等
2020-07-05,1130,1678,1687,3365,富岡,三等
2020-07-06,1130,1584,1579,3163,富岡,三等
2020-07-07,1130,1577,1612,3189,富岡,三等
2020-07-08,1130,1551,1574,3125,富岡,三等
2020-07-09,1130,1476,1534,3010,富岡,三等
2020-07-10,1130,1831,1866,3697,富岡,三等
2020-07-11,1130,1586,1594,3180,富岡,三等
2020-07-12,1130,1800,1770,3570,富岡,三等
2020-07-13,1130,1553,1602,3155,富岡,三等
2020-07-14,1130,1511,1571,3082,富岡,三等
2020-07-15,1130,1583,1558,3141,富岡,三等
2020-07-16,1130,1460,1507,2967,富岡,三等
2020-07-17,1130,1657,1656,3313,富岡,三等
2020-07-18,1130,1560,1547,3107,富岡,三等
2020-07-19,1130,1760,1763,3523,富岡,三等
2020-07-20,1130,1524,1515,3039,富岡,三等
2020-07-21,1130,1473,1443,2916,富岡,三等
2020-07-22,1130,1451,1437,2888,富岡,三等
2020-07-23,1130,1475,1447,2922,富岡,三等
2020-07-24,1130,1655,1685,3340,富岡,三等
2020-07-25,1130,1513,1516,3029,富岡,三等
2020-07-26,1130,1703,1621,3324,富岡,三等
2020-07-27,1130,1543,1519,3062,富岡,三等
2020-07-28,1130,1390,1380,2770,富岡,三等
2020-07-29,1130,1467,1440,2907,富岡,三等
2020-07-30,1130,1506,1477,2983,富岡,三等
2020-07-31,1130,1677,1621,3298,富岡,三等
2020-08-01,1130,1504,1529,3033,富岡,三等
2020-08-02,1130,1428,1442,2870,富岡,三等
2020-08-03,1130,1376,1369,2745,富岡,三等
2020-08-04,1130,1437,1521,2958,富岡,三等
2020-08-05,1130,1529,1472,3001,富岡,三等
2020-08-06,1130,1528,1588,3116,富岡,三等
2020-08-07,1130,1713,1805,3518,富岡,三等
2020-08-08,1130,1649,1724,3373,富岡,三等
2020-08-09,1130,1898,1799,3697,富岡,三等
2020-08-10,1130,1580,1610,3190,富岡,三等
2020-08-11,1130,1366,1392,2758,富岡,三等
2020-08-12,1130,1411,1423,2834,富岡,三等
2020-08-13,1130,1494,1496,2990,富岡,三等
2020-08-14,1130,1723,1714,3437,富岡,三等
2020-08-15,1130,3395,2988,6383,富岡,三等
2020-08-16,1130,2719,2737,5456,富岡,三等
2020-08-17,1130,1669,1709,3378,富岡,三等
2020-08-18,1130,1661,1551,3212,富岡,三等
2020-08-19,1130,1635,1671,3306,富岡,三等
2020-08-20,1130,1677,1674,3351,富岡,三等
2020-08-21,1130,1785,1810,3595,富岡,三等
2020-08-22,1130,1988,2014,4002,富岡,三等
2020-08-23,1130,2195,2140,4335,富岡,三等
2020-08-24,1130,1489,1429,2918,富岡,三等
2020-08-25,1130,1523,1406,2929,富岡,三等
2020-08-26,1130,1484,1472,2956,富岡,三等
2020-08-27,1130,1493,1495,2988,富岡,三等
2020-08-28,1130,1606,1637,3243,富岡,三等
2020-08-29,1130,1784,1839,3623,富岡,三等
2020-08-30,1130,1568,1481,3049,富岡,三等
2020-08-31,1130,1571,1583,3154,富岡,三等
2020-09-01,1130,1579,1593,3172,富岡,三等
2020-09-02,1130,1468,1629,3097,富岡,三等
2020-09-03,1130,1537,1567,3104,富岡,三等
2020-09-04,1130,1793,1796,3589,富岡,三等
2020-09-05,1130,1702,1720,3422,富岡,三等
2020-09-06,1130,1742,1690,3432,富岡,三等
2020-09-07,1130,1799,1774,3573,富岡,三等
2020-09-08,1130,1646,1624,3270,富岡,三等
2020-09-09,1130,1646,1686,3332,富岡,三等
2020-09-10,1130,1654,1698,3352,富岡,三等
2020-09-11,1130,1932,1995,3927,富岡,三等
2020-09-12,1130,1738,1759,3497,富岡,三等
2020-09-13,1130,1953,1837,3790,富岡,三等
2020-09-14,1130,1709,1704,3413,富岡,三等
2020-09-15,1130,1555,1604,3159,富岡,三等
2020-09-16,1130,1606,1665,3271,富岡,三等
2020-09-17,1130,1630,1677,3307,富岡,三等
2020-09-18,1130,1721,1947,3668,富岡,三等
2020-09-19,1130,1670,1736,3406,富岡,三等
2020-09-20,1130,1797,1673,3470,富岡,三等
2020-09-21,1130,1693,1675,3368,富岡,三等
2020-09-22,1130,1593,1625,3218,富岡,三等
2020-09-23,1130,1629,1689,3318,富岡,三等
2020-09-24,1130,1594,1642,3236,富岡,三等
2020-09-25,1130,1666,1805,3471,富岡,三等
2020-09-26,1130,1531,1730,3261,富岡,三等
2020-09-27,1130,1398,1339,2737,富岡,三等
2020-09-28,1130,1653,1603,3256,富岡,三等
2020-09-29,1130,1611,1666,3277,富岡,三等
2020-09-30,1130,1755,2137,3892,富岡,三等
2020-10-01,1130,1759,2156,3915,富岡,三等
2020-10-02,1130,2040,2050,4090,富岡,三等
2020-10-03,1130,1909,1802,3711,富岡,三等
2020-10-04,1130,2047,1695,3742,富岡,三等
2020-10-05,1130,1781,1731,3512,富岡,三等
2020-10-06,1130,1656,1712,3368,富岡,三等
2020-10-07,1130,1641,1733,3374,富岡,三等
2020-10-08,1130,1856,2033,3889,富岡,三等
2020-10-09,1130,1798,1904,3702,富岡,三等
2020-10-10,1130,1848,1711,3559,富岡,三等
2020-10-11,1130,2134,1989,4123,富岡,三等
2020-10-12,1130,1833,1789,3622,富岡,三等
2020-10-13,1130,1604,1683,3287,富岡,三等
2020-10-14,1130,1754,1787,3541,富岡,三等
2020-10-15,1130,1670,1755,3425,富岡,三等
2020-10-16,1130,1834,2051,3885,富岡,三等
2020-10-17,1130,1643,1616,3259,富岡,三等
2020-10-18,1130,1943,1832,3775,富岡,三等
2020-10-19,1130,1781,1773,3554,富岡,三等
2020-10-20,1130,1709,1760,3469,富岡,三等
2020-10-21,1130,1568,1710,3278,富岡,三等
2020-10-22,1130,1538,1550,3088,富岡,三等
2020-10-23,1130,1738,1989,3727,富岡,三等
2020-10-24,1130,1646,1732,3378,富岡,三等
2020-10-25,1130,1914,1721,3635,富岡,三等
2020-10-26,1130,1767,1731,3498,富岡,三等
2020-10-27,1130,1690,1710,3400,富岡,三等
2020-10-28,1130,1631,1685,3316,富岡,三等
2020-10-29,1130,1564,1647,3211,富岡,三等
2020-10-30,1130,1859,2028,3887,富岡,三等
2020-10-31,1130,1693,1750,3443,富岡,三等
2020-11-01,1130,1893,1732,3625,富岡,三等
2020-11-02,1130,1802,1770,3572,富岡,三等
2020-11-03,1130,1620,1677,3297,富岡,三等
2020-11-04,1130,1650,1681,3331,富岡,三等
2020-11-05,1130,1679,1818,3497,富岡,三等
2020-11-06,1130,1940,2111,4051,富岡,三等
2020-11-07,1130,2028,2075,4103,富岡,三等
2020-11-08,1130,1974,1958,3932,富岡,三等
2020-11-09,1130,1866,1819,3685,富岡,三等
2020-11-10,1130,1720,1725,3445,富岡,三等
2020-11-11,1130,1800,1817,3617,富岡,三等
2020-11-12,1130,1783,1844,3627,富岡,三等
2020-11-13,1130,1877,2110,3987,富岡,三等
2020-11-14,1130,2031,2113,4144,富岡,三等
2020-11-15,1130,2368,2215,4583,富岡,三等
2020-11-16,1130,1799,1762,3561,富岡,三等
2020-11-17,1130,1686,1754,3440,富岡,三等
2020-11-18,1130,1722,1783,3505,富岡,三等
2020-11-19,1130,1711,1828,3539,富岡,三等
2020-11-20,1130,1908,2121,4029,富岡,三等
2020-11-21,1130,1865,1900,3765,富岡,三等
2020-11-22,1130,1927,1718,3645,富岡,三等
2020-11-23,1130,1782,1743,3525,富岡,三等
2020-11-24,1130,1605,1634,3239,富岡,三等
2020-11-25,1130,1784,1809,3593,富岡,三等
2020-11-26,1130,1729,1827,3556,富岡,三等
2020-11-27,1130,1806,2066,3872,富岡,三等
2020-11-28,1130,1695,1756,3451,富岡,三等
2020-11-29,1130,2053,1823,3876,富岡,三等
2020-11-30,1130,2118,2070,4188,富岡,三等
2020-12-01,1130,1834,1794,3628,富岡,三等
2020-12-02,1130,1859,1907,3766,富岡,三等
2020-12-03,1130,1775,1863,3638,富岡,三等
2020-12-04,1130,1838,2063,3901,富岡,三等
2020-12-05,1130,2025,2105,4130,富岡,三等
2020-12-06,1130,2235,2220,4455,富岡,三等
2020-12-07,1130,2088,2004,4092,富岡,三等
2020-12-08,1130,1787,1850,3637,富岡,三等
2020-12-09,1130,1596,1685,3281,富岡,三等
2020-12-10,1130,1847,1935,3782,富岡,三等
2020-12-11,1130,2019,2211,4230,富岡,三等
2020-12-12,1130,2023,2037,4060,富岡,三等
2020-12-13,1130,2304,2114,4418,富岡,三等
2020-12-14,1130,1818,1759,3577,富岡,三等
2020-12-15,1130,1573,1622,3195,富岡,三等
2020-12-16,1130,1637,1665,3302,富岡,三等
2020-12-17,1130,1714,1781,3495,富岡,三等
2020-12-18,1130,1786,2030,3816,富岡,三等
2020-12-19,1130,1557,1553,3110,富岡,三等
2020-12-20,1130,1942,1773,3715,富岡,三等
2020-12-21,1130,1746,1704,3450,富岡,三等
2020-12-22,1130,1697,1688,3385,富岡,三等
2020-12-23,1130,1545,1620,3165,富岡,三等
2020-12-24,1130,1629,1750,3379,富岡,三等
2020-12-25,1130,1826,2057,3883,富岡,三等
2020-12-26,1130,1578,1631,3209,富岡,三等
2020-12-27,1130,1797,1618,3415,富岡,三等
2020-12-28,1130,1696,1670,3366,富岡,三等
2020-12-29,1130,1616,1669,3285,富岡,三等
2020-12-30,1130,1557,1661,3218,富岡,三等
2020-12-31,1130,1860,1971,3831,富岡,三等
2020-01-01,1140,80,107,187,新富,招呼
2020-01-02,1140,65,87,152,新富,招呼
2020-01-03,1140,89,119,208,新富,招呼
2020-01-04,1140,73,107,180,新富,招呼
2020-01-05,1140,83,94,177,新富,招呼
2020-01-06,1140,82,96,178,新富,招呼
2020-01-07,1140,90,126,216,新富,招呼
2020-01-08,1140,77,98,175,新富,招呼
2020-01-09,1140,78,98,176,新富,招呼
2020-01-10,1140,75,91,166,新富,招呼
2020-01-11,1140,98,122,220,新富,招呼
2020-01-12,1140,97,119,216,新富,招呼
2020-01-13,1140,97,101,198,新富,招呼
2020-01-14,1140,88,116,204,新富,招呼
2020-01-15,1140,55,101,156,新富,招呼
2020-01-16,1140,84,100,184,新富,招呼
2020-01-17,1140,65,86,151,新富,招呼
2020-01-18,1140,78,90,168,新富,招呼
2020-01-19,1140,71,83,154,新富,招呼
2020-01-20,1140,74,84,158,新富,招呼
2020-01-21,1140,75,95,170,新富,招呼
2020-01-22,1140,84,96,180,新富,招呼
2020-01-23,1140,68,98,166,新富,招呼
2020-01-24,1140,62,88,150,新富,招呼
2020-01-25,1140,69,72,141,新富,招呼
2020-01-26,1140,67,78,145,新富,招呼
2020-01-27,1140,55,75,130,新富,招呼
2020-01-28,1140,58,82,140,新富,招呼
2020-01-29,1140,49,66,115,新富,招呼
2020-01-30,1140,69,73,142,新富,招呼
2020-01-31,1140,67,72,139,新富,招呼
2020-02-01,1140,57,88,145,新富,招呼
2020-02-02,1140,88,74,162,新富,招呼
2020-02-03,1140,85,80,165,新富,招呼
2020-02-04,1140,65,66,131,新富,招呼
2020-02-05,1140,65,73,138,新富,招呼
2020-02-06,1140,60,75,135,新富,招呼
2020-02-07,1140,58,85,143,新富,招呼
2020-02-08,1140,69,87,156,新富,招呼
2020-02-09,1140,81,104,185,新富,招呼
2020-02-10,1140,68,86,154,新富,招呼
2020-02-11,1140,60,73,133,新富,招呼
2020-02-12,1140,58,85,143,新富,招呼
2020-02-13,1140,57,71,128,新富,招呼
2020-02-14,1140,48,65,113,新富,招呼
2020-02-15,1140,40,65,105,新富,招呼
2020-02-16,1140,44,58,102,新富,招呼
2020-02-17,1140,55,69,124,新富,招呼
2020-02-18,1140,53,62,115,新富,招呼
2020-02-19,1140,53,72,125,新富,招呼
2020-02-20,1140,54,65,119,新富,招呼
2020-02-21,1140,70,96,166,新富,招呼
2020-02-22,1140,73,89,162,新富,招呼
2020-02-23,1140,63,60,123,新富,招呼
2020-02-24,1140,68,94,162,新富,招呼
2020-02-25,1140,74,90,164,新富,招呼
2020-02-26,1140,70,80,150,新富,招呼
2020-02-27,1140,29,80,109,新富,招呼
2020-02-28,1140,48,85,133,新富,招呼
2020-02-29,1140,48,66,114,新富,招呼
2020-03-01,1140,68,68,136,新富,招呼
2020-03-02,1140,67,95,162,新富,招呼
2020-03-03,1140,62,93,155,新富,招呼
2020-03-04,1140,64,87,151,新富,招呼
2020-03-05,1140,58,76,134,新富,招呼
2020-03-06,1140,60,95,155,新富,招呼
2020-03-07,1140,72,73,145,新富,招呼
2020-03-08,1140,76,89,165,新富,招呼
2020-03-09,1140,65,84,149,新富,招呼
2020-03-10,1140,69,86,155,新富,招呼
2020-03-11,1140,63,86,149,新富,招呼
2020-03-12,1140,56,67,123,新富,招呼
2020-03-13,1140,56,77,133,新富,招呼
2020-03-14,1140,57,56,113,新富,招呼
2020-03-15,1140,68,76,144,新富,招呼
2020-03-16,1140,77,96,173,新富,招呼
2020-03-17,1140,63,80,143,新富,招呼
2020-03-18,1140,53,86,139,新富,招呼
2020-03-19,1140,47,61,108,新富,招呼
2020-03-20,1140,58,74,132,新富,招呼
2020-03-21,1140,45,82,127,新富,招呼
2020-03-22,1140,37,59,96,新富,招呼
2020-03-23,1140,49,70,119,新富,招呼
2020-03-24,1140,45,66,111,新富,招呼
2020-03-25,1140,56,82,138,新富,招呼
2020-03-26,1140,50,75,125,新富,招呼
2020-03-27,1140,47,79,126,新富,招呼
2020-03-28,1140,41,52,93,新富,招呼
2020-03-29,1140,51,48,99,新富,招呼
2020-03-30,1140,65,74,139,新富,招呼
2020-03-31,1140,52,68,120,新富,招呼
2020-04-01,1140,47,73,120,新富,招呼
2020-04-02,1140,42,55,97,新富,招呼
2020-04-03,1140,30,50,80,新富,招呼
2020-04-04,1140,36,35,71,新富,招呼
2020-04-05,1140,48,43,91,新富,招呼
2020-04-06,1140,58,75,133,新富,招呼
2020-04-07,1140,27,60,87,新富,招呼
2020-04-08,1140,49,75,124,新富,招呼
2020-04-09,1140,48,70,118,新富,招呼
2020-04-10,1140,58,101,159,新富,招呼
2020-04-11,1140,57,71,128,新富,招呼
2020-04-12,1140,51,57,108,新富,招呼
2020-04-13,1140,68,78,146,新富,招呼
2020-04-14,1140,57,68,125,新富,招呼
2020-04-15,1140,53,75,128,新富,招呼
2020-04-16,1140,54,68,122,新富,招呼
2020-04-17,1140,60,81,141,新富,招呼
2020-04-18,1140,39,49,88,新富,招呼
2020-04-19,1140,55,45,100,新富,招呼
2020-04-20,1140,56,68,124,新富,招呼
2020-04-21,1140,45,68,113,新富,招呼
2020-04-22,1140,38,60,98,新富,招呼
2020-04-23,1140,50,63,113,新富,招呼
2020-04-24,1140,56,84,140,新富,招呼
2020-04-25,1140,40,62,102,新富,招呼
2020-04-26,1140,64,59,123,新富,招呼
2020-04-27,1140,63,81,144,新富,招呼
2020-04-28,1140,48,69,117,新富,招呼
2020-04-29,1140,50,72,122,新富,招呼
2020-04-30,1140,56,87,143,新富,招呼
2020-05-01,1140,45,69,114,新富,招呼
2020-05-02,1140,52,75,127,新富,招呼
2020-05-03,1140,59,63,122,新富,招呼
2020-05-04,1140,59,76,135,新富,招呼
2020-05-05,1140,55,81,136,新富,招呼
2020-05-06,1140,58,80,138,新富,招呼
2020-05-07,1140,58,70,128,新富,招呼
2020-05-08,1140,71,110,181,新富,招呼
2020-05-09,1140,59,73,132,新富,招呼
2020-05-10,1140,55,77,132,新富,招呼
2020-05-11,1140,59,77,136,新富,招呼
2020-05-12,1140,55,80,135,新富,招呼
2020-05-13,1140,53,82,135,新富,招呼
2020-05-14,1140,50,75,125,新富,招呼
2020-05-15,1140,84,104,188,新富,招呼
2020-05-16,1140,44,71,115,新富,招呼
2020-05-17,1140,51,64,115,新富,招呼
2020-05-18,1140,58,82,140,新富,招呼
2020-05-19,1140,45,63,108,新富,招呼
2020-05-20,1140,52,84,136,新富,招呼
2020-05-21,1140,49,73,122,新富,招呼
2020-05-22,1140,53,71,124,新富,招呼
2020-05-23,1140,53,54,107,新富,招呼
2020-05-24,1140,66,71,137,新富,招呼
2020-05-25,1140,68,82,150,新富,招呼
2020-05-26,1140,68,77,145,新富,招呼
2020-05-27,1140,54,75,129,新富,招呼
2020-05-28,1140,44,61,105,新富,招呼
2020-05-29,1140,59,94,153,新富,招呼
2020-05-30,1140,77,87,164,新富,招呼
2020-05-31,1140,60,77,137,新富,招呼
2020-06-01,1140,64,77,141,新富,招呼
2020-06-02,1140,55,68,123,新富,招呼
2020-06-03,1140,62,79,141,新富,招呼
2020-06-04,1140,55,61,116,新富,招呼
2020-06-05,1140,75,102,177,新富,招呼
2020-06-06,1140,83,87,170,新富,招呼
2020-06-07,1140,59,83,142,新富,招呼
2020-06-08,1140,65,80,145,新富,招呼
2020-06-09,1140,66,79,145,新富,招呼
2020-06-10,1140,67,93,160,新富,招呼
2020-06-11,1140,67,94,161,新富,招呼
2020-06-12,1140,60,86,146,新富,招呼
2020-06-13,1140,61,78,139,新富,招呼
2020-06-14,1140,86,82,168,新富,招呼
2020-06-15,1140,64,80,144,新富,招呼
2020-06-16,1140,71,97,168,新富,招呼
2020-06-17,1140,67,85,152,新富,招呼
2020-06-18,1140,59,83,142,新富,招呼
2020-06-19,1140,66,104,170,新富,招呼
2020-06-20,1140,71,80,151,新富,招呼
2020-06-21,1140,52,71,123,新富,招呼
2020-06-22,1140,62,81,143,新富,招呼
2020-06-23,1140,58,85,143,新富,招呼
2020-06-24,1140,70,81,151,新富,招呼
2020-06-25,1140,78,80,158,新富,招呼
2020-06-26,1140,59,83,142,新富,招呼
2020-06-27,1140,76,80,156,新富,招呼
2020-06-28,1140,75,98,173,新富,招呼
2020-06-29,1140,64,92,156,新富,招呼
2020-06-30,1140,68,85,153,新富,招呼
2020-07-01,1140,59,82,141,新富,招呼
2020-07-02,1140,60,81,141,新富,招呼
2020-07-03,1140,61,82,143,新富,招呼
2020-07-04,1140,57,70,127,新富,招呼
2020-07-05,1140,72,80,152,新富,招呼
2020-07-06,1140,67,92,159,新富,招呼
2020-07-07,1140,86,108,194,新富,招呼
2020-07-08,1140,65,82,147,新富,招呼
2020-07-09,1140,66,78,144,新富,招呼
2020-07-10,1140,86,122,208,新富,招呼
2020-07-11,1140,84,95,179,新富,招呼
2020-07-12,1140,66,94,160,新富,招呼
2020-07-13,1140,63,103,166,新富,招呼
2020-07-14,1140,66,103,169,新富,招呼
2020-07-15,1140,84,106,190,新富,招呼
2020-07-16,1140,73,89,162,新富,招呼
2020-07-17,1140,91,119,210,新富,招呼
2020-07-18,1140,70,75,145,新富,招呼
2020-07-19,1140,88,110,198,新富,招呼
2020-07-20,1140,68,99,167,新富,招呼
2020-07-21,1140,61,97,158,新富,招呼
2020-07-22,1140,74,89,163,新富,招呼
2020-07-23,1140,61,87,148,新富,招呼
2020-07-24,1140,66,94,160,新富,招呼
2020-07-25,1140,56,69,125,新富,招呼
2020-07-26,1140,66,67,133,新富,招呼
2020-07-27,1140,63,83,146,新富,招呼
2020-07-28,1140,73,99,172,新富,招呼
2020-07-29,1140,63,92,155,新富,招呼
2020-07-30,1140,64,76,140,新富,招呼
2020-07-31,1140,69,83,152,新富,招呼
2020-08-01,1140,61,83,144,新富,招呼
2020-08-02,1140,54,68,122,新富,招呼
2020-08-03,1140,62,78,140,新富,招呼
2020-08-04,1140,58,70,128,新富,招呼
2020-08-05,1140,63,89,152,新富,招呼
2020-08-06,1140,71,82,153,新富,招呼
2020-08-07,1140,41,76,117,新富,招呼
2020-08-08,1140,62,73,135,新富,招呼
2020-08-09,1140,59,74,133,新富,招呼
2020-08-10,1140,55,70,125,新富,招呼
2020-08-11,1140,57,68,125,新富,招呼
2020-08-12,1140,61,77,138,新富,招呼
2020-08-13,1140,68,83,151,新富,招呼
2020-08-14,1140,61,85,146,新富,招呼
2020-08-15,1140,95,127,222,新富,招呼
2020-08-16,1140,71,84,155,新富,招呼
2020-08-17,1140,65,78,143,新富,招呼
2020-08-18,1140,72,95,167,新富,招呼
2020-08-19,1140,67,83,150,新富,招呼
2020-08-20,1140,68,79,147,新富,招呼
2020-08-21,1140,69,89,158,新富,招呼
2020-08-22,1140,85,94,179,新富,招呼
2020-08-23,1140,73,89,162,新富,招呼
2020-08-24,1140,65,84,149,新富,招呼
2020-08-25,1140,81,87,168,新富,招呼
2020-08-26,1140,61,77,138,新富,招呼
2020-08-27,1140,58,66,124,新富,招呼
2020-08-28,1140,63,83,146,新富,招呼
2020-08-29,1140,59,74,133,新富,招呼
2020-08-30,1140,59,75,134,新富,招呼
2020-08-31,1140,50,72,122,新富,招呼
2020-09-01,1140,58,84,142,新富,招呼
2020-09-02,1140,58,98,156,新富,招呼
2020-09-03,1140,65,85,150,新富,招呼
2020-09-04,1140,61,78,139,新富,招呼
2020-09-05,1140,65,71,136,新富,招呼
2020-09-06,1140,58,81,139,新富,招呼
2020-09-07,1140,71,87,158,新富,招呼
2020-09-08,1140,66,96,162,新富,招呼
2020-09-09,1140,63,80,143,新富,招呼
2020-09-10,1140,57,81,138,新富,招呼
2020-09-11,1140,74,106,180,新富,招呼
2020-09-12,1140,67,98,165,新富,招呼
2020-09-13,1140,57,71,128,新富,招呼
2020-09-14,1140,68,88,156,新富,招呼
2020-09-15,1140,74,78,152,新富,招呼
2020-09-16,1140,72,94,166,新富,招呼
2020-09-17,1140,59,72,131,新富,招呼
2020-09-18,1140,76,93,169,新富,招呼
2020-09-19,1140,55,86,141,新富,招呼
2020-09-20,1140,54,67,121,新富,招呼
2020-09-21,1140,67,83,150,新富,招呼
2020-09-22,1140,64,87,151,新富,招呼
2020-09-23,1140,54,67,121,新富,招呼
2020-09-24,1140,60,69,129,新富,招呼
2020-09-25,1140,72,95,167,新富,招呼
2020-09-26,1140,84,89,173,新富,招呼
2020-09-27,1140,59,64,123,新富,招呼
2020-09-28,1140,77,83,160,新富,招呼
2020-09-29,1140,72,83,155,新富,招呼
2020-09-30,1140,78,97,175,新富,招呼
2020-10-01,1140,92,130,222,新富,招呼
2020-10-02,1140,90,106,196,新富,招呼
2020-10-03,1140,53,87,140,新富,招呼
2020-10-04,1140,66,94,160,新富,招呼
2020-10-05,1140,79,81,160,新富,招呼
2020-10-06,1140,81,94,175,新富,招呼
2020-10-07,1140,73,94,167,新富,招呼
2020-10-08,1140,59,76,135,新富,招呼
2020-10-09,1140,80,91,171,新富,招呼
2020-10-10,1140,77,90,167,新富,招呼
2020-10-11,1140,77,114,191,新富,招呼
2020-10-12,1140,67,88,155,新富,招呼
2020-10-13,1140,69,75,144,新富,招呼
2020-10-14,1140,81,94,175,新富,招呼
2020-10-15,1140,68,82,150,新富,招呼
2020-10-16,1140,70,81,151,新富,招呼
2020-10-17,1140,64,69,133,新富,招呼
2020-10-18,1140,77,100,177,新富,招呼
2020-10-19,1140,57,86,143,新富,招呼
2020-10-20,1140,66,72,138,新富,招呼
2020-10-21,1140,74,80,154,新富,招呼
2020-10-22,1140,58,79,137,新富,招呼
2020-10-23,1140,65,89,154,新富,招呼
2020-10-24,1140,76,97,173,新富,招呼
2020-10-25,1140,68,83,151,新富,招呼
2020-10-26,1140,71,100,171,新富,招呼
2020-10-27,1140,81,95,176,新富,招呼
2020-10-28,1140,68,80,148,新富,招呼
2020-10-29,1140,57,74,131,新富,招呼
2020-10-30,1140,63,90,153,新富,招呼
2020-10-31,1140,84,81,165,新富,招呼
2020-11-01,1140,74,82,156,新富,招呼
2020-11-02,1140,73,73,146,新富,招呼
2020-11-03,1140,69,86,155,新富,招呼
2020-11-04,1140,80,93,173,新富,招呼
2020-11-05,1140,65,84,149,新富,招呼
2020-11-06,1140,84,119,203,新富,招呼
2020-11-07,1140,107,121,228,新富,招呼
2020-11-08,1140,82,94,176,新富,招呼
2020-11-09,1140,76,83,159,新富,招呼
2020-11-10,1140,69,91,160,新富,招呼
2020-11-11,1140,65,99,164,新富,招呼
2020-11-12,1140,76,99,175,新富,招呼
2020-11-13,1140,61,82,143,新富,招呼
2020-11-14,1140,80,92,172,新富,招呼
2020-11-15,1140,77,112,189,新富,招呼
2020-11-16,1140,68,86,154,新富,招呼
2020-11-17,1140,80,97,177,新富,招呼
2020-11-18,1140,68,83,151,新富,招呼
2020-11-19,1140,57,78,135,新富,招呼
2020-11-20,1140,86,102,188,新富,招呼
2020-11-21,1140,91,96,187,新富,招呼
2020-11-22,1140,67,96,163,新富,招呼
2020-11-23,1140,76,91,167,新富,招呼
2020-11-24,1140,76,97,173,新富,招呼
2020-11-25,1140,62,92,154,新富,招呼
2020-11-26,1140,79,95,174,新富,招呼
2020-11-27,1140,75,104,179,新富,招呼
2020-11-28,1140,85,107,192,新富,招呼
2020-11-29,1140,83,110,193,新富,招呼
2020-11-30,1140,76,92,168,新富,招呼
2020-12-01,1140,73,96,169,新富,招呼
2020-12-02,1140,77,89,166,新富,招呼
2020-12-03,1140,83,95,178,新富,招呼
2020-12-04,1140,62,84,146,新富,招呼
2020-12-05,1140,92,103,195,新富,招呼
2020-12-06,1140,82,105,187,新富,招呼
2020-12-07,1140,79,99,178,新富,招呼
2020-12-08,1140,72,87,159,新富,招呼
2020-12-09,1140,68,85,153,新富,招呼
2020-12-10,1140,67,83,150,新富,招呼
2020-12-11,1140,81,98,179,新富,招呼
2020-12-12,1140,93,101,194,新富,招呼
2020-12-13,1140,94,133,227,新富,招呼
2020-12-14,1140,77,93,170,新富,招呼
2020-12-15,1140,69,87,156,新富,招呼
2020-12-16,1140,77,79,156,新富,招呼
2020-12-17,1140,133,145,278,新富,招呼
2020-12-18,1140,76,95,171,新富,招呼
2020-12-19,1140,70,85,155,新富,招呼
2020-12-20,1140,82,103,185,新富,招呼
2020-12-21,1140,77,107,184,新富,招呼
2020-12-22,1140,80,90,170,新富,招呼
2020-12-23,1140,69,83,152,新富,招呼
2020-12-24,1140,64,75,139,新富,招呼
2020-12-25,1140,79,97,176,新富,招呼
2020-12-26,1140,77,104,181,新富,招呼
2020-12-27,1140,78,92,170,新富,招呼
2020-12-28,1140,63,87,150,新富,招呼
2020-12-29,1140,72,93,165,新富,招呼
2020-12-30,1140,76,87,163,新富,招呼
2020-12-31,1140,82,76,158,新富,招呼
2020-01-01,1150,608,851,1459,北湖,甲簡
2020-01-02,1150,971,1035,2006,北湖,甲簡
2020-01-03,1150,1071,854,1925,北湖,甲簡
2020-01-04,1150,648,731,1379,北湖,甲簡
2020-01-05,1150,607,829,1436,北湖,甲簡
2020-01-06,1150,967,1163,2130,北湖,甲簡
2020-01-07,1150,1055,1055,2110,北湖,甲簡
2020-01-08,1150,1094,1113,2207,北湖,甲簡
2020-01-09,1150,1188,1115,2303,北湖,甲簡
2020-01-10,1150,1188,919,2107,北湖,甲簡
2020-01-11,1150,597,602,1199,北湖,甲簡
2020-01-12,1150,559,586,1145,北湖,甲簡
2020-01-13,1150,675,725,1400,北湖,甲簡
2020-01-14,1150,653,637,1290,北湖,甲簡
2020-01-15,1150,654,687,1341,北湖,甲簡
2020-01-16,1150,651,630,1281,北湖,甲簡
2020-01-17,1150,647,669,1316,北湖,甲簡
2020-01-18,1150,517,546,1063,北湖,甲簡
2020-01-19,1150,431,511,942,北湖,甲簡
2020-01-20,1150,630,606,1236,北湖,甲簡
2020-01-21,1150,738,625,1363,北湖,甲簡
2020-01-22,1150,568,583,1151,北湖,甲簡
2020-01-23,1150,525,509,1034,北湖,甲簡
2020-01-24,1150,328,321,649,北湖,甲簡
2020-01-25,1150,372,372,744,北湖,甲簡
2020-01-26,1150,286,297,583,北湖,甲簡
2020-01-27,1150,383,386,769,北湖,甲簡
2020-01-28,1150,378,397,775,北湖,甲簡
2020-01-29,1150,372,372,744,北湖,甲簡
2020-01-30,1150,461,491,952,北湖,甲簡
2020-01-31,1150,504,523,1027,北湖,甲簡
2020-02-01,1150,416,406,822,北湖,甲簡
2020-02-02,1150,390,411,801,北湖,甲簡
2020-02-03,1150,513,505,1018,北湖,甲簡
2020-02-04,1150,487,512,999,北湖,甲簡
2020-02-05,1150,525,524,1049,北湖,甲簡
2020-02-06,1150,533,525,1058,北湖,甲簡
2020-02-07,1150,591,559,1150,北湖,甲簡
2020-02-08,1150,430,434,864,北湖,甲簡
2020-02-09,1150,369,383,752,北湖,甲簡
2020-02-10,1150,510,503,1013,北湖,甲簡
2020-02-11,1150,514,512,1026,北湖,甲簡
2020-02-12,1150,556,533,1089,北湖,甲簡
2020-02-13,1150,532,506,1038,北湖,甲簡
2020-02-14,1150,569,508,1077,北湖,甲簡
2020-02-15,1150,453,434,887,北湖,甲簡
2020-02-16,1150,312,366,678,北湖,甲簡
2020-02-17,1150,522,531,1053,北湖,甲簡
2020-02-18,1150,533,521,1054,北湖,甲簡
2020-02-19,1150,545,516,1061,北湖,甲簡
2020-02-20,1150,509,537,1046,北湖,甲簡
2020-02-21,1150,585,578,1163,北湖,甲簡
2020-02-22,1150,497,511,1008,北湖,甲簡
2020-02-23,1150,489,553,1042,北湖,甲簡
2020-02-24,1150,780,905,1685,北湖,甲簡
2020-02-25,1150,975,1022,1997,北湖,甲簡
2020-02-26,1150,986,934,1920,北湖,甲簡
2020-02-27,1150,1250,929,2179,北湖,甲簡
2020-02-28,1150,609,503,1112,北湖,甲簡
2020-02-29,1150,416,387,803,北湖,甲簡
2020-03-01,1150,434,683,1117,北湖,甲簡
2020-03-02,1150,932,1108,2040,北湖,甲簡
2020-03-03,1150,906,938,1844,北湖,甲簡
2020-03-04,1150,936,888,1824,北湖,甲簡
2020-03-05,1150,971,875,1846,北湖,甲簡
2020-03-06,1150,1084,784,1868,北湖,甲簡
2020-03-07,1150,548,530,1078,北湖,甲簡
2020-03-08,1150,466,687,1153,北湖,甲簡
2020-03-09,1150,895,1046,1941,北湖,甲簡
2020-03-10,1150,825,892,1717,北湖,甲簡
2020-03-11,1150,965,941,1906,北湖,甲簡
2020-03-12,1150,1017,936,1953,北湖,甲簡
2020-03-13,1150,1021,769,1790,北湖,甲簡
2020-03-14,1150,528,458,986,北湖,甲簡
2020-03-15,1150,432,677,1109,北湖,甲簡
2020-03-16,1150,838,1038,1876,北湖,甲簡
2020-03-17,1150,892,928,1820,北湖,甲簡
2020-03-18,1150,883,861,1744,北湖,甲簡
2020-03-19,1150,954,880,1834,北湖,甲簡
2020-03-20,1150,1068,804,1872,北湖,甲簡
2020-03-21,1150,453,431,884,北湖,甲簡
2020-03-22,1150,359,570,929,北湖,甲簡
2020-03-23,1150,811,977,1788,北湖,甲簡
2020-03-24,1150,826,857,1683,北湖,甲簡
2020-03-25,1150,867,857,1724,北湖,甲簡
2020-03-26,1150,952,860,1812,北湖,甲簡
2020-03-27,1150,932,726,1658,北湖,甲簡
2020-03-28,1150,390,400,790,北湖,甲簡
2020-03-29,1150,419,605,1024,北湖,甲簡
2020-03-30,1150,747,906,1653,北湖,甲簡
2020-03-31,1150,831,837,1668,北湖,甲簡
2020-04-01,1150,1128,805,1933,北湖,甲簡
2020-04-02,1150,448,340,788,北湖,甲簡
2020-04-03,1150,367,322,689,北湖,甲簡
2020-04-04,1150,308,315,623,北湖,甲簡
2020-04-05,1150,333,565,898,北湖,甲簡
2020-04-06,1150,760,915,1675,北湖,甲簡
2020-04-07,1150,763,823,1586,北湖,甲簡
2020-04-08,1150,800,780,1580,北湖,甲簡
2020-04-09,1150,886,847,1733,北湖,甲簡
2020-04-10,1150,997,738,1735,北湖,甲簡
2020-04-11,1150,414,409,823,北湖,甲簡
2020-04-12,1150,376,565,941,北湖,甲簡
2020-04-13,1150,766,918,1684,北湖,甲簡
2020-04-14,1150,782,831,1613,北湖,甲簡
2020-04-15,1150,853,822,1675,北湖,甲簡
2020-04-16,1150,923,852,1775,北湖,甲簡
2020-04-17,1150,948,750,1698,北湖,甲簡
2020-04-18,1150,558,552,1110,北湖,甲簡
2020-04-19,1150,413,602,1015,北湖,甲簡
2020-04-20,1150,763,911,1674,北湖,甲簡
2020-04-21,1150,806,813,1619,北湖,甲簡
2020-04-22,1150,820,806,1626,北湖,甲簡
2020-04-23,1150,909,819,1728,北湖,甲簡
2020-04-24,1150,992,723,1715,北湖,甲簡
2020-04-25,1150,432,403,835,北湖,甲簡
2020-04-26,1150,371,595,966,北湖,甲簡
2020-04-27,1150,782,626,1408,北湖,甲簡
2020-04-28,1150,766,541,1307,北湖,甲簡
2020-04-29,1150,827,551,1378,北湖,甲簡
2020-04-30,1150,976,897,1873,北湖,甲簡
2020-05-01,1150,865,542,1407,北湖,甲簡
2020-05-02,1150,416,405,821,北湖,甲簡
2020-05-03,1150,378,463,841,北湖,甲簡
2020-05-04,1150,807,981,1788,北湖,甲簡
2020-05-05,1150,860,618,1478,北湖,甲簡
2020-05-06,1150,893,871,1764,北湖,甲簡
2020-05-07,1150,972,860,1832,北湖,甲簡
2020-05-08,1150,1001,538,1539,北湖,甲簡
2020-05-09,1150,481,468,949,北湖,甲簡
2020-05-10,1150,452,708,1160,北湖,甲簡
2020-05-11,1150,831,570,1401,北湖,甲簡
2020-05-12,1150,828,485,1313,北湖,甲簡
2020-05-13,1150,870,856,1726,北湖,甲簡
2020-05-14,1150,995,911,1906,北湖,甲簡
2020-05-15,1150,1039,781,1820,北湖,甲簡
2020-05-16,1150,480,453,933,北湖,甲簡
2020-05-17,1150,391,631,1022,北湖,甲簡
2020-05-18,1150,793,970,1763,北湖,甲簡
2020-05-19,1150,792,825,1617,北湖,甲簡
2020-05-20,1150,903,902,1805,北湖,甲簡
2020-05-21,1150,900,426,1326,北湖,甲簡
2020-05-22,1150,961,483,1444,北湖,甲簡
2020-05-23,1150,509,468,977,北湖,甲簡
2020-05-24,1150,475,407,882,北湖,甲簡
2020-05-25,1150,876,1014,1890,北湖,甲簡
2020-05-26,1150,823,863,1686,北湖,甲簡
2020-05-27,1150,812,804,1616,北湖,甲簡
2020-05-28,1150,908,812,1720,北湖,甲簡
2020-05-29,1150,1004,771,1775,北湖,甲簡
2020-05-30,1150,516,522,1038,北湖,甲簡
2020-05-31,1150,528,754,1282,北湖,甲簡
2020-06-01,1150,835,988,1823,北湖,甲簡
2020-06-02,1150,852,898,1750,北湖,甲簡
2020-06-03,1150,858,826,1684,北湖,甲簡
2020-06-04,1150,972,839,1811,北湖,甲簡
2020-06-05,1150,990,799,1789,北湖,甲簡
2020-06-06,1150,501,498,999,北湖,甲簡
2020-06-07,1150,407,577,984,北湖,甲簡
2020-06-08,1150,831,956,1787,北湖,甲簡
2020-06-09,1150,858,905,1763,北湖,甲簡
2020-06-10,1150,922,903,1825,北湖,甲簡
2020-06-11,1150,1029,951,1980,北湖,甲簡
2020-06-12,1150,1021,888,1909,北湖,甲簡
2020-06-13,1150,864,867,1731,北湖,甲簡
2020-06-14,1150,473,646,1119,北湖,甲簡
2020-06-15,1150,854,961,1815,北湖,甲簡
2020-06-16,1150,827,853,1680,北湖,甲簡
2020-06-17,1150,858,853,1711,北湖,甲簡
2020-06-18,1150,953,882,1835,北湖,甲簡
2020-06-19,1150,963,819,1782,北湖,甲簡
2020-06-20,1150,592,517,1109,北湖,甲簡
2020-06-21,1150,452,560,1012,北湖,甲簡
2020-06-22,1150,721,760,1481,北湖,甲簡
2020-06-23,1150,688,713,1401,北湖,甲簡
2020-06-24,1150,776,720,1496,北湖,甲簡
2020-06-25,1150,521,507,1028,北湖,甲簡
2020-06-26,1150,514,493,1007,北湖,甲簡
2020-06-27,1150,400,430,830,北湖,甲簡
2020-06-28,1150,483,529,1012,北湖,甲簡
2020-06-29,1150,629,665,1294,北湖,甲簡
2020-06-30,1150,649,647,1296,北湖,甲簡
2020-07-01,1150,590,589,1179,北湖,甲簡
2020-07-02,1150,608,580,1188,北湖,甲簡
2020-07-03,1150,544,539,1083,北湖,甲簡
2020-07-04,1150,458,443,901,北湖,甲簡
2020-07-05,1150,431,452,883,北湖,甲簡
2020-07-06,1150,530,560,1090,北湖,甲簡
2020-07-07,1150,574,581,1155,北湖,甲簡
2020-07-08,1150,537,522,1059,北湖,甲簡
2020-07-09,1150,552,544,1096,北湖,甲簡
2020-07-10,1150,582,576,1158,北湖,甲簡
2020-07-11,1150,496,494,990,北湖,甲簡
2020-07-12,1150,444,471,915,北湖,甲簡
2020-07-13,1150,514,538,1052,北湖,甲簡
2020-07-14,1150,622,646,1268,北湖,甲簡
2020-07-15,1150,559,547,1106,北湖,甲簡
2020-07-16,1150,493,547,1040,北湖,甲簡
2020-07-17,1150,598,572,1170,北湖,甲簡
2020-07-18,1150,465,471,936,北湖,甲簡
2020-07-19,1150,393,460,853,北湖,甲簡
2020-07-20,1150,576,542,1118,北湖,甲簡
2020-07-21,1150,567,597,1164,北湖,甲簡
2020-07-22,1150,576,547,1123,北湖,甲簡
2020-07-23,1150,532,544,1076,北湖,甲簡
2020-07-24,1150,578,517,1095,北湖,甲簡
2020-07-25,1150,483,456,939,北湖,甲簡
2020-07-26,1150,399,457,856,北湖,甲簡
2020-07-27,1150,494,505,999,北湖,甲簡
2020-07-28,1150,534,539,1073,北湖,甲簡
2020-07-29,1150,536,525,1061,北湖,甲簡
2020-07-30,1150,589,555,1144,北湖,甲簡
2020-07-31,1150,583,584,1167,北湖,甲簡
2020-08-01,1150,549,535,1084,北湖,甲簡
2020-08-02,1150,379,421,800,北湖,甲簡
2020-08-03,1150,486,494,980,北湖,甲簡
2020-08-04,1150,532,533,1065,北湖,甲簡
2020-08-05,1150,560,518,1078,北湖,甲簡
2020-08-06,1150,553,545,1098,北湖,甲簡
2020-08-07,1150,605,587,1192,北湖,甲簡
2020-08-08,1150,522,529,1051,北湖,甲簡
2020-08-09,1150,412,446,858,北湖,甲簡
2020-08-10,1150,526,531,1057,北湖,甲簡
2020-08-11,1150,505,504,1009,北湖,甲簡
2020-08-12,1150,594,577,1171,北湖,甲簡
2020-08-13,1150,565,547,1112,北湖,甲簡
2020-08-14,1150,597,556,1153,北湖,甲簡
2020-08-15,1150,531,556,1087,北湖,甲簡
2020-08-16,1150,461,495,956,北湖,甲簡
2020-08-17,1150,532,543,1075,北湖,甲簡
2020-08-18,1150,552,547,1099,北湖,甲簡
2020-08-19,1150,567,557,1124,北湖,甲簡
2020-08-20,1150,532,531,1063,北湖,甲簡
2020-08-21,1150,548,535,1083,北湖,甲簡
2020-08-22,1150,562,549,1111,北湖,甲簡
2020-08-23,1150,447,447,894,北湖,甲簡
2020-08-24,1150,553,524,1077,北湖,甲簡
2020-08-25,1150,588,585,1173,北湖,甲簡
2020-08-26,1150,567,529,1096,北湖,甲簡
2020-08-27,1150,513,526,1039,北湖,甲簡
2020-08-28,1150,578,578,1156,北湖,甲簡
2020-08-29,1150,434,455,889,北湖,甲簡
2020-08-30,1150,404,441,845,北湖,甲簡
2020-08-31,1150,526,532,1058,北湖,甲簡
2020-09-01,1150,571,573,1144,北湖,甲簡
2020-09-02,1150,527,534,1061,北湖,甲簡
2020-09-03,1150,516,519,1035,北湖,甲簡
2020-09-04,1150,575,596,1171,北湖,甲簡
2020-09-05,1150,475,454,929,北湖,甲簡
2020-09-06,1150,420,490,910,北湖,甲簡
2020-09-07,1150,588,560,1148,北湖,甲簡
2020-09-08,1150,554,560,1114,北湖,甲簡
2020-09-09,1150,538,529,1067,北湖,甲簡
2020-09-10,1150,541,550,1091,北湖,甲簡
2020-09-11,1150,622,627,1249,北湖,甲簡
2020-09-12,1150,595,567,1162,北湖,甲簡
2020-09-13,1150,556,525,1081,北湖,甲簡
2020-09-14,1150,698,748,1446,北湖,甲簡
2020-09-15,1150,718,783,1501,北湖,甲簡
2020-09-16,1150,921,893,1814,北湖,甲簡
2020-09-17,1150,917,852,1769,北湖,甲簡
2020-09-18,1150,994,738,1732,北湖,甲簡
2020-09-19,1150,622,570,1192,北湖,甲簡
2020-09-20,1150,489,676,1165,北湖,甲簡
2020-09-21,1150,870,993,1863,北湖,甲簡
2020-09-22,1150,880,907,1787,北湖,甲簡
2020-09-23,1150,928,898,1826,北湖,甲簡
2020-09-24,1150,861,796,1657,北湖,甲簡
2020-09-25,1150,803,762,1565,北湖,甲簡
2020-09-26,1150,781,663,1444,北湖,甲簡
2020-09-27,1150,457,569,1026,北湖,甲簡
2020-09-28,1150,797,899,1696,北湖,甲簡
2020-09-29,1150,926,869,1795,北湖,甲簡
2020-09-30,1150,1190,921,2111,北湖,甲簡
2020-10-01,1150,672,583,1255,北湖,甲簡
2020-10-02,1150,576,616,1192,北湖,甲簡
2020-10-03,1150,495,514,1009,北湖,甲簡
2020-10-04,1150,542,713,1255,北湖,甲簡
2020-10-05,1150,869,1006,1875,北湖,甲簡
2020-10-06,1150,906,907,1813,北湖,甲簡
2020-10-07,1150,878,832,1710,北湖,甲簡
2020-10-08,1150,1088,867,1955,北湖,甲簡
2020-10-09,1150,767,644,1411,北湖,甲簡
2020-10-10,1150,600,594,1194,北湖,甲簡
2020-10-11,1150,553,756,1309,北湖,甲簡
2020-10-12,1150,841,970,1811,北湖,甲簡
2020-10-13,1150,915,907,1822,北湖,甲簡
2020-10-14,1150,959,925,1884,北湖,甲簡
2020-10-15,1150,869,818,1687,北湖,甲簡
2020-10-16,1150,1013,850,1863,北湖,甲簡
2020-10-17,1150,726,690,1416,北湖,甲簡
2020-10-18,1150,575,706,1281,北湖,甲簡
2020-10-19,1150,815,918,1733,北湖,甲簡
2020-10-20,1150,887,878,1765,北湖,甲簡
2020-10-21,1150,910,873,1783,北湖,甲簡
2020-10-22,1150,822,805,1627,北湖,甲簡
2020-10-23,1150,959,780,1739,北湖,甲簡
2020-10-24,1150,785,752,1537,北湖,甲簡
2020-10-25,1150,592,705,1297,北湖,甲簡
2020-10-26,1150,873,962,1835,北湖,甲簡
2020-10-27,1150,850,860,1710,北湖,甲簡
2020-10-28,1150,920,874,1794,北湖,甲簡
2020-10-29,1150,814,634,1448,北湖,甲簡
2020-10-30,1150,1022,808,1830,北湖,甲簡
2020-10-31,1150,618,593,1211,北湖,甲簡
2020-11-01,1150,554,738,1292,北湖,甲簡
2020-11-02,1150,821,923,1744,北湖,甲簡
2020-11-03,1150,883,889,1772,北湖,甲簡
2020-11-04,1150,912,903,1815,北湖,甲簡
2020-11-05,1150,887,819,1706,北湖,甲簡
2020-11-06,1150,991,814,1805,北湖,甲簡
2020-11-07,1150,693,630,1323,北湖,甲簡
2020-11-08,1150,545,696,1241,北湖,甲簡
2020-11-09,1150,843,967,1810,北湖,甲簡
2020-11-10,1150,888,895,1783,北湖,甲簡
2020-11-11,1150,938,910,1848,北湖,甲簡
2020-11-12,1150,959,869,1828,北湖,甲簡
2020-11-13,1150,968,753,1721,北湖,甲簡
2020-11-14,1150,720,678,1398,北湖,甲簡
2020-11-15,1150,613,767,1380,北湖,甲簡
2020-11-16,1150,884,993,1877,北湖,甲簡
2020-11-17,1150,900,891,1791,北湖,甲簡
2020-11-18,1150,948,918,1866,北湖,甲簡
2020-11-19,1150,914,844,1758,北湖,甲簡
2020-11-20,1150,901,878,1779,北湖,甲簡
2020-11-21,1150,1137,967,2104,北湖,甲簡
2020-11-22,1150,636,612,1248,北湖,甲簡
2020-11-23,1150,733,900,1633,北湖,甲簡
2020-11-24,1150,882,948,1830,北湖,甲簡
2020-11-25,1150,890,863,1753,北湖,甲簡
2020-11-26,1150,933,853,1786,北湖,甲簡
2020-11-27,1150,1016,823,1839,北湖,甲簡
2020-11-28,1150,645,647,1292,北湖,甲簡
2020-11-29,1150,589,738,1327,北湖,甲簡
2020-11-30,1150,854,956,1810,北湖,甲簡
2020-12-01,1150,859,873,1732,北湖,甲簡
2020-12-02,1150,897,879,1776,北湖,甲簡
2020-12-03,1150,862,815,1677,北湖,甲簡
2020-12-04,1150,958,820,1778,北湖,甲簡
2020-12-05,1150,774,689,1463,北湖,甲簡
2020-12-06,1150,629,775,1404,北湖,甲簡
2020-12-07,1150,827,909,1736,北湖,甲簡
2020-12-08,1150,801,894,1695,北湖,甲簡
2020-12-09,1150,811,833,1644,北湖,甲簡
2020-12-10,1150,858,828,1686,北湖,甲簡
2020-12-11,1150,1033,844,1877,北湖,甲簡
2020-12-12,1150,719,659,1378,北湖,甲簡
2020-12-13,1150,611,724,1335,北湖,甲簡
2020-12-14,1150,769,913,1682,北湖,甲簡
2020-12-15,1150,867,885,1752,北湖,甲簡
2020-12-16,1150,956,907,1863,北湖,甲簡
2020-12-17,1150,908,839,1747,北湖,甲簡
2020-12-18,1150,955,777,1732,北湖,甲簡
2020-12-19,1150,684,612,1296,北湖,甲簡
2020-12-20,1150,590,720,1310,北湖,甲簡
2020-12-21,1150,828,946,1774,北湖,甲簡
2020-12-22,1150,889,939,1828,北湖,甲簡
2020-12-23,1150,938,888,1826,北湖,甲簡
2020-12-24,1150,922,858,1780,北湖,甲簡
2020-12-25,1150,1029,796,1825,北湖,甲簡
2020-12-26,1150,613,638,1251,北湖,甲簡
2020-12-27,1150,547,641,1188,北湖,甲簡
2020-12-28,1150,773,900,1673,北湖,甲簡
2020-12-29,1150,823,822,1645,北湖,甲簡
2020-12-30,1150,839,803,1642,北湖,甲簡
2020-12-31,1150,1121,689,1810,北湖,甲簡
2020-01-01,1160,3532,4159,7691,湖口,三等
2020-01-02,1160,3471,3164,6635,湖口,三等
2020-01-03,1160,4334,4082,8416,湖口,三等
2020-01-04,1160,3900,4023,7923,湖口,三等
2020-01-05,1160,3656,3832,7488,湖口,三等
2020-01-06,1160,3691,3807,7498,湖口,三等
2020-01-07,1160,3645,3767,7412,湖口,三等
2020-01-08,1160,3674,3743,7417,湖口,三等
2020-01-09,1160,3689,3864,7553,湖口,三等
2020-01-10,1160,4593,4995,9588,湖口,三等
2020-01-11,1160,4194,4256,8450,湖口,三等
2020-01-12,1160,4098,3962,8060,湖口,三等
2020-01-13,1160,3774,3799,7573,湖口,三等
2020-01-14,1160,3749,3801,7550,湖口,三等
2020-01-15,1160,3723,3834,7557,湖口,三等
2020-01-16,1160,4382,4336,8718,湖口,三等
2020-01-17,1160,4146,3938,8084,湖口,三等
2020-01-18,1160,3705,3884,7589,湖口,三等
2020-01-19,1160,3588,3831,7419,湖口,三等
2020-01-20,1160,3874,3894,7768,湖口,三等
2020-01-21,1160,3834,3837,7671,湖口,三等
2020-01-22,1160,4248,4116,8364,湖口,三等
2020-01-23,1160,3053,3564,6617,湖口,三等
2020-01-24,1160,2303,2665,4968,湖口,三等
2020-01-25,1160,2929,2728,5657,湖口,三等
2020-01-26,1160,2896,3065,5961,湖口,三等
2020-01-27,1160,3370,3021,6391,湖口,三等
2020-01-28,1160,3402,3206,6608,湖口,三等
2020-01-29,1160,3008,3115,6123,湖口,三等
2020-01-30,1160,3138,3100,6238,湖口,三等
2020-01-31,1160,3862,3251,7113,湖口,三等
2020-02-01,1160,3013,3021,6034,湖口,三等
2020-02-02,1160,2842,3130,5972,湖口,三等
2020-02-03,1160,3219,3106,6325,湖口,三等
2020-02-04,1160,2827,2889,5716,湖口,三等
2020-02-05,1160,2988,2924,5912,湖口,三等
2020-02-06,1160,3157,3124,6281,湖口,三等
2020-02-07,1160,3486,3332,6818,湖口,三等
2020-02-08,1160,2839,2840,5679,湖口,三等
2020-02-09,1160,2763,3063,5826,湖口,三等
2020-02-10,1160,3127,3065,6192,湖口,三等
2020-02-11,1160,3043,3052,6095,湖口,三等
2020-02-12,1160,3156,3140,6296,湖口,三等
2020-02-13,1160,2923,2833,5756,湖口,三等
2020-02-14,1160,3298,3141,6439,湖口,三等
2020-02-15,1160,3239,3020,6259,湖口,三等
2020-02-16,1160,2405,2720,5125,湖口,三等
2020-02-17,1160,2899,2877,5776,湖口,三等
2020-02-18,1160,2841,2820,5661,湖口,三等
2020-02-19,1160,2997,2996,5993,湖口,三等
2020-02-20,1160,2921,2948,5869,湖口,三等
2020-02-21,1160,3537,3202,6739,湖口,三等
2020-02-22,1160,2907,2927,5834,湖口,三等
2020-02-23,1160,3013,3283,6296,湖口,三等
2020-02-24,1160,3167,3129,6296,湖口,三等
2020-02-25,1160,3464,3546,7010,湖口,三等
2020-02-26,1160,3242,3442,6684,湖口,三等
2020-02-27,1160,4326,3961,8287,湖口,三等
2020-02-28,1160,2919,3187,6106,湖口,三等
2020-02-29,1160,2694,2624,5318,湖口,三等
2020-03-01,1160,2894,3025,5919,湖口,三等
2020-03-02,1160,3399,3447,6846,湖口,三等
2020-03-03,1160,3196,3238,6434,湖口,三等
2020-03-04,1160,3119,3261,6380,湖口,三等
2020-03-05,1160,3118,3219,6337,湖口,三等
2020-03-06,1160,3962,3912,7874,湖口,三等
2020-03-07,1160,2886,3067,5953,湖口,三等
2020-03-08,1160,2984,3077,6061,湖口,三等
2020-03-09,1160,3350,3439,6789,湖口,三等
2020-03-10,1160,2948,3050,5998,湖口,三等
2020-03-11,1160,3225,3330,6555,湖口,三等
2020-03-12,1160,3120,3262,6382,湖口,三等
2020-03-13,1160,3729,3730,7459,湖口,三等
2020-03-14,1160,2758,2865,5623,湖口,三等
2020-03-15,1160,3105,3148,6253,湖口,三等
2020-03-16,1160,3297,3349,6646,湖口,三等
2020-03-17,1160,3106,3257,6363,湖口,三等
2020-03-18,1160,3042,3140,6182,湖口,三等
2020-03-19,1160,2915,2963,5878,湖口,三等
2020-03-20,1160,3665,3712,7377,湖口,三等
2020-03-21,1160,2368,2461,4829,湖口,三等
2020-03-22,1160,2633,2626,5259,湖口,三等
2020-03-23,1160,3033,3069,6102,湖口,三等
2020-03-24,1160,2865,2946,5811,湖口,三等
2020-03-25,1160,2779,2916,5695,湖口,三等
2020-03-26,1160,2849,2943,5792,湖口,三等
2020-03-27,1160,3390,3417,6807,湖口,三等
2020-03-28,1160,1967,2122,4089,湖口,三等
2020-03-29,1160,2217,2314,4531,湖口,三等
2020-03-30,1160,2887,2994,5881,湖口,三等
2020-03-31,1160,2796,2970,5766,湖口,三等
2020-04-01,1160,3241,3348,6589,湖口,三等
2020-04-02,1160,1955,2290,4245,湖口,三等
2020-04-03,1160,2020,2162,4182,湖口,三等
2020-04-04,1160,1811,1764,3575,湖口,三等
2020-04-05,1160,2356,2203,4559,湖口,三等
2020-04-06,1160,2899,2838,5737,湖口,三等
2020-04-07,1160,2609,2747,5356,湖口,三等
2020-04-08,1160,2666,2740,5406,湖口,三等
2020-04-09,1160,2671,2712,5383,湖口,三等
2020-04-10,1160,3296,3297,6593,湖口,三等
2020-04-11,1160,2013,2126,4139,湖口,三等
2020-04-12,1160,1983,2187,4170,湖口,三等
2020-04-13,1160,2757,2825,5582,湖口,三等
2020-04-14,1160,2582,2698,5280,湖口,三等
2020-04-15,1160,2831,2882,5713,湖口,三等
2020-04-16,1160,2717,2790,5507,湖口,三等
2020-04-17,1160,3296,3377,6673,湖口,三等
2020-04-18,1160,2291,2458,4749,湖口,三等
2020-04-19,1160,2479,2460,4939,湖口,三等
2020-04-20,1160,2829,2842,5671,湖口,三等
2020-04-21,1160,2547,2712,5259,湖口,三等
2020-04-22,1160,2591,2713,5304,湖口,三等
2020-04-23,1160,2612,2755,5367,湖口,三等
2020-04-24,1160,3191,3265,6456,湖口,三等
2020-04-25,1160,2083,2227,4310,湖口,三等
2020-04-26,1160,2279,2303,4582,湖口,三等
2020-04-27,1160,2928,2958,5886,湖口,三等
2020-04-28,1160,2781,2855,5636,湖口,三等
2020-04-29,1160,2657,2854,5511,湖口,三等
2020-04-30,1160,2969,3100,6069,湖口,三等
2020-05-01,1160,3157,3416,6573,湖口,三等
2020-05-02,1160,2276,2474,4750,湖口,三等
2020-05-03,1160,2683,2510,5193,湖口,三等
2020-05-04,1160,3103,3081,6184,湖口,三等
2020-05-05,1160,2885,2959,5844,湖口,三等
2020-05-06,1160,3012,3021,6033,湖口,三等
2020-05-07,1160,2985,3098,6083,湖口,三等
2020-05-08,1160,3532,3987,7519,湖口,三等
2020-05-09,1160,2697,3056,5753,湖口,三等
2020-05-10,1160,3021,2747,5768,湖口,三等
2020-05-11,1160,3243,3170,6413,湖口,三等
2020-05-12,1160,2860,3052,5912,湖口,三等
2020-05-13,1160,2984,3128,6112,湖口,三等
2020-05-14,1160,3035,3095,6130,湖口,三等
2020-05-15,1160,3924,3954,7878,湖口,三等
2020-05-16,1160,2568,2800,5368,湖口,三等
2020-05-17,1160,2808,2882,5690,湖口,三等
2020-05-18,1160,3064,3089,6153,湖口,三等
2020-05-19,1160,2751,2972,5723,湖口,三等
2020-05-20,1160,3075,3150,6225,湖口,三等
2020-05-21,1160,2969,3067,6036,湖口,三等
2020-05-22,1160,3326,3417,6743,湖口,三等
2020-05-23,1160,2401,2534,4935,湖口,三等
2020-05-24,1160,2977,3010,5987,湖口,三等
2020-05-25,1160,3196,3259,6455,湖口,三等
2020-05-26,1160,3051,3134,6185,湖口,三等
2020-05-27,1160,2984,3071,6055,湖口,三等
2020-05-28,1160,2936,3029,5965,湖口,三等
2020-05-29,1160,3802,3878,7680,湖口,三等
2020-05-30,1160,3087,3153,6240,湖口,三等
2020-05-31,1160,3189,3167,6356,湖口,三等
2020-06-01,1160,3230,3293,6523,湖口,三等
2020-06-02,1160,3140,3253,6393,湖口,三等
2020-06-03,1160,3140,3203,6343,湖口,三等
2020-06-04,1160,3052,3143,6195,湖口,三等
2020-06-05,1160,3918,3916,7834,湖口,三等
2020-06-06,1160,3160,3145,6305,湖口,三等
2020-06-07,1160,3055,3127,6182,湖口,三等
2020-06-08,1160,3255,3280,6535,湖口,三等
2020-06-09,1160,3184,3241,6425,湖口,三等
2020-06-10,1160,3231,3284,6515,湖口,三等
2020-06-11,1160,3333,3375,6708,湖口,三等
2020-06-12,1160,3951,3984,7935,湖口,三等
2020-06-13,1160,3170,3380,6550,湖口,三等
2020-06-14,1160,3343,3396,6739,湖口,三等
2020-06-15,1160,3732,3659,7391,湖口,三等
2020-06-16,1160,3313,3345,6658,湖口,三等
2020-06-17,1160,3200,3337,6537,湖口,三等
2020-06-18,1160,3119,3160,6279,湖口,三等
2020-06-19,1160,3467,3529,6996,湖口,三等
2020-06-20,1160,3191,3079,6270,湖口,三等
2020-06-21,1160,2991,3106,6097,湖口,三等
2020-06-22,1160,3235,3315,6550,湖口,三等
2020-06-23,1160,3389,3442,6831,湖口,三等
2020-06-24,1160,3852,4049,7901,湖口,三等
2020-06-25,1160,3171,3530,6701,湖口,三等
2020-06-26,1160,3496,3426,6922,湖口,三等
2020-06-27,1160,3309,2988,6297,湖口,三等
2020-06-28,1160,3284,3216,6500,湖口,三等
2020-06-29,1160,3282,3276,6558,湖口,三等
2020-06-30,1160,3275,3277,6552,湖口,三等
2020-07-01,1160,3068,3071,6139,湖口,三等
2020-07-02,1160,3111,3058,6169,湖口,三等
2020-07-03,1160,3623,3600,7223,湖口,三等
2020-07-04,1160,3275,3239,6514,湖口,三等
2020-07-05,1160,2973,3252,6225,湖口,三等
2020-07-06,1160,3313,3360,6673,湖口,三等
2020-07-07,1160,3199,3295,6494,湖口,三等
2020-07-08,1160,3264,3356,6620,湖口,三等
2020-07-09,1160,3313,3341,6654,湖口,三等
2020-07-10,1160,4141,3877,8018,湖口,三等
2020-07-11,1160,3372,3321,6693,湖口,三等
2020-07-12,1160,3366,3620,6986,湖口,三等
2020-07-13,1160,3349,3365,6714,湖口,三等
2020-07-14,1160,3474,3601,7075,湖口,三等
2020-07-15,1160,3229,3295,6524,湖口,三等
2020-07-16,1160,3390,3363,6753,湖口,三等
2020-07-17,1160,4003,3637,7640,湖口,三等
2020-07-18,1160,3419,3472,6891,湖口,三等
2020-07-19,1160,3177,3377,6554,湖口,三等
2020-07-20,1160,3297,3251,6548,湖口,三等
2020-07-21,1160,3152,3194,6346,湖口,三等
2020-07-22,1160,3300,3237,6537,湖口,三等
2020-07-23,1160,3336,3304,6640,湖口,三等
2020-07-24,1160,3874,3674,7548,湖口,三等
2020-07-25,1160,3353,3394,6747,湖口,三等
2020-07-26,1160,3178,3381,6559,湖口,三等
2020-07-27,1160,3314,3294,6608,湖口,三等
2020-07-28,1160,3286,3080,6366,湖口,三等
2020-07-29,1160,3227,3221,6448,湖口,三等
2020-07-30,1160,3269,3349,6618,湖口,三等
2020-07-31,1160,4035,3700,7735,湖口,三等
2020-08-01,1160,3383,3426,6809,湖口,三等
2020-08-02,1160,3094,3268,6362,湖口,三等
2020-08-03,1160,3061,3056,6117,湖口,三等
2020-08-04,1160,3114,3120,6234,湖口,三等
2020-08-05,1160,3183,3244,6427,湖口,三等
2020-08-06,1160,3350,3368,6718,湖口,三等
2020-08-07,1160,4163,3908,8071,湖口,三等
2020-08-08,1160,3137,3424,6561,湖口,三等
2020-08-09,1160,3568,3554,7122,湖口,三等
2020-08-10,1160,3291,3251,6542,湖口,三等
2020-08-11,1160,3079,3083,6162,湖口,三等
2020-08-12,1160,3236,3192,6428,湖口,三等
2020-08-13,1160,3432,3395,6827,湖口,三等
2020-08-14,1160,3945,3658,7603,湖口,三等
2020-08-15,1160,3322,3348,6670,湖口,三等
2020-08-16,1160,3443,3850,7293,湖口,三等
2020-08-17,1160,3253,3219,6472,湖口,三等
2020-08-18,1160,3386,3308,6694,湖口,三等
2020-08-19,1160,3351,3330,6681,湖口,三等
2020-08-20,1160,3294,3170,6464,湖口,三等
2020-08-21,1160,4121,3683,7804,湖口,三等
2020-08-22,1160,3487,3433,6920,湖口,三等
2020-08-23,1160,3066,3424,6490,湖口,三等
2020-08-24,1160,3216,3142,6358,湖口,三等
2020-08-25,1160,3334,3291,6625,湖口,三等
2020-08-26,1160,3326,3250,6576,湖口,三等
2020-08-27,1160,3242,3110,6352,湖口,三等
2020-08-28,1160,3771,3519,7290,湖口,三等
2020-08-29,1160,3225,3300,6525,湖口,三等
2020-08-30,1160,3016,3199,6215,湖口,三等
2020-08-31,1160,3345,3410,6755,湖口,三等
2020-09-01,1160,3223,3279,6502,湖口,三等
2020-09-02,1160,3516,3369,6885,湖口,三等
2020-09-03,1160,3341,3525,6866,湖口,三等
2020-09-04,1160,4021,3874,7895,湖口,三等
2020-09-05,1160,3278,3382,6660,湖口,三等
2020-09-06,1160,3290,3463,6753,湖口,三等
2020-09-07,1160,3558,3565,7123,湖口,三等
2020-09-08,1160,3510,3481,6991,湖口,三等
2020-09-09,1160,3440,3522,6962,湖口,三等
2020-09-10,1160,3379,3465,6844,湖口,三等
2020-09-11,1160,4199,3996,8195,湖口,三等
2020-09-12,1160,3496,3482,6978,湖口,三等
2020-09-13,1160,3646,3580,7226,湖口,三等
2020-09-14,1160,3471,3545,7016,湖口,三等
2020-09-15,1160,3355,3477,6832,湖口,三等
2020-09-16,1160,3417,3495,6912,湖口,三等
2020-09-17,1160,3379,3442,6821,湖口,三等
2020-09-18,1160,4112,4166,8278,湖口,三等
2020-09-19,1160,3559,3763,7322,湖口,三等
2020-09-20,1160,3400,3361,6761,湖口,三等
2020-09-21,1160,3569,3489,7058,湖口,三等
2020-09-22,1160,3343,3458,6801,湖口,三等
2020-09-23,1160,3397,3500,6897,湖口,三等
2020-09-24,1160,3417,3412,6829,湖口,三等
2020-09-25,1160,3635,3776,7411,湖口,三等
2020-09-26,1160,3449,3546,6995,湖口,三等
2020-09-27,1160,2779,2948,5727,湖口,三等
2020-09-28,1160,3251,3312,6563,湖口,三等
2020-09-29,1160,3490,3567,7057,湖口,三等
2020-09-30,1160,4064,4559,8623,湖口,三等
2020-10-01,1160,3595,4212,7807,湖口,三等
2020-10-02,1160,4178,4138,8316,湖口,三等
2020-10-03,1160,3869,3660,7529,湖口,三等
2020-10-04,1160,3998,3563,7561,湖口,三等
2020-10-05,1160,3538,3448,6986,湖口,三等
2020-10-06,1160,3378,3485,6863,湖口,三等
2020-10-07,1160,3412,3463,6875,湖口,三等
2020-10-08,1160,4071,4238,8309,湖口,三等
2020-10-09,1160,3749,3909,7658,湖口,三等
2020-10-10,1160,3399,3346,6745,湖口,三等
2020-10-11,1160,3761,3676,7437,湖口,三等
2020-10-12,1160,3568,3473,7041,湖口,三等
2020-10-13,1160,3399,3511,6910,湖口,三等
2020-10-14,1160,3469,3570,7039,湖口,三等
2020-10-15,1160,3564,3644,7208,湖口,三等
2020-10-16,1160,4165,4161,8326,湖口,三等
2020-10-17,1160,3768,3805,7573,湖口,三等
2020-10-18,1160,3735,3925,7660,湖口,三等
2020-10-19,1160,3528,3457,6985,湖口,三等
2020-10-20,1160,3415,3548,6963,湖口,三等
2020-10-21,1160,3455,3559,7014,湖口,三等
2020-10-22,1160,3389,3379,6768,湖口,三等
2020-10-23,1160,3966,4037,8003,湖口,三等
2020-10-24,1160,3652,3731,7383,湖口,三等
2020-10-25,1160,3813,3852,7665,湖口,三等
2020-10-26,1160,3578,3512,7090,湖口,三等
2020-10-27,1160,3395,3504,6899,湖口,三等
2020-10-28,1160,3432,3479,6911,湖口,三等
2020-10-29,1160,3253,3342,6595,湖口,三等
2020-10-30,1160,4155,4240,8395,湖口,三等
2020-10-31,1160,3680,3834,7514,湖口,三等
2020-11-01,1160,3706,3844,7550,湖口,三等
2020-11-02,1160,3588,3643,7231,湖口,三等
2020-11-03,1160,3296,3528,6824,湖口,三等
2020-11-04,1160,3462,3458,6920,湖口,三等
2020-11-05,1160,3525,3551,7076,湖口,三等
2020-11-06,1160,4182,4260,8442,湖口,三等
2020-11-07,1160,3663,3776,7439,湖口,三等
2020-11-08,1160,3722,3862,7584,湖口,三等
2020-11-09,1160,3660,3599,7259,湖口,三等
2020-11-10,1160,3461,3530,6991,湖口,三等
2020-11-11,1160,3481,3640,7121,湖口,三等
2020-11-12,1160,3629,3662,7291,湖口,三等
2020-11-13,1160,4297,4362,8659,湖口,三等
2020-11-14,1160,3770,3962,7732,湖口,三等
2020-11-15,1160,4016,4039,8055,湖口,三等
2020-11-16,1160,3669,3726,7395,湖口,三等
2020-11-17,1160,3552,3603,7155,湖口,三等
2020-11-18,1160,3486,3579,7065,湖口,三等
2020-11-19,1160,3507,3632,7139,湖口,三等
2020-11-20,1160,4223,4389,8612,湖口,三等
2020-11-21,1160,3839,3938,7777,湖口,三等
2020-11-22,1160,3705,3510,7215,湖口,三等
2020-11-23,1160,3501,3509,7010,湖口,三等
2020-11-24,1160,3418,3522,6940,湖口,三等
2020-11-25,1160,3477,3556,7033,湖口,三等
2020-11-26,1160,3550,3628,7178,湖口,三等
2020-11-27,1160,4238,4445,8683,湖口,三等
2020-11-28,1160,3749,3913,7662,湖口,三等
2020-11-29,1160,3804,3644,7448,湖口,三等
2020-11-30,1160,3749,3715,7464,湖口,三等
2020-12-01,1160,3418,3501,6919,湖口,三等
2020-12-02,1160,3396,3488,6884,湖口,三等
2020-12-03,1160,3358,3404,6762,湖口,三等
2020-12-04,1160,4145,4423,8568,湖口,三等
2020-12-05,1160,3847,3953,7800,湖口,三等
2020-12-06,1160,4135,3993,8128,湖口,三等
2020-12-07,1160,3629,3486,7115,湖口,三等
2020-12-08,1160,3476,1356,4832,湖口,三等
2020-12-09,1160,3265,899,4164,湖口,三等
2020-12-10,1160,3382,1940,5322,湖口,三等
2020-12-11,1160,4187,4319,8506,湖口,三等
2020-12-12,1160,3943,4006,7949,湖口,三等
2020-12-13,1160,3832,3838,7670,湖口,三等
2020-12-14,1160,3646,3497,7143,湖口,三等
2020-12-15,1160,3289,3449,6738,湖口,三等
2020-12-16,1160,3280,3382,6662,湖口,三等
2020-12-17,1160,3464,3626,7090,湖口,三等
2020-12-18,1160,4083,4278,8361,湖口,三等
2020-12-19,1160,3553,3627,7180,湖口,三等
2020-12-20,1160,3543,3531,7074,湖口,三等
2020-12-21,1160,3563,3483,7046,湖口,三等
2020-12-22,1160,3458,3585,7043,湖口,三等
2020-12-23,1160,3287,3346,6633,湖口,三等
2020-12-24,1160,3409,3531,6940,湖口,三等
2020-12-25,1160,4249,4403,8652,湖口,三等
2020-12-26,1160,3389,3482,6871,湖口,三等
2020-12-27,1160,3632,3579,7211,湖口,三等
2020-12-28,1160,3563,3552,7115,湖口,三等
2020-12-29,1160,3628,3690,7318,湖口,三等
2020-12-30,1160,3416,3487,6903,湖口,三等
2020-12-31,1160,4254,4237,8491,湖口,三等
2020-01-01,1170,5808,7360,13168,新豐,三等
2020-01-02,1170,5356,5777,11133,新豐,三等
2020-01-03,1170,6905,6213,13118,新豐,三等
2020-01-04,1170,5976,5504,11480,新豐,三等
2020-01-05,1170,6519,7709,14228,新豐,三等
2020-01-06,1170,5623,6294,11917,新豐,三等
2020-01-07,1170,5499,5617,11116,新豐,三等
2020-01-08,1170,5355,5521,10876,新豐,三等
2020-01-09,1170,5420,5662,11082,新豐,三等
2020-01-10,1170,7596,6628,14224,新豐,三等
2020-01-11,1170,6417,6040,12457,新豐,三等
2020-01-12,1170,6674,7618,14292,新豐,三等
2020-01-13,1170,5174,5684,10858,新豐,三等
2020-01-14,1170,4810,5099,9909,新豐,三等
2020-01-15,1170,4710,4975,9685,新豐,三等
2020-01-16,1170,5488,5414,10902,新豐,三等
2020-01-17,1170,5585,5351,10936,新豐,三等
2020-01-18,1170,5383,5233,10616,新豐,三等
2020-01-19,1170,5831,6484,12315,新豐,三等
2020-01-20,1170,5372,5423,10795,新豐,三等
2020-01-21,1170,5284,5300,10584,新豐,三等
2020-01-22,1170,6020,5364,11384,新豐,三等
2020-01-23,1170,5632,5062,10694,新豐,三等
2020-01-24,1170,5735,5247,10982,新豐,三等
2020-01-25,1170,5504,5480,10984,新豐,三等
2020-01-26,1170,5154,5499,10653,新豐,三等
2020-01-27,1170,5277,5343,10620,新豐,三等
2020-01-28,1170,4752,4834,9586,新豐,三等
2020-01-29,1170,4142,4979,9121,新豐,三等
2020-01-30,1170,4178,2862,7040,新豐,三等
2020-01-31,1170,5054,4562,9616,新豐,三等
2020-02-01,1170,4187,4004,8191,新豐,三等
2020-02-02,1170,4359,5221,9580,新豐,三等
2020-02-03,1170,4304,4437,8741,新豐,三等
2020-02-04,1170,3930,4036,7966,新豐,三等
2020-02-05,1170,4462,4399,8861,新豐,三等
2020-02-06,1170,4595,4665,9260,新豐,三等
2020-02-07,1170,5241,4712,9953,新豐,三等
2020-02-08,1170,4750,4373,9123,新豐,三等
2020-02-09,1170,5355,6118,11473,新豐,三等
2020-02-10,1170,4764,4903,9667,新豐,三等
2020-02-11,1170,4355,4446,8801,新豐,三等
2020-02-12,1170,4425,4524,8949,新豐,三等
2020-02-13,1170,4444,4376,8820,新豐,三等
2020-02-14,1170,5383,4981,10364,新豐,三等
2020-02-15,1170,4855,4528,9383,新豐,三等
2020-02-16,1170,4370,4939,9309,新豐,三等
2020-02-17,1170,4352,4451,8803,新豐,三等
2020-02-18,1170,3958,4036,7994,新豐,三等
2020-02-19,1170,4281,4202,8483,新豐,三等
2020-02-20,1170,4227,4323,8550,新豐,三等
2020-02-21,1170,5152,4465,9617,新豐,三等
2020-02-22,1170,4297,4047,8344,新豐,三等
2020-02-23,1170,4985,5713,10698,新豐,三等
2020-02-24,1170,4541,4647,9188,新豐,三等
2020-02-25,1170,4251,4453,8704,新豐,三等
2020-02-26,1170,4327,4544,8871,新豐,三等
2020-02-27,1170,5400,4986,10386,新豐,三等
2020-02-28,1170,4433,4101,8534,新豐,三等
2020-02-29,1170,4070,3949,8019,新豐,三等
2020-03-01,1170,4505,5349,9854,新豐,三等
2020-03-02,1170,4906,5394,10300,新豐,三等
2020-03-03,1170,4469,4749,9218,新豐,三等
2020-03-04,1170,4429,4528,8957,新豐,三等
2020-03-05,1170,4618,4792,9410,新豐,三等
2020-03-06,1170,6643,5661,12304,新豐,三等
2020-03-07,1170,5453,5220,10673,新豐,三等
2020-03-08,1170,5292,6261,11553,新豐,三等
2020-03-09,1170,4966,5508,10474,新豐,三等
2020-03-10,1170,4247,4388,8635,新豐,三等
2020-03-11,1170,4851,4944,9795,新豐,三等
2020-03-12,1170,4537,4618,9155,新豐,三等
2020-03-13,1170,6015,5191,11206,新豐,三等
2020-03-14,1170,4630,4230,8860,新豐,三等
2020-03-15,1170,4944,5993,10937,新豐,三等
2020-03-16,1170,4680,5020,9700,新豐,三等
2020-03-17,1170,4304,4511,8815,新豐,三等
2020-03-18,1170,4302,4494,8796,新豐,三等
2020-03-19,1170,4211,4248,8459,新豐,三等
2020-03-20,1170,5686,4814,10500,新豐,三等
2020-03-21,1170,3525,3435,6960,新豐,三等
2020-03-22,1170,3551,4372,7923,新豐,三等
2020-03-23,1170,4258,4599,8857,新豐,三等
2020-03-24,1170,4032,4127,8159,新豐,三等
2020-03-25,1170,3960,4120,8080,新豐,三等
2020-03-26,1170,3947,4098,8045,新豐,三等
2020-03-27,1170,5293,4548,9841,新豐,三等
2020-03-28,1170,2882,2697,5579,新豐,三等
2020-03-29,1170,3095,3835,6930,新豐,三等
2020-03-30,1170,3938,4321,8259,新豐,三等
2020-03-31,1170,4369,3999,8368,新豐,三等
2020-04-01,1170,4617,3981,8598,新豐,三等
2020-04-02,1170,3072,2862,5934,新豐,三等
2020-04-03,1170,3121,2909,6030,新豐,三等
2020-04-04,1170,2785,2854,5639,新豐,三等
2020-04-05,1170,3375,4503,7878,新豐,三等
2020-04-06,1170,4057,4399,8456,新豐,三等
2020-04-07,1170,3686,3846,7532,新豐,三等
2020-04-08,1170,3846,3982,7828,新豐,三等
2020-04-09,1170,3866,3961,7827,新豐,三等
2020-04-10,1170,5254,4580,9834,新豐,三等
2020-04-11,1170,3333,3243,6576,新豐,三等
2020-04-12,1170,3310,4195,7505,新豐,三等
2020-04-13,1170,4060,4439,8499,新豐,三等
2020-04-14,1170,3782,4032,7814,新豐,三等
2020-04-15,1170,4122,4098,8220,新豐,三等
2020-04-16,1170,4003,4115,8118,新豐,三等
2020-04-17,1170,5436,4591,10027,新豐,三等
2020-04-18,1170,3686,3484,7170,新豐,三等
2020-04-19,1170,3597,4569,8166,新豐,三等
2020-04-20,1170,4005,4447,8452,新豐,三等
2020-04-21,1170,3760,3871,7631,新豐,三等
2020-04-22,1170,3830,3916,7746,新豐,三等
2020-04-23,1170,3820,3850,7670,新豐,三等
2020-04-24,1170,5173,4406,9579,新豐,三等
2020-04-25,1170,3286,3195,6481,新豐,三等
2020-04-26,1170,3227,4119,7346,新豐,三等
2020-04-27,1170,4036,4358,8394,新豐,三等
2020-04-28,1170,3833,4020,7853,新豐,三等
2020-04-29,1170,3953,4010,7963,新豐,三等
2020-04-30,1170,4628,4331,8959,新豐,三等
2020-05-01,1170,5325,4536,9861,新豐,三等
2020-05-02,1170,3643,3632,7275,新豐,三等
2020-05-03,1170,4115,4832,8947,新豐,三等
2020-05-04,1170,4189,4598,8787,新豐,三等
2020-05-05,1170,4375,4573,8948,新豐,三等
2020-05-06,1170,4524,4698,9222,新豐,三等
2020-05-07,1170,4521,4618,9139,新豐,三等
2020-05-08,1170,6182,5490,11672,新豐,三等
2020-05-09,1170,4733,4484,9217,新豐,三等
2020-05-10,1170,5094,5936,11030,新豐,三等
2020-05-11,1170,4578,5044,9622,新豐,三等
2020-05-12,1170,4112,4397,8509,新豐,三等
2020-05-13,1170,4445,4567,9012,新豐,三等
2020-05-14,1170,4516,4581,9097,新豐,三等
2020-05-15,1170,6221,5597,11818,新豐,三等
2020-05-16,1170,4327,3209,7536,新豐,三等
2020-05-17,1170,4517,5465,9982,新豐,三等
2020-05-18,1170,4262,4777,9039,新豐,三等
2020-05-19,1170,3988,4209,8197,新豐,三等
2020-05-20,1170,4378,4470,8848,新豐,三等
2020-05-21,1170,4058,4242,8300,新豐,三等
2020-05-22,1170,5084,4440,9524,新豐,三等
2020-05-23,1170,3755,3599,7354,新豐,三等
2020-05-24,1170,4676,5530,10206,新豐,三等
2020-05-25,1170,4423,4891,9314,新豐,三等
2020-05-26,1170,4251,4504,8755,新豐,三等
2020-05-27,1170,4107,4247,8354,新豐,三等
2020-05-28,1170,4177,4170,8347,新豐,三等
2020-05-29,1170,6023,5159,11182,新豐,三等
2020-05-30,1170,4656,4374,9030,新豐,三等
2020-05-31,1170,4692,5569,10261,新豐,三等
2020-06-01,1170,4590,5029,9619,新豐,三等
2020-06-02,1170,4372,4484,8856,新豐,三等
2020-06-03,1170,4483,4585,9068,新豐,三等
2020-06-04,1170,4485,4574,9059,新豐,三等
2020-06-05,1170,6737,5771,12508,新豐,三等
2020-06-06,1170,5238,5024,10262,新豐,三等
2020-06-07,1170,5041,6225,11266,新豐,三等
2020-06-08,1170,4744,5057,9801,新豐,三等
2020-06-09,1170,4754,4875,9629,新豐,三等
2020-06-10,1170,4848,4928,9776,新豐,三等
2020-06-11,1170,4840,4851,9691,新豐,三等
2020-06-12,1170,6563,5597,12160,新豐,三等
2020-06-13,1170,5671,5311,10982,新豐,三等
2020-06-14,1170,5577,6714,12291,新豐,三等
2020-06-15,1170,5115,5601,10716,新豐,三等
2020-06-16,1170,4698,4885,9583,新豐,三等
2020-06-17,1170,4579,4787,9366,新豐,三等
2020-06-18,1170,4761,4836,9597,新豐,三等
2020-06-19,1170,5323,5148,10471,新豐,三等
2020-06-20,1170,5046,4683,9729,新豐,三等
2020-06-21,1170,5059,5342,10401,新豐,三等
2020-06-22,1170,4406,4698,9104,新豐,三等
2020-06-23,1170,4574,4554,9128,新豐,三等
2020-06-24,1170,5947,5487,11434,新豐,三等
2020-06-25,1170,5126,4813,9939,新豐,三等
2020-06-26,1170,4978,4818,9796,新豐,三等
2020-06-27,1170,5010,5065,10075,新豐,三等
2020-06-28,1170,5355,6139,11494,新豐,三等
2020-06-29,1170,4549,4841,9390,新豐,三等
2020-06-30,1170,4299,4088,8387,新豐,三等
2020-07-01,1170,4249,4383,8632,新豐,三等
2020-07-02,1170,4240,4191,8431,新豐,三等
2020-07-03,1170,5664,5125,10789,新豐,三等
2020-07-04,1170,5065,4759,9824,新豐,三等
2020-07-05,1170,5498,6278,11776,新豐,三等
2020-07-06,1170,4747,4956,9703,新豐,三等
2020-07-07,1170,4555,4876,9431,新豐,三等
2020-07-08,1170,4595,4683,9278,新豐,三等
2020-07-09,1170,4607,4707,9314,新豐,三等
2020-07-10,1170,6097,5339,11436,新豐,三等
2020-07-11,1170,5468,5309,10777,新豐,三等
2020-07-12,1170,6028,6683,12711,新豐,三等
2020-07-13,1170,4729,5051,9780,新豐,三等
2020-07-14,1170,4962,5101,10063,新豐,三等
2020-07-15,1170,4698,4633,9331,新豐,三等
2020-07-16,1170,4525,4445,8970,新豐,三等
2020-07-17,1170,5573,4935,10508,新豐,三等
2020-07-18,1170,5036,4824,9860,新豐,三等
2020-07-19,1170,5168,5968,11136,新豐,三等
2020-07-20,1170,4610,4730,9340,新豐,三等
2020-07-21,1170,4501,4421,8922,新豐,三等
2020-07-22,1170,4554,4465,9019,新豐,三等
2020-07-23,1170,4545,4490,9035,新豐,三等
2020-07-24,1170,5474,4781,10255,新豐,三等
2020-07-25,1170,4923,4850,9773,新豐,三等
2020-07-26,1170,4953,5223,10176,新豐,三等
2020-07-27,1170,4496,4663,9159,新豐,三等
2020-07-28,1170,4049,4114,8163,新豐,三等
2020-07-29,1170,4209,4282,8491,新豐,三等
2020-07-30,1170,4401,4246,8647,新豐,三等
2020-07-31,1170,5245,4801,10046,新豐,三等
2020-08-01,1170,4731,4649,9380,新豐,三等
2020-08-02,1170,4610,5159,9769,新豐,三等
2020-08-03,1170,4198,4283,8481,新豐,三等
2020-08-04,1170,4430,4549,8979,新豐,三等
2020-08-05,1170,4822,4644,9466,新豐,三等
2020-08-06,1170,4780,4936,9716,新豐,三等
2020-08-07,1170,5973,5178,11151,新豐,三等
2020-08-08,1170,5351,5276,10627,新豐,三等
2020-08-09,1170,5855,6592,12447,新豐,三等
2020-08-10,1170,4799,5079,9878,新豐,三等
2020-08-11,1170,4246,4218,8464,新豐,三等
2020-08-12,1170,4444,4515,8959,新豐,三等
2020-08-13,1170,4726,4681,9407,新豐,三等
2020-08-14,1170,5582,5038,10620,新豐,三等
2020-08-15,1170,5367,5176,10543,新豐,三等
2020-08-16,1170,5899,6571,12470,新豐,三等
2020-08-17,1170,4647,4777,9424,新豐,三等
2020-08-18,1170,4377,4574,8951,新豐,三等
2020-08-19,1170,4525,4559,9084,新豐,三等
2020-08-20,1170,4587,4460,9047,新豐,三等
2020-08-21,1170,5510,4973,10483,新豐,三等
2020-08-22,1170,5011,4843,9854,新豐,三等
2020-08-23,1170,5210,5866,11076,新豐,三等
2020-08-24,1170,4470,4522,8992,新豐,三等
2020-08-25,1170,4401,4411,8812,新豐,三等
2020-08-26,1170,4557,4523,9080,新豐,三等
2020-08-27,1170,4461,4399,8860,新豐,三等
2020-08-28,1170,5175,4518,9693,新豐,三等
2020-08-29,1170,4630,4350,8980,新豐,三等
2020-08-30,1170,4860,5590,10450,新豐,三等
2020-08-31,1170,4295,4570,8865,新豐,三等
2020-09-01,1170,4063,4265,8328,新豐,三等
2020-09-02,1170,4167,4249,8416,新豐,三等
2020-09-03,1170,4012,4253,8265,新豐,三等
2020-09-04,1170,5601,5121,10722,新豐,三等
2020-09-05,1170,5524,5394,10918,新豐,三等
2020-09-06,1170,6068,6607,12675,新豐,三等
2020-09-07,1170,5189,5192,10381,新豐,三等
2020-09-08,1170,4499,4683,9182,新豐,三等
2020-09-09,1170,4513,4684,9197,新豐,三等
2020-09-10,1170,4543,4662,9205,新豐,三等
2020-09-11,1170,5637,5440,11077,新豐,三等
2020-09-12,1170,5571,5109,10680,新豐,三等
2020-09-13,1170,6040,6968,13008,新豐,三等
2020-09-14,1170,5083,5503,10586,新豐,三等
2020-09-15,1170,4923,5102,10025,新豐,三等
2020-09-16,1170,4818,4976,9794,新豐,三等
2020-09-17,1170,4790,4909,9699,新豐,三等
2020-09-18,1170,6745,5747,12492,新豐,三等
2020-09-19,1170,5124,4916,10040,新豐,三等
2020-09-20,1170,5298,6267,11565,新豐,三等
2020-09-21,1170,5101,5358,10459,新豐,三等
2020-09-22,1170,4749,4889,9638,新豐,三等
2020-09-23,1170,4681,4900,9581,新豐,三等
2020-09-24,1170,4797,4944,9741,新豐,三等
2020-09-25,1170,5364,5293,10657,新豐,三等
2020-09-26,1170,5144,4852,9996,新豐,三等
2020-09-27,1170,4632,4868,9500,新豐,三等
2020-09-28,1170,4254,4825,9079,新豐,三等
2020-09-29,1170,4789,4961,9750,新豐,三等
2020-09-30,1170,6519,5877,12396,新豐,三等
2020-10-01,1170,5795,5498,11293,新豐,三等
2020-10-02,1170,5319,5316,10635,新豐,三等
2020-10-03,1170,5337,5400,10737,新豐,三等
2020-10-04,1170,6030,7085,13115,新豐,三等
2020-10-05,1170,5504,5766,11270,新豐,三等
2020-10-06,1170,5139,5257,10396,新豐,三等
2020-10-07,1170,5248,5339,10587,新豐,三等
2020-10-08,1170,6675,6066,12741,新豐,三等
2020-10-09,1170,6019,5713,11732,新豐,三等
2020-10-10,1170,5966,6082,12048,新豐,三等
2020-10-11,1170,6862,7667,14529,新豐,三等
2020-10-12,1170,5306,5524,10830,新豐,三等
2020-10-13,1170,4810,5161,9971,新豐,三等
2020-10-14,1170,5040,5148,10188,新豐,三等
2020-10-15,1170,5160,5397,10557,新豐,三等
2020-10-16,1170,6545,5952,12497,新豐,三等
2020-10-17,1170,5593,5491,11084,新豐,三等
2020-10-18,1170,6230,6971,13201,新豐,三等
2020-10-19,1170,5216,5592,10808,新豐,三等
2020-10-20,1170,4923,5042,9965,新豐,三等
2020-10-21,1170,4952,5168,10120,新豐,三等
2020-10-22,1170,4716,4753,9469,新豐,三等
2020-10-23,1170,5785,5663,11448,新豐,三等
2020-10-24,1170,5871,5425,11296,新豐,三等
2020-10-25,1170,5902,6735,12637,新豐,三等
2020-10-26,1170,5070,5266,10336,新豐,三等
2020-10-27,1170,4790,4907,9697,新豐,三等
2020-10-28,1170,4763,4841,9604,新豐,三等
2020-10-29,1170,4885,5017,9902,新豐,三等
2020-10-30,1170,6641,5783,12424,新豐,三等
2020-10-31,1170,5467,5321,10788,新豐,三等
2020-11-01,1170,5679,6648,12327,新豐,三等
2020-11-02,1170,5180,5354,10534,新豐,三等
2020-11-03,1170,4667,4830,9497,新豐,三等
2020-11-04,1170,4901,5046,9947,新豐,三等
2020-11-05,1170,5383,5389,10772,新豐,三等
2020-11-06,1170,6750,6152,12902,新豐,三等
2020-11-07,1170,6087,5696,11783,新豐,三等
2020-11-08,1170,6399,7260,13659,新豐,三等
2020-11-09,1170,5586,5838,11424,新豐,三等
2020-11-10,1170,5152,5329,10481,新豐,三等
2020-11-11,1170,5301,5405,10706,新豐,三等
2020-11-12,1170,5170,5254,10424,新豐,三等
2020-11-13,1170,6698,6000,12698,新豐,三等
2020-11-14,1170,5960,5817,11777,新豐,三等
2020-11-15,1170,6745,7539,14284,新豐,三等
2020-11-16,1170,5328,5714,11042,新豐,三等
2020-11-17,1170,4948,5175,10123,新豐,三等
2020-11-18,1170,5025,5236,10261,新豐,三等
2020-11-19,1170,5345,5288,10633,新豐,三等
2020-11-20,1170,6332,5767,12099,新豐,三等
2020-11-21,1170,5898,5629,11527,新豐,三等
2020-11-22,1170,6012,6871,12883,新豐,三等
2020-11-23,1170,5309,5611,10920,新豐,三等
2020-11-24,1170,4913,5177,10090,新豐,三等
2020-11-25,1170,5015,5103,10118,新豐,三等
2020-11-26,1170,5101,5240,10341,新豐,三等
2020-11-27,1170,6623,5916,12539,新豐,三等
2020-11-28,1170,5484,5365,10849,新豐,三等
2020-11-29,1170,5754,6555,12309,新豐,三等
2020-11-30,1170,5105,5555,10660,新豐,三等
2020-12-01,1170,4784,4873,9657,新豐,三等
2020-12-02,1170,4829,5100,9929,新豐,三等
2020-12-03,1170,5025,5082,10107,新豐,三等
2020-12-04,1170,6934,6368,13302,新豐,三等
2020-12-05,1170,6510,6343,12853,新豐,三等
2020-12-06,1170,7184,8218,15402,新豐,三等
2020-12-07,1170,5550,5727,11277,新豐,三等
2020-12-08,1170,4730,5202,9932,新豐,三等
2020-12-09,1170,4580,4889,9469,新豐,三等
2020-12-10,1170,5074,5320,10394,新豐,三等
2020-12-11,1170,6883,6134,13017,新豐,三等
2020-12-12,1170,6491,6256,12747,新豐,三等
2020-12-13,1170,7103,7948,15051,新豐,三等
2020-12-14,1170,5375,5826,11201,新豐,三等
2020-12-15,1170,4784,5089,9873,新豐,三等
2020-12-16,1170,5051,5389,10440,新豐,三等
2020-12-17,1170,5216,5296,10512,新豐,三等
2020-12-18,1170,6517,5840,12357,新豐,三等
2020-12-19,1170,5622,5193,10815,新豐,三等
2020-12-20,1170,6532,7377,13909,新豐,三等
2020-12-21,1170,5258,5559,10817,新豐,三等
2020-12-22,1170,4885,5174,10059,新豐,三等
2020-12-23,1170,4672,4975,9647,新豐,三等
2020-12-24,1170,5005,5218,10223,新豐,三等
2020-12-25,1170,6899,6307,13206,新豐,三等
2020-12-26,1170,5264,4699,9963,新豐,三等
2020-12-27,1170,5640,6339,11979,新豐,三等
2020-12-28,1170,4961,5431,10392,新豐,三等
2020-12-29,1170,4901,5126,10027,新豐,三等
2020-12-30,1170,4843,5011,9854,新豐,三等
2020-12-31,1170,7111,6167,13278,新豐,三等
2020-01-01,1180,4785,5296,10081,竹北,三等
2020-01-02,1180,5138,5219,10357,竹北,三等
2020-01-03,1180,5737,5818,11555,竹北,三等
2020-01-04,1180,4970,5110,10080,竹北,三等
2020-01-05,1180,4372,4931,9303,竹北,三等
2020-01-06,1180,5439,5468,10907,竹北,三等
2020-01-07,1180,5257,5120,10377,竹北,三等
2020-01-08,1180,5364,5245,10609,竹北,三等
2020-01-09,1180,5437,5431,10868,竹北,三等
2020-01-10,1180,6930,6702,13632,竹北,三等
2020-01-11,1180,5381,5238,10619,竹北,三等
2020-01-12,1180,5279,5475,10754,竹北,三等
2020-01-13,1180,5799,5725,11524,竹北,三等
2020-01-14,1180,5377,5555,10932,竹北,三等
2020-01-15,1180,5492,5387,10879,竹北,三等
2020-01-16,1180,6494,5973,12467,竹北,三等
2020-01-17,1180,6005,5955,11960,竹北,三等
2020-01-18,1180,5443,3847,9290,竹北,三等
2020-01-19,1180,4972,5237,10209,竹北,三等
2020-01-20,1180,5613,5582,11195,竹北,三等
2020-01-21,1180,5355,5551,10906,竹北,三等
2020-01-22,1180,5677,5598,11275,竹北,三等
2020-01-23,1180,4114,3836,7950,竹北,三等
2020-01-24,1180,3389,3266,6655,竹北,三等
2020-01-25,1180,3147,3124,6271,竹北,三等
2020-01-26,1180,3214,3301,6515,竹北,三等
2020-01-27,1180,3850,3745,7595,竹北,三等
2020-01-28,1180,3732,3722,7454,竹北,三等
2020-01-29,1180,3364,3709,7073,竹北,三等
2020-01-30,1180,4398,4386,8784,竹北,三等
2020-01-31,1180,4966,4706,9672,竹北,三等
2020-02-01,1180,3711,3570,7281,竹北,三等
2020-02-02,1180,3598,3958,7556,竹北,三等
2020-02-03,1180,4704,4702,9406,竹北,三等
2020-02-04,1180,4291,4318,8609,竹北,三等
2020-02-05,1180,4487,4558,9045,竹北,三等
2020-02-06,1180,4845,4763,9608,竹北,三等
2020-02-07,1180,5177,3232,8409,竹北,三等
2020-02-08,1180,3944,3955,7899,竹北,三等
2020-02-09,1180,4123,2838,6961,竹北,三等
2020-02-10,1180,4865,4875,9740,竹北,三等
2020-02-11,1180,4550,4529,9079,竹北,三等
2020-02-12,1180,4684,4717,9401,竹北,三等
2020-02-13,1180,4441,4458,8899,竹北,三等
2020-02-14,1180,5265,4979,10244,竹北,三等
2020-02-15,1180,4206,4202,8408,竹北,三等
2020-02-16,1180,3274,3636,6910,竹北,三等
2020-02-17,1180,4328,4406,8734,竹北,三等
2020-02-18,1180,4172,4235,8407,竹北,三等
2020-02-19,1180,4481,4415,8896,竹北,三等
2020-02-20,1180,4416,3117,7533,竹北,三等
2020-02-21,1180,5359,5126,10485,竹北,三等
2020-02-22,1180,4010,4005,8015,竹北,三等
2020-02-23,1180,3968,4238,8206,竹北,三等
2020-02-24,1180,4515,4599,9114,竹北,三等
2020-02-25,1180,4991,4899,9890,竹北,三等
2020-02-26,1180,4931,4882,9813,竹北,三等
2020-02-27,1180,5809,5594,11403,竹北,三等
2020-02-28,1180,4112,3892,8004,竹北,三等
2020-02-29,1180,3499,3457,6956,竹北,三等
2020-03-01,1180,3808,3845,7653,竹北,三等
2020-03-02,1180,4903,4827,9730,竹北,三等
2020-03-03,1180,4569,4540,9109,竹北,三等
2020-03-04,1180,4627,4559,9186,竹北,三等
2020-03-05,1180,4462,4414,8876,竹北,三等
2020-03-06,1180,5546,5795,11341,竹北,三等
2020-03-07,1180,4152,4127,8279,竹北,三等
2020-03-08,1180,4340,3757,8097,竹北,三等
2020-03-09,1180,5123,5001,10124,竹北,三等
2020-03-10,1180,4349,4239,8588,竹北,三等
2020-03-11,1180,4918,4731,9649,竹北,三等
2020-03-12,1180,4535,4640,9175,竹北,三等
2020-03-13,1180,5350,5602,10952,竹北,三等
2020-03-14,1180,3859,3895,7754,竹北,三等
2020-03-15,1180,4269,4099,8368,竹北,三等
2020-03-16,1180,4824,4756,9580,竹北,三等
2020-03-17,1180,4492,4424,8916,竹北,三等
2020-03-18,1180,4437,4424,8861,竹北,三等
2020-03-19,1180,4133,4170,8303,竹北,三等
2020-03-20,1180,5025,5180,10205,竹北,三等
2020-03-21,1180,3303,3256,6559,竹北,三等
2020-03-22,1180,3239,3161,6400,竹北,三等
2020-03-23,1180,4541,4406,8947,竹北,三等
2020-03-24,1180,4149,4183,8332,竹北,三等
2020-03-25,1180,4233,4214,8447,竹北,三等
2020-03-26,1180,4102,4134,8236,竹北,三等
2020-03-27,1180,4755,4839,9594,竹北,三等
2020-03-28,1180,2653,2624,5277,竹北,三等
2020-03-29,1180,2717,2806,5523,竹北,三等
2020-03-30,1180,4295,4190,8485,竹北,三等
2020-03-31,1180,4043,4103,8146,竹北,三等
2020-04-01,1180,4735,4836,9571,竹北,三等
2020-04-02,1180,2681,2695,5376,竹北,三等
2020-04-03,1180,2627,2705,5332,竹北,三等
2020-04-04,1180,2269,2335,4604,竹北,三等
2020-04-05,1180,2926,2764,5690,竹北,三等
2020-04-06,1180,4408,4141,8549,竹北,三等
2020-04-07,1180,3973,3066,7039,竹北,三等
2020-04-08,1180,4040,3867,7907,竹北,三等
2020-04-09,1180,4036,4050,8086,竹北,三等
2020-04-10,1180,4855,4793,9648,竹北,三等
2020-04-11,1180,2744,2579,5323,竹北,三等
2020-04-12,1180,2802,2643,5445,竹北,三等
2020-04-13,1180,4352,4028,8380,竹北,三等
2020-04-14,1180,4087,3959,8046,竹北,三等
2020-04-15,1180,4231,4142,8373,竹北,三等
2020-04-16,1180,4035,4102,8137,竹北,三等
2020-04-17,1180,4908,4949,9857,竹北,三等
2020-04-18,1180,3234,3266,6500,竹北,三等
2020-04-19,1180,3177,3255,6432,竹北,三等
2020-04-20,1180,4435,4200,8635,竹北,三等
2020-04-21,1180,4127,3929,8056,竹北,三等
2020-04-22,1180,4042,3961,8003,竹北,三等
2020-04-23,1180,3831,3872,7703,竹北,三等
2020-04-24,1180,4593,4637,9230,竹北,三等
2020-04-25,1180,2831,2848,5679,竹北,三等
2020-04-26,1180,2927,2975,5902,竹北,三等
2020-04-27,1180,4424,4224,8648,竹北,三等
2020-04-28,1180,4129,4026,8155,竹北,三等
2020-04-29,1180,4129,4104,8233,竹北,三等
2020-04-30,1180,4609,4497,9106,竹北,三等
2020-05-01,1180,4076,4304,8380,竹北,三等
2020-05-02,1180,2989,3146,6135,竹北,三等
2020-05-03,1180,3444,3404,6848,竹北,三等
2020-05-04,1180,4533,4350,8883,竹北,三等
2020-05-05,1180,4427,4263,8690,竹北,三等
2020-05-06,1180,4484,4314,8798,竹北,三等
2020-05-07,1180,4389,4331,8720,竹北,三等
2020-05-08,1180,5352,5847,11199,竹北,三等
2020-05-09,1180,3762,3797,7559,竹北,三等
2020-05-10,1180,3935,3801,7736,竹北,三等
2020-05-11,1180,4902,4672,9574,竹北,三等
2020-05-12,1180,4280,4277,8557,竹北,三等
2020-05-13,1180,4656,4514,9170,竹北,三等
2020-05-14,1180,4421,4413,8834,竹北,三等
2020-05-15,1180,5882,5691,11573,竹北,三等
2020-05-16,1180,3564,3709,7273,竹北,三等
2020-05-17,1180,3911,3730,7641,竹北,三等
2020-05-18,1180,4540,4420,8960,竹北,三等
2020-05-19,1180,4109,3120,7229,竹北,三等
2020-05-20,1180,4574,4361,8935,竹北,三等
2020-05-21,1180,4149,4234,8383,竹北,三等
2020-05-22,1180,4603,4709,9312,竹北,三等
2020-05-23,1180,3181,3145,6326,竹北,三等
2020-05-24,1180,3896,3836,7732,竹北,三等
2020-05-25,1180,4845,4714,9559,竹北,三等
2020-05-26,1180,4490,4399,8889,竹北,三等
2020-05-27,1180,4400,4204,8604,竹北,三等
2020-05-28,1180,4153,4183,8336,竹北,三等
2020-05-29,1180,5253,5417,10670,竹北,三等
2020-05-30,1180,4218,4150,8368,竹北,三等
2020-05-31,1180,4154,4231,8385,竹北,三等
2020-06-01,1180,4812,4628,9440,竹北,三等
2020-06-02,1180,4543,4390,8933,竹北,三等
2020-06-03,1180,4639,4519,9158,竹北,三等
2020-06-04,1180,4449,4496,8945,竹北,三等
2020-06-05,1180,5543,5556,11099,竹北,三等
2020-06-06,1180,4540,4372,8912,竹北,三等
2020-06-07,1180,3787,4051,7838,竹北,三等
2020-06-08,1180,4760,4565,9325,竹北,三等
2020-06-09,1180,4629,4477,9106,竹北,三等
2020-06-10,1180,4843,4702,9545,竹北,三等
2020-06-11,1180,4913,4844,9757,竹北,三等
2020-06-12,1180,5910,5861,11771,竹北,三等
2020-06-13,1180,4514,4505,9019,竹北,三等
2020-06-14,1180,4455,4657,9112,竹北,三等
2020-06-15,1180,5026,5061,10087,竹北,三等
2020-06-16,1180,4630,4674,9304,竹北,三等
2020-06-17,1180,4605,4552,9157,竹北,三等
2020-06-18,1180,4612,4636,9248,竹北,三等
2020-06-19,1180,5239,5190,10429,竹北,三等
2020-06-20,1180,4441,4336,8777,竹北,三等
2020-06-21,1180,4001,4193,8194,竹北,三等
2020-06-22,1180,4782,4740,9522,竹北,三等
2020-06-23,1180,4912,4841,9753,竹北,三等
2020-06-24,1180,5622,6008,11630,竹北,三等
2020-06-25,1180,4222,4178,8400,竹北,三等
2020-06-26,1180,4084,4199,8283,竹北,三等
2020-06-27,1180,4188,4227,8415,竹北,三等
2020-06-28,1180,4421,4588,9009,竹北,三等
2020-06-29,1180,4970,4943,9913,竹北,三等
2020-06-30,1180,4767,4652,9419,竹北,三等
2020-07-01,1180,4740,4625,9365,竹北,三等
2020-07-02,1180,4780,4693,9473,竹北,三等
2020-07-03,1180,5251,5016,10267,竹北,三等
2020-07-04,1180,4459,4210,8669,竹北,三等
2020-07-05,1180,4059,4376,8435,竹北,三等
2020-07-06,1180,5035,5081,10116,竹北,三等
2020-07-07,1180,4766,4764,9530,竹北,三等
2020-07-08,1180,4935,4787,9722,竹北,三等
2020-07-09,1180,4788,4713,9501,竹北,三等
2020-07-10,1180,6060,5646,11706,竹北,三等
2020-07-11,1180,4671,4501,9172,竹北,三等
2020-07-12,1180,4357,4833,9190,竹北,三等
2020-07-13,1180,4974,4984,9958,竹北,三等
2020-07-14,1180,5503,4810,10313,竹北,三等
2020-07-15,1180,5196,5052,10248,竹北,三等
2020-07-16,1180,5008,4949,9957,竹北,三等
2020-07-17,1180,5534,5336,10870,竹北,三等
2020-07-18,1180,4506,4540,9046,竹北,三等
2020-07-19,1180,4298,4607,8905,竹北,三等
2020-07-20,1180,4981,4961,9942,竹北,三等
2020-07-21,1180,4646,4661,9307,竹北,三等
2020-07-22,1180,4914,4889,9803,竹北,三等
2020-07-23,1180,4916,4946,9862,竹北,三等
2020-07-24,1180,5632,5281,10913,竹北,三等
2020-07-25,1180,4452,3954,8406,竹北,三等
2020-07-26,1180,4252,4645,8897,竹北,三等
2020-07-27,1180,5105,5014,10119,竹北,三等
2020-07-28,1180,4551,4667,9218,竹北,三等
2020-07-29,1180,4929,4823,9752,竹北,三等
2020-07-30,1180,4897,5013,9910,竹北,三等
2020-07-31,1180,5614,5430,11044,竹北,三等
2020-08-01,1180,4448,4569,9017,竹北,三等
2020-08-02,1180,3992,4213,8205,竹北,三等
2020-08-03,1180,4748,4704,9452,竹北,三等
2020-08-04,1180,4806,4706,9512,竹北,三等
2020-08-05,1180,5130,4985,10115,竹北,三等
2020-08-06,1180,5178,5154,10332,竹北,三等
2020-08-07,1180,6095,5585,11680,竹北,三等
2020-08-08,1180,4256,4200,8456,竹北,三等
2020-08-09,1180,4623,4958,9581,竹北,三等
2020-08-10,1180,5071,5072,10143,竹北,三等
2020-08-11,1180,4650,3987,8637,竹北,三等
2020-08-12,1180,5079,4956,10035,竹北,三等
2020-08-13,1180,5182,4846,10028,竹北,三等
2020-08-14,1180,5943,5504,11447,竹北,三等
2020-08-15,1180,4659,4638,9297,竹北,三等
2020-08-16,1180,4508,4934,9442,竹北,三等
2020-08-17,1180,5434,5232,10666,竹北,三等
2020-08-18,1180,5303,5220,10523,竹北,三等
2020-08-19,1180,5169,5096,10265,竹北,三等
2020-08-20,1180,5214,5096,10310,竹北,三等
2020-08-21,1180,6139,5769,11908,竹北,三等
2020-08-22,1180,4764,4724,9488,竹北,三等
2020-08-23,1180,4302,4668,8970,竹北,三等
2020-08-24,1180,5056,5094,10150,竹北,三等
2020-08-25,1180,4748,4959,9707,竹北,三等
2020-08-26,1180,4881,4859,9740,竹北,三等
2020-08-27,1180,4728,4814,9542,竹北,三等
2020-08-28,1180,5458,5225,10683,竹北,三等
2020-08-29,1180,4347,4178,8525,竹北,三等
2020-08-30,1180,4205,4578,8783,竹北,三等
2020-08-31,1180,5011,4858,9869,竹北,三等
2020-09-01,1180,4603,4547,9150,竹北,三等
2020-09-02,1180,4789,4692,9481,竹北,三等
2020-09-03,1180,4850,4745,9595,竹北,三等
2020-09-04,1180,5961,5599,11560,竹北,三等
2020-09-05,1180,4481,4395,8876,竹北,三等
2020-09-06,1180,4416,4682,9098,竹北,三等
2020-09-07,1180,5215,5272,10487,竹北,三等
2020-09-08,1180,4906,4797,9703,竹北,三等
2020-09-09,1180,4984,4943,9927,竹北,三等
2020-09-10,1180,5023,5001,10024,竹北,三等
2020-09-11,1180,5867,5811,11678,竹北,三等
2020-09-12,1180,4742,4677,9419,竹北,三等
2020-09-13,1180,5044,5042,10086,竹北,三等
2020-09-14,1180,5108,5072,10180,竹北,三等
2020-09-15,1180,4863,4685,9548,竹北,三等
2020-09-16,1180,4878,4729,9607,竹北,三等
2020-09-17,1180,4882,4901,9783,竹北,三等
2020-09-18,1180,5586,6022,11608,竹北,三等
2020-09-19,1180,4797,4985,9782,竹北,三等
2020-09-20,1180,4582,4663,9245,竹北,三等
2020-09-21,1180,5095,4920,10015,竹北,三等
2020-09-22,1180,4848,4773,9621,竹北,三等
2020-09-23,1180,5001,4891,9892,竹北,三等
2020-09-24,1180,4822,4787,9609,竹北,三等
2020-09-25,1180,5280,5324,10604,竹北,三等
2020-09-26,1180,5013,4797,9810,竹北,三等
2020-09-27,1180,3811,3979,7790,竹北,三等
2020-09-28,1180,4885,4392,9277,竹北,三等
2020-09-29,1180,4719,4718,9437,竹北,三等
2020-09-30,1180,5753,6321,12074,竹北,三等
2020-10-01,1180,4699,4954,9653,竹北,三等
2020-10-02,1180,4721,4711,9432,竹北,三等
2020-10-03,1180,4560,4487,9047,竹北,三等
2020-10-04,1180,5020,4761,9781,竹北,三等
2020-10-05,1180,5348,5080,10428,竹北,三等
2020-10-06,1180,4979,4898,9877,竹北,三等
2020-10-07,1180,5114,4956,10070,竹北,三等
2020-10-08,1180,5910,6167,12077,竹北,三等
2020-10-09,1180,5055,5182,10237,竹北,三等
2020-10-10,1180,4738,4850,9588,竹北,三等
2020-10-11,1180,5258,4874,10132,竹北,三等
2020-10-12,1180,5383,5035,10418,竹北,三等
2020-10-13,1180,4883,4800,9683,竹北,三等
2020-10-14,1180,5195,5060,10255,竹北,三等
2020-10-15,1180,5424,5152,10576,竹北,三等
2020-10-16,1180,5818,5971,11789,竹北,三等
2020-10-17,1180,6998,6717,13715,竹北,三等
2020-10-18,1180,5431,5338,10769,竹北,三等
2020-10-19,1180,4961,5005,9966,竹北,三等
2020-10-20,1180,4914,4889,9803,竹北,三等
2020-10-21,1180,5175,5022,10197,竹北,三等
2020-10-22,1180,4769,4767,9536,竹北,三等
2020-10-23,1180,5797,5862,11659,竹北,三等
2020-10-24,1180,4942,4925,9867,竹北,三等
2020-10-25,1180,4983,5146,10129,竹北,三等
2020-10-26,1180,5157,4960,10117,竹北,三等
2020-10-27,1180,4861,4817,9678,竹北,三等
2020-10-28,1180,4961,4739,9700,竹北,三等
2020-10-29,1180,4825,4899,9724,竹北,三等
2020-10-30,1180,5811,5972,11783,竹北,三等
2020-10-31,1180,5411,4881,10292,竹北,三等
2020-11-01,1180,5173,4682,9855,竹北,三等
2020-11-02,1180,5253,5026,10279,竹北,三等
2020-11-03,1180,4807,4735,9542,竹北,三等
2020-11-04,1180,5033,4744,9777,竹北,三等
2020-11-05,1180,5130,5095,10225,竹北,三等
2020-11-06,1180,6117,6048,12165,竹北,三等
2020-11-07,1180,5402,5186,10588,竹北,三等
2020-11-08,1180,4807,5069,9876,竹北,三等
2020-11-09,1180,5463,5311,10774,竹北,三等
2020-11-10,1180,5005,4869,9874,竹北,三等
2020-11-11,1180,5346,4581,9927,竹北,三等
2020-11-12,1180,5205,5210,10415,竹北,三等
2020-11-13,1180,5965,6191,12156,竹北,三等
2020-11-14,1180,5163,5120,10283,竹北,三等
2020-11-15,1180,5311,5406,10717,竹北,三等
2020-11-16,1180,5558,5213,10771,竹北,三等
2020-11-17,1180,5020,4859,9879,竹北,三等
2020-11-18,1180,5247,5030,10277,竹北,三等
2020-11-19,1180,5132,5072,10204,竹北,三等
2020-11-20,1180,6104,6208,12312,竹北,三等
2020-11-21,1180,5150,5166,10316,竹北,三等
2020-11-22,1180,5022,5079,10101,竹北,三等
2020-11-23,1180,5357,5169,10526,竹北,三等
2020-11-24,1180,5059,4951,10010,竹北,三等
2020-11-25,1180,5081,4918,9999,竹北,三等
2020-11-26,1180,4993,4992,9985,竹北,三等
2020-11-27,1180,5871,6109,11980,竹北,三等
2020-11-28,1180,5035,5039,10074,竹北,三等
2020-11-29,1180,5002,5155,10157,竹北,三等
2020-11-30,1180,5276,5089,10365,竹北,三等
2020-12-01,1180,4945,4787,9732,竹北,三等
2020-12-02,1180,4972,4850,9822,竹北,三等
2020-12-03,1180,4885,4969,9854,竹北,三等
2020-12-04,1180,6111,6158,12269,竹北,三等
2020-12-05,1180,5533,5533,11066,竹北,三等
2020-12-06,1180,5306,5403,10709,竹北,三等
2020-12-07,1180,5344,5020,10364,竹北,三等
2020-12-08,1180,4611,4756,9367,竹北,三等
2020-12-09,1180,4451,4669,9120,竹北,三等
2020-12-10,1180,4701,4459,9160,竹北,三等
2020-12-11,1180,6016,6123,12139,竹北,三等
2020-12-12,1180,5561,5411,10972,竹北,三等
2020-12-13,1180,5283,5270,10553,竹北,三等
2020-12-14,1180,5269,5160,10429,竹北,三等
2020-12-15,1180,4769,4739,9508,竹北,三等
2020-12-16,1180,5097,4813,9910,竹北,三等
2020-12-17,1180,4904,4974,9878,竹北,三等
2020-12-18,1180,5872,5972,11844,竹北,三等
2020-12-19,1180,5136,5167,10303,竹北,三等
2020-12-20,1180,5076,5217,10293,竹北,三等
2020-12-21,1180,5218,4960,10178,竹北,三等
2020-12-22,1180,5073,4920,9993,竹北,三等
2020-12-23,1180,4792,4604,9396,竹北,三等
2020-12-24,1180,4855,4844,9699,竹北,三等
2020-12-25,1180,6088,6237,12325,竹北,三等
2020-12-26,1180,4934,4844,9778,竹北,三等
2020-12-27,1180,4862,4870,9732,竹北,三等
2020-12-28,1180,5205,5021,10226,竹北,三等
2020-12-29,1180,5048,5123,10171,竹北,三等
2020-12-30,1180,4912,4779,9691,竹北,三等
2020-12-31,1180,5983,6566,12549,竹北,三等
2020-01-01,1190,1924,2015,3939,北新竹,簡易
2020-01-02,1190,2356,2551,4907,北新竹,簡易
2020-01-03,1190,2801,2884,5685,北新竹,簡易
2020-01-04,1190,2379,2335,4714,北新竹,簡易
2020-01-05,1190,1926,2178,4104,北新竹,簡易
2020-01-06,1190,2574,1661,4235,北新竹,簡易
2020-01-07,1190,2626,2687,5313,北新竹,簡易
2020-01-08,1190,2627,2741,5368,北新竹,簡易
2020-01-09,1190,2675,2764,5439,北新竹,簡易
2020-01-10,1190,3248,3106,6354,北新竹,簡易
2020-01-11,1190,2030,2084,4114,北新竹,簡易
2020-01-12,1190,1652,2145,3797,北新竹,簡易
2020-01-13,1190,2689,2830,5519,北新竹,簡易
2020-01-14,1190,2752,2815,5567,北新竹,簡易
2020-01-15,1190,2766,2755,5521,北新竹,簡易
2020-01-16,1190,2862,3086,5948,北新竹,簡易
2020-01-17,1190,2619,2662,5281,北新竹,簡易
2020-01-18,1190,1990,1458,3448,北新竹,簡易
2020-01-19,1190,1602,1974,3576,北新竹,簡易
2020-01-20,1190,2339,2510,4849,北新竹,簡易
2020-01-21,1190,2426,2407,4833,北新竹,簡易
2020-01-22,1190,2483,2443,4926,北新竹,簡易
2020-01-23,1190,1668,1637,3305,北新竹,簡易
2020-01-24,1190,1238,1291,2529,北新竹,簡易
2020-01-25,1190,1062,1181,2243,北新竹,簡易
2020-01-26,1190,953,1177,2130,北新竹,簡易
2020-01-27,1190,1210,1452,2662,北新竹,簡易
2020-01-28,1190,1270,1526,2796,北新竹,簡易
2020-01-29,1190,1244,1654,2898,北新竹,簡易
2020-01-30,1190,1676,1878,3554,北新竹,簡易
2020-01-31,1190,1882,1971,3853,北新竹,簡易
2020-02-01,1190,1422,1487,2909,北新竹,簡易
2020-02-02,1190,1238,1517,2755,北新竹,簡易
2020-02-03,1190,1883,2159,4042,北新竹,簡易
2020-02-04,1190,1776,1902,3678,北新竹,簡易
2020-02-05,1190,1881,1959,3840,北新竹,簡易
2020-02-06,1190,1939,2060,3999,北新竹,簡易
2020-02-07,1190,2199,2202,4401,北新竹,簡易
2020-02-08,1190,1371,1469,2840,北新竹,簡易
2020-02-09,1190,1300,1591,2891,北新竹,簡易
2020-02-10,1190,1907,1995,3902,北新竹,簡易
2020-02-11,1190,1902,1979,3881,北新竹,簡易
2020-02-12,1190,1931,2009,3940,北新竹,簡易
2020-02-13,1190,1817,1841,3658,北新竹,簡易
2020-02-14,1190,2029,2043,4072,北新竹,簡易
2020-02-15,1190,1677,1681,3358,北新竹,簡易
2020-02-16,1190,1009,1318,2327,北新竹,簡易
2020-02-17,1190,1722,1928,3650,北新竹,簡易
2020-02-18,1190,1787,1849,3636,北新竹,簡易
2020-02-19,1190,1868,1933,3801,北新竹,簡易
2020-02-20,1190,1819,1949,3768,北新竹,簡易
2020-02-21,1190,2155,2112,4267,北新竹,簡易
2020-02-22,1190,1415,1514,2929,北新竹,簡易
2020-02-23,1190,1264,1520,2784,北新竹,簡易
2020-02-24,1190,1903,1974,3877,北新竹,簡易
2020-02-25,1190,2391,2498,4889,北新竹,簡易
2020-02-26,1190,2374,2456,4830,北新竹,簡易
2020-02-27,1190,2640,2587,5227,北新竹,簡易
2020-02-28,1190,1630,1607,3237,北新竹,簡易
2020-02-29,1190,1228,1305,2533,北新竹,簡易
2020-03-01,1190,1170,1503,2673,北新竹,簡易
2020-03-02,1190,2302,2367,4669,北新竹,簡易
2020-03-03,1190,2267,2265,4532,北新竹,簡易
2020-03-04,1190,2264,2328,4592,北新竹,簡易
2020-03-05,1190,2228,2212,4440,北新竹,簡易
2020-03-06,1190,2489,2609,5098,北新竹,簡易
2020-03-07,1190,1550,1563,3113,北新竹,簡易
2020-03-08,1190,1354,1553,2907,北新竹,簡易
2020-03-09,1190,2344,2357,4701,北新竹,簡易
2020-03-10,1190,2141,2164,4305,北新竹,簡易
2020-03-11,1190,2356,2394,4750,北新竹,簡易
2020-03-12,1190,2222,2356,4578,北新竹,簡易
2020-03-13,1190,2421,2509,4930,北新竹,簡易
2020-03-14,1190,1418,1360,2778,北新竹,簡易
2020-03-15,1190,1283,1447,2730,北新竹,簡易
2020-03-16,1190,2167,2355,4522,北新竹,簡易
2020-03-17,1190,2157,2191,4348,北新竹,簡易
2020-03-18,1190,2217,2152,4369,北新竹,簡易
2020-03-19,1190,2063,2132,4195,北新竹,簡易
2020-03-20,1190,2431,2489,4920,北新竹,簡易
2020-03-21,1190,1166,1204,2370,北新竹,簡易
2020-03-22,1190,1078,1169,2247,北新竹,簡易
2020-03-23,1190,2112,2172,4284,北新竹,簡易
2020-03-24,1190,2051,2095,4146,北新竹,簡易
2020-03-25,1190,2050,2098,4148,北新竹,簡易
2020-03-26,1190,2001,2103,4104,北新竹,簡易
2020-03-27,1190,2239,2311,4550,北新竹,簡易
2020-03-28,1190,991,992,1983,北新竹,簡易
2020-03-29,1190,988,1154,2142,北新竹,簡易
2020-03-30,1190,2062,2059,4121,北新竹,簡易
2020-03-31,1190,1980,2102,4082,北新竹,簡易
2020-04-01,1190,2226,2370,4596,北新竹,簡易
2020-04-02,1190,1251,1139,2390,北新竹,簡易
2020-04-03,1190,1044,1052,2096,北新竹,簡易
2020-04-04,1190,769,927,1696,北新竹,簡易
2020-04-05,1190,889,1124,2013,北新竹,簡易
2020-04-06,1190,2065,2104,4169,北新竹,簡易
2020-04-07,1190,1901,1980,3881,北新竹,簡易
2020-04-08,1190,1997,2060,4057,北新竹,簡易
2020-04-09,1190,1985,2088,4073,北新竹,簡易
2020-04-10,1190,2200,2318,4518,北新竹,簡易
2020-04-11,1190,1012,1036,2048,北新竹,簡易
2020-04-12,1190,1136,1145,2281,北新竹,簡易
2020-04-13,1190,2024,2084,4108,北新竹,簡易
2020-04-14,1190,2003,2071,4074,北新竹,簡易
2020-04-15,1190,2092,2075,4167,北新竹,簡易
2020-04-16,1190,2042,2107,4149,北新竹,簡易
2020-04-17,1190,2260,2395,4655,北新竹,簡易
2020-04-18,1190,1220,1279,2499,北新竹,簡易
2020-04-19,1190,1008,1205,2213,北新竹,簡易
2020-04-20,1190,2037,2161,4198,北新竹,簡易
2020-04-21,1190,1977,1992,3969,北新竹,簡易
2020-04-22,1190,2009,2034,4043,北新竹,簡易
2020-04-23,1190,1965,2017,3982,北新竹,簡易
2020-04-24,1190,2185,2276,4461,北新竹,簡易
2020-04-25,1190,1189,1195,2384,北新竹,簡易
2020-04-26,1190,903,1073,1976,北新竹,簡易
2020-04-27,1190,2030,2121,4151,北新竹,簡易
2020-04-28,1190,2012,2026,4038,北新竹,簡易
2020-04-29,1190,2083,2134,4217,北新竹,簡易
2020-04-30,1190,2198,2200,4398,北新竹,簡易
2020-05-01,1190,2022,2132,4154,北新竹,簡易
2020-05-02,1190,1192,1233,2425,北新竹,簡易
2020-05-03,1190,1081,1342,2423,北新竹,簡易
2020-05-04,1190,2106,2267,4373,北新竹,簡易
2020-05-05,1190,2119,2212,4331,北新竹,簡易
2020-05-06,1190,2143,2186,4329,北新竹,簡易
2020-05-07,1190,2222,2238,4460,北新竹,簡易
2020-05-08,1190,2573,2640,5213,北新竹,簡易
2020-05-09,1190,1484,1508,2992,北新竹,簡易
2020-05-10,1190,1141,1512,2653,北新竹,簡易
2020-05-11,1190,2143,2215,4358,北新竹,簡易
2020-05-12,1190,2150,2168,4318,北新竹,簡易
2020-05-13,1190,2260,2267,4527,北新竹,簡易
2020-05-14,1190,2197,2264,4461,北新竹,簡易
2020-05-15,1190,2515,2591,5106,北新竹,簡易
2020-05-16,1190,1320,1398,2718,北新竹,簡易
2020-05-17,1190,1329,1482,2811,北新竹,簡易
2020-05-18,1190,2152,2199,4351,北新竹,簡易
2020-05-19,1190,2038,2079,4117,北新竹,簡易
2020-05-20,1190,2259,2198,4457,北新竹,簡易
2020-05-21,1190,2167,2160,4327,北新竹,簡易
2020-05-22,1190,2348,2309,4657,北新竹,簡易
2020-05-23,1190,1226,1291,2517,北新竹,簡易
2020-05-24,1190,1129,1381,2510,北新竹,簡易
2020-05-25,1190,2217,2229,4446,北新竹,簡易
2020-05-26,1190,2165,2224,4389,北新竹,簡易
2020-05-27,1190,2204,2121,4325,北新竹,簡易
2020-05-28,1190,2124,2163,4287,北新竹,簡易
2020-05-29,1190,2602,2604,5206,北新竹,簡易
2020-05-30,1190,1459,1538,2997,北新竹,簡易
2020-05-31,1190,1213,1488,2701,北新竹,簡易
2020-06-01,1190,2210,2261,4471,北新竹,簡易
2020-06-02,1190,2162,2223,4385,北新竹,簡易
2020-06-03,1190,2113,2260,4373,北新竹,簡易
2020-06-04,1190,2126,2165,4291,北新竹,簡易
2020-06-05,1190,2557,2606,5163,北新竹,簡易
2020-06-06,1190,1562,1586,3148,北新竹,簡易
2020-06-07,1190,1228,1457,2685,北新竹,簡易
2020-06-08,1190,2248,2271,4519,北新竹,簡易
2020-06-09,1190,2273,2410,4683,北新竹,簡易
2020-06-10,1190,2343,2367,4710,北新竹,簡易
2020-06-11,1190,2330,2387,4717,北新竹,簡易
2020-06-12,1190,2538,2578,5116,北新竹,簡易
2020-06-13,1190,1589,1605,3194,北新竹,簡易
2020-06-14,1190,1298,1518,2816,北新竹,簡易
2020-06-15,1190,2300,2450,4750,北新竹,簡易
2020-06-16,1190,2170,2201,4371,北新竹,簡易
2020-06-17,1190,2160,2226,4386,北新竹,簡易
2020-06-18,1190,2220,2195,4415,北新竹,簡易
2020-06-19,1190,2286,2426,4712,北新竹,簡易
2020-06-20,1190,1754,1834,3588,北新竹,簡易
2020-06-21,1190,1346,1560,2906,北新竹,簡易
2020-06-22,1190,2118,2182,4300,北新竹,簡易
2020-06-23,1190,2190,2286,4476,北新竹,簡易
2020-06-24,1190,2468,2455,4923,北新竹,簡易
2020-06-25,1190,1669,1664,3333,北新竹,簡易
2020-06-26,1190,1610,1687,3297,北新竹,簡易
2020-06-27,1190,1443,1597,3040,北新竹,簡易
2020-06-28,1190,1354,1724,3078,北新竹,簡易
2020-06-29,1190,2200,2368,4568,北新竹,簡易
2020-06-30,1190,2179,2396,4575,北新竹,簡易
2020-07-01,1190,1995,2167,4162,北新竹,簡易
2020-07-02,1190,1917,2017,3934,北新竹,簡易
2020-07-03,1190,2407,2307,4714,北新竹,簡易
2020-07-04,1190,1510,1588,3098,北新竹,簡易
2020-07-05,1190,1324,1669,2993,北新竹,簡易
2020-07-06,1190,2145,2318,4463,北新竹,簡易
2020-07-07,1190,2228,2330,4558,北新竹,簡易
2020-07-08,1190,2337,2398,4735,北新竹,簡易
2020-07-09,1190,2259,2269,4528,北新竹,簡易
2020-07-10,1190,2770,2821,5591,北新竹,簡易
2020-07-11,1190,1726,1756,3482,北新竹,簡易
2020-07-12,1190,1397,1692,3089,北新竹,簡易
2020-07-13,1190,2201,2345,4546,北新竹,簡易
2020-07-14,1190,2277,2445,4722,北新竹,簡易
2020-07-15,1190,2024,2098,4122,北新竹,簡易
2020-07-16,1190,2025,2114,4139,北新竹,簡易
2020-07-17,1190,2288,2359,4647,北新竹,簡易
2020-07-18,1190,1729,1655,3384,北新竹,簡易
2020-07-19,1190,1478,1740,3218,北新竹,簡易
2020-07-20,1190,1937,2100,4037,北新竹,簡易
2020-07-21,1190,1999,2134,4133,北新竹,簡易
2020-07-22,1190,1949,2093,4042,北新竹,簡易
2020-07-23,1190,2056,2082,4138,北新竹,簡易
2020-07-24,1190,2373,2402,4775,北新竹,簡易
2020-07-25,1190,1637,1648,3285,北新竹,簡易
2020-07-26,1190,1336,1697,3033,北新竹,簡易
2020-07-27,1190,1949,2063,4012,北新竹,簡易
2020-07-28,1190,2072,2094,4166,北新竹,簡易
2020-07-29,1190,2116,2218,4334,北新竹,簡易
2020-07-30,1190,2057,2053,4110,北新竹,簡易
2020-07-31,1190,2329,2413,4742,北新竹,簡易
2020-08-01,1190,1713,1699,3412,北新竹,簡易
2020-08-02,1190,1302,1726,3028,北新竹,簡易
2020-08-03,1190,1967,2125,4092,北新竹,簡易
2020-08-04,1190,2118,2278,4396,北新竹,簡易
2020-08-05,1190,2220,2315,4535,北新竹,簡易
2020-08-06,1190,2330,2353,4683,北新竹,簡易
2020-08-07,1190,2686,2543,5229,北新竹,簡易
2020-08-08,1190,1635,1630,3265,北新竹,簡易
2020-08-09,1190,1473,1975,3448,北新竹,簡易
2020-08-10,1190,2152,2319,4471,北新竹,簡易
2020-08-11,1190,2139,2241,4380,北新竹,簡易
2020-08-12,1190,2183,2317,4500,北新竹,簡易
2020-08-13,1190,2199,2355,4554,北新竹,簡易
2020-08-14,1190,2529,2171,4700,北新竹,簡易
2020-08-15,1190,1724,1834,3558,北新竹,簡易
2020-08-16,1190,1548,1856,3404,北新竹,簡易
2020-08-17,1190,2009,2187,4196,北新竹,簡易
2020-08-18,1190,2283,2465,4748,北新竹,簡易
2020-08-19,1190,2340,2345,4685,北新竹,簡易
2020-08-20,1190,2383,2510,4893,北新竹,簡易
2020-08-21,1190,2684,2640,5324,北新竹,簡易
2020-08-22,1190,1752,1698,3450,北新竹,簡易
2020-08-23,1190,1438,1807,3245,北新竹,簡易
2020-08-24,1190,1931,2149,4080,北新竹,簡易
2020-08-25,1190,2092,2227,4319,北新竹,簡易
2020-08-26,1190,2003,2094,4097,北新竹,簡易
2020-08-27,1190,2074,2035,4109,北新竹,簡易
2020-08-28,1190,2217,2239,4456,北新竹,簡易
2020-08-29,1190,1623,1589,3212,北新竹,簡易
2020-08-30,1190,1404,1672,3076,北新竹,簡易
2020-08-31,1190,2440,2547,4987,北新竹,簡易
2020-09-01,1190,2412,2453,4865,北新竹,簡易
2020-09-02,1190,2353,2444,4797,北新竹,簡易
2020-09-03,1190,2357,2400,4757,北新竹,簡易
2020-09-04,1190,2791,2762,5553,北新竹,簡易
2020-09-05,1190,1755,1825,3580,北新竹,簡易
2020-09-06,1190,1451,1818,3269,北新竹,簡易
2020-09-07,1190,2455,2545,5000,北新竹,簡易
2020-09-08,1190,2519,2567,5086,北新竹,簡易
2020-09-09,1190,2487,2465,4952,北新竹,簡易
2020-09-10,1190,2455,2573,5028,北新竹,簡易
2020-09-11,1190,2814,2780,5594,北新竹,簡易
2020-09-12,1190,1672,1643,3315,北新竹,簡易
2020-09-13,1190,1405,1693,3098,北新竹,簡易
2020-09-14,1190,2355,2429,4784,北新竹,簡易
2020-09-15,1190,2450,2584,5034,北新竹,簡易
2020-09-16,1190,2466,2503,4969,北新竹,簡易
2020-09-17,1190,2468,2492,4960,北新竹,簡易
2020-09-18,1190,2866,2877,5743,北新竹,簡易
2020-09-19,1190,1742,1872,3614,北新竹,簡易
2020-09-20,1190,1499,1693,3192,北新竹,簡易
2020-09-21,1190,2415,2530,4945,北新竹,簡易
2020-09-22,1190,2448,2550,4998,北新竹,簡易
2020-09-23,1190,2415,2531,4946,北新竹,簡易
2020-09-24,1190,2491,2513,5004,北新竹,簡易
2020-09-25,1190,2752,2752,5504,北新竹,簡易
2020-09-26,1190,2278,2300,4578,北新竹,簡易
2020-09-27,1190,1256,1517,2773,北新竹,簡易
2020-09-28,1190,2438,2462,4900,北新竹,簡易
2020-09-29,1190,2470,2588,5058,北新竹,簡易
2020-09-30,1190,2875,3048,5923,北新竹,簡易
2020-10-01,1190,2101,2018,4119,北新竹,簡易
2020-10-02,1190,1884,2077,3961,北新竹,簡易
2020-10-03,1190,1636,1867,3503,北新竹,簡易
2020-10-04,1190,1496,1936,3432,北新竹,簡易
2020-10-05,1190,2581,2661,5242,北新竹,簡易
2020-10-06,1190,2549,2709,5258,北新竹,簡易
2020-10-07,1190,2518,2647,5165,北新竹,簡易
2020-10-08,1190,2807,2926,5733,北新竹,簡易
2020-10-09,1190,2063,2185,4248,北新竹,簡易
2020-10-10,1190,1615,1806,3421,北新竹,簡易
2020-10-11,1190,1498,1792,3290,北新竹,簡易
2020-10-12,1190,2514,2604,5118,北新竹,簡易
2020-10-13,1190,2587,2645,5232,北新竹,簡易
2020-10-14,1190,2481,2587,5068,北新竹,簡易
2020-10-15,1190,2560,2664,5224,北新竹,簡易
2020-10-16,1190,2877,3056,5933,北新竹,簡易
2020-10-17,1190,2079,2193,4272,北新竹,簡易
2020-10-18,1190,1638,1972,3610,北新竹,簡易
2020-10-19,1190,2428,2592,5020,北新竹,簡易
2020-10-20,1190,2443,2557,5000,北新竹,簡易
2020-10-21,1190,2459,2586,5045,北新竹,簡易
2020-10-22,1190,2431,2514,4945,北新竹,簡易
2020-10-23,1190,2773,2836,5609,北新竹,簡易
2020-10-24,1190,1838,1996,3834,北新竹,簡易
2020-10-25,1190,1557,1856,3413,北新竹,簡易
2020-10-26,1190,2513,2617,5130,北新竹,簡易
2020-10-27,1190,2522,2609,5131,北新竹,簡易
2020-10-28,1190,2410,2506,4916,北新竹,簡易
2020-10-29,1190,2414,2487,4901,北新竹,簡易
2020-10-30,1190,2809,2900,5709,北新竹,簡易
2020-10-31,1190,1912,1334,3246,北新竹,簡易
2020-11-01,1190,1490,1840,3330,北新竹,簡易
2020-11-02,1190,2326,2497,4823,北新竹,簡易
2020-11-03,1190,2485,2500,4985,北新竹,簡易
2020-11-04,1190,2482,2588,5070,北新竹,簡易
2020-11-05,1190,2517,2656,5173,北新竹,簡易
2020-11-06,1190,2881,2993,5874,北新竹,簡易
2020-11-07,1190,1774,1848,3622,北新竹,簡易
2020-11-08,1190,1536,1864,3400,北新竹,簡易
2020-11-09,1190,2514,2650,5164,北新竹,簡易
2020-11-10,1190,2452,2535,4987,北新竹,簡易
2020-11-11,1190,2476,2569,5045,北新竹,簡易
2020-11-12,1190,2535,2654,5189,北新竹,簡易
2020-11-13,1190,2908,2976,5884,北新竹,簡易
2020-11-14,1190,1826,1987,3813,北新竹,簡易
2020-11-15,1190,1692,1970,3662,北新竹,簡易
2020-11-16,1190,2543,2116,4659,北新竹,簡易
2020-11-17,1190,2554,2660,5214,北新竹,簡易
2020-11-18,1190,2490,2614,5104,北新竹,簡易
2020-11-19,1190,2605,2681,5286,北新竹,簡易
2020-11-20,1190,2826,2927,5753,北新竹,簡易
2020-11-21,1190,1800,1849,3649,北新竹,簡易
2020-11-22,1190,1553,1522,3075,北新竹,簡易
2020-11-23,1190,2603,2717,5320,北新竹,簡易
2020-11-24,1190,2551,2593,5144,北新竹,簡易
2020-11-25,1190,2483,2517,5000,北新竹,簡易
2020-11-26,1190,2528,2613,5141,北新竹,簡易
2020-11-27,1190,3005,3154,6159,北新竹,簡易
2020-11-28,1190,1865,1954,3819,北新竹,簡易
2020-11-29,1190,1575,1918,3493,北新竹,簡易
2020-11-30,1190,2544,2273,4817,北新竹,簡易
2020-12-01,1190,2601,2637,5238,北新竹,簡易
2020-12-02,1190,2513,2553,5066,北新竹,簡易
2020-12-03,1190,2474,2577,5051,北新竹,簡易
2020-12-04,1190,2917,2995,5912,北新竹,簡易
2020-12-05,1190,1939,2023,3962,北新竹,簡易
2020-12-06,1190,1671,1971,3642,北新竹,簡易
2020-12-07,1190,2606,2703,5309,北新竹,簡易
2020-12-08,1190,2590,2764,5354,北新竹,簡易
2020-12-09,1190,2275,2449,4724,北新竹,簡易
2020-12-10,1190,2400,2504,4904,北新竹,簡易
2020-12-11,1190,2889,3026,5915,北新竹,簡易
2020-12-12,1190,2059,2170,4229,北新竹,簡易
2020-12-13,1190,1629,1930,3559,北新竹,簡易
2020-12-14,1190,2531,2666,5197,北新竹,簡易
2020-12-15,1190,2474,2125,4599,北新竹,簡易
2020-12-16,1190,2469,2509,4978,北新竹,簡易
2020-12-17,1190,2574,2585,5159,北新竹,簡易
2020-12-18,1190,2944,2625,5569,北新竹,簡易
2020-12-19,1190,2345,2431,4776,北新竹,簡易
2020-12-20,1190,1693,1756,3449,北新竹,簡易
2020-12-21,1190,2560,2657,5217,北新竹,簡易
2020-12-22,1190,2553,2632,5185,北新竹,簡易
2020-12-23,1190,2421,2513,4934,北新竹,簡易
2020-12-24,1190,2524,2267,4791,北新竹,簡易
2020-12-25,1190,3015,2745,5760,北新竹,簡易
2020-12-26,1190,1738,1853,3591,北新竹,簡易
2020-12-27,1190,1484,1520,3004,北新竹,簡易
2020-12-28,1190,2535,2240,4775,北新竹,簡易
2020-12-29,1190,2584,2281,4865,北新竹,簡易
2020-12-30,1190,2384,2462,4846,北新竹,簡易
2020-12-31,1190,2814,2563,5377,北新竹,簡易
2020-01-01,1191,428,480,908,千甲,簡易
2020-01-02,1191,314,356,670,千甲,簡易
2020-01-03,1191,373,313,686,千甲,簡易
2020-01-04,1191,524,418,942,千甲,簡易
2020-01-05,1191,517,490,1007,千甲,簡易
2020-01-06,1191,334,361,695,千甲,簡易
2020-01-07,1191,275,309,584,千甲,簡易
2020-01-08,1191,320,299,619,千甲,簡易
2020-01-09,1191,311,301,612,千甲,簡易
2020-01-10,1191,429,337,766,千甲,簡易
2020-01-11,1191,508,412,920,千甲,簡易
2020-01-12,1191,500,552,1052,千甲,簡易
2020-01-13,1191,317,400,717,千甲,簡易
2020-01-14,1191,301,315,616,千甲,簡易
2020-01-15,1191,317,321,638,千甲,簡易
2020-01-16,1191,296,310,606,千甲,簡易
2020-01-17,1191,327,311,638,千甲,簡易
2020-01-18,1191,373,320,693,千甲,簡易
2020-01-19,1191,444,424,868,千甲,簡易
2020-01-20,1191,329,358,687,千甲,簡易
2020-01-21,1191,370,354,724,千甲,簡易
2020-01-22,1191,457,354,811,千甲,簡易
2020-01-23,1191,474,339,813,千甲,簡易
2020-01-24,1191,515,371,886,千甲,簡易
2020-01-25,1191,539,426,965,千甲,簡易
2020-01-26,1191,349,371,720,千甲,簡易
2020-01-27,1191,414,474,888,千甲,簡易
2020-01-28,1191,272,325,597,千甲,簡易
2020-01-29,1191,266,342,608,千甲,簡易
2020-01-30,1191,245,269,514,千甲,簡易
2020-01-31,1191,331,287,618,千甲,簡易
2020-02-01,1191,398,309,707,千甲,簡易
2020-02-02,1191,377,438,815,千甲,簡易
2020-02-03,1191,272,317,589,千甲,簡易
2020-02-04,1191,287,258,545,千甲,簡易
2020-02-05,1191,363,302,665,千甲,簡易
2020-02-06,1191,344,301,645,千甲,簡易
2020-02-07,1191,403,327,730,千甲,簡易
2020-02-08,1191,410,317,727,千甲,簡易
2020-02-09,1191,462,468,930,千甲,簡易
2020-02-10,1191,312,328,640,千甲,簡易
2020-02-11,1191,303,267,570,千甲,簡易
2020-02-12,1191,338,311,649,千甲,簡易
2020-02-13,1191,304,273,577,千甲,簡易
2020-02-14,1191,410,345,755,千甲,簡易
2020-02-15,1191,415,335,750,千甲,簡易
2020-02-16,1191,301,313,614,千甲,簡易
2020-02-17,1191,274,301,575,千甲,簡易
2020-02-18,1191,251,228,479,千甲,簡易
2020-02-19,1191,295,287,582,千甲,簡易
2020-02-20,1191,301,289,590,千甲,簡易
2020-02-21,1191,319,279,598,千甲,簡易
2020-02-22,1191,359,270,629,千甲,簡易
2020-02-23,1191,355,387,742,千甲,簡易
2020-02-24,1191,274,277,551,千甲,簡易
2020-02-25,1191,258,253,511,千甲,簡易
2020-02-26,1191,293,298,591,千甲,簡易
2020-02-27,1191,375,340,715,千甲,簡易
2020-02-28,1191,369,269,638,千甲,簡易
2020-02-29,1191,373,317,690,千甲,簡易
2020-03-01,1191,340,416,756,千甲,簡易
2020-03-02,1191,256,324,580,千甲,簡易
2020-03-03,1191,220,232,452,千甲,簡易
2020-03-04,1191,218,215,433,千甲,簡易
2020-03-05,1191,284,275,559,千甲,簡易
2020-03-06,1191,361,326,687,千甲,簡易
2020-03-07,1191,412,322,734,千甲,簡易
2020-03-08,1191,493,415,908,千甲,簡易
2020-03-09,1191,319,336,655,千甲,簡易
2020-03-10,1191,217,242,459,千甲,簡易
2020-03-11,1191,257,255,512,千甲,簡易
2020-03-12,1191,241,235,476,千甲,簡易
2020-03-13,1191,290,265,555,千甲,簡易
2020-03-14,1191,340,303,643,千甲,簡易
2020-03-15,1191,361,361,722,千甲,簡易
2020-03-16,1191,252,260,512,千甲,簡易
2020-03-17,1191,210,223,433,千甲,簡易
2020-03-18,1191,230,229,459,千甲,簡易
2020-03-19,1191,169,177,346,千甲,簡易
2020-03-20,1191,287,288,575,千甲,簡易
2020-03-21,1191,369,273,642,千甲,簡易
2020-03-22,1191,320,278,598,千甲,簡易
2020-03-23,1191,212,246,458,千甲,簡易
2020-03-24,1191,186,194,380,千甲,簡易
2020-03-25,1191,195,191,386,千甲,簡易
2020-03-26,1191,204,205,409,千甲,簡易
2020-03-27,1191,244,237,481,千甲,簡易
2020-03-28,1191,202,175,377,千甲,簡易
2020-03-29,1191,238,239,477,千甲,簡易
2020-03-30,1191,194,215,409,千甲,簡易
2020-03-31,1191,211,216,427,千甲,簡易
2020-04-01,1191,291,259,550,千甲,簡易
2020-04-02,1191,262,155,417,千甲,簡易
2020-04-03,1191,287,233,520,千甲,簡易
2020-04-04,1191,294,247,541,千甲,簡易
2020-04-05,1191,276,287,563,千甲,簡易
2020-04-06,1191,228,252,480,千甲,簡易
2020-04-07,1191,220,201,421,千甲,簡易
2020-04-08,1191,196,207,403,千甲,簡易
2020-04-09,1191,236,226,462,千甲,簡易
2020-04-10,1191,269,245,514,千甲,簡易
2020-04-11,1191,275,208,483,千甲,簡易
2020-04-12,1191,272,273,545,千甲,簡易
2020-04-13,1191,228,263,491,千甲,簡易
2020-04-14,1191,211,219,430,千甲,簡易
2020-04-15,1191,209,207,416,千甲,簡易
2020-04-16,1191,204,194,398,千甲,簡易
2020-04-17,1191,289,278,567,千甲,簡易
2020-04-18,1191,328,252,580,千甲,簡易
2020-04-19,1191,316,315,631,千甲,簡易
2020-04-20,1191,205,251,456,千甲,簡易
2020-04-21,1191,208,204,412,千甲,簡易
2020-04-22,1191,178,169,347,千甲,簡易
2020-04-23,1191,182,177,359,千甲,簡易
2020-04-24,1191,233,230,463,千甲,簡易
2020-04-25,1191,304,202,506,千甲,簡易
2020-04-26,1191,264,275,539,千甲,簡易
2020-04-27,1191,193,225,418,千甲,簡易
2020-04-28,1191,169,190,359,千甲,簡易
2020-04-29,1191,197,206,403,千甲,簡易
2020-04-30,1191,311,217,528,千甲,簡易
2020-05-01,1191,368,270,638,千甲,簡易
2020-05-02,1191,374,304,678,千甲,簡易
2020-05-03,1191,339,312,651,千甲,簡易
2020-05-04,1191,226,263,489,千甲,簡易
2020-05-05,1191,267,220,487,千甲,簡易
2020-05-06,1191,265,250,515,千甲,簡易
2020-05-07,1191,267,253,520,千甲,簡易
2020-05-08,1191,350,297,647,千甲,簡易
2020-05-09,1191,217,241,458,千甲,簡易
2020-05-10,1191,390,375,765,千甲,簡易
2020-05-11,1191,271,277,548,千甲,簡易
2020-05-12,1191,210,215,425,千甲,簡易
2020-05-13,1191,247,245,492,千甲,簡易
2020-05-14,1191,255,250,505,千甲,簡易
2020-05-15,1191,306,294,600,千甲,簡易
2020-05-16,1191,354,260,614,千甲,簡易
2020-05-17,1191,307,325,632,千甲,簡易
2020-05-18,1191,229,243,472,千甲,簡易
2020-05-19,1191,210,222,432,千甲,簡易
2020-05-20,1191,248,241,489,千甲,簡易
2020-05-21,1191,238,222,460,千甲,簡易
2020-05-22,1191,251,237,488,千甲,簡易
2020-05-23,1191,311,263,574,千甲,簡易
2020-05-24,1191,345,332,677,千甲,簡易
2020-05-25,1191,244,212,456,千甲,簡易
2020-05-26,1191,241,181,422,千甲,簡易
2020-05-27,1191,200,227,427,千甲,簡易
2020-05-28,1191,199,229,428,千甲,簡易
2020-05-29,1191,369,232,601,千甲,簡易
2020-05-30,1191,365,284,649,千甲,簡易
2020-05-31,1191,364,279,643,千甲,簡易
2020-06-01,1191,253,273,526,千甲,簡易
2020-06-02,1191,250,198,448,千甲,簡易
2020-06-03,1191,256,248,504,千甲,簡易
2020-06-04,1191,226,229,455,千甲,簡易
2020-06-05,1191,418,223,641,千甲,簡易
2020-06-06,1191,426,340,766,千甲,簡易
2020-06-07,1191,331,297,628,千甲,簡易
2020-06-08,1191,218,275,493,千甲,簡易
2020-06-09,1191,259,223,482,千甲,簡易
2020-06-10,1191,290,260,550,千甲,簡易
2020-06-11,1191,294,272,566,千甲,簡易
2020-06-12,1191,309,222,531,千甲,簡易
2020-06-13,1191,421,329,750,千甲,簡易
2020-06-14,1191,387,356,743,千甲,簡易
2020-06-15,1191,336,259,595,千甲,簡易
2020-06-16,1191,226,261,487,千甲,簡易
2020-06-17,1191,289,213,502,千甲,簡易
2020-06-18,1191,253,222,475,千甲,簡易
2020-06-19,1191,309,188,497,千甲,簡易
2020-06-20,1191,360,320,680,千甲,簡易
2020-06-21,1191,331,363,694,千甲,簡易
2020-06-22,1191,249,200,449,千甲,簡易
2020-06-23,1191,262,243,505,千甲,簡易
2020-06-24,1191,328,256,584,千甲,簡易
2020-06-25,1191,374,173,547,千甲,簡易
2020-06-26,1191,316,274,590,千甲,簡易
2020-06-27,1191,363,286,649,千甲,簡易
2020-06-28,1191,353,367,720,千甲,簡易
2020-06-29,1191,287,231,518,千甲,簡易
2020-06-30,1191,300,295,595,千甲,簡易
2020-07-01,1191,268,263,531,千甲,簡易
2020-07-02,1191,218,236,454,千甲,簡易
2020-07-03,1191,365,322,687,千甲,簡易
2020-07-04,1191,397,301,698,千甲,簡易
2020-07-05,1191,446,399,845,千甲,簡易
2020-07-06,1191,371,359,730,千甲,簡易
2020-07-07,1191,320,324,644,千甲,簡易
2020-07-08,1191,287,256,543,千甲,簡易
2020-07-09,1191,271,255,526,千甲,簡易
2020-07-10,1191,366,318,684,千甲,簡易
2020-07-11,1191,410,268,678,千甲,簡易
2020-07-12,1191,408,437,845,千甲,簡易
2020-07-13,1191,292,304,596,千甲,簡易
2020-07-14,1191,271,251,522,千甲,簡易
2020-07-15,1191,245,243,488,千甲,簡易
2020-07-16,1191,296,249,545,千甲,簡易
2020-07-17,1191,340,271,611,千甲,簡易
2020-07-18,1191,286,239,525,千甲,簡易
2020-07-19,1191,368,363,731,千甲,簡易
2020-07-20,1191,225,299,524,千甲,簡易
2020-07-21,1191,238,240,478,千甲,簡易
2020-07-22,1191,257,247,504,千甲,簡易
2020-07-23,1191,226,243,469,千甲,簡易
2020-07-24,1191,281,239,520,千甲,簡易
2020-07-25,1191,340,274,614,千甲,簡易
2020-07-26,1191,369,375,744,千甲,簡易
2020-07-27,1191,266,299,565,千甲,簡易
2020-07-28,1191,263,227,490,千甲,簡易
2020-07-29,1191,228,221,449,千甲,簡易
2020-07-30,1191,241,281,522,千甲,簡易
2020-07-31,1191,348,263,611,千甲,簡易
2020-08-01,1191,375,300,675,千甲,簡易
2020-08-02,1191,373,379,752,千甲,簡易
2020-08-03,1191,245,298,543,千甲,簡易
2020-08-04,1191,265,257,522,千甲,簡易
2020-08-05,1191,337,289,626,千甲,簡易
2020-08-06,1191,305,288,593,千甲,簡易
2020-08-07,1191,400,293,693,千甲,簡易
2020-08-08,1191,445,305,750,千甲,簡易
2020-08-09,1191,442,427,869,千甲,簡易
2020-08-10,1191,284,315,599,千甲,簡易
2020-08-11,1191,233,242,475,千甲,簡易
2020-08-12,1191,312,225,537,千甲,簡易
2020-08-13,1191,251,241,492,千甲,簡易
2020-08-14,1191,313,257,570,千甲,簡易
2020-08-15,1191,368,321,689,千甲,簡易
2020-08-16,1191,424,440,864,千甲,簡易
2020-08-17,1191,302,338,640,千甲,簡易
2020-08-18,1191,283,251,534,千甲,簡易
2020-08-19,1191,312,293,605,千甲,簡易
2020-08-20,1191,250,280,530,千甲,簡易
2020-08-21,1191,349,294,643,千甲,簡易
2020-08-22,1191,414,315,729,千甲,簡易
2020-08-23,1191,339,342,681,千甲,簡易
2020-08-24,1191,308,285,593,千甲,簡易
2020-08-25,1191,283,247,530,千甲,簡易
2020-08-26,1191,259,244,503,千甲,簡易
2020-08-27,1191,297,255,552,千甲,簡易
2020-08-28,1191,332,278,610,千甲,簡易
2020-08-29,1191,367,286,653,千甲,簡易
2020-08-30,1191,337,313,650,千甲,簡易
2020-08-31,1191,261,277,538,千甲,簡易
2020-09-01,1191,261,233,494,千甲,簡易
2020-09-02,1191,247,238,485,千甲,簡易
2020-09-03,1191,243,220,463,千甲,簡易
2020-09-04,1191,358,303,661,千甲,簡易
2020-09-05,1191,471,338,809,千甲,簡易
2020-09-06,1191,453,394,847,千甲,簡易
2020-09-07,1191,327,332,659,千甲,簡易
2020-09-08,1191,283,281,564,千甲,簡易
2020-09-09,1191,291,251,542,千甲,簡易
2020-09-10,1191,268,264,532,千甲,簡易
2020-09-11,1191,334,283,617,千甲,簡易
2020-09-12,1191,380,312,692,千甲,簡易
2020-09-13,1191,426,385,811,千甲,簡易
2020-09-14,1191,280,334,614,千甲,簡易
2020-09-15,1191,229,254,483,千甲,簡易
2020-09-16,1191,267,248,515,千甲,簡易
2020-09-17,1191,256,260,516,千甲,簡易
2020-09-18,1191,338,306,644,千甲,簡易
2020-09-19,1191,388,309,697,千甲,簡易
2020-09-20,1191,381,361,742,千甲,簡易
2020-09-21,1191,253,259,512,千甲,簡易
2020-09-22,1191,240,246,486,千甲,簡易
2020-09-23,1191,272,255,527,千甲,簡易
2020-09-24,1191,264,228,492,千甲,簡易
2020-09-25,1191,309,269,578,千甲,簡易
2020-09-26,1191,368,311,679,千甲,簡易
2020-09-27,1191,286,298,584,千甲,簡易
2020-09-28,1191,243,286,529,千甲,簡易
2020-09-29,1191,261,255,516,千甲,簡易
2020-09-30,1191,390,278,668,千甲,簡易
2020-10-01,1191,417,316,733,千甲,簡易
2020-10-02,1191,396,328,724,千甲,簡易
2020-10-03,1191,455,387,842,千甲,簡易
2020-10-04,1191,417,434,851,千甲,簡易
2020-10-05,1191,330,370,700,千甲,簡易
2020-10-06,1191,338,242,580,千甲,簡易
2020-10-07,1191,344,293,637,千甲,簡易
2020-10-08,1191,379,379,758,千甲,簡易
2020-10-09,1191,457,372,829,千甲,簡易
2020-10-10,1191,514,371,885,千甲,簡易
2020-10-11,1191,478,462,940,千甲,簡易
2020-10-12,1191,296,331,627,千甲,簡易
2020-10-13,1191,278,280,558,千甲,簡易
2020-10-14,1191,311,253,564,千甲,簡易
2020-10-15,1191,301,205,506,千甲,簡易
2020-10-16,1191,362,342,704,千甲,簡易
2020-10-17,1191,444,399,843,千甲,簡易
2020-10-18,1191,469,245,714,千甲,簡易
2020-10-19,1191,260,186,446,千甲,簡易
2020-10-20,1191,307,291,598,千甲,簡易
2020-10-21,1191,260,144,404,千甲,簡易
2020-10-22,1191,262,165,427,千甲,簡易
2020-10-23,1191,350,301,651,千甲,簡易
2020-10-24,1191,399,324,723,千甲,簡易
2020-10-25,1191,407,384,791,千甲,簡易
2020-10-26,1191,267,193,460,千甲,簡易
2020-10-27,1191,252,162,414,千甲,簡易
2020-10-28,1191,286,156,442,千甲,簡易
2020-10-29,1191,280,256,536,千甲,簡易
2020-10-30,1191,401,183,584,千甲,簡易
2020-10-31,1191,390,309,699,千甲,簡易
2020-11-01,1191,437,432,869,千甲,簡易
2020-11-02,1191,268,321,589,千甲,簡易
2020-11-03,1191,252,224,476,千甲,簡易
2020-11-04,1191,266,257,523,千甲,簡易
2020-11-05,1191,356,320,676,千甲,簡易
2020-11-06,1191,399,296,695,千甲,簡易
2020-11-07,1191,501,344,845,千甲,簡易
2020-11-08,1191,404,434,838,千甲,簡易
2020-11-09,1191,328,326,654,千甲,簡易
2020-11-10,1191,287,209,496,千甲,簡易
2020-11-11,1191,285,267,552,千甲,簡易
2020-11-12,1191,276,238,514,千甲,簡易
2020-11-13,1191,395,340,735,千甲,簡易
2020-11-14,1191,411,350,761,千甲,簡易
2020-11-15,1191,423,415,838,千甲,簡易
2020-11-16,1191,266,268,534,千甲,簡易
2020-11-17,1191,354,324,678,千甲,簡易
2020-11-18,1191,321,302,623,千甲,簡易
2020-11-19,1191,292,260,552,千甲,簡易
2020-11-20,1191,358,336,694,千甲,簡易
2020-11-21,1191,420,340,760,千甲,簡易
2020-11-22,1191,379,371,750,千甲,簡易
2020-11-23,1191,270,298,568,千甲,簡易
2020-11-24,1191,279,279,558,千甲,簡易
2020-11-25,1191,276,246,522,千甲,簡易
2020-11-26,1191,278,253,531,千甲,簡易
2020-11-27,1191,357,303,660,千甲,簡易
2020-11-28,1191,377,354,731,千甲,簡易
2020-11-29,1191,419,414,833,千甲,簡易
2020-11-30,1191,295,309,604,千甲,簡易
2020-12-01,1191,265,180,445,千甲,簡易
2020-12-02,1191,286,269,555,千甲,簡易
2020-12-03,1191,266,261,527,千甲,簡易
2020-12-04,1191,426,309,735,千甲,簡易
2020-12-05,1191,492,359,851,千甲,簡易
2020-12-06,1191,414,433,847,千甲,簡易
2020-12-07,1191,327,327,654,千甲,簡易
2020-12-08,1191,271,271,542,千甲,簡易
2020-12-09,1191,265,241,506,千甲,簡易
2020-12-10,1191,298,277,575,千甲,簡易
2020-12-11,1191,404,332,736,千甲,簡易
2020-12-12,1191,507,401,908,千甲,簡易
2020-12-13,1191,417,443,860,千甲,簡易
2020-12-14,1191,277,314,591,千甲,簡易
2020-12-15,1191,261,274,535,千甲,簡易
2020-12-16,1191,286,296,582,千甲,簡易
2020-12-17,1191,309,278,587,千甲,簡易
2020-12-18,1191,410,345,755,千甲,簡易
2020-12-19,1191,376,331,707,千甲,簡易
2020-12-20,1191,360,393,753,千甲,簡易
2020-12-21,1191,280,372,652,千甲,簡易
2020-12-22,1191,279,283,562,千甲,簡易
2020-12-23,1191,268,247,515,千甲,簡易
2020-12-24,1191,338,243,581,千甲,簡易
2020-12-25,1191,402,371,773,千甲,簡易
2020-12-26,1191,370,350,720,千甲,簡易
2020-12-27,1191,347,240,587,千甲,簡易
2020-12-28,1191,265,213,478,千甲,簡易
2020-12-29,1191,318,299,617,千甲,簡易
2020-12-30,1191,341,212,553,千甲,簡易
2020-12-31,1191,493,345,838,千甲,簡易
2020-01-01,1192,1589,1949,3538,新莊,簡易
2020-01-02,1192,1752,1802,3554,新莊,簡易
2020-01-03,1192,2298,1948,4246,新莊,簡易
2020-01-04,1192,2067,1733,3800,新莊,簡易
2020-01-05,1192,1510,2303,3813,新莊,簡易
2020-01-06,1192,1637,1808,3445,新莊,簡易
2020-01-07,1192,1552,1609,3161,新莊,簡易
2020-01-08,1192,1707,1675,3382,新莊,簡易
2020-01-09,1192,1763,1737,3500,新莊,簡易
2020-01-10,1192,3644,2094,5738,新莊,簡易
2020-01-11,1192,2230,1782,4012,新莊,簡易
2020-01-12,1192,1294,3396,4690,新莊,簡易
2020-01-13,1192,1648,2001,3649,新莊,簡易
2020-01-14,1192,1724,1773,3497,新莊,簡易
2020-01-15,1192,1741,1743,3484,新莊,簡易
2020-01-16,1192,1864,1954,3818,新莊,簡易
2020-01-17,1192,2763,2315,5078,新莊,簡易
2020-01-18,1192,1967,1660,3627,新莊,簡易
2020-01-19,1192,1457,2170,3627,新莊,簡易
2020-01-20,1192,1953,1909,3862,新莊,簡易
2020-01-21,1192,2043,1878,3921,新莊,簡易
2020-01-22,1192,3141,1847,4988,新莊,簡易
2020-01-23,1192,2335,882,3217,新莊,簡易
2020-01-24,1192,1262,648,1910,新莊,簡易
2020-01-25,1192,694,781,1475,新莊,簡易
2020-01-26,1192,740,924,1664,新莊,簡易
2020-01-27,1192,832,1139,1971,新莊,簡易
2020-01-28,1192,905,1659,2564,新莊,簡易
2020-01-29,1192,859,2628,3487,新莊,簡易
2020-01-30,1192,1395,1651,3046,新莊,簡易
2020-01-31,1192,1837,1573,3410,新莊,簡易
2020-02-01,1192,1322,1154,2476,新莊,簡易
2020-02-02,1192,1040,1786,2826,新莊,簡易
2020-02-03,1192,1589,1702,3291,新莊,簡易
2020-02-04,1192,1384,1423,2807,新莊,簡易
2020-02-05,1192,1440,1444,2884,新莊,簡易
2020-02-06,1192,1514,1450,2964,新莊,簡易
2020-02-07,1192,2271,1573,3844,新莊,簡易
2020-02-08,1192,1490,1149,2639,新莊,簡易
2020-02-09,1192,1059,1922,2981,新莊,簡易
2020-02-10,1192,1554,1600,3154,新莊,簡易
2020-02-11,1192,1473,1566,3039,新莊,簡易
2020-02-12,1192,1511,1492,3003,新莊,簡易
2020-02-13,1192,1501,1445,2946,新莊,簡易
2020-02-14,1192,2212,1680,3892,新莊,簡易
2020-02-15,1192,1676,1342,3018,新莊,簡易
2020-02-16,1192,959,1724,2683,新莊,簡易
2020-02-17,1192,1458,1575,3033,新莊,簡易
2020-02-18,1192,1381,1392,2773,新莊,簡易
2020-02-19,1192,1463,1499,2962,新莊,簡易
2020-02-20,1192,1549,1513,3062,新莊,簡易
2020-02-21,1192,2257,1644,3901,新莊,簡易
2020-02-22,1192,1502,1138,2640,新莊,簡易
2020-02-23,1192,1018,1761,2779,新莊,簡易
2020-02-24,1192,1445,1579,3024,新莊,簡易
2020-02-25,1192,1445,1513,2958,新莊,簡易
2020-02-26,1192,1552,1564,3116,新莊,簡易
2020-02-27,1192,2578,1829,4407,新莊,簡易
2020-02-28,1192,1962,1154,3116,新莊,簡易
2020-02-29,1192,1100,1048,2148,新莊,簡易
2020-03-01,1192,968,2375,3343,新莊,簡易
2020-03-02,1192,1452,1695,3147,新莊,簡易
2020-03-03,1192,1336,1427,2763,新莊,簡易
2020-03-04,1192,1217,1314,2531,新莊,簡易
2020-03-05,1192,1333,1393,2726,新莊,簡易
2020-03-06,1192,2066,1805,3871,新莊,簡易
2020-03-07,1192,1438,1178,2616,新莊,簡易
2020-03-08,1192,1053,1723,2776,新莊,簡易
2020-03-09,1192,1458,1587,3045,新莊,簡易
2020-03-10,1192,1314,1356,2670,新莊,簡易
2020-03-11,1192,1331,1415,2746,新莊,簡易
2020-03-12,1192,1381,1447,2828,新莊,簡易
2020-03-13,1192,2298,1800,4098,新莊,簡易
2020-03-14,1192,1404,1180,2584,新莊,簡易
2020-03-15,1192,1110,1899,3009,新莊,簡易
2020-03-16,1192,1434,1528,2962,新莊,簡易
2020-03-17,1192,1289,1379,2668,新莊,簡易
2020-03-18,1192,1253,1362,2615,新莊,簡易
2020-03-19,1192,1328,1300,2628,新莊,簡易
2020-03-20,1192,2070,1675,3745,新莊,簡易
2020-03-21,1192,1140,973,2113,新莊,簡易
2020-03-22,1192,800,1412,2212,新莊,簡易
2020-03-23,1192,1259,1453,2712,新莊,簡易
2020-03-24,1192,1188,1274,2462,新莊,簡易
2020-03-25,1192,1186,1260,2446,新莊,簡易
2020-03-26,1192,1209,1230,2439,新莊,簡易
2020-03-27,1192,1822,1557,3379,新莊,簡易
2020-03-28,1192,1008,796,1804,新莊,簡易
2020-03-29,1192,784,1247,2031,新莊,簡易
2020-03-30,1192,1264,1399,2663,新莊,簡易
2020-03-31,1192,1240,1299,2539,新莊,簡易
2020-04-01,1192,2054,1464,3518,新莊,簡易
2020-04-02,1192,1548,766,2314,新莊,簡易
2020-04-03,1192,899,681,1580,新莊,簡易
2020-04-04,1192,614,839,1453,新莊,簡易
2020-04-05,1192,703,1995,2698,新莊,簡易
2020-04-06,1192,1172,1480,2652,新莊,簡易
2020-04-07,1192,1108,1214,2322,新莊,簡易
2020-04-08,1192,1106,1228,2334,新莊,簡易
2020-04-09,1192,1139,1196,2335,新莊,簡易
2020-04-10,1192,1672,1483,3155,新莊,簡易
2020-04-11,1192,994,802,1796,新莊,簡易
2020-04-12,1192,795,1207,2002,新莊,簡易
2020-04-13,1192,1201,1405,2606,新莊,簡易
2020-04-14,1192,1114,1196,2310,新莊,簡易
2020-04-15,1192,1156,1218,2374,新莊,簡易
2020-04-16,1192,1229,1302,2531,新莊,簡易
2020-04-17,1192,1859,1517,3376,新莊,簡易
2020-04-18,1192,1169,956,2125,新莊,簡易
2020-04-19,1192,881,1444,2325,新莊,簡易
2020-04-20,1192,1283,1442,2725,新莊,簡易
2020-04-21,1192,1118,1198,2316,新莊,簡易
2020-04-22,1192,1127,1199,2326,新莊,簡易
2020-04-23,1192,1150,1219,2369,新莊,簡易
2020-04-24,1192,1825,1457,3282,新莊,簡易
2020-04-25,1192,1131,886,2017,新莊,簡易
2020-04-26,1192,751,1388,2139,新莊,簡易
2020-04-27,1192,1239,1355,2594,新莊,簡易
2020-04-28,1192,1151,1197,2348,新莊,簡易
2020-04-29,1192,1228,1268,2496,新莊,簡易
2020-04-30,1192,2012,1447,3459,新莊,簡易
2020-05-01,1192,1698,1189,2887,新莊,簡易
2020-05-02,1192,963,975,1938,新莊,簡易
2020-05-03,1192,858,1940,2798,新莊,簡易
2020-05-04,1192,1289,1522,2811,新莊,簡易
2020-05-05,1192,1227,1306,2533,新莊,簡易
2020-05-06,1192,1213,1284,2497,新莊,簡易
2020-05-07,1192,1275,1329,2604,新莊,簡易
2020-05-08,1192,2241,1662,3903,新莊,簡易
2020-05-09,1192,1463,1025,2488,新莊,簡易
2020-05-10,1192,929,2016,2945,新莊,簡易
2020-05-11,1192,1282,1551,2833,新莊,簡易
2020-05-12,1192,1233,1318,2551,新莊,簡易
2020-05-13,1192,1246,1340,2586,新莊,簡易
2020-05-14,1192,1305,1396,2701,新莊,簡易
2020-05-15,1192,2159,1799,3958,新莊,簡易
2020-05-16,1192,751,753,1504,新莊,簡易
2020-05-17,1192,1057,1735,2792,新莊,簡易
2020-05-18,1192,1309,1492,2801,新莊,簡易
2020-05-19,1192,1263,1346,2609,新莊,簡易
2020-05-20,1192,1256,1359,2615,新莊,簡易
2020-05-21,1192,1291,1374,2665,新莊,簡易
2020-05-22,1192,1949,1628,3577,新莊,簡易
2020-05-23,1192,1303,970,2273,新莊,簡易
2020-05-24,1192,1078,1787,2865,新莊,簡易
2020-05-25,1192,1380,1594,2974,新莊,簡易
2020-05-26,1192,1299,1370,2669,新莊,簡易
2020-05-27,1192,1291,1428,2719,新莊,簡易
2020-05-28,1192,1302,1392,2694,新莊,簡易
2020-05-29,1192,2190,1794,3984,新莊,簡易
2020-05-30,1192,1608,1183,2791,新莊,簡易
2020-05-31,1192,1190,1983,3173,新莊,簡易
2020-06-01,1192,1386,1654,3040,新莊,簡易
2020-06-02,1192,1388,1453,2841,新莊,簡易
2020-06-03,1192,1305,1399,2704,新莊,簡易
2020-06-04,1192,1486,1511,2997,新莊,簡易
2020-06-05,1192,2357,1656,4013,新莊,簡易
2020-06-06,1192,1635,1179,2814,新莊,簡易
2020-06-07,1192,987,2077,3064,新莊,簡易
2020-06-08,1192,1381,1608,2989,新莊,簡易
2020-06-09,1192,1324,1388,2712,新莊,簡易
2020-06-10,1192,1383,1451,2834,新莊,簡易
2020-06-11,1192,1473,1483,2956,新莊,簡易
2020-06-12,1192,2276,1776,4052,新莊,簡易
2020-06-13,1192,1675,1358,3033,新莊,簡易
2020-06-14,1192,1219,2017,3236,新莊,簡易
2020-06-15,1192,1443,1685,3128,新莊,簡易
2020-06-16,1192,1425,1461,2886,新莊,簡易
2020-06-17,1192,1397,1448,2845,新莊,簡易
2020-06-18,1192,1380,1447,2827,新莊,簡易
2020-06-19,1192,2012,1633,3645,新莊,簡易
2020-06-20,1192,1698,1429,3127,新莊,簡易
2020-06-21,1192,1138,1736,2874,新莊,簡易
2020-06-22,1192,1441,1662,3103,新莊,簡易
2020-06-23,1192,1506,1449,2955,新莊,簡易
2020-06-24,1192,2777,1638,4415,新莊,簡易
2020-06-25,1192,2118,1131,3249,新莊,簡易
2020-06-26,1192,1183,1058,2241,新莊,簡易
2020-06-27,1192,999,1449,2448,新莊,簡易
2020-06-28,1192,1049,2560,3609,新莊,簡易
2020-06-29,1192,1507,1907,3414,新莊,簡易
2020-06-30,1192,1472,1547,3019,新莊,簡易
2020-07-01,1192,1395,1496,2891,新莊,簡易
2020-07-02,1192,1503,1488,2991,新莊,簡易
2020-07-03,1192,2092,1676,3768,新莊,簡易
2020-07-04,1192,1490,1281,2771,新莊,簡易
2020-07-05,1192,1161,1853,3014,新莊,簡易
2020-07-06,1192,1610,1749,3359,新莊,簡易
2020-07-07,1192,1485,1532,3017,新莊,簡易
2020-07-08,1192,1503,1553,3056,新莊,簡易
2020-07-09,1192,1538,1553,3091,新莊,簡易
2020-07-10,1192,2423,1890,4313,新莊,簡易
2020-07-11,1192,1734,1319,3053,新莊,簡易
2020-07-12,1192,1136,2036,3172,新莊,簡易
2020-07-13,1192,1544,1785,3329,新莊,簡易
2020-07-14,1192,1643,1656,3299,新莊,簡易
2020-07-15,1192,1558,1588,3146,新莊,簡易
2020-07-16,1192,1671,1630,3301,新莊,簡易
2020-07-17,1192,2466,1755,4221,新莊,簡易
2020-07-18,1192,1758,1317,3075,新莊,簡易
2020-07-19,1192,1136,2046,3182,新莊,簡易
2020-07-20,1192,1648,1762,3410,新莊,簡易
2020-07-21,1192,1499,1548,3047,新莊,簡易
2020-07-22,1192,1604,1627,3231,新莊,簡易
2020-07-23,1192,1696,1687,3383,新莊,簡易
2020-07-24,1192,2569,1788,4357,新莊,簡易
2020-07-25,1192,1762,1440,3202,新莊,簡易
2020-07-26,1192,1189,2230,3419,新莊,簡易
2020-07-27,1192,1589,1744,3333,新莊,簡易
2020-07-28,1192,1536,1595,3131,新莊,簡易
2020-07-29,1192,1564,1571,3135,新莊,簡易
2020-07-30,1192,1559,1634,3193,新莊,簡易
2020-07-31,1192,2388,1847,4235,新莊,簡易
2020-08-01,1192,1764,1440,3204,新莊,簡易
2020-08-02,1192,1196,2068,3264,新莊,簡易
2020-08-03,1192,1471,1665,3136,新莊,簡易
2020-08-04,1192,1508,1593,3101,新莊,簡易
2020-08-05,1192,1605,1618,3223,新莊,簡易
2020-08-06,1192,1607,1582,3189,新莊,簡易
2020-08-07,1192,2914,1869,4783,新莊,簡易
2020-08-08,1192,1647,1200,2847,新莊,簡易
2020-08-09,1192,1086,2461,3547,新莊,簡易
2020-08-10,1192,1501,1849,3350,新莊,簡易
2020-08-11,1192,1495,1522,3017,新莊,簡易
2020-08-12,1192,1617,1641,3258,新莊,簡易
2020-08-13,1192,1622,1613,3235,新莊,簡易
2020-08-14,1192,2538,1932,4470,新莊,簡易
2020-08-15,1192,1686,1405,3091,新莊,簡易
2020-08-16,1192,1277,2316,3593,新莊,簡易
2020-08-17,1192,1629,1863,3492,新莊,簡易
2020-08-18,1192,1653,1776,3429,新莊,簡易
2020-08-19,1192,1712,1706,3418,新莊,簡易
2020-08-20,1192,1751,1709,3460,新莊,簡易
2020-08-21,1192,2618,1940,4558,新莊,簡易
2020-08-22,1192,1820,1402,3222,新莊,簡易
2020-08-23,1192,1265,2206,3471,新莊,簡易
2020-08-24,1192,1652,1884,3536,新莊,簡易
2020-08-25,1192,1655,1665,3320,新莊,簡易
2020-08-26,1192,1661,1679,3340,新莊,簡易
2020-08-27,1192,1572,1608,3180,新莊,簡易
2020-08-28,1192,2469,1811,4280,新莊,簡易
2020-08-29,1192,1772,1357,3129,新莊,簡易
2020-08-30,1192,1151,2217,3368,新莊,簡易
2020-08-31,1192,1540,1747,3287,新莊,簡易
2020-09-01,1192,1434,1549,2983,新莊,簡易
2020-09-02,1192,1505,1600,3105,新莊,簡易
2020-09-03,1192,1562,1628,3190,新莊,簡易
2020-09-04,1192,2495,1857,4352,新莊,簡易
2020-09-05,1192,1805,1432,3237,新莊,簡易
2020-09-06,1192,1262,2138,3400,新莊,簡易
2020-09-07,1192,1528,1777,3305,新莊,簡易
2020-09-08,1192,1535,1556,3091,新莊,簡易
2020-09-09,1192,1452,1537,2989,新莊,簡易
2020-09-10,1192,1586,1625,3211,新莊,簡易
2020-09-11,1192,2442,1879,4321,新莊,簡易
2020-09-12,1192,1712,1346,3058,新莊,簡易
2020-09-13,1192,1285,2133,3418,新莊,簡易
2020-09-14,1192,1543,1781,3324,新莊,簡易
2020-09-15,1192,1501,1544,3045,新莊,簡易
2020-09-16,1192,1489,1548,3037,新莊,簡易
2020-09-17,1192,1571,1562,3133,新莊,簡易
2020-09-18,1192,2472,1929,4401,新莊,簡易
2020-09-19,1192,1979,1648,3627,新莊,簡易
2020-09-20,1192,1442,2328,3770,新莊,簡易
2020-09-21,1192,1550,1782,3332,新莊,簡易
2020-09-22,1192,1567,1653,3220,新莊,簡易
2020-09-23,1192,1600,1622,3222,新莊,簡易
2020-09-24,1192,1723,1749,3472,新莊,簡易
2020-09-25,1192,2283,1831,4114,新莊,簡易
2020-09-26,1192,1787,1587,3374,新莊,簡易
2020-09-27,1192,1131,1851,2982,新莊,簡易
2020-09-28,1192,1572,1685,3257,新莊,簡易
2020-09-29,1192,1599,1625,3224,新莊,簡易
2020-09-30,1192,2918,1941,4859,新莊,簡易
2020-10-01,1192,2508,1303,3811,新莊,簡易
2020-10-02,1192,1480,1411,2891,新莊,簡易
2020-10-03,1192,1319,1819,3138,新莊,簡易
2020-10-04,1192,1263,3035,4298,新莊,簡易
2020-10-05,1192,1593,1982,3575,新莊,簡易
2020-10-06,1192,1475,1549,3024,新莊,簡易
2020-10-07,1192,1545,1571,3116,新莊,簡易
2020-10-08,1192,2547,2030,4577,新莊,簡易
2020-10-09,1192,2239,1637,3876,新莊,簡易
2020-10-10,1192,1684,1684,3368,新莊,簡易
2020-10-11,1192,1390,2612,4002,新莊,簡易
2020-10-12,1192,1586,1836,3422,新莊,簡易
2020-10-13,1192,1495,1545,3040,新莊,簡易
2020-10-14,1192,1527,1579,3106,新莊,簡易
2020-10-15,1192,1611,1649,3260,新莊,簡易
2020-10-16,1192,2398,1974,4372,新莊,簡易
2020-10-17,1192,2052,1723,3775,新莊,簡易
2020-10-18,1192,1486,2237,3723,新莊,簡易
2020-10-19,1192,1582,1777,3359,新莊,簡易
2020-10-20,1192,1516,1582,3098,新莊,簡易
2020-10-21,1192,1542,1583,3125,新莊,簡易
2020-10-22,1192,1542,1544,3086,新莊,簡易
2020-10-23,1192,2517,2001,4518,新莊,簡易
2020-10-24,1192,2146,1582,3728,新莊,簡易
2020-10-25,1192,1380,2329,3709,新莊,簡易
2020-10-26,1192,1632,1849,3481,新莊,簡易
2020-10-27,1192,1530,1602,3132,新莊,簡易
2020-10-28,1192,1548,1591,3139,新莊,簡易
2020-10-29,1192,1572,1642,3214,新莊,簡易
2020-10-30,1192,2536,1970,4506,新莊,簡易
2020-10-31,1192,2160,1839,3999,新莊,簡易
2020-11-01,1192,1317,2281,3598,新莊,簡易
2020-11-02,1192,1591,1826,3417,新莊,簡易
2020-11-03,1192,1478,1547,3025,新莊,簡易
2020-11-04,1192,1464,1495,2959,新莊,簡易
2020-11-05,1192,1561,1622,3183,新莊,簡易
2020-11-06,1192,2593,1954,4547,新莊,簡易
2020-11-07,1192,2070,1582,3652,新莊,簡易
2020-11-08,1192,1312,2351,3663,新莊,簡易
2020-11-09,1192,1580,1864,3444,新莊,簡易
2020-11-10,1192,1478,1581,3059,新莊,簡易
2020-11-11,1192,1541,1599,3140,新莊,簡易
2020-11-12,1192,1621,1620,3241,新莊,簡易
2020-11-13,1192,2740,2120,4860,新莊,簡易
2020-11-14,1192,2082,1662,3744,新莊,簡易
2020-11-15,1192,1598,2636,4234,新莊,簡易
2020-11-16,1192,1628,1963,3591,新莊,簡易
2020-11-17,1192,1640,1737,3377,新莊,簡易
2020-11-18,1192,1537,1590,3127,新莊,簡易
2020-11-19,1192,1615,1638,3253,新莊,簡易
2020-11-20,1192,2646,2098,4744,新莊,簡易
2020-11-21,1192,2037,1600,3637,新莊,簡易
2020-11-22,1192,1432,2402,3834,新莊,簡易
2020-11-23,1192,1669,1869,3538,新莊,簡易
2020-11-24,1192,1578,1716,3294,新莊,簡易
2020-11-25,1192,1685,1743,3428,新莊,簡易
2020-11-26,1192,1639,1673,3312,新莊,簡易
2020-11-27,1192,2760,2063,4823,新莊,簡易
2020-11-28,1192,1896,1663,3559,新莊,簡易
2020-11-29,1192,1526,2467,3993,新莊,簡易
2020-11-30,1192,1628,1866,3494,新莊,簡易
2020-12-01,1192,1573,1669,3242,新莊,簡易
2020-12-02,1192,1545,1614,3159,新莊,簡易
2020-12-03,1192,1623,1641,3264,新莊,簡易
2020-12-04,1192,2728,2061,4789,新莊,簡易
2020-12-05,1192,2112,1709,3821,新莊,簡易
2020-12-06,1192,1507,2519,4026,新莊,簡易
2020-12-07,1192,1686,1903,3589,新莊,簡易
2020-12-08,1192,1552,1634,3186,新莊,簡易
2020-12-09,1192,1577,1589,3166,新莊,簡易
2020-12-10,1192,1585,1590,3175,新莊,簡易
2020-12-11,1192,2711,2097,4808,新莊,簡易
2020-12-12,1192,2044,1716,3760,新莊,簡易
2020-12-13,1192,1455,2460,3915,新莊,簡易
2020-12-14,1192,1667,1924,3591,新莊,簡易
2020-12-15,1192,1608,1638,3246,新莊,簡易
2020-12-16,1192,1607,1610,3217,新莊,簡易
2020-12-17,1192,1738,1674,3412,新莊,簡易
2020-12-18,1192,2829,2154,4983,新莊,簡易
2020-12-19,1192,2038,1657,3695,新莊,簡易
2020-12-20,1192,1413,2529,3942,新莊,簡易
2020-12-21,1192,1675,1902,3577,新莊,簡易
2020-12-22,1192,1621,1766,3387,新莊,簡易
2020-12-23,1192,1511,1568,3079,新莊,簡易
2020-12-24,1192,1710,1704,3414,新莊,簡易
2020-12-25,1192,2777,2083,4860,新莊,簡易
2020-12-26,1192,1912,1610,3522,新莊,簡易
2020-12-27,1192,1390,2277,3667,新莊,簡易
2020-12-28,1192,1675,1919,3594,新莊,簡易
2020-12-29,1192,1779,1723,3502,新莊,簡易
2020-12-30,1192,1794,1654,3448,新莊,簡易
2020-12-31,1192,3142,2092,5234,新莊,簡易
2020-01-01,1193,701,861,1562,竹中,甲簡
2020-01-02,1193,603,617,1220,竹中,甲簡
2020-01-03,1193,758,718,1476,竹中,甲簡
2020-01-04,1193,831,842,1673,竹中,甲簡
2020-01-05,1193,666,882,1548,竹中,甲簡
2020-01-06,1193,573,644,1217,竹中,甲簡
2020-01-07,1193,498,558,1056,竹中,甲簡
2020-01-08,1193,658,651,1309,竹中,甲簡
2020-01-09,1193,627,726,1353,竹中,甲簡
2020-01-10,1193,1225,800,2025,竹中,甲簡
2020-01-11,1193,832,767,1599,竹中,甲簡
2020-01-12,1193,575,1108,1683,竹中,甲簡
2020-01-13,1193,610,712,1322,竹中,甲簡
2020-01-14,1193,592,655,1247,竹中,甲簡
2020-01-15,1193,572,620,1192,竹中,甲簡
2020-01-16,1193,766,769,1535,竹中,甲簡
2020-01-17,1193,963,811,1774,竹中,甲簡
2020-01-18,1193,795,760,1555,竹中,甲簡
2020-01-19,1193,565,768,1333,竹中,甲簡
2020-01-20,1193,716,753,1469,竹中,甲簡
2020-01-21,1193,735,695,1430,竹中,甲簡
2020-01-22,1193,1098,707,1805,竹中,甲簡
2020-01-23,1193,820,504,1324,竹中,甲簡
2020-01-24,1193,468,372,840,竹中,甲簡
2020-01-25,1193,478,560,1038,竹中,甲簡
2020-01-26,1193,378,393,771,竹中,甲簡
2020-01-27,1193,563,709,1272,竹中,甲簡
2020-01-28,1193,527,744,1271,竹中,甲簡
2020-01-29,1193,415,924,1339,竹中,甲簡
2020-01-30,1193,536,592,1128,竹中,甲簡
2020-01-31,1193,704,684,1388,竹中,甲簡
2020-02-01,1193,576,584,1160,竹中,甲簡
2020-02-02,1193,545,753,1298,竹中,甲簡
2020-02-03,1193,560,639,1199,竹中,甲簡
2020-02-04,1193,525,553,1078,竹中,甲簡
2020-02-05,1193,536,535,1071,竹中,甲簡
2020-02-06,1193,601,591,1192,竹中,甲簡
2020-02-07,1193,827,605,1432,竹中,甲簡
2020-02-08,1193,583,534,1117,竹中,甲簡
2020-02-09,1193,541,760,1301,竹中,甲簡
2020-02-10,1193,575,601,1176,竹中,甲簡
2020-02-11,1193,541,562,1103,竹中,甲簡
2020-02-12,1193,605,578,1183,竹中,甲簡
2020-02-13,1193,580,534,1114,竹中,甲簡
2020-02-14,1193,789,629,1418,竹中,甲簡
2020-02-15,1193,686,600,1286,竹中,甲簡
2020-02-16,1193,395,547,942,竹中,甲簡
2020-02-17,1193,596,615,1211,竹中,甲簡
2020-02-18,1193,603,601,1204,竹中,甲簡
2020-02-19,1193,516,502,1018,竹中,甲簡
2020-02-20,1193,557,552,1109,竹中,甲簡
2020-02-21,1193,819,592,1411,竹中,甲簡
2020-02-22,1193,648,587,1235,竹中,甲簡
2020-02-23,1193,510,715,1225,竹中,甲簡
2020-02-24,1193,591,634,1225,竹中,甲簡
2020-02-25,1193,527,560,1087,竹中,甲簡
2020-02-26,1193,537,610,1147,竹中,甲簡
2020-02-27,1193,880,647,1527,竹中,甲簡
2020-02-28,1193,716,539,1255,竹中,甲簡
2020-02-29,1193,553,561,1114,竹中,甲簡
2020-03-01,1193,463,879,1342,竹中,甲簡
2020-03-02,1193,543,621,1164,竹中,甲簡
2020-03-03,1193,488,574,1062,竹中,甲簡
2020-03-04,1193,446,532,978,竹中,甲簡
2020-03-05,1193,449,558,1007,竹中,甲簡
2020-03-06,1193,766,653,1419,竹中,甲簡
2020-03-07,1193,586,561,1147,竹中,甲簡
2020-03-08,1193,527,669,1196,竹中,甲簡
2020-03-09,1193,500,600,1100,竹中,甲簡
2020-03-10,1193,468,531,999,竹中,甲簡
2020-03-11,1193,517,569,1086,竹中,甲簡
2020-03-12,1193,477,534,1011,竹中,甲簡
2020-03-13,1193,782,649,1431,竹中,甲簡
2020-03-14,1193,559,511,1070,竹中,甲簡
2020-03-15,1193,514,709,1223,竹中,甲簡
2020-03-16,1193,525,573,1098,竹中,甲簡
2020-03-17,1193,450,508,958,竹中,甲簡
2020-03-18,1193,477,529,1006,竹中,甲簡
2020-03-19,1193,489,510,999,竹中,甲簡
2020-03-20,1193,729,604,1333,竹中,甲簡
2020-03-21,1193,448,421,869,竹中,甲簡
2020-03-22,1193,439,578,1017,竹中,甲簡
2020-03-23,1193,484,576,1060,竹中,甲簡
2020-03-24,1193,417,483,900,竹中,甲簡
2020-03-25,1193,423,452,875,竹中,甲簡
2020-03-26,1193,429,489,918,竹中,甲簡
2020-03-27,1193,671,561,1232,竹中,甲簡
2020-03-28,1193,417,357,774,竹中,甲簡
2020-03-29,1193,398,589,987,竹中,甲簡
2020-03-30,1193,455,527,982,竹中,甲簡
2020-03-31,1193,434,477,911,竹中,甲簡
2020-04-01,1193,738,584,1322,竹中,甲簡
2020-04-02,1193,546,345,891,竹中,甲簡
2020-04-03,1193,426,348,774,竹中,甲簡
2020-04-04,1193,283,372,655,竹中,甲簡
2020-04-05,1193,344,683,1027,竹中,甲簡
2020-04-06,1193,449,524,973,竹中,甲簡
2020-04-07,1193,384,459,843,竹中,甲簡
2020-04-08,1193,402,457,859,竹中,甲簡
2020-04-09,1193,398,468,866,竹中,甲簡
2020-04-10,1193,603,537,1140,竹中,甲簡
2020-04-11,1193,372,353,725,竹中,甲簡
2020-04-12,1193,329,427,756,竹中,甲簡
2020-04-13,1193,461,505,966,竹中,甲簡
2020-04-14,1193,417,475,892,竹中,甲簡
2020-04-15,1193,390,438,828,竹中,甲簡
2020-04-16,1193,409,467,876,竹中,甲簡
2020-04-17,1193,666,558,1224,竹中,甲簡
2020-04-18,1193,493,462,955,竹中,甲簡
2020-04-19,1193,432,614,1046,竹中,甲簡
2020-04-20,1193,471,534,1005,竹中,甲簡
2020-04-21,1193,413,469,882,竹中,甲簡
2020-04-22,1193,403,452,855,竹中,甲簡
2020-04-23,1193,400,501,901,竹中,甲簡
2020-04-24,1193,642,541,1183,竹中,甲簡
2020-04-25,1193,477,446,923,竹中,甲簡
2020-04-26,1193,342,508,850,竹中,甲簡
2020-04-27,1193,461,519,980,竹中,甲簡
2020-04-28,1193,414,467,881,竹中,甲簡
2020-04-29,1193,418,480,898,竹中,甲簡
2020-04-30,1193,680,526,1206,竹中,甲簡
2020-05-01,1193,580,519,1099,竹中,甲簡
2020-05-02,1193,463,490,953,竹中,甲簡
2020-05-03,1193,449,750,1199,竹中,甲簡
2020-05-04,1193,483,550,1033,竹中,甲簡
2020-05-05,1193,412,461,873,竹中,甲簡
2020-05-06,1193,434,484,918,竹中,甲簡
2020-05-07,1193,436,482,918,竹中,甲簡
2020-05-08,1193,780,578,1358,竹中,甲簡
2020-05-09,1193,608,484,1092,竹中,甲簡
2020-05-10,1193,419,697,1116,竹中,甲簡
2020-05-11,1193,480,582,1062,竹中,甲簡
2020-05-12,1193,448,504,952,竹中,甲簡
2020-05-13,1193,437,505,942,竹中,甲簡
2020-05-14,1193,506,571,1077,竹中,甲簡
2020-05-15,1193,749,636,1385,竹中,甲簡
2020-05-16,1193,525,495,1020,竹中,甲簡
2020-05-17,1193,506,643,1149,竹中,甲簡
2020-05-18,1193,479,543,1022,竹中,甲簡
2020-05-19,1193,427,474,901,竹中,甲簡
2020-05-20,1193,434,496,930,竹中,甲簡
2020-05-21,1193,476,486,962,竹中,甲簡
2020-05-22,1193,693,599,1292,竹中,甲簡
2020-05-23,1193,481,426,907,竹中,甲簡
2020-05-24,1193,477,700,1177,竹中,甲簡
2020-05-25,1193,527,572,1099,竹中,甲簡
2020-05-26,1193,438,504,942,竹中,甲簡
2020-05-27,1193,422,499,921,竹中,甲簡
2020-05-28,1193,468,514,982,竹中,甲簡
2020-05-29,1193,767,613,1380,竹中,甲簡
2020-05-30,1193,679,583,1262,竹中,甲簡
2020-05-31,1193,563,844,1407,竹中,甲簡
2020-06-01,1193,529,571,1100,竹中,甲簡
2020-06-02,1193,483,507,990,竹中,甲簡
2020-06-03,1193,458,520,978,竹中,甲簡
2020-06-04,1193,531,587,1118,竹中,甲簡
2020-06-05,1193,855,590,1445,竹中,甲簡
2020-06-06,1193,615,537,1152,竹中,甲簡
2020-06-07,1193,481,773,1254,竹中,甲簡
2020-06-08,1193,473,579,1052,竹中,甲簡
2020-06-09,1193,477,501,978,竹中,甲簡
2020-06-10,1193,448,508,956,竹中,甲簡
2020-06-11,1193,508,548,1056,竹中,甲簡
2020-06-12,1193,788,624,1412,竹中,甲簡
2020-06-13,1193,690,621,1311,竹中,甲簡
2020-06-14,1193,539,776,1315,竹中,甲簡
2020-06-15,1193,504,566,1070,竹中,甲簡
2020-06-16,1193,800,845,1645,竹中,甲簡
2020-06-17,1193,478,531,1009,竹中,甲簡
2020-06-18,1193,500,486,986,竹中,甲簡
2020-06-19,1193,713,570,1283,竹中,甲簡
2020-06-20,1193,605,530,1135,竹中,甲簡
2020-06-21,1193,591,769,1360,竹中,甲簡
2020-06-22,1193,512,585,1097,竹中,甲簡
2020-06-23,1193,555,555,1110,竹中,甲簡
2020-06-24,1193,868,586,1454,竹中,甲簡
2020-06-25,1193,765,536,1301,竹中,甲簡
2020-06-26,1193,592,581,1173,竹中,甲簡
2020-06-27,1193,589,665,1254,竹中,甲簡
2020-06-28,1193,472,909,1381,竹中,甲簡
2020-06-29,1193,525,623,1148,竹中,甲簡
2020-06-30,1193,514,557,1071,竹中,甲簡
2020-07-01,1193,474,517,991,竹中,甲簡
2020-07-02,1193,544,595,1139,竹中,甲簡
2020-07-03,1193,755,614,1369,竹中,甲簡
2020-07-04,1193,579,567,1146,竹中,甲簡
2020-07-05,1193,460,633,1093,竹中,甲簡
2020-07-06,1193,559,599,1158,竹中,甲簡
2020-07-07,1193,477,526,1003,竹中,甲簡
2020-07-08,1193,497,541,1038,竹中,甲簡
2020-07-09,1193,515,533,1048,竹中,甲簡
2020-07-10,1193,886,692,1578,竹中,甲簡
2020-07-11,1193,699,601,1300,竹中,甲簡
2020-07-12,1193,566,774,1340,竹中,甲簡
2020-07-13,1193,556,608,1164,竹中,甲簡
2020-07-14,1193,561,638,1199,竹中,甲簡
2020-07-15,1193,585,575,1160,竹中,甲簡
2020-07-16,1193,614,558,1172,竹中,甲簡
2020-07-17,1193,851,664,1515,竹中,甲簡
2020-07-18,1193,692,638,1330,竹中,甲簡
2020-07-19,1193,579,843,1422,竹中,甲簡
2020-07-20,1193,596,625,1221,竹中,甲簡
2020-07-21,1193,544,551,1095,竹中,甲簡
2020-07-22,1193,583,566,1149,竹中,甲簡
2020-07-23,1193,595,566,1161,竹中,甲簡
2020-07-24,1193,878,673,1551,竹中,甲簡
2020-07-25,1193,699,629,1328,竹中,甲簡
2020-07-26,1193,551,791,1342,竹中,甲簡
2020-07-27,1193,539,629,1168,竹中,甲簡
2020-07-28,1193,526,565,1091,竹中,甲簡
2020-07-29,1193,590,571,1161,竹中,甲簡
2020-07-30,1193,576,562,1138,竹中,甲簡
2020-07-31,1193,964,763,1727,竹中,甲簡
2020-08-01,1193,670,618,1288,竹中,甲簡
2020-08-02,1193,515,897,1412,竹中,甲簡
2020-08-03,1193,593,589,1182,竹中,甲簡
2020-08-04,1193,512,529,1041,竹中,甲簡
2020-08-05,1193,541,550,1091,竹中,甲簡
2020-08-06,1193,595,588,1183,竹中,甲簡
2020-08-07,1193,973,640,1613,竹中,甲簡
2020-08-08,1193,638,564,1202,竹中,甲簡
2020-08-09,1193,535,923,1458,竹中,甲簡
2020-08-10,1193,562,636,1198,竹中,甲簡
2020-08-11,1193,554,552,1106,竹中,甲簡
2020-08-12,1193,555,584,1139,竹中,甲簡
2020-08-13,1193,595,554,1149,竹中,甲簡
2020-08-14,1193,891,647,1538,竹中,甲簡
2020-08-15,1193,683,588,1271,竹中,甲簡
2020-08-16,1193,557,897,1454,竹中,甲簡
2020-08-17,1193,619,695,1314,竹中,甲簡
2020-08-18,1193,574,623,1197,竹中,甲簡
2020-08-19,1193,600,595,1195,竹中,甲簡
2020-08-20,1193,617,591,1208,竹中,甲簡
2020-08-21,1193,866,644,1510,竹中,甲簡
2020-08-22,1193,711,645,1356,竹中,甲簡
2020-08-23,1193,579,856,1435,竹中,甲簡
2020-08-24,1193,598,649,1247,竹中,甲簡
2020-08-25,1193,614,629,1243,竹中,甲簡
2020-08-26,1193,604,591,1195,竹中,甲簡
2020-08-27,1193,586,548,1134,竹中,甲簡
2020-08-28,1193,873,646,1519,竹中,甲簡
2020-08-29,1193,654,573,1227,竹中,甲簡
2020-08-30,1193,511,848,1359,竹中,甲簡
2020-08-31,1193,563,628,1191,竹中,甲簡
2020-09-01,1193,533,540,1073,竹中,甲簡
2020-09-02,1193,512,504,1016,竹中,甲簡
2020-09-03,1193,553,555,1108,竹中,甲簡
2020-09-04,1193,907,665,1572,竹中,甲簡
2020-09-05,1193,724,616,1340,竹中,甲簡
2020-09-06,1193,569,891,1460,竹中,甲簡
2020-09-07,1193,547,633,1180,竹中,甲簡
2020-09-08,1193,502,521,1023,竹中,甲簡
2020-09-09,1193,528,559,1087,竹中,甲簡
2020-09-10,1193,525,532,1057,竹中,甲簡
2020-09-11,1193,858,679,1537,竹中,甲簡
2020-09-12,1193,737,701,1438,竹中,甲簡
2020-09-13,1193,577,876,1453,竹中,甲簡
2020-09-14,1193,496,586,1082,竹中,甲簡
2020-09-15,1193,522,555,1077,竹中,甲簡
2020-09-16,1193,505,543,1048,竹中,甲簡
2020-09-17,1193,516,553,1069,竹中,甲簡
2020-09-18,1193,896,686,1582,竹中,甲簡
2020-09-19,1193,708,641,1349,竹中,甲簡
2020-09-20,1193,592,807,1399,竹中,甲簡
2020-09-21,1193,519,586,1105,竹中,甲簡
2020-09-22,1193,520,531,1051,竹中,甲簡
2020-09-23,1193,502,556,1058,竹中,甲簡
2020-09-24,1193,541,533,1074,竹中,甲簡
2020-09-25,1193,702,595,1297,竹中,甲簡
2020-09-26,1193,605,568,1173,竹中,甲簡
2020-09-27,1193,455,607,1062,竹中,甲簡
2020-09-28,1193,574,602,1176,竹中,甲簡
2020-09-29,1193,575,546,1121,竹中,甲簡
2020-09-30,1193,1015,687,1702,竹中,甲簡
2020-10-01,1193,893,623,1516,竹中,甲簡
2020-10-02,1193,745,742,1487,竹中,甲簡
2020-10-03,1193,708,824,1532,竹中,甲簡
2020-10-04,1193,596,1173,1769,竹中,甲簡
2020-10-05,1193,545,673,1218,竹中,甲簡
2020-10-06,1193,536,546,1082,竹中,甲簡
2020-10-07,1193,506,572,1078,竹中,甲簡
2020-10-08,1193,844,656,1500,竹中,甲簡
2020-10-09,1193,937,772,1709,竹中,甲簡
2020-10-10,1193,766,814,1580,竹中,甲簡
2020-10-11,1193,573,941,1514,竹中,甲簡
2020-10-12,1193,546,611,1157,竹中,甲簡
2020-10-13,1193,542,565,1107,竹中,甲簡
2020-10-14,1193,528,562,1090,竹中,甲簡
2020-10-15,1193,531,580,1111,竹中,甲簡
2020-10-16,1193,818,654,1472,竹中,甲簡
2020-10-17,1193,774,799,1573,竹中,甲簡
2020-10-18,1193,612,844,1456,竹中,甲簡
2020-10-19,1193,568,595,1163,竹中,甲簡
2020-10-20,1193,535,576,1111,竹中,甲簡
2020-10-21,1193,534,593,1127,竹中,甲簡
2020-10-22,1193,563,582,1145,竹中,甲簡
2020-10-23,1193,843,687,1530,竹中,甲簡
2020-10-24,1193,758,840,1598,竹中,甲簡
2020-10-25,1193,599,894,1493,竹中,甲簡
2020-10-26,1193,555,680,1235,竹中,甲簡
2020-10-27,1193,538,578,1116,竹中,甲簡
2020-10-28,1193,495,515,1010,竹中,甲簡
2020-10-29,1193,508,527,1035,竹中,甲簡
2020-10-30,1193,921,668,1589,竹中,甲簡
2020-10-31,1193,760,749,1509,竹中,甲簡
2020-11-01,1193,636,882,1518,竹中,甲簡
2020-11-02,1193,582,625,1207,竹中,甲簡
2020-11-03,1193,510,550,1060,竹中,甲簡
2020-11-04,1193,503,537,1040,竹中,甲簡
2020-11-05,1193,559,553,1112,竹中,甲簡
2020-11-06,1193,831,663,1494,竹中,甲簡
2020-11-07,1193,727,639,1366,竹中,甲簡
2020-11-08,1193,579,870,1449,竹中,甲簡
2020-11-09,1193,552,631,1183,竹中,甲簡
2020-11-10,1193,499,516,1015,竹中,甲簡
2020-11-11,1193,577,578,1155,竹中,甲簡
2020-11-12,1193,515,576,1091,竹中,甲簡
2020-11-13,1193,887,713,1600,竹中,甲簡
2020-11-14,1193,827,771,1598,竹中,甲簡
2020-11-15,1193,638,949,1587,竹中,甲簡
2020-11-16,1193,574,684,1258,竹中,甲簡
2020-11-17,1193,543,563,1106,竹中,甲簡
2020-11-18,1193,528,579,1107,竹中,甲簡
2020-11-19,1193,564,576,1140,竹中,甲簡
2020-11-20,1193,884,666,1550,竹中,甲簡
2020-11-21,1193,792,709,1501,竹中,甲簡
2020-11-22,1193,581,892,1473,竹中,甲簡
2020-11-23,1193,551,636,1187,竹中,甲簡
2020-11-24,1193,547,610,1157,竹中,甲簡
2020-11-25,1193,554,597,1151,竹中,甲簡
2020-11-26,1193,562,581,1143,竹中,甲簡
2020-11-27,1193,906,741,1647,竹中,甲簡
2020-11-28,1193,826,748,1574,竹中,甲簡
2020-11-29,1193,693,930,1623,竹中,甲簡
2020-11-30,1193,533,625,1158,竹中,甲簡
2020-12-01,1193,528,564,1092,竹中,甲簡
2020-12-02,1193,530,567,1097,竹中,甲簡
2020-12-03,1193,535,577,1112,竹中,甲簡
2020-12-04,1193,912,721,1633,竹中,甲簡
2020-12-05,1193,887,788,1675,竹中,甲簡
2020-12-06,1193,671,1016,1687,竹中,甲簡
2020-12-07,1193,562,640,1202,竹中,甲簡
2020-12-08,1193,546,588,1134,竹中,甲簡
2020-12-09,1193,506,582,1088,竹中,甲簡
2020-12-10,1193,536,585,1121,竹中,甲簡
2020-12-11,1193,960,748,1708,竹中,甲簡
2020-12-12,1193,786,743,1529,竹中,甲簡
2020-12-13,1193,723,988,1711,竹中,甲簡
2020-12-14,1193,590,679,1269,竹中,甲簡
2020-12-15,1193,522,552,1074,竹中,甲簡
2020-12-16,1193,506,558,1064,竹中,甲簡
2020-12-17,1193,588,605,1193,竹中,甲簡
2020-12-18,1193,923,728,1651,竹中,甲簡
2020-12-19,1193,755,643,1398,竹中,甲簡
2020-12-20,1193,659,971,1630,竹中,甲簡
2020-12-21,1193,572,631,1203,竹中,甲簡
2020-12-22,1193,513,579,1092,竹中,甲簡
2020-12-23,1193,546,567,1113,竹中,甲簡
2020-12-24,1193,547,584,1131,竹中,甲簡
2020-12-25,1193,864,716,1580,竹中,甲簡
2020-12-26,1193,774,719,1493,竹中,甲簡
2020-12-27,1193,638,816,1454,竹中,甲簡
2020-12-28,1193,568,643,1211,竹中,甲簡
2020-12-29,1193,583,589,1172,竹中,甲簡
2020-12-30,1193,612,573,1185,竹中,甲簡
2020-12-31,1193,1052,728,1780,竹中,甲簡
2020-01-01,1194,3505,2544,6049,六家,乙簡
2020-01-02,1194,2789,2731,5520,六家,乙簡
2020-01-03,1194,3177,3278,6455,六家,乙簡
2020-01-04,1194,2939,2969,5908,六家,乙簡
2020-01-05,1194,3480,2375,5855,六家,乙簡
2020-01-06,1194,2615,2609,5224,六家,乙簡
2020-01-07,1194,2469,2438,4907,六家,乙簡
2020-01-08,1194,2536,2448,4984,六家,乙簡
2020-01-09,1194,2877,2914,5791,六家,乙簡
2020-01-10,1194,4128,5312,9440,六家,乙簡
2020-01-11,1194,3747,3350,7097,六家,乙簡
2020-01-12,1194,5214,2462,7676,六家,乙簡
2020-01-13,1194,3223,2783,6006,六家,乙簡
2020-01-14,1194,2949,2742,5691,六家,乙簡
2020-01-15,1194,2901,2838,5739,六家,乙簡
2020-01-16,1194,2917,3090,6007,六家,乙簡
2020-01-17,1194,3575,3818,7393,六家,乙簡
2020-01-18,1194,3142,3113,6255,六家,乙簡
2020-01-19,1194,3384,2467,5851,六家,乙簡
2020-01-20,1194,3214,2973,6187,六家,乙簡
2020-01-21,1194,3247,3338,6585,六家,乙簡
2020-01-22,1194,3338,4658,7996,六家,乙簡
2020-01-23,1194,2547,3560,6107,六家,乙簡
2020-01-24,1194,1713,2094,3807,六家,乙簡
2020-01-25,1194,2047,1695,3742,六家,乙簡
2020-01-26,1194,2498,1699,4197,六家,乙簡
2020-01-27,1194,3162,2219,5381,六家,乙簡
2020-01-28,1194,3707,2032,5739,六家,乙簡
2020-01-29,1194,4595,1874,6469,六家,乙簡
2020-01-30,1194,2868,2355,5223,六家,乙簡
2020-01-31,1194,2956,2774,5730,六家,乙簡
2020-02-01,1194,2232,1986,4218,六家,乙簡
2020-02-02,1194,2875,1727,4602,六家,乙簡
2020-02-03,1194,2922,2395,5317,六家,乙簡
2020-02-04,1194,2470,2243,4713,六家,乙簡
2020-02-05,1194,2520,2423,4943,六家,乙簡
2020-02-06,1194,2553,2451,5004,六家,乙簡
2020-02-07,1194,2835,3178,6013,六家,乙簡
2020-02-08,1194,2203,2000,4203,六家,乙簡
2020-02-09,1194,2814,1763,4577,六家,乙簡
2020-02-10,1194,2575,2290,4865,六家,乙簡
2020-02-11,1194,2396,2173,4569,六家,乙簡
2020-02-12,1194,2492,2397,4889,六家,乙簡
2020-02-13,1194,2371,2317,4688,六家,乙簡
2020-02-14,1194,2883,3205,6088,六家,乙簡
2020-02-15,1194,2291,2240,4531,六家,乙簡
2020-02-16,1194,2330,1369,3699,六家,乙簡
2020-02-17,1194,2569,2228,4797,六家,乙簡
2020-02-18,1194,2283,2131,4414,六家,乙簡
2020-02-19,1194,2369,2204,4573,六家,乙簡
2020-02-20,1194,2423,2351,4774,六家,乙簡
2020-02-21,1194,2842,3105,5947,六家,乙簡
2020-02-22,1194,2136,2141,4277,六家,乙簡
2020-02-23,1194,2640,1668,4308,六家,乙簡
2020-02-24,1194,2531,2268,4799,六家,乙簡
2020-02-25,1194,2209,2303,4512,六家,乙簡
2020-02-26,1194,2334,2419,4753,六家,乙簡
2020-02-27,1194,2932,3791,6723,六家,乙簡
2020-02-28,1194,2257,2771,5028,六家,乙簡
2020-02-29,1194,1990,1723,3713,六家,乙簡
2020-03-01,1194,3713,1776,5489,六家,乙簡
2020-03-02,1194,2442,2255,4697,六家,乙簡
2020-03-03,1194,2007,1961,3968,六家,乙簡
2020-03-04,1194,1965,1947,3912,六家,乙簡
2020-03-05,1194,1999,2057,4056,六家,乙簡
2020-03-06,1194,2716,3038,5754,六家,乙簡
2020-03-07,1194,1850,1822,3672,六家,乙簡
2020-03-08,1194,2429,1597,4026,六家,乙簡
2020-03-09,1194,2213,2203,4416,六家,乙簡
2020-03-10,1194,2040,2013,4053,六家,乙簡
2020-03-11,1194,2070,2057,4127,六家,乙簡
2020-03-12,1194,2103,2084,4187,六家,乙簡
2020-03-13,1194,2815,3336,6151,六家,乙簡
2020-03-14,1194,1873,1862,3735,六家,乙簡
2020-03-15,1194,2756,1672,4428,六家,乙簡
2020-03-16,1194,2153,2140,4293,六家,乙簡
2020-03-17,1194,1968,2002,3970,六家,乙簡
2020-03-18,1194,1956,1885,3841,六家,乙簡
2020-03-19,1194,1803,1898,3701,六家,乙簡
2020-03-20,1194,2461,2825,5286,六家,乙簡
2020-03-21,1194,1552,1578,3130,六家,乙簡
2020-03-22,1194,2074,1313,3387,六家,乙簡
2020-03-23,1194,2045,1911,3956,六家,乙簡
2020-03-24,1194,1766,1762,3528,六家,乙簡
2020-03-25,1194,1696,1688,3384,六家,乙簡
2020-03-26,1194,1764,1803,3567,六家,乙簡
2020-03-27,1194,2246,2589,4835,六家,乙簡
2020-03-28,1194,1295,1303,2598,六家,乙簡
2020-03-29,1194,1827,1164,2991,六家,乙簡
2020-03-30,1194,1972,1891,3863,六家,乙簡
2020-03-31,1194,1773,1866,3639,六家,乙簡
2020-04-01,1194,2377,3220,5597,六家,乙簡
2020-04-02,1194,1415,2220,3635,六家,乙簡
2020-04-03,1194,1273,1271,2544,六家,乙簡
2020-04-04,1194,1431,960,2391,六家,乙簡
2020-04-05,1194,3077,1234,4311,六家,乙簡
2020-04-06,1194,2183,1775,3958,六家,乙簡
2020-04-07,1194,1641,1647,3288,六家,乙簡
2020-04-08,1194,1657,1594,3251,六家,乙簡
2020-04-09,1194,1646,1677,3323,六家,乙簡
2020-04-10,1194,2185,2462,4647,六家,乙簡
2020-04-11,1194,1236,1286,2522,六家,乙簡
2020-04-12,1194,1669,1164,2833,六家,乙簡
2020-04-13,1194,1861,1802,3663,六家,乙簡
2020-04-14,1194,1688,1664,3352,六家,乙簡
2020-04-15,1194,1629,1696,3325,六家,乙簡
2020-04-16,1194,1723,1762,3485,六家,乙簡
2020-04-17,1194,2356,2660,5016,六家,乙簡
2020-04-18,1194,1598,1578,3176,六家,乙簡
2020-04-19,1194,2011,1312,3323,六家,乙簡
2020-04-20,1194,1957,1872,3829,六家,乙簡
2020-04-21,1194,1586,1641,3227,六家,乙簡
2020-04-22,1194,1668,1675,3343,六家,乙簡
2020-04-23,1194,1719,1726,3445,六家,乙簡
2020-04-24,1194,2204,2551,4755,六家,乙簡
2020-04-25,1194,1430,1387,2817,六家,乙簡
2020-04-26,1194,1823,1166,2989,六家,乙簡
2020-04-27,1194,1874,1843,3717,六家,乙簡
2020-04-28,1194,1664,1720,3384,六家,乙簡
2020-04-29,1194,1782,1860,3642,六家,乙簡
2020-04-30,1194,2052,2687,4739,六家,乙簡
2020-05-01,1194,1888,2314,4202,六家,乙簡
2020-05-02,1194,1544,1381,2925,六家,乙簡
2020-05-03,1194,2756,1369,4125,六家,乙簡
2020-05-04,1194,2127,1950,4077,六家,乙簡
2020-05-05,1194,1797,1783,3580,六家,乙簡
2020-05-06,1194,1769,1806,3575,六家,乙簡
2020-05-07,1194,1884,1996,3880,六家,乙簡
2020-05-08,1194,2623,3376,5999,六家,乙簡
2020-05-09,1194,1800,1809,3609,六家,乙簡
2020-05-10,1194,2938,1474,4412,六家,乙簡
2020-05-11,1194,2236,1943,4179,六家,乙簡
2020-05-12,1194,1856,1859,3715,六家,乙簡
2020-05-13,1194,1834,1831,3665,六家,乙簡
2020-05-14,1194,1925,1914,3839,六家,乙簡
2020-05-15,1194,2650,3095,5745,六家,乙簡
2020-05-16,1194,1641,1565,3206,六家,乙簡
2020-05-17,1194,2373,1540,3913,六家,乙簡
2020-05-18,1194,2165,2015,4180,六家,乙簡
2020-05-19,1194,1820,1895,3715,六家,乙簡
2020-05-20,1194,1861,1861,3722,六家,乙簡
2020-05-21,1194,1922,1958,3880,六家,乙簡
2020-05-22,1194,2516,2750,5266,六家,乙簡
2020-05-23,1194,1673,1749,3422,六家,乙簡
2020-05-24,1194,2509,1543,4052,六家,乙簡
2020-05-25,1194,2114,2134,4248,六家,乙簡
2020-05-26,1194,1927,1965,3892,六家,乙簡
2020-05-27,1194,1963,1963,3926,六家,乙簡
2020-05-28,1194,2000,1988,3988,六家,乙簡
2020-05-29,1194,2671,3088,5759,六家,乙簡
2020-05-30,1194,2109,2094,4203,六家,乙簡
2020-05-31,1194,2917,1787,4704,六家,乙簡
2020-06-01,1194,2200,2150,4350,六家,乙簡
2020-06-02,1194,2039,2072,4111,六家,乙簡
2020-06-03,1194,2060,1982,4042,六家,乙簡
2020-06-04,1194,2022,2125,4147,六家,乙簡
2020-06-05,1194,2618,3598,6216,六家,乙簡
2020-06-06,1194,2184,2297,4481,六家,乙簡
2020-06-07,1194,3220,1645,4865,六家,乙簡
2020-06-08,1194,2369,2088,4457,六家,乙簡
2020-06-09,1194,2043,2011,4054,六家,乙簡
2020-06-10,1194,2125,2046,4171,六家,乙簡
2020-06-11,1194,2156,2185,4341,六家,乙簡
2020-06-12,1194,2872,3203,6075,六家,乙簡
2020-06-13,1194,2394,2378,4772,六家,乙簡
2020-06-14,1194,3055,1989,5044,六家,乙簡
2020-06-15,1194,2369,2295,4664,六家,乙簡
2020-06-16,1194,2109,2121,4230,六家,乙簡
2020-06-17,1194,2146,2215,4361,六家,乙簡
2020-06-18,1194,2113,2156,4269,六家,乙簡
2020-06-19,1194,2433,2879,5312,六家,乙簡
2020-06-20,1194,2188,2401,4589,六家,乙簡
2020-06-21,1194,2809,1876,4685,六家,乙簡
2020-06-22,1194,2405,2198,4603,六家,乙簡
2020-06-23,1194,2228,2363,4591,六家,乙簡
2020-06-24,1194,2895,4198,7093,六家,乙簡
2020-06-25,1194,2632,3091,5723,六家,乙簡
2020-06-26,1194,2160,2099,4259,六家,乙簡
2020-06-27,1194,3038,1987,5025,六家,乙簡
2020-06-28,1194,4044,2167,6211,六家,乙簡
2020-06-29,1194,2967,2370,5337,六家,乙簡
2020-06-30,1194,2373,2306,4679,六家,乙簡
2020-07-01,1194,2258,2211,4469,六家,乙簡
2020-07-02,1194,2302,2302,4604,六家,乙簡
2020-07-03,1194,2901,3030,5931,六家,乙簡
2020-07-04,1194,2387,2197,4584,六家,乙簡
2020-07-05,1194,2621,1873,4494,六家,乙簡
2020-07-06,1194,2593,2373,4966,六家,乙簡
2020-07-07,1194,2370,2281,4651,六家,乙簡
2020-07-08,1194,2435,2344,4779,六家,乙簡
2020-07-09,1194,2465,2449,4914,六家,乙簡
2020-07-10,1194,3275,3561,6836,六家,乙簡
2020-07-11,1194,2487,2575,5062,六家,乙簡
2020-07-12,1194,3229,2025,5254,六家,乙簡
2020-07-13,1194,2684,2495,5179,六家,乙簡
2020-07-14,1194,2631,2652,5283,六家,乙簡
2020-07-15,1194,2621,2606,5227,六家,乙簡
2020-07-16,1194,2641,2696,5337,六家,乙簡
2020-07-17,1194,3142,3626,6768,六家,乙簡
2020-07-18,1194,2584,2664,5248,六家,乙簡
2020-07-19,1194,3355,2055,5410,六家,乙簡
2020-07-20,1194,2798,2532,5330,六家,乙簡
2020-07-21,1194,2554,2359,4913,六家,乙簡
2020-07-22,1194,2569,2490,5059,六家,乙簡
2020-07-23,1194,2636,2519,5155,六家,乙簡
2020-07-24,1194,3215,3669,6884,六家,乙簡
2020-07-25,1194,2743,2805,5548,六家,乙簡
2020-07-26,1194,3511,2133,5644,六家,乙簡
2020-07-27,1194,2807,2572,5379,六家,乙簡
2020-07-28,1194,2563,2500,5063,六家,乙簡
2020-07-29,1194,2516,2443,4959,六家,乙簡
2020-07-30,1194,2580,2564,5144,六家,乙簡
2020-07-31,1194,3368,3796,7164,六家,乙簡
2020-08-01,1194,2695,2759,5454,六家,乙簡
2020-08-02,1194,3354,1940,5294,六家,乙簡
2020-08-03,1194,2619,2419,5038,六家,乙簡
2020-08-04,1194,2614,2404,5018,六家,乙簡
2020-08-05,1194,2529,2385,4914,六家,乙簡
2020-08-06,1194,2541,2661,5202,六家,乙簡
2020-08-07,1194,3319,4114,7433,六家,乙簡
2020-08-08,1194,2573,2581,5154,六家,乙簡
2020-08-09,1194,4042,2138,6180,六家,乙簡
2020-08-10,1194,2925,2553,5478,六家,乙簡
2020-08-11,1194,2623,2550,5173,六家,乙簡
2020-08-12,1194,2684,2577,5261,六家,乙簡
2020-08-13,1194,2665,2716,5381,六家,乙簡
2020-08-14,1194,3297,3930,7227,六家,乙簡
2020-08-15,1194,3018,2870,5888,六家,乙簡
2020-08-16,1194,3927,2369,6296,六家,乙簡
2020-08-17,1194,3132,2778,5910,六家,乙簡
2020-08-18,1194,2838,2727,5565,六家,乙簡
2020-08-19,1194,2829,2696,5525,六家,乙簡
2020-08-20,1194,2842,2828,5670,六家,乙簡
2020-08-21,1194,3454,3929,7383,六家,乙簡
2020-08-22,1194,2757,2813,5570,六家,乙簡
2020-08-23,1194,3534,2125,5659,六家,乙簡
2020-08-24,1194,3156,2694,5850,六家,乙簡
2020-08-25,1194,2902,2678,5580,六家,乙簡
2020-08-26,1194,2841,2682,5523,六家,乙簡
2020-08-27,1194,2807,2722,5529,六家,乙簡
2020-08-28,1194,3245,3705,6950,六家,乙簡
2020-08-29,1194,2641,2729,5370,六家,乙簡
2020-08-30,1194,3484,2056,5540,六家,乙簡
2020-08-31,1194,2631,2488,5119,六家,乙簡
2020-09-01,1194,2419,2338,4757,六家,乙簡
2020-09-02,1194,2317,2353,4670,六家,乙簡
2020-09-03,1194,2448,2619,5067,六家,乙簡
2020-09-04,1194,3084,3638,6722,六家,乙簡
2020-09-05,1194,2706,2617,5323,六家,乙簡
2020-09-06,1194,3420,2182,5602,六家,乙簡
2020-09-07,1194,2648,2515,5163,六家,乙簡
2020-09-08,1194,2373,2409,4782,六家,乙簡
2020-09-09,1194,2373,2387,4760,六家,乙簡
2020-09-10,1194,2479,2557,5036,六家,乙簡
2020-09-11,1194,3205,3613,6818,六家,乙簡
2020-09-12,1194,2584,2613,5197,六家,乙簡
2020-09-13,1194,3445,2311,5756,六家,乙簡
2020-09-14,1194,2604,2484,5088,六家,乙簡
2020-09-15,1194,2296,2310,4606,六家,乙簡
2020-09-16,1194,2274,2295,4569,六家,乙簡
2020-09-17,1194,2378,2486,4864,六家,乙簡
2020-09-18,1194,3196,3688,6884,六家,乙簡
2020-09-19,1194,2910,3036,5946,六家,乙簡
2020-09-20,1194,3684,2342,6026,六家,乙簡
2020-09-21,1194,2587,2401,4988,六家,乙簡
2020-09-22,1194,2493,2452,4945,六家,乙簡
2020-09-23,1194,2497,2486,4983,六家,乙簡
2020-09-24,1194,2599,2732,5331,六家,乙簡
2020-09-25,1194,2982,3453,6435,六家,乙簡
2020-09-26,1194,2687,2851,5538,六家,乙簡
2020-09-27,1194,2870,2007,4877,六家,乙簡
2020-09-28,1194,2567,2488,5055,六家,乙簡
2020-09-29,1194,2455,2618,5073,六家,乙簡
2020-09-30,1194,3756,4645,8401,六家,乙簡
2020-10-01,1194,3353,3976,7329,六家,乙簡
2020-10-02,1194,3203,2841,6044,六家,乙簡
2020-10-03,1194,3908,2777,6685,六家,乙簡
2020-10-04,1194,5420,2807,8227,六家,乙簡
2020-10-05,1194,3014,2482,5496,六家,乙簡
2020-10-06,1194,2419,2326,4745,六家,乙簡
2020-10-07,1194,2551,2517,5068,六家,乙簡
2020-10-08,1194,3474,3903,7377,六家,乙簡
2020-10-09,1194,3933,3861,7794,六家,乙簡
2020-10-10,1194,3869,3426,7295,六家,乙簡
2020-10-11,1194,4750,2801,7551,六家,乙簡
2020-10-12,1194,2714,2490,5204,六家,乙簡
2020-10-13,1194,2393,2391,4784,六家,乙簡
2020-10-14,1194,2471,2442,4913,六家,乙簡
2020-10-15,1194,2552,2582,5134,六家,乙簡
2020-10-16,1194,3380,3723,7103,六家,乙簡
2020-10-17,1194,3574,3453,7027,六家,乙簡
2020-10-18,1194,3830,2710,6540,六家,乙簡
2020-10-19,1194,2748,2692,5440,六家,乙簡
2020-10-20,1194,2398,2417,4815,六家,乙簡
2020-10-21,1194,2523,2475,4998,六家,乙簡
2020-10-22,1194,2560,2523,5083,六家,乙簡
2020-10-23,1194,3332,3839,7171,六家,乙簡
2020-10-24,1194,2955,3010,5965,六家,乙簡
2020-10-25,1194,3822,2378,6200,六家,乙簡
2020-10-26,1194,2730,2522,5252,六家,乙簡
2020-10-27,1194,2385,2317,4702,六家,乙簡
2020-10-28,1194,2381,2392,4773,六家,乙簡
2020-10-29,1194,2423,2548,4971,六家,乙簡
2020-10-30,1194,3280,3921,7201,六家,乙簡
2020-10-31,1194,3289,3268,6557,六家,乙簡
2020-11-01,1194,3732,2322,6054,六家,乙簡
2020-11-02,1194,2685,2502,5187,六家,乙簡
2020-11-03,1194,2303,2298,4601,六家,乙簡
2020-11-04,1194,2289,2312,4601,六家,乙簡
2020-11-05,1194,2469,2446,4915,六家,乙簡
2020-11-06,1194,3355,3883,7238,六家,乙簡
2020-11-07,1194,2905,3121,6026,六家,乙簡
2020-11-08,1194,3812,2404,6216,六家,乙簡
2020-11-09,1194,2905,2644,5549,六家,乙簡
2020-11-10,1194,2345,2404,4749,六家,乙簡
2020-11-11,1194,2470,2470,4940,六家,乙簡
2020-11-12,1194,2520,2505,5025,六家,乙簡
2020-11-13,1194,3638,4040,7678,六家,乙簡
2020-11-14,1194,3250,3274,6524,六家,乙簡
2020-11-15,1194,4207,2619,6826,六家,乙簡
2020-11-16,1194,2916,2696,5612,六家,乙簡
2020-11-17,1194,2445,2470,4915,六家,乙簡
2020-11-18,1194,2531,2506,5037,六家,乙簡
2020-11-19,1194,2519,2581,5100,六家,乙簡
2020-11-20,1194,3573,4011,7584,六家,乙簡
2020-11-21,1194,3197,3301,6498,六家,乙簡
2020-11-22,1194,3966,2497,6463,六家,乙簡
2020-11-23,1194,2985,2729,5714,六家,乙簡
2020-11-24,1194,2472,2460,4932,六家,乙簡
2020-11-25,1194,2498,2475,4973,六家,乙簡
2020-11-26,1194,2639,2643,5282,六家,乙簡
2020-11-27,1194,3497,4072,7569,六家,乙簡
2020-11-28,1194,3290,3187,6477,六家,乙簡
2020-11-29,1194,4101,2588,6689,六家,乙簡
2020-11-30,1194,2782,2507,5289,六家,乙簡
2020-12-01,1194,2453,2445,4898,六家,乙簡
2020-12-02,1194,2433,2480,4913,六家,乙簡
2020-12-03,1194,2572,2592,5164,六家,乙簡
2020-12-04,1194,3606,4201,7807,六家,乙簡
2020-12-05,1194,3390,3441,6831,六家,乙簡
2020-12-06,1194,4412,2742,7154,六家,乙簡
2020-12-07,1194,2870,2570,5440,六家,乙簡
2020-12-08,1194,2612,2600,5212,六家,乙簡
2020-12-09,1194,2455,2437,4892,六家,乙簡
2020-12-10,1194,2535,2629,5164,六家,乙簡
2020-12-11,1194,3525,4126,7651,六家,乙簡
2020-12-12,1194,3572,3394,6966,六家,乙簡
2020-12-13,1194,4289,2710,6999,六家,乙簡
2020-12-14,1194,2957,2762,5719,六家,乙簡
2020-12-15,1194,2399,2470,4869,六家,乙簡
2020-12-16,1194,2481,2440,4921,六家,乙簡
2020-12-17,1194,2681,2779,5460,六家,乙簡
2020-12-18,1194,3646,4373,8019,六家,乙簡
2020-12-19,1194,3232,3304,6536,六家,乙簡
2020-12-20,1194,4230,2579,6809,六家,乙簡
2020-12-21,1194,2893,2635,5528,六家,乙簡
2020-12-22,1194,2655,2536,5191,六家,乙簡
2020-12-23,1194,2520,2436,4956,六家,乙簡
2020-12-24,1194,2553,2726,5279,六家,乙簡
2020-12-25,1194,3423,4124,7547,六家,乙簡
2020-12-26,1194,3080,2996,6076,六家,乙簡
2020-12-27,1194,3665,2439,6104,六家,乙簡
2020-12-28,1194,2738,2636,5374,六家,乙簡
2020-12-29,1194,2586,2598,5184,六家,乙簡
2020-12-30,1194,2527,2797,5324,六家,乙簡
2020-12-31,1194,3640,5036,8676,六家,乙簡
2020-01-01,1201,83,89,172,上員,招呼
2020-01-02,1201,57,75,132,上員,招呼
2020-01-03,1201,58,73,131,上員,招呼
2020-01-04,1201,64,91,155,上員,招呼
2020-01-05,1201,46,74,120,上員,招呼
2020-01-06,1201,51,72,123,上員,招呼
2020-01-07,1201,52,60,112,上員,招呼
2020-01-08,1201,63,74,137,上員,招呼
2020-01-09,1201,49,70,119,上員,招呼
2020-01-10,1201,49,77,126,上員,招呼
2020-01-11,1201,71,92,163,上員,招呼
2020-01-12,1201,41,47,88,上員,招呼
2020-01-13,1201,56,50,106,上員,招呼
2020-01-14,1201,50,54,104,上員,招呼
2020-01-15,1201,53,65,118,上員,招呼
2020-01-16,1201,160,175,335,上員,招呼
2020-01-17,1201,48,68,116,上員,招呼
2020-01-18,1201,54,68,122,上員,招呼
2020-01-19,1201,47,49,96,上員,招呼
2020-01-20,1201,59,51,110,上員,招呼
2020-01-21,1201,59,55,114,上員,招呼
2020-01-22,1201,62,55,117,上員,招呼
2020-01-23,1201,37,44,81,上員,招呼
2020-01-24,1201,26,45,71,上員,招呼
2020-01-25,1201,54,62,116,上員,招呼
2020-01-26,1201,29,44,73,上員,招呼
2020-01-27,1201,42,43,85,上員,招呼
2020-01-28,1201,62,70,132,上員,招呼
2020-01-29,1201,63,78,141,上員,招呼
2020-01-30,1201,60,54,114,上員,招呼
2020-01-31,1201,31,41,72,上員,招呼
2020-02-01,1201,65,44,109,上員,招呼
2020-02-02,1201,42,48,90,上員,招呼
2020-02-03,1201,62,60,122,上員,招呼
2020-02-04,1201,86,71,157,上員,招呼
2020-02-05,1201,41,48,89,上員,招呼
2020-02-06,1201,82,41,123,上員,招呼
2020-02-07,1201,56,58,114,上員,招呼
2020-02-08,1201,39,48,87,上員,招呼
2020-02-09,1201,39,55,94,上員,招呼
2020-02-10,1201,65,57,122,上員,招呼
2020-02-11,1201,56,58,114,上員,招呼
2020-02-12,1201,57,55,112,上員,招呼
2020-02-13,1201,39,46,85,上員,招呼
2020-02-14,1201,57,54,111,上員,招呼
2020-02-15,1201,78,71,149,上員,招呼
2020-02-16,1201,31,32,63,上員,招呼
2020-02-17,1201,45,49,94,上員,招呼
2020-02-18,1201,36,36,72,上員,招呼
2020-02-19,1201,43,44,87,上員,招呼
2020-02-20,1201,50,54,104,上員,招呼
2020-02-21,1201,60,57,117,上員,招呼
2020-02-22,1201,55,59,114,上員,招呼
2020-02-23,1201,45,41,86,上員,招呼
2020-02-24,1201,50,55,105,上員,招呼
2020-02-25,1201,58,58,116,上員,招呼
2020-02-26,1201,58,66,124,上員,招呼
2020-02-27,1201,42,53,95,上員,招呼
2020-02-28,1201,64,56,120,上員,招呼
2020-02-29,1201,28,33,61,上員,招呼
2020-03-01,1201,29,52,81,上員,招呼
2020-03-02,1201,54,61,115,上員,招呼
2020-03-03,1201,56,58,114,上員,招呼
2020-03-04,1201,43,47,90,上員,招呼
2020-03-05,1201,38,47,85,上員,招呼
2020-03-06,1201,52,70,122,上員,招呼
2020-03-07,1201,56,57,113,上員,招呼
2020-03-08,1201,43,62,105,上員,招呼
2020-03-09,1201,49,57,106,上員,招呼
2020-03-10,1201,45,48,93,上員,招呼
2020-03-11,1201,54,54,108,上員,招呼
2020-03-12,1201,42,54,96,上員,招呼
2020-03-13,1201,55,66,121,上員,招呼
2020-03-14,1201,48,58,106,上員,招呼
2020-03-15,1201,48,69,117,上員,招呼
2020-03-16,1201,50,55,105,上員,招呼
2020-03-17,1201,56,63,119,上員,招呼
2020-03-18,1201,28,57,85,上員,招呼
2020-03-19,1201,41,52,93,上員,招呼
2020-03-20,1201,37,51,88,上員,招呼
2020-03-21,1201,27,31,58,上員,招呼
2020-03-22,1201,36,34,70,上員,招呼
2020-03-23,1201,48,52,100,上員,招呼
2020-03-24,1201,47,42,89,上員,招呼
2020-03-25,1201,47,57,104,上員,招呼
2020-03-26,1201,41,55,96,上員,招呼
2020-03-27,1201,35,53,88,上員,招呼
2020-03-28,1201,25,47,72,上員,招呼
2020-03-29,1201,28,35,63,上員,招呼
2020-03-30,1201,43,53,96,上員,招呼
2020-03-31,1201,46,50,96,上員,招呼
2020-04-01,1201,40,61,101,上員,招呼
2020-04-02,1201,26,30,56,上員,招呼
2020-04-03,1201,28,42,70,上員,招呼
2020-04-04,1201,35,32,67,上員,招呼
2020-04-05,1201,27,33,60,上員,招呼
2020-04-06,1201,49,41,90,上員,招呼
2020-04-07,1201,42,46,88,上員,招呼
2020-04-08,1201,40,52,92,上員,招呼
2020-04-09,1201,40,39,79,上員,招呼
2020-04-10,1201,38,61,99,上員,招呼
2020-04-11,1201,24,33,57,上員,招呼
2020-04-12,1201,24,39,63,上員,招呼
2020-04-13,1201,40,44,84,上員,招呼
2020-04-14,1201,37,50,87,上員,招呼
2020-04-15,1201,36,52,88,上員,招呼
2020-04-16,1201,46,61,107,上員,招呼
2020-04-17,1201,36,58,94,上員,招呼
2020-04-18,1201,34,38,72,上員,招呼
2020-04-19,1201,33,63,96,上員,招呼
2020-04-20,1201,46,51,97,上員,招呼
2020-04-21,1201,40,48,88,上員,招呼
2020-04-22,1201,46,53,99,上員,招呼
2020-04-23,1201,30,46,76,上員,招呼
2020-04-24,1201,40,52,92,上員,招呼
2020-04-25,1201,35,45,80,上員,招呼
2020-04-26,1201,29,34,63,上員,招呼
2020-04-27,1201,31,45,76,上員,招呼
2020-04-28,1201,37,40,77,上員,招呼
2020-04-29,1201,39,53,92,上員,招呼
2020-04-30,1201,41,62,103,上員,招呼
2020-05-01,1201,49,57,106,上員,招呼
2020-05-02,1201,42,46,88,上員,招呼
2020-05-03,1201,44,53,97,上員,招呼
2020-05-04,1201,43,49,92,上員,招呼
2020-05-05,1201,42,41,83,上員,招呼
2020-05-06,1201,39,43,82,上員,招呼
2020-05-07,1201,28,54,82,上員,招呼
2020-05-08,1201,40,64,104,上員,招呼
2020-05-09,1201,37,44,81,上員,招呼
2020-05-10,1201,40,49,89,上員,招呼
2020-05-11,1201,34,46,80,上員,招呼
2020-05-12,1201,42,43,85,上員,招呼
2020-05-13,1201,42,60,102,上員,招呼
2020-05-14,1201,44,55,99,上員,招呼
2020-05-15,1201,53,58,111,上員,招呼
2020-05-16,1201,34,35,69,上員,招呼
2020-05-17,1201,39,40,79,上員,招呼
2020-05-18,1201,45,47,92,上員,招呼
2020-05-19,1201,37,49,86,上員,招呼
2020-05-20,1201,42,54,96,上員,招呼
2020-05-21,1201,44,58,102,上員,招呼
2020-05-22,1201,41,57,98,上員,招呼
2020-05-23,1201,29,41,70,上員,招呼
2020-05-24,1201,81,80,161,上員,招呼
2020-05-25,1201,42,63,105,上員,招呼
2020-05-26,1201,27,56,83,上員,招呼
2020-05-27,1201,44,54,98,上員,招呼
2020-05-28,1201,38,49,87,上員,招呼
2020-05-29,1201,52,70,122,上員,招呼
2020-05-30,1201,63,57,120,上員,招呼
2020-05-31,1201,56,60,116,上員,招呼
2020-06-01,1201,41,52,93,上員,招呼
2020-06-02,1201,45,48,93,上員,招呼
2020-06-03,1201,43,54,97,上員,招呼
2020-06-04,1201,36,47,83,上員,招呼
2020-06-05,1201,53,78,131,上員,招呼
2020-06-06,1201,54,64,118,上員,招呼
2020-06-07,1201,36,50,86,上員,招呼
2020-06-08,1201,46,55,101,上員,招呼
2020-06-09,1201,41,54,95,上員,招呼
2020-06-10,1201,45,45,90,上員,招呼
2020-06-11,1201,54,62,116,上員,招呼
2020-06-12,1201,42,73,115,上員,招呼
2020-06-13,1201,51,54,105,上員,招呼
2020-06-14,1201,42,49,91,上員,招呼
2020-06-15,1201,40,42,82,上員,招呼
2020-06-16,1201,39,54,93,上員,招呼
2020-06-17,1201,39,53,92,上員,招呼
2020-06-18,1201,37,51,88,上員,招呼
2020-06-19,1201,49,56,105,上員,招呼
2020-06-20,1201,50,70,120,上員,招呼
2020-06-21,1201,38,41,79,上員,招呼
2020-06-22,1201,48,61,109,上員,招呼
2020-06-23,1201,56,52,108,上員,招呼
2020-06-24,1201,45,47,92,上員,招呼
2020-06-25,1201,32,49,81,上員,招呼
2020-06-26,1201,68,80,148,上員,招呼
2020-06-27,1201,72,73,145,上員,招呼
2020-06-28,1201,51,59,110,上員,招呼
2020-06-29,1201,55,46,101,上員,招呼
2020-06-30,1201,42,46,88,上員,招呼
2020-07-01,1201,31,40,71,上員,招呼
2020-07-02,1201,31,54,85,上員,招呼
2020-07-03,1201,48,56,104,上員,招呼
2020-07-04,1201,39,39,78,上員,招呼
2020-07-05,1201,56,51,107,上員,招呼
2020-07-06,1201,48,44,92,上員,招呼
2020-07-07,1201,50,50,100,上員,招呼
2020-07-08,1201,47,50,97,上員,招呼
2020-07-09,1201,41,46,87,上員,招呼
2020-07-10,1201,58,60,118,上員,招呼
2020-07-11,1201,58,66,124,上員,招呼
2020-07-12,1201,54,61,115,上員,招呼
2020-07-13,1201,48,52,100,上員,招呼
2020-07-14,1201,36,37,73,上員,招呼
2020-07-15,1201,53,39,92,上員,招呼
2020-07-16,1201,48,54,102,上員,招呼
2020-07-17,1201,42,49,91,上員,招呼
2020-07-18,1201,62,79,141,上員,招呼
2020-07-19,1201,55,43,98,上員,招呼
2020-07-20,1201,47,40,87,上員,招呼
2020-07-21,1201,32,34,66,上員,招呼
2020-07-22,1201,48,38,86,上員,招呼
2020-07-23,1201,48,52,100,上員,招呼
2020-07-24,1201,45,42,87,上員,招呼
2020-07-25,1201,49,56,105,上員,招呼
2020-07-26,1201,44,55,99,上員,招呼
2020-07-27,1201,54,53,107,上員,招呼
2020-07-28,1201,48,52,100,上員,招呼
2020-07-29,1201,41,48,89,上員,招呼
2020-07-30,1201,50,58,108,上員,招呼
2020-07-31,1201,51,62,113,上員,招呼
2020-08-01,1201,60,64,124,上員,招呼
2020-08-02,1201,40,49,89,上員,招呼
2020-08-03,1201,30,35,65,上員,招呼
2020-08-04,1201,39,48,87,上員,招呼
2020-08-05,1201,35,38,73,上員,招呼
2020-08-06,1201,40,45,85,上員,招呼
2020-08-07,1201,50,54,104,上員,招呼
2020-08-08,1201,47,47,94,上員,招呼
2020-08-09,1201,45,45,90,上員,招呼
2020-08-10,1201,37,47,84,上員,招呼
2020-08-11,1201,50,50,100,上員,招呼
2020-08-12,1201,40,50,90,上員,招呼
2020-08-13,1201,34,42,76,上員,招呼
2020-08-14,1201,45,63,108,上員,招呼
2020-08-15,1201,50,57,107,上員,招呼
2020-08-16,1201,34,47,81,上員,招呼
2020-08-17,1201,36,54,90,上員,招呼
2020-08-18,1201,46,48,94,上員,招呼
2020-08-19,1201,37,34,71,上員,招呼
2020-08-20,1201,39,53,92,上員,招呼
2020-08-21,1201,47,57,104,上員,招呼
2020-08-22,1201,51,55,106,上員,招呼
2020-08-23,1201,59,72,131,上員,招呼
2020-08-24,1201,38,48,86,上員,招呼
2020-08-25,1201,55,45,100,上員,招呼
2020-08-26,1201,46,38,84,上員,招呼
2020-08-27,1201,34,49,83,上員,招呼
2020-08-28,1201,54,47,101,上員,招呼
2020-08-29,1201,38,46,84,上員,招呼
2020-08-30,1201,62,59,121,上員,招呼
2020-08-31,1201,42,42,84,上員,招呼
2020-09-01,1201,41,47,88,上員,招呼
2020-09-02,1201,39,38,77,上員,招呼
2020-09-03,1201,53,46,99,上員,招呼
2020-09-04,1201,55,64,119,上員,招呼
2020-09-05,1201,54,65,119,上員,招呼
2020-09-06,1201,39,49,88,上員,招呼
2020-09-07,1201,45,45,90,上員,招呼
2020-09-08,1201,40,51,91,上員,招呼
2020-09-09,1201,48,56,104,上員,招呼
2020-09-10,1201,52,60,112,上員,招呼
2020-09-11,1201,40,62,102,上員,招呼
2020-09-12,1201,56,56,112,上員,招呼
2020-09-13,1201,60,66,126,上員,招呼
2020-09-14,1201,37,43,80,上員,招呼
2020-09-15,1201,50,50,100,上員,招呼
2020-09-16,1201,48,41,89,上員,招呼
2020-09-17,1201,47,44,91,上員,招呼
2020-09-18,1201,44,63,107,上員,招呼
2020-09-19,1201,45,64,109,上員,招呼
2020-09-20,1201,47,45,92,上員,招呼
2020-09-21,1201,51,39,90,上員,招呼
2020-09-22,1201,39,43,82,上員,招呼
2020-09-23,1201,45,52,97,上員,招呼
2020-09-24,1201,46,48,94,上員,招呼
2020-09-25,1201,42,52,94,上員,招呼
2020-09-26,1201,54,53,107,上員,招呼
2020-09-27,1201,29,32,61,上員,招呼
2020-09-28,1201,44,45,89,上員,招呼
2020-09-29,1201,44,50,94,上員,招呼
2020-09-30,1201,35,74,109,上員,招呼
2020-10-01,1201,29,38,67,上員,招呼
2020-10-02,1201,63,77,140,上員,招呼
2020-10-03,1201,65,77,142,上員,招呼
2020-10-04,1201,65,65,130,上員,招呼
2020-10-05,1201,48,57,105,上員,招呼
2020-10-06,1201,46,50,96,上員,招呼
2020-10-07,1201,39,57,96,上員,招呼
2020-10-08,1201,49,55,104,上員,招呼
2020-10-09,1201,96,94,190,上員,招呼
2020-10-10,1201,87,93,180,上員,招呼
2020-10-11,1201,60,65,125,上員,招呼
2020-10-12,1201,38,68,106,上員,招呼
2020-10-13,1201,45,51,96,上員,招呼
2020-10-14,1201,43,48,91,上員,招呼
2020-10-15,1201,50,57,107,上員,招呼
2020-10-16,1201,46,68,114,上員,招呼
2020-10-17,1201,52,55,107,上員,招呼
2020-10-18,1201,62,81,143,上員,招呼
2020-10-19,1201,45,56,101,上員,招呼
2020-10-20,1201,36,57,93,上員,招呼
2020-10-21,1201,56,53,109,上員,招呼
2020-10-22,1201,44,54,98,上員,招呼
2020-10-23,1201,37,63,100,上員,招呼
2020-10-24,1201,50,58,108,上員,招呼
2020-10-25,1201,68,78,146,上員,招呼
2020-10-26,1201,49,61,110,上員,招呼
2020-10-27,1201,46,49,95,上員,招呼
2020-10-28,1201,48,58,106,上員,招呼
2020-10-29,1201,56,61,117,上員,招呼
2020-10-30,1201,35,62,97,上員,招呼
2020-10-31,1201,79,96,175,上員,招呼
2020-11-01,1201,70,75,145,上員,招呼
2020-11-02,1201,51,38,89,上員,招呼
2020-11-03,1201,40,52,92,上員,招呼
2020-11-04,1201,42,50,92,上員,招呼
2020-11-05,1201,47,62,109,上員,招呼
2020-11-06,1201,47,65,112,上員,招呼
2020-11-07,1201,57,56,113,上員,招呼
2020-11-08,1201,55,75,130,上員,招呼
2020-11-09,1201,47,46,93,上員,招呼
2020-11-10,1201,43,52,95,上員,招呼
2020-11-11,1201,53,54,107,上員,招呼
2020-11-12,1201,48,51,99,上員,招呼
2020-11-13,1201,57,68,125,上員,招呼
2020-11-14,1201,49,57,106,上員,招呼
2020-11-15,1201,70,65,135,上員,招呼
2020-11-16,1201,36,50,86,上員,招呼
2020-11-17,1201,52,51,103,上員,招呼
2020-11-18,1201,52,59,111,上員,招呼
2020-11-19,1201,54,66,120,上員,招呼
2020-11-20,1201,51,66,117,上員,招呼
2020-11-21,1201,59,78,137,上員,招呼
2020-11-22,1201,56,62,118,上員,招呼
2020-11-23,1201,51,50,101,上員,招呼
2020-11-24,1201,48,48,96,上員,招呼
2020-11-25,1201,57,65,122,上員,招呼
2020-11-26,1201,49,64,113,上員,招呼
2020-11-27,1201,57,63,120,上員,招呼
2020-11-28,1201,58,78,136,上員,招呼
2020-11-29,1201,57,59,116,上員,招呼
2020-11-30,1201,48,45,93,上員,招呼
2020-12-01,1201,49,45,94,上員,招呼
2020-12-02,1201,73,53,126,上員,招呼
2020-12-03,1201,48,55,103,上員,招呼
2020-12-04,1201,51,68,119,上員,招呼
2020-12-05,1201,49,52,101,上員,招呼
2020-12-06,1201,57,64,121,上員,招呼
2020-12-07,1201,44,52,96,上員,招呼
2020-12-08,1201,52,57,109,上員,招呼
2020-12-09,1201,43,40,83,上員,招呼
2020-12-10,1201,50,56,106,上員,招呼
2020-12-11,1201,37,56,93,上員,招呼
2020-12-12,1201,57,70,127,上員,招呼
2020-12-13,1201,60,64,124,上員,招呼
2020-12-14,1201,51,61,112,上員,招呼
2020-12-15,1201,57,76,133,上員,招呼
2020-12-16,1201,54,61,115,上員,招呼
2020-12-17,1201,52,56,108,上員,招呼
2020-12-18,1201,45,76,121,上員,招呼
2020-12-19,1201,47,59,106,上員,招呼
2020-12-20,1201,42,44,86,上員,招呼
2020-12-21,1201,36,45,81,上員,招呼
2020-12-22,1201,47,55,102,上員,招呼
2020-12-23,1201,43,53,96,上員,招呼
2020-12-24,1201,53,65,118,上員,招呼
2020-12-25,1201,45,64,109,上員,招呼
2020-12-26,1201,54,80,134,上員,招呼
2020-12-27,1201,43,51,94,上員,招呼
2020-12-28,1201,49,51,100,上員,招呼
2020-12-29,1201,44,51,95,上員,招呼
2020-12-30,1201,48,37,85,上員,招呼
2020-12-31,1201,50,59,109,上員,招呼
2020-01-01,1202,645,163,808,榮華,招呼
2020-01-02,1202,112,130,242,榮華,招呼
2020-01-03,1202,127,131,258,榮華,招呼
2020-01-04,1202,143,151,294,榮華,招呼
2020-01-05,1202,122,131,253,榮華,招呼
2020-01-06,1202,112,128,240,榮華,招呼
2020-01-07,1202,111,120,231,榮華,招呼
2020-01-08,1202,121,125,246,榮華,招呼
2020-01-09,1202,119,144,263,榮華,招呼
2020-01-10,1202,175,156,331,榮華,招呼
2020-01-11,1202,146,134,280,榮華,招呼
2020-01-12,1202,139,132,271,榮華,招呼
2020-01-13,1202,151,110,261,榮華,招呼
2020-01-14,1202,163,141,304,榮華,招呼
2020-01-15,1202,165,154,319,榮華,招呼
2020-01-16,1202,152,186,338,榮華,招呼
2020-01-17,1202,151,136,287,榮華,招呼
2020-01-18,1202,147,155,302,榮華,招呼
2020-01-19,1202,121,103,224,榮華,招呼
2020-01-20,1202,149,130,279,榮華,招呼
2020-01-21,1202,153,134,287,榮華,招呼
2020-01-22,1202,174,161,335,榮華,招呼
2020-01-23,1202,100,100,200,榮華,招呼
2020-01-24,1202,74,91,165,榮華,招呼
2020-01-25,1202,238,163,401,榮華,招呼
2020-01-26,1202,81,73,154,榮華,招呼
2020-01-27,1202,121,127,248,榮華,招呼
2020-01-28,1202,110,102,212,榮華,招呼
2020-01-29,1202,114,94,208,榮華,招呼
2020-01-30,1202,135,114,249,榮華,招呼
2020-01-31,1202,149,141,290,榮華,招呼
2020-02-01,1202,139,134,273,榮華,招呼
2020-02-02,1202,192,106,298,榮華,招呼
2020-02-03,1202,107,81,188,榮華,招呼
2020-02-04,1202,119,99,218,榮華,招呼
2020-02-05,1202,139,106,245,榮華,招呼
2020-02-06,1202,123,104,227,榮華,招呼
2020-02-07,1202,122,108,230,榮華,招呼
2020-02-08,1202,128,112,240,榮華,招呼
2020-02-09,1202,135,95,230,榮華,招呼
2020-02-10,1202,107,105,212,榮華,招呼
2020-02-11,1202,141,111,252,榮華,招呼
2020-02-12,1202,139,110,249,榮華,招呼
2020-02-13,1202,125,117,242,榮華,招呼
2020-02-14,1202,161,133,294,榮華,招呼
2020-02-15,1202,100,112,212,榮華,招呼
2020-02-16,1202,54,65,119,榮華,招呼
2020-02-17,1202,103,98,201,榮華,招呼
2020-02-18,1202,146,98,244,榮華,招呼
2020-02-19,1202,119,96,215,榮華,招呼
2020-02-20,1202,136,145,281,榮華,招呼
2020-02-21,1202,111,97,208,榮華,招呼
2020-02-22,1202,116,118,234,榮華,招呼
2020-02-23,1202,72,91,163,榮華,招呼
2020-02-24,1202,111,100,211,榮華,招呼
2020-02-25,1202,117,115,232,榮華,招呼
2020-02-26,1202,128,116,244,榮華,招呼
2020-02-27,1202,127,133,260,榮華,招呼
2020-02-28,1202,154,116,270,榮華,招呼
2020-02-29,1202,118,101,219,榮華,招呼
2020-03-01,1202,105,85,190,榮華,招呼
2020-03-02,1202,103,99,202,榮華,招呼
2020-03-03,1202,115,117,232,榮華,招呼
2020-03-04,1202,87,92,179,榮華,招呼
2020-03-05,1202,97,99,196,榮華,招呼
2020-03-06,1202,102,143,245,榮華,招呼
2020-03-07,1202,113,108,221,榮華,招呼
2020-03-08,1202,109,120,229,榮華,招呼
2020-03-09,1202,105,102,207,榮華,招呼
2020-03-10,1202,101,88,189,榮華,招呼
2020-03-11,1202,99,106,205,榮華,招呼
2020-03-12,1202,99,113,212,榮華,招呼
2020-03-13,1202,84,134,218,榮華,招呼
2020-03-14,1202,106,120,226,榮華,招呼
2020-03-15,1202,99,109,208,榮華,招呼
2020-03-16,1202,103,91,194,榮華,招呼
2020-03-17,1202,94,104,198,榮華,招呼
2020-03-18,1202,86,101,187,榮華,招呼
2020-03-19,1202,97,101,198,榮華,招呼
2020-03-20,1202,112,147,259,榮華,招呼
2020-03-21,1202,103,95,198,榮華,招呼
2020-03-22,1202,108,85,193,榮華,招呼
2020-03-23,1202,88,89,177,榮華,招呼
2020-03-24,1202,103,98,201,榮華,招呼
2020-03-25,1202,92,110,202,榮華,招呼
2020-03-26,1202,99,96,195,榮華,招呼
2020-03-27,1202,92,124,216,榮華,招呼
2020-03-28,1202,65,79,144,榮華,招呼
2020-03-29,1202,66,55,121,榮華,招呼
2020-03-30,1202,82,99,181,榮華,招呼
2020-03-31,1202,111,115,226,榮華,招呼
2020-04-01,1202,94,114,208,榮華,招呼
2020-04-02,1202,90,97,187,榮華,招呼
2020-04-03,1202,89,77,166,榮華,招呼
2020-04-04,1202,62,59,121,榮華,招呼
2020-04-05,1202,82,75,157,榮華,招呼
2020-04-06,1202,92,105,197,榮華,招呼
2020-04-07,1202,88,81,169,榮華,招呼
2020-04-08,1202,92,93,185,榮華,招呼
2020-04-09,1202,85,92,177,榮華,招呼
2020-04-10,1202,103,119,222,榮華,招呼
2020-04-11,1202,79,72,151,榮華,招呼
2020-04-12,1202,57,52,109,榮華,招呼
2020-04-13,1202,89,101,190,榮華,招呼
2020-04-14,1202,93,93,186,榮華,招呼
2020-04-15,1202,88,96,184,榮華,招呼
2020-04-16,1202,84,99,183,榮華,招呼
2020-04-17,1202,97,115,212,榮華,招呼
2020-04-18,1202,70,87,157,榮華,招呼
2020-04-19,1202,104,66,170,榮華,招呼
2020-04-20,1202,101,96,197,榮華,招呼
2020-04-21,1202,100,91,191,榮華,招呼
2020-04-22,1202,93,98,191,榮華,招呼
2020-04-23,1202,89,93,182,榮華,招呼
2020-04-24,1202,89,102,191,榮華,招呼
2020-04-25,1202,75,79,154,榮華,招呼
2020-04-26,1202,72,65,137,榮華,招呼
2020-04-27,1202,103,95,198,榮華,招呼
2020-04-28,1202,97,97,194,榮華,招呼
2020-04-29,1202,78,90,168,榮華,招呼
2020-04-30,1202,99,106,205,榮華,招呼
2020-05-01,1202,100,124,224,榮華,招呼
2020-05-02,1202,90,89,179,榮華,招呼
2020-05-03,1202,87,76,163,榮華,招呼
2020-05-04,1202,108,97,205,榮華,招呼
2020-05-05,1202,84,79,163,榮華,招呼
2020-05-06,1202,89,98,187,榮華,招呼
2020-05-07,1202,92,83,175,榮華,招呼
2020-05-08,1202,113,123,236,榮華,招呼
2020-05-09,1202,93,107,200,榮華,招呼
2020-05-10,1202,84,73,157,榮華,招呼
2020-05-11,1202,92,103,195,榮華,招呼
2020-05-12,1202,102,105,207,榮華,招呼
2020-05-13,1202,120,120,240,榮華,招呼
2020-05-14,1202,103,114,217,榮華,招呼
2020-05-15,1202,133,123,256,榮華,招呼
2020-05-16,1202,84,77,161,榮華,招呼
2020-05-17,1202,83,81,164,榮華,招呼
2020-05-18,1202,90,82,172,榮華,招呼
2020-05-19,1202,99,94,193,榮華,招呼
2020-05-20,1202,172,100,272,榮華,招呼
2020-05-21,1202,102,103,205,榮華,招呼
2020-05-22,1202,102,124,226,榮華,招呼
2020-05-23,1202,77,73,150,榮華,招呼
2020-05-24,1202,110,79,189,榮華,招呼
2020-05-25,1202,105,116,221,榮華,招呼
2020-05-26,1202,116,111,227,榮華,招呼
2020-05-27,1202,108,110,218,榮華,招呼
2020-05-28,1202,90,107,197,榮華,招呼
2020-05-29,1202,128,164,292,榮華,招呼
2020-05-30,1202,150,106,256,榮華,招呼
2020-05-31,1202,115,101,216,榮華,招呼
2020-06-01,1202,109,109,218,榮華,招呼
2020-06-02,1202,108,120,228,榮華,招呼
2020-06-03,1202,107,97,204,榮華,招呼
2020-06-04,1202,107,110,217,榮華,招呼
2020-06-05,1202,109,116,225,榮華,招呼
2020-06-06,1202,111,96,207,榮華,招呼
2020-06-07,1202,104,89,193,榮華,招呼
2020-06-08,1202,85,90,175,榮華,招呼
2020-06-09,1202,119,110,229,榮華,招呼
2020-06-10,1202,110,133,243,榮華,招呼
2020-06-11,1202,98,96,194,榮華,招呼
2020-06-12,1202,205,158,363,榮華,招呼
2020-06-13,1202,124,123,247,榮華,招呼
2020-06-14,1202,110,100,210,榮華,招呼
2020-06-15,1202,112,112,224,榮華,招呼
2020-06-16,1202,137,127,264,榮華,招呼
2020-06-17,1202,111,97,208,榮華,招呼
2020-06-18,1202,119,105,224,榮華,招呼
2020-06-19,1202,118,119,237,榮華,招呼
2020-06-20,1202,136,99,235,榮華,招呼
2020-06-21,1202,105,104,209,榮華,招呼
2020-06-22,1202,108,114,222,榮華,招呼
2020-06-23,1202,176,147,323,榮華,招呼
2020-06-24,1202,115,132,247,榮華,招呼
2020-06-25,1202,134,118,252,榮華,招呼
2020-06-26,1202,146,123,269,榮華,招呼
2020-06-27,1202,119,116,235,榮華,招呼
2020-06-28,1202,93,99,192,榮華,招呼
2020-06-29,1202,118,130,248,榮華,招呼
2020-06-30,1202,137,139,276,榮華,招呼
2020-07-01,1202,137,117,254,榮華,招呼
2020-07-02,1202,129,107,236,榮華,招呼
2020-07-03,1202,129,132,261,榮華,招呼
2020-07-04,1202,131,97,228,榮華,招呼
2020-07-05,1202,105,100,205,榮華,招呼
2020-07-06,1202,137,122,259,榮華,招呼
2020-07-07,1202,125,126,251,榮華,招呼
2020-07-08,1202,138,140,278,榮華,招呼
2020-07-09,1202,112,116,228,榮華,招呼
2020-07-10,1202,130,129,259,榮華,招呼
2020-07-11,1202,169,139,308,榮華,招呼
2020-07-12,1202,126,138,264,榮華,招呼
2020-07-13,1202,130,120,250,榮華,招呼
2020-07-14,1202,159,158,317,榮華,招呼
2020-07-15,1202,141,113,254,榮華,招呼
2020-07-16,1202,111,106,217,榮華,招呼
2020-07-17,1202,183,138,321,榮華,招呼
2020-07-18,1202,138,106,244,榮華,招呼
2020-07-19,1202,136,138,274,榮華,招呼
2020-07-20,1202,151,122,273,榮華,招呼
2020-07-21,1202,158,165,323,榮華,招呼
2020-07-22,1202,130,124,254,榮華,招呼
2020-07-23,1202,137,133,270,榮華,招呼
2020-07-24,1202,119,122,241,榮華,招呼
2020-07-25,1202,129,129,258,榮華,招呼
2020-07-26,1202,152,108,260,榮華,招呼
2020-07-27,1202,118,121,239,榮華,招呼
2020-07-28,1202,185,105,290,榮華,招呼
2020-07-29,1202,125,134,259,榮華,招呼
2020-07-30,1202,111,126,237,榮華,招呼
2020-07-31,1202,158,139,297,榮華,招呼
2020-08-01,1202,144,129,273,榮華,招呼
2020-08-02,1202,102,109,211,榮華,招呼
2020-08-03,1202,120,121,241,榮華,招呼
2020-08-04,1202,170,178,348,榮華,招呼
2020-08-05,1202,117,127,244,榮華,招呼
2020-08-06,1202,123,135,258,榮華,招呼
2020-08-07,1202,144,142,286,榮華,招呼
2020-08-08,1202,151,130,281,榮華,招呼
2020-08-09,1202,137,113,250,榮華,招呼
2020-08-10,1202,126,95,221,榮華,招呼
2020-08-11,1202,155,192,347,榮華,招呼
2020-08-12,1202,127,105,232,榮華,招呼
2020-08-13,1202,112,131,243,榮華,招呼
2020-08-14,1202,135,146,281,榮華,招呼
2020-08-15,1202,137,135,272,榮華,招呼
2020-08-16,1202,132,122,254,榮華,招呼
2020-08-17,1202,129,117,246,榮華,招呼
2020-08-18,1202,130,146,276,榮華,招呼
2020-08-19,1202,126,126,252,榮華,招呼
2020-08-20,1202,152,142,294,榮華,招呼
2020-08-21,1202,145,146,291,榮華,招呼
2020-08-22,1202,117,111,228,榮華,招呼
2020-08-23,1202,129,121,250,榮華,招呼
2020-08-24,1202,118,125,243,榮華,招呼
2020-08-25,1202,135,203,338,榮華,招呼
2020-08-26,1202,115,120,235,榮華,招呼
2020-08-27,1202,114,116,230,榮華,招呼
2020-08-28,1202,131,118,249,榮華,招呼
2020-08-29,1202,120,115,235,榮華,招呼
2020-08-30,1202,124,130,254,榮華,招呼
2020-08-31,1202,125,116,241,榮華,招呼
2020-09-01,1202,119,126,245,榮華,招呼
2020-09-02,1202,105,110,215,榮華,招呼
2020-09-03,1202,138,114,252,榮華,招呼
2020-09-04,1202,139,134,273,榮華,招呼
2020-09-05,1202,144,126,270,榮華,招呼
2020-09-06,1202,137,126,263,榮華,招呼
2020-09-07,1202,123,131,254,榮華,招呼
2020-09-08,1202,133,121,254,榮華,招呼
2020-09-09,1202,122,117,239,榮華,招呼
2020-09-10,1202,119,114,233,榮華,招呼
2020-09-11,1202,125,148,273,榮華,招呼
2020-09-12,1202,114,117,231,榮華,招呼
2020-09-13,1202,153,141,294,榮華,招呼
2020-09-14,1202,118,124,242,榮華,招呼
2020-09-15,1202,104,116,220,榮華,招呼
2020-09-16,1202,102,119,221,榮華,招呼
2020-09-17,1202,115,121,236,榮華,招呼
2020-09-18,1202,135,148,283,榮華,招呼
2020-09-19,1202,121,130,251,榮華,招呼
2020-09-20,1202,117,104,221,榮華,招呼
2020-09-21,1202,122,95,217,榮華,招呼
2020-09-22,1202,140,112,252,榮華,招呼
2020-09-23,1202,116,126,242,榮華,招呼
2020-09-24,1202,119,115,234,榮華,招呼
2020-09-25,1202,128,129,257,榮華,招呼
2020-09-26,1202,118,135,253,榮華,招呼
2020-09-27,1202,103,77,180,榮華,招呼
2020-09-28,1202,121,100,221,榮華,招呼
2020-09-29,1202,130,116,246,榮華,招呼
2020-09-30,1202,132,154,286,榮華,招呼
2020-10-01,1202,155,141,296,榮華,招呼
2020-10-02,1202,133,133,266,榮華,招呼
2020-10-03,1202,157,137,294,榮華,招呼
2020-10-04,1202,176,145,321,榮華,招呼
2020-10-05,1202,126,139,265,榮華,招呼
2020-10-06,1202,119,120,239,榮華,招呼
2020-10-07,1202,106,123,229,榮華,招呼
2020-10-08,1202,128,155,283,榮華,招呼
2020-10-09,1202,130,127,257,榮華,招呼
2020-10-10,1202,161,170,331,榮華,招呼
2020-10-11,1202,132,126,258,榮華,招呼
2020-10-12,1202,127,126,253,榮華,招呼
2020-10-13,1202,133,126,259,榮華,招呼
2020-10-14,1202,114,120,234,榮華,招呼
2020-10-15,1202,115,109,224,榮華,招呼
2020-10-16,1202,134,146,280,榮華,招呼
2020-10-17,1202,213,135,348,榮華,招呼
2020-10-18,1202,121,117,238,榮華,招呼
2020-10-19,1202,128,108,236,榮華,招呼
2020-10-20,1202,118,117,235,榮華,招呼
2020-10-21,1202,131,126,257,榮華,招呼
2020-10-22,1202,184,115,299,榮華,招呼
2020-10-23,1202,125,142,267,榮華,招呼
2020-10-24,1202,147,142,289,榮華,招呼
2020-10-25,1202,147,130,277,榮華,招呼
2020-10-26,1202,137,121,258,榮華,招呼
2020-10-27,1202,124,114,238,榮華,招呼
2020-10-28,1202,112,140,252,榮華,招呼
2020-10-29,1202,126,132,258,榮華,招呼
2020-10-30,1202,143,157,300,榮華,招呼
2020-10-31,1202,143,136,279,榮華,招呼
2020-11-01,1202,141,144,285,榮華,招呼
2020-11-02,1202,134,117,251,榮華,招呼
2020-11-03,1202,125,131,256,榮華,招呼
2020-11-04,1202,109,118,227,榮華,招呼
2020-11-05,1202,121,121,242,榮華,招呼
2020-11-06,1202,127,148,275,榮華,招呼
2020-11-07,1202,142,144,286,榮華,招呼
2020-11-08,1202,156,113,269,榮華,招呼
2020-11-09,1202,126,116,242,榮華,招呼
2020-11-10,1202,113,111,224,榮華,招呼
2020-11-11,1202,170,136,306,榮華,招呼
2020-11-12,1202,121,120,241,榮華,招呼
2020-11-13,1202,132,164,296,榮華,招呼
2020-11-14,1202,154,113,267,榮華,招呼
2020-11-15,1202,140,133,273,榮華,招呼
2020-11-16,1202,145,151,296,榮華,招呼
2020-11-17,1202,113,116,229,榮華,招呼
2020-11-18,1202,99,117,216,榮華,招呼
2020-11-19,1202,95,106,201,榮華,招呼
2020-11-20,1202,193,212,405,榮華,招呼
2020-11-21,1202,137,123,260,榮華,招呼
2020-11-22,1202,134,152,286,榮華,招呼
2020-11-23,1202,125,132,257,榮華,招呼
2020-11-24,1202,116,121,237,榮華,招呼
2020-11-25,1202,126,119,245,榮華,招呼
2020-11-26,1202,126,112,238,榮華,招呼
2020-11-27,1202,125,152,277,榮華,招呼
2020-11-28,1202,144,160,304,榮華,招呼
2020-11-29,1202,142,116,258,榮華,招呼
2020-11-30,1202,125,121,246,榮華,招呼
2020-12-01,1202,114,113,227,榮華,招呼
2020-12-02,1202,104,120,224,榮華,招呼
2020-12-03,1202,126,123,249,榮華,招呼
2020-12-04,1202,148,124,272,榮華,招呼
2020-12-05,1202,133,148,281,榮華,招呼
2020-12-06,1202,150,128,278,榮華,招呼
2020-12-07,1202,130,139,269,榮華,招呼
2020-12-08,1202,117,123,240,榮華,招呼
2020-12-09,1202,88,120,208,榮華,招呼
2020-12-10,1202,98,111,209,榮華,招呼
2020-12-11,1202,128,151,279,榮華,招呼
2020-12-12,1202,208,120,328,榮華,招呼
2020-12-13,1202,127,125,252,榮華,招呼
2020-12-14,1202,124,129,253,榮華,招呼
2020-12-15,1202,102,109,211,榮華,招呼
2020-12-16,1202,105,116,221,榮華,招呼
2020-12-17,1202,108,111,219,榮華,招呼
2020-12-18,1202,133,157,290,榮華,招呼
2020-12-19,1202,129,151,280,榮華,招呼
2020-12-20,1202,121,117,238,榮華,招呼
2020-12-21,1202,161,102,263,榮華,招呼
2020-12-22,1202,111,117,228,榮華,招呼
2020-12-23,1202,78,92,170,榮華,招呼
2020-12-24,1202,99,100,199,榮華,招呼
2020-12-25,1202,144,159,303,榮華,招呼
2020-12-26,1202,139,111,250,榮華,招呼
2020-12-27,1202,129,125,254,榮華,招呼
2020-12-28,1202,111,108,219,榮華,招呼
2020-12-29,1202,115,110,225,榮華,招呼
2020-12-30,1202,116,107,223,榮華,招呼
2020-12-31,1202,117,136,253,榮華,招呼
2020-01-01,1203,666,583,1249,竹東,二等
2020-01-02,1203,631,461,1092,竹東,二等
2020-01-03,1203,526,477,1003,竹東,二等
2020-01-04,1203,720,656,1376,竹東,二等
2020-01-05,1203,549,534,1083,竹東,二等
2020-01-06,1203,436,411,847,竹東,二等
2020-01-07,1203,448,420,868,竹東,二等
2020-01-08,1203,439,464,903,竹東,二等
2020-01-09,1203,451,410,861,竹東,二等
2020-01-10,1203,594,559,1153,竹東,二等
2020-01-11,1203,597,565,1162,竹東,二等
2020-01-12,1203,567,438,1005,竹東,二等
2020-01-13,1203,418,398,816,竹東,二等
2020-01-14,1203,466,380,846,竹東,二等
2020-01-15,1203,452,448,900,竹東,二等
2020-01-16,1203,649,505,1154,竹東,二等
2020-01-17,1203,507,437,944,竹東,二等
2020-01-18,1203,572,582,1154,竹東,二等
2020-01-19,1203,559,470,1029,竹東,二等
2020-01-20,1203,548,426,974,竹東,二等
2020-01-21,1203,651,556,1207,竹東,二等
2020-01-22,1203,572,519,1091,竹東,二等
2020-01-23,1203,501,460,961,竹東,二等
2020-01-24,1203,262,297,559,竹東,二等
2020-01-25,1203,531,461,992,竹東,二等
2020-01-26,1203,304,292,596,竹東,二等
2020-01-27,1203,528,397,925,竹東,二等
2020-01-28,1203,500,432,932,竹東,二等
2020-01-29,1203,461,462,923,竹東,二等
2020-01-30,1203,481,444,925,竹東,二等
2020-01-31,1203,464,442,906,竹東,二等
2020-02-01,1203,508,520,1028,竹東,二等
2020-02-02,1203,463,430,893,竹東,二等
2020-02-03,1203,444,395,839,竹東,二等
2020-02-04,1203,376,359,735,竹東,二等
2020-02-05,1203,443,405,848,竹東,二等
2020-02-06,1203,520,459,979,竹東,二等
2020-02-07,1203,421,380,801,竹東,二等
2020-02-08,1203,487,460,947,竹東,二等
2020-02-09,1203,391,384,775,竹東,二等
2020-02-10,1203,429,395,824,竹東,二等
2020-02-11,1203,512,456,968,竹東,二等
2020-02-12,1203,506,430,936,竹東,二等
2020-02-13,1203,409,399,808,竹東,二等
2020-02-14,1203,499,429,928,竹東,二等
2020-02-15,1203,621,558,1179,竹東,二等
2020-02-16,1203,267,279,546,竹東,二等
2020-02-17,1203,485,375,860,竹東,二等
2020-02-18,1203,491,425,916,竹東,二等
2020-02-19,1203,455,384,839,竹東,二等
2020-02-20,1203,485,425,910,竹東,二等
2020-02-21,1203,489,458,947,竹東,二等
2020-02-22,1203,491,485,976,竹東,二等
2020-02-23,1203,554,426,980,竹東,二等
2020-02-24,1203,431,389,820,竹東,二等
2020-02-25,1203,428,408,836,竹東,二等
2020-02-26,1203,455,351,806,竹東,二等
2020-02-27,1203,469,445,914,竹東,二等
2020-02-28,1203,536,473,1009,竹東,二等
2020-02-29,1203,645,552,1197,竹東,二等
2020-03-01,1203,476,365,841,竹東,二等
2020-03-02,1203,387,373,760,竹東,二等
2020-03-03,1203,413,364,777,竹東,二等
2020-03-04,1203,408,350,758,竹東,二等
2020-03-05,1203,386,335,721,竹東,二等
2020-03-06,1203,461,442,903,竹東,二等
2020-03-07,1203,533,491,1024,竹東,二等
2020-03-08,1203,422,369,791,竹東,二等
2020-03-09,1203,377,366,743,竹東,二等
2020-03-10,1203,369,312,681,竹東,二等
2020-03-11,1203,424,343,767,竹東,二等
2020-03-12,1203,366,363,729,竹東,二等
2020-03-13,1203,413,396,809,竹東,二等
2020-03-14,1203,451,422,873,竹東,二等
2020-03-15,1203,480,397,877,竹東,二等
2020-03-16,1203,377,370,747,竹東,二等
2020-03-17,1203,428,395,823,竹東,二等
2020-03-18,1203,368,351,719,竹東,二等
2020-03-19,1203,317,333,650,竹東,二等
2020-03-20,1203,410,406,816,竹東,二等
2020-03-21,1203,395,367,762,竹東,二等
2020-03-22,1203,365,326,691,竹東,二等
2020-03-23,1203,339,315,654,竹東,二等
2020-03-24,1203,328,330,658,竹東,二等
2020-03-25,1203,323,306,629,竹東,二等
2020-03-26,1203,339,324,663,竹東,二等
2020-03-27,1203,373,382,755,竹東,二等
2020-03-28,1203,232,235,467,竹東,二等
2020-03-29,1203,337,297,634,竹東,二等
2020-03-30,1203,313,320,633,竹東,二等
2020-03-31,1203,372,331,703,竹東,二等
2020-04-01,1203,348,395,743,竹東,二等
2020-04-02,1203,297,280,577,竹東,二等
2020-04-03,1203,339,287,626,竹東,二等
2020-04-04,1203,260,236,496,竹東,二等
2020-04-05,1203,322,260,582,竹東,二等
2020-04-06,1203,320,303,623,竹東,二等
2020-04-07,1203,335,294,629,竹東,二等
2020-04-08,1203,348,348,696,竹東,二等
2020-04-09,1203,346,295,641,竹東,二等
2020-04-10,1203,393,363,756,竹東,二等
2020-04-11,1203,329,266,595,竹東,二等
2020-04-12,1203,290,268,558,竹東,二等
2020-04-13,1203,359,341,700,竹東,二等
2020-04-14,1203,367,335,702,竹東,二等
2020-04-15,1203,355,316,671,竹東,二等
2020-04-16,1203,354,341,695,竹東,二等
2020-04-17,1203,399,364,763,竹東,二等
2020-04-18,1203,403,364,767,竹東,二等
2020-04-19,1203,406,339,745,竹東,二等
2020-04-20,1203,358,317,675,竹東,二等
2020-04-21,1203,318,310,628,竹東,二等
2020-04-22,1203,340,327,667,竹東,二等
2020-04-23,1203,298,297,595,竹東,二等
2020-04-24,1203,387,342,729,竹東,二等
2020-04-25,1203,348,339,687,竹東,二等
2020-04-26,1203,271,197,468,竹東,二等
2020-04-27,1203,365,324,689,竹東,二等
2020-04-28,1203,341,292,633,竹東,二等
2020-04-29,1203,352,317,669,竹東,二等
2020-04-30,1203,329,333,662,竹東,二等
2020-05-01,1203,419,425,844,竹東,二等
2020-05-02,1203,446,383,829,竹東,二等
2020-05-03,1203,383,299,682,竹東,二等
2020-05-04,1203,380,333,713,竹東,二等
2020-05-05,1203,352,331,683,竹東,二等
2020-05-06,1203,379,368,747,竹東,二等
2020-05-07,1203,357,330,687,竹東,二等
2020-05-08,1203,411,438,849,竹東,二等
2020-05-09,1203,391,370,761,竹東,二等
2020-05-10,1203,416,297,713,竹東,二等
2020-05-11,1203,354,317,671,竹東,二等
2020-05-12,1203,354,350,704,竹東,二等
2020-05-13,1203,346,336,682,竹東,二等
2020-05-14,1203,366,355,721,竹東,二等
2020-05-15,1203,565,435,1000,竹東,二等
2020-05-16,1203,399,395,794,竹東,二等
2020-05-17,1203,404,353,757,竹東,二等
2020-05-18,1203,358,322,680,竹東,二等
2020-05-19,1203,282,282,564,竹東,二等
2020-05-20,1203,373,334,707,竹東,二等
2020-05-21,1203,346,344,690,竹東,二等
2020-05-22,1203,326,356,682,竹東,二等
2020-05-23,1203,287,293,580,竹東,二等
2020-05-24,1203,399,397,796,竹東,二等
2020-05-25,1203,375,364,739,竹東,二等
2020-05-26,1203,347,338,685,竹東,二等
2020-05-27,1203,322,317,639,竹東,二等
2020-05-28,1203,307,313,620,竹東,二等
2020-05-29,1203,465,456,921,竹東,二等
2020-05-30,1203,677,560,1237,竹東,二等
2020-05-31,1203,515,453,968,竹東,二等
2020-06-01,1203,344,330,674,竹東,二等
2020-06-02,1203,359,336,695,竹東,二等
2020-06-03,1203,391,351,742,竹東,二等
2020-06-04,1203,358,349,707,竹東,二等
2020-06-05,1203,449,432,881,竹東,二等
2020-06-06,1203,547,516,1063,竹東,二等
2020-06-07,1203,457,382,839,竹東,二等
2020-06-08,1203,402,354,756,竹東,二等
2020-06-09,1203,404,363,767,竹東,二等
2020-06-10,1203,398,388,786,竹東,二等
2020-06-11,1203,387,371,758,竹東,二等
2020-06-12,1203,471,573,1044,竹東,二等
2020-06-13,1203,625,527,1152,竹東,二等
2020-06-14,1203,480,436,916,竹東,二等
2020-06-15,1203,411,385,796,竹東,二等
2020-06-16,1203,538,536,1074,竹東,二等
2020-06-17,1203,355,351,706,竹東,二等
2020-06-18,1203,473,399,872,竹東,二等
2020-06-19,1203,573,550,1123,竹東,二等
2020-06-20,1203,527,503,1030,竹東,二等
2020-06-21,1203,563,474,1037,竹東,二等
2020-06-22,1203,593,343,936,竹東,二等
2020-06-23,1203,615,392,1007,竹東,二等
2020-06-24,1203,475,454,929,竹東,二等
2020-06-25,1203,496,467,963,竹東,二等
2020-06-26,1203,634,616,1250,竹東,二等
2020-06-27,1203,631,555,1186,竹東,二等
2020-06-28,1203,492,419,911,竹東,二等
2020-06-29,1203,388,379,767,竹東,二等
2020-06-30,1203,410,367,777,竹東,二等
2020-07-01,1203,368,330,698,竹東,二等
2020-07-02,1203,390,400,790,竹東,二等
2020-07-03,1203,536,464,1000,竹東,二等
2020-07-04,1203,485,489,974,竹東,二等
2020-07-05,1203,449,400,849,竹東,二等
2020-07-06,1203,394,378,772,竹東,二等
2020-07-07,1203,431,366,797,竹東,二等
2020-07-08,1203,422,382,804,竹東,二等
2020-07-09,1203,399,356,755,竹東,二等
2020-07-10,1203,524,453,977,竹東,二等
2020-07-11,1203,627,605,1232,竹東,二等
2020-07-12,1203,516,517,1033,竹東,二等
2020-07-13,1203,435,397,832,竹東,二等
2020-07-14,1203,651,465,1116,竹東,二等
2020-07-15,1203,509,426,935,竹東,二等
2020-07-16,1203,493,507,1000,竹東,二等
2020-07-17,1203,524,441,965,竹東,二等
2020-07-18,1203,619,579,1198,竹東,二等
2020-07-19,1203,609,442,1051,竹東,二等
2020-07-20,1203,452,364,816,竹東,二等
2020-07-21,1203,458,390,848,竹東,二等
2020-07-22,1203,487,440,927,竹東,二等
2020-07-23,1203,492,413,905,竹東,二等
2020-07-24,1203,448,422,870,竹東,二等
2020-07-25,1203,591,514,1105,竹東,二等
2020-07-26,1203,451,424,875,竹東,二等
2020-07-27,1203,416,466,882,竹東,二等
2020-07-28,1203,399,497,896,竹東,二等
2020-07-29,1203,437,387,824,竹東,二等
2020-07-30,1203,446,393,839,竹東,二等
2020-07-31,1203,638,510,1148,竹東,二等
2020-08-01,1203,613,566,1179,竹東,二等
2020-08-02,1203,496,413,909,竹東,二等
2020-08-03,1203,422,363,785,竹東,二等
2020-08-04,1203,523,439,962,竹東,二等
2020-08-05,1203,460,379,839,竹東,二等
2020-08-06,1203,474,406,880,竹東,二等
2020-08-07,1203,543,477,1020,竹東,二等
2020-08-08,1203,510,456,966,竹東,二等
2020-08-09,1203,594,520,1114,竹東,二等
2020-08-10,1203,442,369,811,竹東,二等
2020-08-11,1203,366,336,702,竹東,二等
2020-08-12,1203,424,379,803,竹東,二等
2020-08-13,1203,450,405,855,竹東,二等
2020-08-14,1203,554,484,1038,竹東,二等
2020-08-15,1203,551,496,1047,竹東,二等
2020-08-16,1203,559,553,1112,竹東,二等
2020-08-17,1203,465,430,895,竹東,二等
2020-08-18,1203,515,429,944,竹東,二等
2020-08-19,1203,463,418,881,竹東,二等
2020-08-20,1203,470,428,898,竹東,二等
2020-08-21,1203,578,487,1065,竹東,二等
2020-08-22,1203,566,558,1124,竹東,二等
2020-08-23,1203,587,423,1010,竹東,二等
2020-08-24,1203,517,420,937,竹東,二等
2020-08-25,1203,506,550,1056,竹東,二等
2020-08-26,1203,554,537,1091,竹東,二等
2020-08-27,1203,454,398,852,竹東,二等
2020-08-28,1203,482,449,931,竹東,二等
2020-08-29,1203,511,445,956,竹東,二等
2020-08-30,1203,586,432,1018,竹東,二等
2020-08-31,1203,367,347,714,竹東,二等
2020-09-01,1203,360,382,742,竹東,二等
2020-09-02,1203,377,351,728,竹東,二等
2020-09-03,1203,397,351,748,竹東,二等
2020-09-04,1203,501,444,945,竹東,二等
2020-09-05,1203,630,532,1162,竹東,二等
2020-09-06,1203,618,483,1101,竹東,二等
2020-09-07,1203,394,409,803,竹東,二等
2020-09-08,1203,440,342,782,竹東,二等
2020-09-09,1203,405,386,791,竹東,二等
2020-09-10,1203,406,395,801,竹東,二等
2020-09-11,1203,491,500,991,竹東,二等
2020-09-12,1203,629,465,1094,竹東,二等
2020-09-13,1203,641,485,1126,竹東,二等
2020-09-14,1203,401,380,781,竹東,二等
2020-09-15,1203,390,375,765,竹東,二等
2020-09-16,1203,385,348,733,竹東,二等
2020-09-17,1203,374,359,733,竹東,二等
2020-09-18,1203,418,436,854,竹東,二等
2020-09-19,1203,552,535,1087,竹東,二等
2020-09-20,1203,532,466,998,竹東,二等
2020-09-21,1203,369,328,697,竹東,二等
2020-09-22,1203,421,384,805,竹東,二等
2020-09-23,1203,460,400,860,竹東,二等
2020-09-24,1203,365,361,726,竹東,二等
2020-09-25,1203,437,403,840,竹東,二等
2020-09-26,1203,567,520,1087,竹東,二等
2020-09-27,1203,511,388,899,竹東,二等
2020-09-28,1203,389,327,716,竹東,二等
2020-09-29,1203,371,374,745,竹東,二等
2020-09-30,1203,422,477,899,竹東,二等
2020-10-01,1203,518,501,1019,竹東,二等
2020-10-02,1203,609,562,1171,竹東,二等
2020-10-03,1203,663,667,1330,竹東,二等
2020-10-04,1203,563,428,991,竹東,二等
2020-10-05,1203,482,353,835,竹東,二等
2020-10-06,1203,401,368,769,竹東,二等
2020-10-07,1203,428,403,831,竹東,二等
2020-10-08,1203,503,456,959,竹東,二等
2020-10-09,1203,617,643,1260,竹東,二等
2020-10-10,1203,798,745,1543,竹東,二等
2020-10-11,1203,614,578,1192,竹東,二等
2020-10-12,1203,388,339,727,竹東,二等
2020-10-13,1203,398,380,778,竹東,二等
2020-10-14,1203,399,400,799,竹東,二等
2020-10-15,1203,512,429,941,竹東,二等
2020-10-16,1203,560,513,1073,竹東,二等
2020-10-17,1203,668,619,1287,竹東,二等
2020-10-18,1203,692,603,1295,竹東,二等
2020-10-19,1203,397,365,762,竹東,二等
2020-10-20,1203,489,408,897,竹東,二等
2020-10-21,1203,425,410,835,竹東,二等
2020-10-22,1203,425,357,782,竹東,二等
2020-10-23,1203,447,404,851,竹東,二等
2020-10-24,1203,657,502,1159,竹東,二等
2020-10-25,1203,530,465,995,竹東,二等
2020-10-26,1203,423,387,810,竹東,二等
2020-10-27,1203,528,373,901,竹東,二等
2020-10-28,1203,451,393,844,竹東,二等
2020-10-29,1203,461,371,832,竹東,二等
2020-10-30,1203,519,498,1017,竹東,二等
2020-10-31,1203,679,632,1311,竹東,二等
2020-11-01,1203,638,539,1177,竹東,二等
2020-11-02,1203,361,348,709,竹東,二等
2020-11-03,1203,381,329,710,竹東,二等
2020-11-04,1203,475,433,908,竹東,二等
2020-11-05,1203,437,398,835,竹東,二等
2020-11-06,1203,477,465,942,竹東,二等
2020-11-07,1203,667,554,1221,竹東,二等
2020-11-08,1203,676,575,1251,竹東,二等
2020-11-09,1203,425,404,829,竹東,二等
2020-11-10,1203,421,360,781,竹東,二等
2020-11-11,1203,422,428,850,竹東,二等
2020-11-12,1203,400,377,777,竹東,二等
2020-11-13,1203,477,471,948,竹東,二等
2020-11-14,1203,691,771,1462,竹東,二等
2020-11-15,1203,1200,529,1729,竹東,二等
2020-11-16,1203,521,459,980,竹東,二等
2020-11-17,1203,428,402,830,竹東,二等
2020-11-18,1203,447,412,859,竹東,二等
2020-11-19,1203,427,458,885,竹東,二等
2020-11-20,1203,550,499,1049,竹東,二等
2020-11-21,1203,727,689,1416,竹東,二等
2020-11-22,1203,594,513,1107,竹東,二等
2020-11-23,1203,457,388,845,竹東,二等
2020-11-24,1203,421,406,827,竹東,二等
2020-11-25,1203,406,382,788,竹東,二等
2020-11-26,1203,515,417,932,竹東,二等
2020-11-27,1203,487,508,995,竹東,二等
2020-11-28,1203,672,569,1241,竹東,二等
2020-11-29,1203,611,602,1213,竹東,二等
2020-11-30,1203,377,382,759,竹東,二等
2020-12-01,1203,386,386,772,竹東,二等
2020-12-02,1203,441,403,844,竹東,二等
2020-12-03,1203,399,357,756,竹東,二等
2020-12-04,1203,632,461,1093,竹東,二等
2020-12-05,1203,681,579,1260,竹東,二等
2020-12-06,1203,769,449,1218,竹東,二等
2020-12-07,1203,442,362,804,竹東,二等
2020-12-08,1203,416,379,795,竹東,二等
2020-12-09,1203,365,324,689,竹東,二等
2020-12-10,1203,392,362,754,竹東,二等
2020-12-11,1203,503,479,982,竹東,二等
2020-12-12,1203,589,498,1087,竹東,二等
2020-12-13,1203,622,537,1159,竹東,二等
2020-12-14,1203,424,402,826,竹東,二等
2020-12-15,1203,363,357,720,竹東,二等
2020-12-16,1203,445,381,826,竹東,二等
2020-12-17,1203,423,415,838,竹東,二等
2020-12-18,1203,487,475,962,竹東,二等
2020-12-19,1203,623,572,1195,竹東,二等
2020-12-20,1203,665,549,1214,竹東,二等
2020-12-21,1203,374,360,734,竹東,二等
2020-12-22,1203,477,418,895,竹東,二等
2020-12-23,1203,429,325,754,竹東,二等
2020-12-24,1203,428,387,815,竹東,二等
2020-12-25,1203,529,504,1033,竹東,二等
2020-12-26,1203,598,592,1190,竹東,二等
2020-12-27,1203,503,447,950,竹東,二等
2020-12-28,1203,389,363,752,竹東,二等
2020-12-29,1203,402,365,767,竹東,二等
2020-12-30,1203,365,355,720,竹東,二等
2020-12-31,1203,503,441,944,竹東,二等
2020-01-01,1204,114,137,251,橫山,招呼
2020-01-02,1204,79,87,166,橫山,招呼
2020-01-03,1204,105,98,203,橫山,招呼
2020-01-04,1204,77,116,193,橫山,招呼
2020-01-05,1204,65,102,167,橫山,招呼
2020-01-06,1204,81,89,170,橫山,招呼
2020-01-07,1204,84,84,168,橫山,招呼
2020-01-08,1204,88,98,186,橫山,招呼
2020-01-09,1204,101,105,206,橫山,招呼
2020-01-10,1204,107,115,222,橫山,招呼
2020-01-11,1204,103,111,214,橫山,招呼
2020-01-12,1204,82,96,178,橫山,招呼
2020-01-13,1204,72,75,147,橫山,招呼
2020-01-14,1204,87,82,169,橫山,招呼
2020-01-15,1204,89,86,175,橫山,招呼
2020-01-16,1204,83,83,166,橫山,招呼
2020-01-17,1204,100,85,185,橫山,招呼
2020-01-18,1204,84,97,181,橫山,招呼
2020-01-19,1204,72,73,145,橫山,招呼
2020-01-20,1204,97,100,197,橫山,招呼
2020-01-21,1204,76,94,170,橫山,招呼
2020-01-22,1204,97,112,209,橫山,招呼
2020-01-23,1204,118,128,246,橫山,招呼
2020-01-24,1204,45,74,119,橫山,招呼
2020-01-25,1204,133,129,262,橫山,招呼
2020-01-26,1204,84,82,166,橫山,招呼
2020-01-27,1204,85,94,179,橫山,招呼
2020-01-28,1204,136,139,275,橫山,招呼
2020-01-29,1204,86,86,172,橫山,招呼
2020-01-30,1204,71,74,145,橫山,招呼
2020-01-31,1204,84,96,180,橫山,招呼
2020-02-01,1204,69,106,175,橫山,招呼
2020-02-02,1204,87,73,160,橫山,招呼
2020-02-03,1204,67,72,139,橫山,招呼
2020-02-04,1204,67,56,123,橫山,招呼
2020-02-05,1204,77,84,161,橫山,招呼
2020-02-06,1204,94,73,167,橫山,招呼
2020-02-07,1204,84,85,169,橫山,招呼
2020-02-08,1204,53,76,129,橫山,招呼
2020-02-09,1204,77,70,147,橫山,招呼
2020-02-10,1204,73,68,141,橫山,招呼
2020-02-11,1204,70,71,141,橫山,招呼
2020-02-12,1204,82,66,148,橫山,招呼
2020-02-13,1204,69,69,138,橫山,招呼
2020-02-14,1204,75,71,146,橫山,招呼
2020-02-15,1204,71,89,160,橫山,招呼
2020-02-16,1204,46,66,112,橫山,招呼
2020-02-17,1204,72,75,147,橫山,招呼
2020-02-18,1204,67,73,140,橫山,招呼
2020-02-19,1204,69,72,141,橫山,招呼
2020-02-20,1204,72,79,151,橫山,招呼
2020-02-21,1204,78,69,147,橫山,招呼
2020-02-22,1204,72,98,170,橫山,招呼
2020-02-23,1204,76,73,149,橫山,招呼
2020-02-24,1204,76,85,161,橫山,招呼
2020-02-25,1204,79,85,164,橫山,招呼
2020-02-26,1204,88,98,186,橫山,招呼
2020-02-27,1204,97,87,184,橫山,招呼
2020-02-28,1204,110,131,241,橫山,招呼
2020-02-29,1204,112,127,239,橫山,招呼
2020-03-01,1204,95,95,190,橫山,招呼
2020-03-02,1204,84,82,166,橫山,招呼
2020-03-03,1204,83,83,166,橫山,招呼
2020-03-04,1204,98,87,185,橫山,招呼
2020-03-05,1204,73,90,163,橫山,招呼
2020-03-06,1204,108,91,199,橫山,招呼
2020-03-07,1204,64,91,155,橫山,招呼
2020-03-08,1204,83,94,177,橫山,招呼
2020-03-09,1204,75,83,158,橫山,招呼
2020-03-10,1204,77,76,153,橫山,招呼
2020-03-11,1204,77,87,164,橫山,招呼
2020-03-12,1204,74,80,154,橫山,招呼
2020-03-13,1204,97,87,184,橫山,招呼
2020-03-14,1204,43,59,102,橫山,招呼
2020-03-15,1204,90,123,213,橫山,招呼
2020-03-16,1204,82,80,162,橫山,招呼
2020-03-17,1204,78,79,157,橫山,招呼
2020-03-18,1204,70,67,137,橫山,招呼
2020-03-19,1204,73,69,142,橫山,招呼
2020-03-20,1204,101,89,190,橫山,招呼
2020-03-21,1204,58,69,127,橫山,招呼
2020-03-22,1204,74,74,148,橫山,招呼
2020-03-23,1204,63,58,121,橫山,招呼
2020-03-24,1204,71,80,151,橫山,招呼
2020-03-25,1204,56,67,123,橫山,招呼
2020-03-26,1204,64,65,129,橫山,招呼
2020-03-27,1204,89,89,178,橫山,招呼
2020-03-28,1204,57,54,111,橫山,招呼
2020-03-29,1204,50,60,110,橫山,招呼
2020-03-30,1204,70,87,157,橫山,招呼
2020-03-31,1204,75,81,156,橫山,招呼
2020-04-01,1204,104,92,196,橫山,招呼
2020-04-02,1204,65,73,138,橫山,招呼
2020-04-03,1204,67,72,139,橫山,招呼
2020-04-04,1204,57,49,106,橫山,招呼
2020-04-05,1204,65,96,161,橫山,招呼
2020-04-06,1204,67,80,147,橫山,招呼
2020-04-07,1204,71,70,141,橫山,招呼
2020-04-08,1204,75,71,146,橫山,招呼
2020-04-09,1204,60,76,136,橫山,招呼
2020-04-10,1204,93,97,190,橫山,招呼
2020-04-11,1204,49,60,109,橫山,招呼
2020-04-12,1204,57,63,120,橫山,招呼
2020-04-13,1204,71,84,155,橫山,招呼
2020-04-14,1204,68,68,136,橫山,招呼
2020-04-15,1204,71,72,143,橫山,招呼
2020-04-16,1204,79,76,155,橫山,招呼
2020-04-17,1204,88,87,175,橫山,招呼
2020-04-18,1204,62,77,139,橫山,招呼
2020-04-19,1204,68,69,137,橫山,招呼
2020-04-20,1204,74,71,145,橫山,招呼
2020-04-21,1204,69,60,129,橫山,招呼
2020-04-22,1204,66,73,139,橫山,招呼
2020-04-23,1204,73,64,137,橫山,招呼
2020-04-24,1204,85,77,162,橫山,招呼
2020-04-25,1204,49,55,104,橫山,招呼
2020-04-26,1204,44,63,107,橫山,招呼
2020-04-27,1204,74,82,156,橫山,招呼
2020-04-28,1204,72,83,155,橫山,招呼
2020-04-29,1204,63,74,137,橫山,招呼
2020-04-30,1204,67,78,145,橫山,招呼
2020-05-01,1204,102,102,204,橫山,招呼
2020-05-02,1204,71,86,157,橫山,招呼
2020-05-03,1204,52,73,125,橫山,招呼
2020-05-04,1204,77,90,167,橫山,招呼
2020-05-05,1204,74,71,145,橫山,招呼
2020-05-06,1204,82,76,158,橫山,招呼
2020-05-07,1204,69,76,145,橫山,招呼
2020-05-08,1204,118,98,216,橫山,招呼
2020-05-09,1204,69,84,153,橫山,招呼
2020-05-10,1204,83,96,179,橫山,招呼
2020-05-11,1204,73,82,155,橫山,招呼
2020-05-12,1204,77,79,156,橫山,招呼
2020-05-13,1204,74,60,134,橫山,招呼
2020-05-14,1204,73,78,151,橫山,招呼
2020-05-15,1204,115,98,213,橫山,招呼
2020-05-16,1204,53,53,106,橫山,招呼
2020-05-17,1204,59,78,137,橫山,招呼
2020-05-18,1204,81,72,153,橫山,招呼
2020-05-19,1204,65,64,129,橫山,招呼
2020-05-20,1204,67,72,139,橫山,招呼
2020-05-21,1204,78,79,157,橫山,招呼
2020-05-22,1204,94,69,163,橫山,招呼
2020-05-23,1204,54,65,119,橫山,招呼
2020-05-24,1204,90,80,170,橫山,招呼
2020-05-25,1204,80,87,167,橫山,招呼
2020-05-26,1204,80,81,161,橫山,招呼
2020-05-27,1204,79,78,157,橫山,招呼
2020-05-28,1204,64,66,130,橫山,招呼
2020-05-29,1204,126,86,212,橫山,招呼
2020-05-30,1204,83,123,206,橫山,招呼
2020-05-31,1204,99,99,198,橫山,招呼
2020-06-01,1204,74,79,153,橫山,招呼
2020-06-02,1204,67,72,139,橫山,招呼
2020-06-03,1204,80,71,151,橫山,招呼
2020-06-04,1204,87,84,171,橫山,招呼
2020-06-05,1204,100,99,199,橫山,招呼
2020-06-06,1204,85,81,166,橫山,招呼
2020-06-07,1204,74,90,164,橫山,招呼
2020-06-08,1204,88,81,169,橫山,招呼
2020-06-09,1204,77,76,153,橫山,招呼
2020-06-10,1204,76,81,157,橫山,招呼
2020-06-11,1204,91,86,177,橫山,招呼
2020-06-12,1204,122,102,224,橫山,招呼
2020-06-13,1204,113,117,230,橫山,招呼
2020-06-14,1204,99,103,202,橫山,招呼
2020-06-15,1204,93,95,188,橫山,招呼
2020-06-16,1204,97,82,179,橫山,招呼
2020-06-17,1204,89,92,181,橫山,招呼
2020-06-18,1204,81,76,157,橫山,招呼
2020-06-19,1204,123,109,232,橫山,招呼
2020-06-20,1204,89,85,174,橫山,招呼
2020-06-21,1204,69,78,147,橫山,招呼
2020-06-22,1204,85,80,165,橫山,招呼
2020-06-23,1204,104,99,203,橫山,招呼
2020-06-24,1204,87,93,180,橫山,招呼
2020-06-25,1204,92,91,183,橫山,招呼
2020-06-26,1204,128,142,270,橫山,招呼
2020-06-27,1204,98,89,187,橫山,招呼
2020-06-28,1204,65,78,143,橫山,招呼
2020-06-29,1204,86,86,172,橫山,招呼
2020-06-30,1204,69,62,131,橫山,招呼
2020-07-01,1204,97,88,185,橫山,招呼
2020-07-02,1204,115,110,225,橫山,招呼
2020-07-03,1204,78,93,171,橫山,招呼
2020-07-04,1204,106,99,205,橫山,招呼
2020-07-05,1204,86,88,174,橫山,招呼
2020-07-06,1204,66,78,144,橫山,招呼
2020-07-07,1204,77,62,139,橫山,招呼
2020-07-08,1204,69,76,145,橫山,招呼
2020-07-09,1204,87,102,189,橫山,招呼
2020-07-10,1204,70,86,156,橫山,招呼
2020-07-11,1204,103,116,219,橫山,招呼
2020-07-12,1204,82,82,164,橫山,招呼
2020-07-13,1204,79,82,161,橫山,招呼
2020-07-14,1204,80,99,179,橫山,招呼
2020-07-15,1204,85,84,169,橫山,招呼
2020-07-16,1204,79,89,168,橫山,招呼
2020-07-17,1204,85,84,169,橫山,招呼
2020-07-18,1204,108,95,203,橫山,招呼
2020-07-19,1204,81,74,155,橫山,招呼
2020-07-20,1204,77,76,153,橫山,招呼
2020-07-21,1204,72,79,151,橫山,招呼
2020-07-22,1204,72,69,141,橫山,招呼
2020-07-23,1204,79,73,152,橫山,招呼
2020-07-24,1204,70,72,142,橫山,招呼
2020-07-25,1204,65,64,129,橫山,招呼
2020-07-26,1204,93,103,196,橫山,招呼
2020-07-27,1204,67,65,132,橫山,招呼
2020-07-28,1204,65,70,135,橫山,招呼
2020-07-29,1204,71,69,140,橫山,招呼
2020-07-30,1204,78,75,153,橫山,招呼
2020-07-31,1204,90,89,179,橫山,招呼
2020-08-01,1204,100,93,193,橫山,招呼
2020-08-02,1204,66,70,136,橫山,招呼
2020-08-03,1204,69,87,156,橫山,招呼
2020-08-04,1204,80,81,161,橫山,招呼
2020-08-05,1204,88,85,173,橫山,招呼
2020-08-06,1204,75,80,155,橫山,招呼
2020-08-07,1204,89,89,178,橫山,招呼
2020-08-08,1204,65,80,145,橫山,招呼
2020-08-09,1204,74,56,130,橫山,招呼
2020-08-10,1204,70,66,136,橫山,招呼
2020-08-11,1204,83,81,164,橫山,招呼
2020-08-12,1204,67,66,133,橫山,招呼
2020-08-13,1204,98,80,178,橫山,招呼
2020-08-14,1204,80,80,160,橫山,招呼
2020-08-15,1204,83,87,170,橫山,招呼
2020-08-16,1204,83,79,162,橫山,招呼
2020-08-17,1204,75,97,172,橫山,招呼
2020-08-18,1204,78,74,152,橫山,招呼
2020-08-19,1204,91,105,196,橫山,招呼
2020-08-20,1204,83,78,161,橫山,招呼
2020-08-21,1204,118,104,222,橫山,招呼
2020-08-22,1204,67,64,131,橫山,招呼
2020-08-23,1204,68,79,147,橫山,招呼
2020-08-24,1204,60,60,120,橫山,招呼
2020-08-25,1204,82,74,156,橫山,招呼
2020-08-26,1204,67,62,129,橫山,招呼
2020-08-27,1204,75,71,146,橫山,招呼
2020-08-28,1204,82,85,167,橫山,招呼
2020-08-29,1204,71,56,127,橫山,招呼
2020-08-30,1204,64,60,124,橫山,招呼
2020-08-31,1204,72,78,150,橫山,招呼
2020-09-01,1204,73,72,145,橫山,招呼
2020-09-02,1204,69,68,137,橫山,招呼
2020-09-03,1204,83,71,154,橫山,招呼
2020-09-04,1204,72,82,154,橫山,招呼
2020-09-05,1204,92,88,180,橫山,招呼
2020-09-06,1204,100,95,195,橫山,招呼
2020-09-07,1204,68,75,143,橫山,招呼
2020-09-08,1204,76,60,136,橫山,招呼
2020-09-09,1204,74,85,159,橫山,招呼
2020-09-10,1204,71,73,144,橫山,招呼
2020-09-11,1204,88,76,164,橫山,招呼
2020-09-12,1204,95,77,172,橫山,招呼
2020-09-13,1204,107,97,204,橫山,招呼
2020-09-14,1204,81,77,158,橫山,招呼
2020-09-15,1204,81,92,173,橫山,招呼
2020-09-16,1204,92,79,171,橫山,招呼
2020-09-17,1204,78,78,156,橫山,招呼
2020-09-18,1204,92,102,194,橫山,招呼
2020-09-19,1204,103,113,216,橫山,招呼
2020-09-20,1204,77,83,160,橫山,招呼
2020-09-21,1204,83,90,173,橫山,招呼
2020-09-22,1204,87,91,178,橫山,招呼
2020-09-23,1204,80,74,154,橫山,招呼
2020-09-24,1204,89,79,168,橫山,招呼
2020-09-25,1204,91,82,173,橫山,招呼
2020-09-26,1204,95,108,203,橫山,招呼
2020-09-27,1204,53,68,121,橫山,招呼
2020-09-28,1204,92,73,165,橫山,招呼
2020-09-29,1204,93,91,184,橫山,招呼
2020-09-30,1204,114,105,219,橫山,招呼
2020-10-01,1204,94,97,191,橫山,招呼
2020-10-02,1204,157,139,296,橫山,招呼
2020-10-03,1204,118,123,241,橫山,招呼
2020-10-04,1204,109,101,210,橫山,招呼
2020-10-05,1204,91,95,186,橫山,招呼
2020-10-06,1204,85,87,172,橫山,招呼
2020-10-07,1204,77,71,148,橫山,招呼
2020-10-08,1204,109,92,201,橫山,招呼
2020-10-09,1204,206,108,314,橫山,招呼
2020-10-10,1204,131,118,249,橫山,招呼
2020-10-11,1204,88,104,192,橫山,招呼
2020-10-12,1204,80,89,169,橫山,招呼
2020-10-13,1204,80,87,167,橫山,招呼
2020-10-14,1204,78,89,167,橫山,招呼
2020-10-15,1204,82,86,168,橫山,招呼
2020-10-16,1204,97,84,181,橫山,招呼
2020-10-17,1204,110,110,220,橫山,招呼
2020-10-18,1204,98,89,187,橫山,招呼
2020-10-19,1204,87,94,181,橫山,招呼
2020-10-20,1204,89,86,175,橫山,招呼
2020-10-21,1204,83,81,164,橫山,招呼
2020-10-22,1204,76,82,158,橫山,招呼
2020-10-23,1204,100,76,176,橫山,招呼
2020-10-24,1204,104,114,218,橫山,招呼
2020-10-25,1204,132,128,260,橫山,招呼
2020-10-26,1204,95,95,190,橫山,招呼
2020-10-27,1204,90,81,171,橫山,招呼
2020-10-28,1204,80,80,160,橫山,招呼
2020-10-29,1204,79,79,158,橫山,招呼
2020-10-30,1204,105,92,197,橫山,招呼
2020-10-31,1204,90,84,174,橫山,招呼
2020-11-01,1204,105,109,214,橫山,招呼
2020-11-02,1204,85,87,172,橫山,招呼
2020-11-03,1204,85,78,163,橫山,招呼
2020-11-04,1204,92,77,169,橫山,招呼
2020-11-05,1204,82,72,154,橫山,招呼
2020-11-06,1204,95,92,187,橫山,招呼
2020-11-07,1204,91,110,201,橫山,招呼
2020-11-08,1204,87,110,197,橫山,招呼
2020-11-09,1204,83,84,167,橫山,招呼
2020-11-10,1204,79,78,157,橫山,招呼
2020-11-11,1204,91,78,169,橫山,招呼
2020-11-12,1204,79,89,168,橫山,招呼
2020-11-13,1204,110,93,203,橫山,招呼
2020-11-14,1204,92,104,196,橫山,招呼
2020-11-15,1204,128,143,271,橫山,招呼
2020-11-16,1204,76,93,169,橫山,招呼
2020-11-17,1204,84,85,169,橫山,招呼
2020-11-18,1204,89,86,175,橫山,招呼
2020-11-19,1204,72,72,144,橫山,招呼
2020-11-20,1204,99,101,200,橫山,招呼
2020-11-21,1204,112,116,228,橫山,招呼
2020-11-22,1204,81,129,210,橫山,招呼
2020-11-23,1204,98,106,204,橫山,招呼
2020-11-24,1204,90,89,179,橫山,招呼
2020-11-25,1204,83,95,178,橫山,招呼
2020-11-26,1204,94,146,240,橫山,招呼
2020-11-27,1204,89,70,159,橫山,招呼
2020-11-28,1204,81,83,164,橫山,招呼
2020-11-29,1204,103,111,214,橫山,招呼
2020-11-30,1204,97,107,204,橫山,招呼
2020-12-01,1204,69,78,147,橫山,招呼
2020-12-02,1204,87,78,165,橫山,招呼
2020-12-03,1204,71,82,153,橫山,招呼
2020-12-04,1204,99,95,194,橫山,招呼
2020-12-05,1204,83,79,162,橫山,招呼
2020-12-06,1204,88,100,188,橫山,招呼
2020-12-07,1204,98,99,197,橫山,招呼
2020-12-08,1204,92,74,166,橫山,招呼
2020-12-09,1204,67,76,143,橫山,招呼
2020-12-10,1204,84,81,165,橫山,招呼
2020-12-11,1204,88,84,172,橫山,招呼
2020-12-12,1204,78,95,173,橫山,招呼
2020-12-13,1204,104,96,200,橫山,招呼
2020-12-14,1204,88,99,187,橫山,招呼
2020-12-15,1204,87,80,167,橫山,招呼
2020-12-16,1204,75,68,143,橫山,招呼
2020-12-17,1204,72,82,154,橫山,招呼
2020-12-18,1204,90,86,176,橫山,招呼
2020-12-19,1204,89,100,189,橫山,招呼
2020-12-20,1204,104,111,215,橫山,招呼
2020-12-21,1204,79,82,161,橫山,招呼
2020-12-22,1204,89,76,165,橫山,招呼
2020-12-23,1204,75,66,141,橫山,招呼
2020-12-24,1204,125,104,229,橫山,招呼
2020-12-25,1204,101,89,190,橫山,招呼
2020-12-26,1204,65,86,151,橫山,招呼
2020-12-27,1204,80,96,176,橫山,招呼
2020-12-28,1204,71,73,144,橫山,招呼
2020-12-29,1204,80,70,150,橫山,招呼
2020-12-30,1204,79,75,154,橫山,招呼
2020-12-31,1204,119,98,217,橫山,招呼
2020-01-01,1205,56,93,149,九讚頭,乙簡
2020-01-02,1205,33,39,72,九讚頭,乙簡
2020-01-03,1205,43,48,91,九讚頭,乙簡
2020-01-04,1205,38,44,82,九讚頭,乙簡
2020-01-05,1205,40,40,80,九讚頭,乙簡
2020-01-06,1205,36,49,85,九讚頭,乙簡
2020-01-07,1205,37,46,83,九讚頭,乙簡
2020-01-08,1205,40,43,83,九讚頭,乙簡
2020-01-09,1205,44,54,98,九讚頭,乙簡
2020-01-10,1205,45,54,99,九讚頭,乙簡
2020-01-11,1205,49,57,106,九讚頭,乙簡
2020-01-12,1205,50,45,95,九讚頭,乙簡
2020-01-13,1205,38,52,90,九讚頭,乙簡
2020-01-14,1205,52,52,104,九讚頭,乙簡
2020-01-15,1205,53,60,113,九讚頭,乙簡
2020-01-16,1205,41,59,100,九讚頭,乙簡
2020-01-17,1205,56,47,103,九讚頭,乙簡
2020-01-18,1205,35,45,80,九讚頭,乙簡
2020-01-19,1205,54,50,104,九讚頭,乙簡
2020-01-20,1205,39,45,84,九讚頭,乙簡
2020-01-21,1205,57,49,106,九讚頭,乙簡
2020-01-22,1205,68,54,122,九讚頭,乙簡
2020-01-23,1205,50,47,97,九讚頭,乙簡
2020-01-24,1205,19,42,61,九讚頭,乙簡
2020-01-25,1205,68,77,145,九讚頭,乙簡
2020-01-26,1205,38,34,72,九讚頭,乙簡
2020-01-27,1205,37,50,87,九讚頭,乙簡
2020-01-28,1205,70,62,132,九讚頭,乙簡
2020-01-29,1205,38,52,90,九讚頭,乙簡
2020-01-30,1205,50,44,94,九讚頭,乙簡
2020-01-31,1205,50,66,116,九讚頭,乙簡
2020-02-01,1205,36,40,76,九讚頭,乙簡
2020-02-02,1205,39,29,68,九讚頭,乙簡
2020-02-03,1205,45,45,90,九讚頭,乙簡
2020-02-04,1205,34,38,72,九讚頭,乙簡
2020-02-05,1205,54,45,99,九讚頭,乙簡
2020-02-06,1205,44,44,88,九讚頭,乙簡
2020-02-07,1205,46,39,85,九讚頭,乙簡
2020-02-08,1205,33,21,54,九讚頭,乙簡
2020-02-09,1205,29,35,64,九讚頭,乙簡
2020-02-10,1205,37,31,68,九讚頭,乙簡
2020-02-11,1205,36,36,72,九讚頭,乙簡
2020-02-12,1205,49,51,100,九讚頭,乙簡
2020-02-13,1205,45,40,85,九讚頭,乙簡
2020-02-14,1205,44,49,93,九讚頭,乙簡
2020-02-15,1205,61,67,128,九讚頭,乙簡
2020-02-16,1205,26,21,47,九讚頭,乙簡
2020-02-17,1205,38,41,79,九讚頭,乙簡
2020-02-18,1205,32,34,66,九讚頭,乙簡
2020-02-19,1205,39,32,71,九讚頭,乙簡
2020-02-20,1205,46,50,96,九讚頭,乙簡
2020-02-21,1205,48,52,100,九讚頭,乙簡
2020-02-22,1205,41,41,82,九讚頭,乙簡
2020-02-23,1205,37,33,70,九讚頭,乙簡
2020-02-24,1205,31,41,72,九讚頭,乙簡
2020-02-25,1205,35,43,78,九讚頭,乙簡
2020-02-26,1205,46,45,91,九讚頭,乙簡
2020-02-27,1205,40,50,90,九讚頭,乙簡
2020-02-28,1205,49,71,120,九讚頭,乙簡
2020-02-29,1205,49,44,93,九讚頭,乙簡
2020-03-01,1205,42,29,71,九讚頭,乙簡
2020-03-02,1205,41,43,84,九讚頭,乙簡
2020-03-03,1205,43,40,83,九讚頭,乙簡
2020-03-04,1205,39,46,85,九讚頭,乙簡
2020-03-05,1205,35,38,73,九讚頭,乙簡
2020-03-06,1205,34,43,77,九讚頭,乙簡
2020-03-07,1205,42,42,84,九讚頭,乙簡
2020-03-08,1205,42,45,87,九讚頭,乙簡
2020-03-09,1205,33,51,84,九讚頭,乙簡
2020-03-10,1205,34,44,78,九讚頭,乙簡
2020-03-11,1205,40,48,88,九讚頭,乙簡
2020-03-12,1205,32,32,64,九讚頭,乙簡
2020-03-13,1205,39,47,86,九讚頭,乙簡
2020-03-14,1205,34,38,72,九讚頭,乙簡
2020-03-15,1205,51,38,89,九讚頭,乙簡
2020-03-16,1205,43,51,94,九讚頭,乙簡
2020-03-17,1205,36,37,73,九讚頭,乙簡
2020-03-18,1205,41,34,75,九讚頭,乙簡
2020-03-19,1205,34,32,66,九讚頭,乙簡
2020-03-20,1205,38,48,86,九讚頭,乙簡
2020-03-21,1205,36,29,65,九讚頭,乙簡
2020-03-22,1205,31,31,62,九讚頭,乙簡
2020-03-23,1205,36,41,77,九讚頭,乙簡
2020-03-24,1205,31,40,71,九讚頭,乙簡
2020-03-25,1205,34,38,72,九讚頭,乙簡
2020-03-26,1205,38,31,69,九讚頭,乙簡
2020-03-27,1205,34,41,75,九讚頭,乙簡
2020-03-28,1205,16,17,33,九讚頭,乙簡
2020-03-29,1205,34,27,61,九讚頭,乙簡
2020-03-30,1205,32,46,78,九讚頭,乙簡
2020-03-31,1205,39,44,83,九讚頭,乙簡
2020-04-01,1205,34,54,88,九讚頭,乙簡
2020-04-02,1205,30,39,69,九讚頭,乙簡
2020-04-03,1205,35,34,69,九讚頭,乙簡
2020-04-04,1205,25,25,50,九讚頭,乙簡
2020-04-05,1205,27,20,47,九讚頭,乙簡
2020-04-06,1205,43,41,84,九讚頭,乙簡
2020-04-07,1205,34,32,66,九讚頭,乙簡
2020-04-08,1205,37,39,76,九讚頭,乙簡
2020-04-09,1205,34,41,75,九讚頭,乙簡
2020-04-10,1205,35,47,82,九讚頭,乙簡
2020-04-11,1205,25,16,41,九讚頭,乙簡
2020-04-12,1205,32,27,59,九讚頭,乙簡
2020-04-13,1205,35,38,73,九讚頭,乙簡
2020-04-14,1205,38,33,71,九讚頭,乙簡
2020-04-15,1205,36,32,68,九讚頭,乙簡
2020-04-16,1205,40,36,76,九讚頭,乙簡
2020-04-17,1205,35,46,81,九讚頭,乙簡
2020-04-18,1205,44,53,97,九讚頭,乙簡
2020-04-19,1205,36,28,64,九讚頭,乙簡
2020-04-20,1205,34,40,74,九讚頭,乙簡
2020-04-21,1205,37,34,71,九讚頭,乙簡
2020-04-22,1205,33,34,67,九讚頭,乙簡
2020-04-23,1205,33,40,73,九讚頭,乙簡
2020-04-24,1205,44,47,91,九讚頭,乙簡
2020-04-25,1205,29,35,64,九讚頭,乙簡
2020-04-26,1205,28,29,57,九讚頭,乙簡
2020-04-27,1205,41,42,83,九讚頭,乙簡
2020-04-28,1205,34,36,70,九讚頭,乙簡
2020-04-29,1205,41,37,78,九讚頭,乙簡
2020-04-30,1205,41,38,79,九讚頭,乙簡
2020-05-01,1205,33,53,86,九讚頭,乙簡
2020-05-02,1205,40,38,78,九讚頭,乙簡
2020-05-03,1205,24,28,52,九讚頭,乙簡
2020-05-04,1205,44,39,83,九讚頭,乙簡
2020-05-05,1205,37,42,79,九讚頭,乙簡
2020-05-06,1205,39,33,72,九讚頭,乙簡
2020-05-07,1205,38,42,80,九讚頭,乙簡
2020-05-08,1205,37,44,81,九讚頭,乙簡
2020-05-09,1205,43,39,82,九讚頭,乙簡
2020-05-10,1205,24,29,53,九讚頭,乙簡
2020-05-11,1205,40,46,86,九讚頭,乙簡
2020-05-12,1205,41,38,79,九讚頭,乙簡
2020-05-13,1205,30,34,64,九讚頭,乙簡
2020-05-14,1205,44,27,71,九讚頭,乙簡
2020-05-15,1205,40,54,94,九讚頭,乙簡
2020-05-16,1205,50,59,109,九讚頭,乙簡
2020-05-17,1205,36,38,74,九讚頭,乙簡
2020-05-18,1205,32,34,66,九讚頭,乙簡
2020-05-19,1205,40,32,72,九讚頭,乙簡
2020-05-20,1205,41,36,77,九讚頭,乙簡
2020-05-21,1205,39,34,73,九讚頭,乙簡
2020-05-22,1205,46,45,91,九讚頭,乙簡
2020-05-23,1205,28,26,54,九讚頭,乙簡
2020-05-24,1205,57,38,95,九讚頭,乙簡
2020-05-25,1205,38,43,81,九讚頭,乙簡
2020-05-26,1205,38,43,81,九讚頭,乙簡
2020-05-27,1205,36,35,71,九讚頭,乙簡
2020-05-28,1205,37,47,84,九讚頭,乙簡
2020-05-29,1205,38,49,87,九讚頭,乙簡
2020-05-30,1205,63,60,123,九讚頭,乙簡
2020-05-31,1205,37,30,67,九讚頭,乙簡
2020-06-01,1205,43,44,87,九讚頭,乙簡
2020-06-02,1205,40,42,82,九讚頭,乙簡
2020-06-03,1205,36,33,69,九讚頭,乙簡
2020-06-04,1205,38,37,75,九讚頭,乙簡
2020-06-05,1205,48,49,97,九讚頭,乙簡
2020-06-06,1205,49,33,82,九讚頭,乙簡
2020-06-07,1205,38,31,69,九讚頭,乙簡
2020-06-08,1205,43,48,91,九讚頭,乙簡
2020-06-09,1205,47,46,93,九讚頭,乙簡
2020-06-10,1205,44,43,87,九讚頭,乙簡
2020-06-11,1205,54,50,104,九讚頭,乙簡
2020-06-12,1205,39,55,94,九讚頭,乙簡
2020-06-13,1205,49,40,89,九讚頭,乙簡
2020-06-14,1205,48,43,91,九讚頭,乙簡
2020-06-15,1205,40,39,79,九讚頭,乙簡
2020-06-16,1205,48,46,94,九讚頭,乙簡
2020-06-17,1205,38,45,83,九讚頭,乙簡
2020-06-18,1205,46,57,103,九讚頭,乙簡
2020-06-19,1205,44,44,88,九讚頭,乙簡
2020-06-20,1205,35,46,81,九讚頭,乙簡
2020-06-21,1205,57,52,109,九讚頭,乙簡
2020-06-22,1205,33,47,80,九讚頭,乙簡
2020-06-23,1205,56,42,98,九讚頭,乙簡
2020-06-24,1205,46,46,92,九讚頭,乙簡
2020-06-25,1205,57,76,133,九讚頭,乙簡
2020-06-26,1205,71,81,152,九讚頭,乙簡
2020-06-27,1205,50,58,108,九讚頭,乙簡
2020-06-28,1205,56,38,94,九讚頭,乙簡
2020-06-29,1205,50,43,93,九讚頭,乙簡
2020-06-30,1205,44,53,97,九讚頭,乙簡
2020-07-01,1205,38,48,86,九讚頭,乙簡
2020-07-02,1205,48,51,99,九讚頭,乙簡
2020-07-03,1205,54,49,103,九讚頭,乙簡
2020-07-04,1205,53,37,90,九讚頭,乙簡
2020-07-05,1205,46,45,91,九讚頭,乙簡
2020-07-06,1205,65,57,122,九讚頭,乙簡
2020-07-07,1205,41,40,81,九讚頭,乙簡
2020-07-08,1205,42,36,78,九讚頭,乙簡
2020-07-09,1205,42,41,83,九讚頭,乙簡
2020-07-10,1205,35,45,80,九讚頭,乙簡
2020-07-11,1205,56,68,124,九讚頭,乙簡
2020-07-12,1205,46,30,76,九讚頭,乙簡
2020-07-13,1205,43,37,80,九讚頭,乙簡
2020-07-14,1205,39,60,99,九讚頭,乙簡
2020-07-15,1205,49,64,113,九讚頭,乙簡
2020-07-16,1205,46,51,97,九讚頭,乙簡
2020-07-17,1205,35,40,75,九讚頭,乙簡
2020-07-18,1205,42,43,85,九讚頭,乙簡
2020-07-19,1205,44,49,93,九讚頭,乙簡
2020-07-20,1205,46,38,84,九讚頭,乙簡
2020-07-21,1205,47,44,91,九讚頭,乙簡
2020-07-22,1205,45,43,88,九讚頭,乙簡
2020-07-23,1205,56,42,98,九讚頭,乙簡
2020-07-24,1205,45,44,89,九讚頭,乙簡
2020-07-25,1205,52,44,96,九讚頭,乙簡
2020-07-26,1205,41,41,82,九讚頭,乙簡
2020-07-27,1205,39,34,73,九讚頭,乙簡
2020-07-28,1205,45,46,91,九讚頭,乙簡
2020-07-29,1205,50,41,91,九讚頭,乙簡
2020-07-30,1205,35,37,72,九讚頭,乙簡
2020-07-31,1205,53,54,107,九讚頭,乙簡
2020-08-01,1205,43,50,93,九讚頭,乙簡
2020-08-02,1205,43,43,86,九讚頭,乙簡
2020-08-03,1205,34,36,70,九讚頭,乙簡
2020-08-04,1205,48,50,98,九讚頭,乙簡
2020-08-05,1205,38,37,75,九讚頭,乙簡
2020-08-06,1205,34,36,70,九讚頭,乙簡
2020-08-07,1205,47,37,84,九讚頭,乙簡
2020-08-08,1205,33,46,79,九讚頭,乙簡
2020-08-09,1205,61,55,116,九讚頭,乙簡
2020-08-10,1205,49,37,86,九讚頭,乙簡
2020-08-11,1205,36,40,76,九讚頭,乙簡
2020-08-12,1205,45,43,88,九讚頭,乙簡
2020-08-13,1205,44,41,85,九讚頭,乙簡
2020-08-14,1205,33,49,82,九讚頭,乙簡
2020-08-15,1205,48,62,110,九讚頭,乙簡
2020-08-16,1205,51,39,90,九讚頭,乙簡
2020-08-17,1205,31,40,71,九讚頭,乙簡
2020-08-18,1205,53,43,96,九讚頭,乙簡
2020-08-19,1205,40,78,118,九讚頭,乙簡
2020-08-20,1205,38,44,82,九讚頭,乙簡
2020-08-21,1205,54,65,119,九讚頭,乙簡
2020-08-22,1205,44,57,101,九讚頭,乙簡
2020-08-23,1205,35,44,79,九讚頭,乙簡
2020-08-24,1205,54,57,111,九讚頭,乙簡
2020-08-25,1205,47,49,96,九讚頭,乙簡
2020-08-26,1205,48,54,102,九讚頭,乙簡
2020-08-27,1205,40,34,74,九讚頭,乙簡
2020-08-28,1205,46,54,100,九讚頭,乙簡
2020-08-29,1205,57,41,98,九讚頭,乙簡
2020-08-30,1205,53,50,103,九讚頭,乙簡
2020-08-31,1205,51,49,100,九讚頭,乙簡
2020-09-01,1205,42,41,83,九讚頭,乙簡
2020-09-02,1205,41,40,81,九讚頭,乙簡
2020-09-03,1205,41,39,80,九讚頭,乙簡
2020-09-04,1205,44,47,91,九讚頭,乙簡
2020-09-05,1205,57,74,131,九讚頭,乙簡
2020-09-06,1205,35,40,75,九讚頭,乙簡
2020-09-07,1205,42,41,83,九讚頭,乙簡
2020-09-08,1205,41,41,82,九讚頭,乙簡
2020-09-09,1205,43,39,82,九讚頭,乙簡
2020-09-10,1205,110,37,147,九讚頭,乙簡
2020-09-11,1205,50,46,96,九讚頭,乙簡
2020-09-12,1205,38,35,73,九讚頭,乙簡
2020-09-13,1205,60,52,112,九讚頭,乙簡
2020-09-14,1205,43,47,90,九讚頭,乙簡
2020-09-15,1205,35,34,69,九讚頭,乙簡
2020-09-16,1205,37,32,69,九讚頭,乙簡
2020-09-17,1205,37,34,71,九讚頭,乙簡
2020-09-18,1205,35,51,86,九讚頭,乙簡
2020-09-19,1205,39,49,88,九讚頭,乙簡
2020-09-20,1205,50,37,87,九讚頭,乙簡
2020-09-21,1205,40,35,75,九讚頭,乙簡
2020-09-22,1205,38,34,72,九讚頭,乙簡
2020-09-23,1205,45,33,78,九讚頭,乙簡
2020-09-24,1205,42,33,75,九讚頭,乙簡
2020-09-25,1205,50,41,91,九讚頭,乙簡
2020-09-26,1205,102,109,211,九讚頭,乙簡
2020-09-27,1205,39,31,70,九讚頭,乙簡
2020-09-28,1205,37,33,70,九讚頭,乙簡
2020-09-29,1205,48,39,87,九讚頭,乙簡
2020-09-30,1205,40,47,87,九讚頭,乙簡
2020-10-01,1205,33,62,95,九讚頭,乙簡
2020-10-02,1205,85,78,163,九讚頭,乙簡
2020-10-03,1205,96,91,187,九讚頭,乙簡
2020-10-04,1205,67,53,120,九讚頭,乙簡
2020-10-05,1205,39,35,74,九讚頭,乙簡
2020-10-06,1205,47,34,81,九讚頭,乙簡
2020-10-07,1205,38,37,75,九讚頭,乙簡
2020-10-08,1205,45,38,83,九讚頭,乙簡
2020-10-09,1205,51,58,109,九讚頭,乙簡
2020-10-10,1205,95,106,201,九讚頭,乙簡
2020-10-11,1205,47,41,88,九讚頭,乙簡
2020-10-12,1205,45,41,86,九讚頭,乙簡
2020-10-13,1205,41,39,80,九讚頭,乙簡
2020-10-14,1205,41,40,81,九讚頭,乙簡
2020-10-15,1205,44,32,76,九讚頭,乙簡
2020-10-16,1205,42,47,89,九讚頭,乙簡
2020-10-17,1205,45,54,99,九讚頭,乙簡
2020-10-18,1205,48,43,91,九讚頭,乙簡
2020-10-19,1205,36,31,67,九讚頭,乙簡
2020-10-20,1205,43,65,108,九讚頭,乙簡
2020-10-21,1205,43,40,83,九讚頭,乙簡
2020-10-22,1205,33,27,60,九讚頭,乙簡
2020-10-23,1205,37,55,92,九讚頭,乙簡
2020-10-24,1205,45,65,110,九讚頭,乙簡
2020-10-25,1205,51,50,101,九讚頭,乙簡
2020-10-26,1205,48,39,87,九讚頭,乙簡
2020-10-27,1205,46,43,89,九讚頭,乙簡
2020-10-28,1205,93,83,176,九讚頭,乙簡
2020-10-29,1205,37,34,71,九讚頭,乙簡
2020-10-30,1205,34,44,78,九讚頭,乙簡
2020-10-31,1205,67,73,140,九讚頭,乙簡
2020-11-01,1205,35,28,63,九讚頭,乙簡
2020-11-02,1205,36,35,71,九讚頭,乙簡
2020-11-03,1205,40,42,82,九讚頭,乙簡
2020-11-04,1205,41,30,71,九讚頭,乙簡
2020-11-05,1205,35,35,70,九讚頭,乙簡
2020-11-06,1205,40,42,82,九讚頭,乙簡
2020-11-07,1205,56,58,114,九讚頭,乙簡
2020-11-08,1205,47,44,91,九讚頭,乙簡
2020-11-09,1205,54,52,106,九讚頭,乙簡
2020-11-10,1205,52,51,103,九讚頭,乙簡
2020-11-11,1205,44,45,89,九讚頭,乙簡
2020-11-12,1205,45,40,85,九讚頭,乙簡
2020-11-13,1205,41,53,94,九讚頭,乙簡
2020-11-14,1205,48,49,97,九讚頭,乙簡
2020-11-15,1205,42,50,92,九讚頭,乙簡
2020-11-16,1205,40,47,87,九讚頭,乙簡
2020-11-17,1205,49,47,96,九讚頭,乙簡
2020-11-18,1205,47,41,88,九讚頭,乙簡
2020-11-19,1205,45,32,77,九讚頭,乙簡
2020-11-20,1205,35,41,76,九讚頭,乙簡
2020-11-21,1205,76,98,174,九讚頭,乙簡
2020-11-22,1205,59,40,99,九讚頭,乙簡
2020-11-23,1205,39,51,90,九讚頭,乙簡
2020-11-24,1205,45,45,90,九讚頭,乙簡
2020-11-25,1205,41,37,78,九讚頭,乙簡
2020-11-26,1205,47,42,89,九讚頭,乙簡
2020-11-27,1205,35,48,83,九讚頭,乙簡
2020-11-28,1205,43,60,103,九讚頭,乙簡
2020-11-29,1205,50,46,96,九讚頭,乙簡
2020-11-30,1205,39,36,75,九讚頭,乙簡
2020-12-01,1205,50,44,94,九讚頭,乙簡
2020-12-02,1205,41,29,70,九讚頭,乙簡
2020-12-03,1205,41,32,73,九讚頭,乙簡
2020-12-04,1205,40,42,82,九讚頭,乙簡
2020-12-05,1205,42,64,106,九讚頭,乙簡
2020-12-06,1205,44,44,88,九讚頭,乙簡
2020-12-07,1205,54,40,94,九讚頭,乙簡
2020-12-08,1205,41,32,73,九讚頭,乙簡
2020-12-09,1205,37,35,72,九讚頭,乙簡
2020-12-10,1205,48,38,86,九讚頭,乙簡
2020-12-11,1205,29,41,70,九讚頭,乙簡
2020-12-12,1205,54,58,112,九讚頭,乙簡
2020-12-13,1205,38,52,90,九讚頭,乙簡
2020-12-14,1205,46,42,88,九讚頭,乙簡
2020-12-15,1205,39,32,71,九讚頭,乙簡
2020-12-16,1205,32,32,64,九讚頭,乙簡
2020-12-17,1205,40,32,72,九讚頭,乙簡
2020-12-18,1205,41,55,96,九讚頭,乙簡
2020-12-19,1205,54,55,109,九讚頭,乙簡
2020-12-20,1205,46,54,100,九讚頭,乙簡
2020-12-21,1205,43,41,84,九讚頭,乙簡
2020-12-22,1205,42,39,81,九讚頭,乙簡
2020-12-23,1205,31,30,61,九讚頭,乙簡
2020-12-24,1205,65,83,148,九讚頭,乙簡
2020-12-25,1205,42,50,92,九讚頭,乙簡
2020-12-26,1205,71,72,143,九讚頭,乙簡
2020-12-27,1205,47,37,84,九讚頭,乙簡
2020-12-28,1205,37,50,87,九讚頭,乙簡
2020-12-29,1205,29,34,63,九讚頭,乙簡
2020-12-30,1205,34,31,65,九讚頭,乙簡
2020-12-31,1205,47,49,96,九讚頭,乙簡
2020-01-01,1206,144,203,347,合興,招呼
2020-01-02,1206,70,71,141,合興,招呼
2020-01-03,1206,37,31,68,合興,招呼
2020-01-04,1206,172,185,357,合興,招呼
2020-01-05,1206,89,265,354,合興,招呼
2020-01-06,1206,25,32,57,合興,招呼
2020-01-07,1206,28,28,56,合興,招呼
2020-01-08,1206,23,20,43,合興,招呼
2020-01-09,1206,32,24,56,合興,招呼
2020-01-10,1206,35,31,66,合興,招呼
2020-01-11,1206,107,134,241,合興,招呼
2020-01-12,1206,56,72,128,合興,招呼
2020-01-13,1206,31,28,59,合興,招呼
2020-01-14,1206,44,40,84,合興,招呼
2020-01-15,1206,50,53,103,合興,招呼
2020-01-16,1206,92,99,191,合興,招呼
2020-01-17,1206,66,68,134,合興,招呼
2020-01-18,1206,124,142,266,合興,招呼
2020-01-19,1206,65,95,160,合興,招呼
2020-01-20,1206,61,63,124,合興,招呼
2020-01-21,1206,34,131,165,合興,招呼
2020-01-22,1206,72,90,162,合興,招呼
2020-01-23,1206,49,74,123,合興,招呼
2020-01-24,1206,41,31,72,合興,招呼
2020-01-25,1206,210,259,469,合興,招呼
2020-01-26,1206,55,121,176,合興,招呼
2020-01-27,1206,265,327,592,合興,招呼
2020-01-28,1206,250,345,595,合興,招呼
2020-01-29,1206,175,217,392,合興,招呼
2020-01-30,1206,61,86,147,合興,招呼
2020-01-31,1206,72,106,178,合興,招呼
2020-02-01,1206,133,174,307,合興,招呼
2020-02-02,1206,155,213,368,合興,招呼
2020-02-03,1206,66,67,133,合興,招呼
2020-02-04,1206,26,65,91,合興,招呼
2020-02-05,1206,26,44,70,合興,招呼
2020-02-06,1206,52,89,141,合興,招呼
2020-02-07,1206,32,29,61,合興,招呼
2020-02-08,1206,100,122,222,合興,招呼
2020-02-09,1206,146,161,307,合興,招呼
2020-02-10,1206,49,44,93,合興,招呼
2020-02-11,1206,75,62,137,合興,招呼
2020-02-12,1206,85,91,176,合興,招呼
2020-02-13,1206,55,80,135,合興,招呼
2020-02-14,1206,96,104,200,合興,招呼
2020-02-15,1206,149,170,319,合興,招呼
2020-02-16,1206,31,35,66,合興,招呼
2020-02-17,1206,54,55,109,合興,招呼
2020-02-18,1206,48,56,104,合興,招呼
2020-02-19,1206,47,61,108,合興,招呼
2020-02-20,1206,53,82,135,合興,招呼
2020-02-21,1206,84,83,167,合興,招呼
2020-02-22,1206,144,168,312,合興,招呼
2020-02-23,1206,142,281,423,合興,招呼
2020-02-24,1206,53,66,119,合興,招呼
2020-02-25,1206,53,55,108,合興,招呼
2020-02-26,1206,52,51,103,合興,招呼
2020-02-27,1206,50,45,95,合興,招呼
2020-02-28,1206,169,238,407,合興,招呼
2020-02-29,1206,237,300,537,合興,招呼
2020-03-01,1206,137,161,298,合興,招呼
2020-03-02,1206,27,28,55,合興,招呼
2020-03-03,1206,23,25,48,合興,招呼
2020-03-04,1206,20,24,44,合興,招呼
2020-03-05,1206,18,15,33,合興,招呼
2020-03-06,1206,28,32,60,合興,招呼
2020-03-07,1206,153,178,331,合興,招呼
2020-03-08,1206,79,98,177,合興,招呼
2020-03-09,1206,35,33,68,合興,招呼
2020-03-10,1206,12,10,22,合興,招呼
2020-03-11,1206,36,32,68,合興,招呼
2020-03-12,1206,20,17,37,合興,招呼
2020-03-13,1206,29,29,58,合興,招呼
2020-03-14,1206,62,63,125,合興,招呼
2020-03-15,1206,126,170,296,合興,招呼
2020-03-16,1206,27,28,55,合興,招呼
2020-03-17,1206,12,21,33,合興,招呼
2020-03-18,1206,22,27,49,合興,招呼
2020-03-19,1206,20,19,39,合興,招呼
2020-03-20,1206,30,33,63,合興,招呼
2020-03-21,1206,82,94,176,合興,招呼
2020-03-22,1206,70,71,141,合興,招呼
2020-03-23,1206,15,22,37,合興,招呼
2020-03-24,1206,20,22,42,合興,招呼
2020-03-25,1206,27,27,54,合興,招呼
2020-03-26,1206,25,18,43,合興,招呼
2020-03-27,1206,17,17,34,合興,招呼
2020-03-28,1206,20,30,50,合興,招呼
2020-03-29,1206,68,89,157,合興,招呼
2020-03-30,1206,23,20,43,合興,招呼
2020-03-31,1206,33,63,96,合興,招呼
2020-04-01,1206,22,19,41,合興,招呼
2020-04-02,1206,49,59,108,合興,招呼
2020-04-03,1206,111,115,226,合興,招呼
2020-04-04,1206,83,99,182,合興,招呼
2020-04-05,1206,32,41,73,合興,招呼
2020-04-06,1206,21,17,38,合興,招呼
2020-04-07,1206,13,11,24,合興,招呼
2020-04-08,1206,17,14,31,合興,招呼
2020-04-09,1206,14,16,30,合興,招呼
2020-04-10,1206,19,24,43,合興,招呼
2020-04-11,1206,35,34,69,合興,招呼
2020-04-12,1206,21,29,50,合興,招呼
2020-04-13,1206,19,20,39,合興,招呼
2020-04-14,1206,16,16,32,合興,招呼
2020-04-15,1206,28,34,62,合興,招呼
2020-04-16,1206,19,20,39,合興,招呼
2020-04-17,1206,21,22,43,合興,招呼
2020-04-18,1206,89,105,194,合興,招呼
2020-04-19,1206,66,66,132,合興,招呼
2020-04-20,1206,22,21,43,合興,招呼
2020-04-21,1206,11,7,18,合興,招呼
2020-04-22,1206,13,14,27,合興,招呼
2020-04-23,1206,15,12,27,合興,招呼
2020-04-24,1206,15,20,35,合興,招呼
2020-04-25,1206,74,78,152,合興,招呼
2020-04-26,1206,58,67,125,合興,招呼
2020-04-27,1206,19,19,38,合興,招呼
2020-04-28,1206,21,17,38,合興,招呼
2020-04-29,1206,26,28,54,合興,招呼
2020-04-30,1206,33,36,69,合興,招呼
2020-05-01,1206,75,93,168,合興,招呼
2020-05-02,1206,132,159,291,合興,招呼
2020-05-03,1206,104,130,234,合興,招呼
2020-05-04,1206,37,35,72,合興,招呼
2020-05-05,1206,20,21,41,合興,招呼
2020-05-06,1206,18,14,32,合興,招呼
2020-05-07,1206,16,19,35,合興,招呼
2020-05-08,1206,21,26,47,合興,招呼
2020-05-09,1206,56,105,161,合興,招呼
2020-05-10,1206,74,95,169,合興,招呼
2020-05-11,1206,33,41,74,合興,招呼
2020-05-12,1206,22,34,56,合興,招呼
2020-05-13,1206,42,34,76,合興,招呼
2020-05-14,1206,39,35,74,合興,招呼
2020-05-15,1206,37,34,71,合興,招呼
2020-05-16,1206,85,109,194,合興,招呼
2020-05-17,1206,82,114,196,合興,招呼
2020-05-18,1206,17,15,32,合興,招呼
2020-05-19,1206,83,18,101,合興,招呼
2020-05-20,1206,23,22,45,合興,招呼
2020-05-21,1206,24,17,41,合興,招呼
2020-05-22,1206,12,30,42,合興,招呼
2020-05-23,1206,54,53,107,合興,招呼
2020-05-24,1206,131,176,307,合興,招呼
2020-05-25,1206,23,21,44,合興,招呼
2020-05-26,1206,23,18,41,合興,招呼
2020-05-27,1206,14,11,25,合興,招呼
2020-05-28,1206,12,11,23,合興,招呼
2020-05-29,1206,39,40,79,合興,招呼
2020-05-30,1206,163,175,338,合興,招呼
2020-05-31,1206,160,190,350,合興,招呼
2020-06-01,1206,14,20,34,合興,招呼
2020-06-02,1206,22,20,42,合興,招呼
2020-06-03,1206,29,30,59,合興,招呼
2020-06-04,1206,36,32,68,合興,招呼
2020-06-05,1206,25,35,60,合興,招呼
2020-06-06,1206,107,144,251,合興,招呼
2020-06-07,1206,104,145,249,合興,招呼
2020-06-08,1206,13,80,93,合興,招呼
2020-06-09,1206,23,64,87,合興,招呼
2020-06-10,1206,26,26,52,合興,招呼
2020-06-11,1206,30,36,66,合興,招呼
2020-06-12,1206,44,49,93,合興,招呼
2020-06-13,1206,112,146,258,合興,招呼
2020-06-14,1206,89,120,209,合興,招呼
2020-06-15,1206,23,23,46,合興,招呼
2020-06-16,1206,25,63,88,合興,招呼
2020-06-17,1206,19,24,43,合興,招呼
2020-06-18,1206,41,47,88,合興,招呼
2020-06-19,1206,19,19,38,合興,招呼
2020-06-20,1206,87,76,163,合興,招呼
2020-06-21,1206,105,106,211,合興,招呼
2020-06-22,1206,45,46,91,合興,招呼
2020-06-23,1206,10,15,25,合興,招呼
2020-06-24,1206,17,25,42,合興,招呼
2020-06-25,1206,120,141,261,合興,招呼
2020-06-26,1206,300,403,703,合興,招呼
2020-06-27,1206,298,313,611,合興,招呼
2020-06-28,1206,117,144,261,合興,招呼
2020-06-29,1206,29,38,67,合興,招呼
2020-06-30,1206,24,57,81,合興,招呼
2020-07-01,1206,36,38,74,合興,招呼
2020-07-02,1206,87,12,99,合興,招呼
2020-07-03,1206,27,32,59,合興,招呼
2020-07-04,1206,144,144,288,合興,招呼
2020-07-05,1206,109,148,257,合興,招呼
2020-07-06,1206,72,66,138,合興,招呼
2020-07-07,1206,46,42,88,合興,招呼
2020-07-08,1206,29,33,62,合興,招呼
2020-07-09,1206,24,34,58,合興,招呼
2020-07-10,1206,41,54,95,合興,招呼
2020-07-11,1206,198,227,425,合興,招呼
2020-07-12,1206,110,135,245,合興,招呼
2020-07-13,1206,31,47,78,合興,招呼
2020-07-14,1206,19,28,47,合興,招呼
2020-07-15,1206,41,130,171,合興,招呼
2020-07-16,1206,121,134,255,合興,招呼
2020-07-17,1206,66,110,176,合興,招呼
2020-07-18,1206,141,167,308,合興,招呼
2020-07-19,1206,146,148,294,合興,招呼
2020-07-20,1206,40,45,85,合興,招呼
2020-07-21,1206,27,40,67,合興,招呼
2020-07-22,1206,45,55,100,合興,招呼
2020-07-23,1206,96,52,148,合興,招呼
2020-07-24,1206,96,108,204,合興,招呼
2020-07-25,1206,131,143,274,合興,招呼
2020-07-26,1206,107,130,237,合興,招呼
2020-07-27,1206,57,49,106,合興,招呼
2020-07-28,1206,52,56,108,合興,招呼
2020-07-29,1206,152,72,224,合興,招呼
2020-07-30,1206,47,39,86,合興,招呼
2020-07-31,1206,99,190,289,合興,招呼
2020-08-01,1206,112,165,277,合興,招呼
2020-08-02,1206,124,129,253,合興,招呼
2020-08-03,1206,28,65,93,合興,招呼
2020-08-04,1206,54,25,79,合興,招呼
2020-08-05,1206,24,200,224,合興,招呼
2020-08-06,1206,39,42,81,合興,招呼
2020-08-07,1206,51,106,157,合興,招呼
2020-08-08,1206,173,238,411,合興,招呼
2020-08-09,1206,162,176,338,合興,招呼
2020-08-10,1206,42,24,66,合興,招呼
2020-08-11,1206,46,117,163,合興,招呼
2020-08-12,1206,26,92,118,合興,招呼
2020-08-13,1206,40,69,109,合興,招呼
2020-08-14,1206,152,240,392,合興,招呼
2020-08-15,1206,117,132,249,合興,招呼
2020-08-16,1206,138,175,313,合興,招呼
2020-08-17,1206,79,72,151,合興,招呼
2020-08-18,1206,55,54,109,合興,招呼
2020-08-19,1206,85,103,188,合興,招呼
2020-08-20,1206,69,75,144,合興,招呼
2020-08-21,1206,263,117,380,合興,招呼
2020-08-22,1206,117,183,300,合興,招呼
2020-08-23,1206,202,337,539,合興,招呼
2020-08-24,1206,71,70,141,合興,招呼
2020-08-25,1206,44,83,127,合興,招呼
2020-08-26,1206,40,54,94,合興,招呼
2020-08-27,1206,40,72,112,合興,招呼
2020-08-28,1206,104,43,147,合興,招呼
2020-08-29,1206,89,104,193,合興,招呼
2020-08-30,1206,157,179,336,合興,招呼
2020-08-31,1206,32,34,66,合興,招呼
2020-09-01,1206,15,18,33,合興,招呼
2020-09-02,1206,31,42,73,合興,招呼
2020-09-03,1206,17,21,38,合興,招呼
2020-09-04,1206,41,46,87,合興,招呼
2020-09-05,1206,162,205,367,合興,招呼
2020-09-06,1206,245,224,469,合興,招呼
2020-09-07,1206,34,30,64,合興,招呼
2020-09-08,1206,31,33,64,合興,招呼
2020-09-09,1206,43,26,69,合興,招呼
2020-09-10,1206,37,39,76,合興,招呼
2020-09-11,1206,73,37,110,合興,招呼
2020-09-12,1206,96,210,306,合興,招呼
2020-09-13,1206,135,152,287,合興,招呼
2020-09-14,1206,29,24,53,合興,招呼
2020-09-15,1206,22,34,56,合興,招呼
2020-09-16,1206,45,48,93,合興,招呼
2020-09-17,1206,26,31,57,合興,招呼
2020-09-18,1206,21,18,39,合興,招呼
2020-09-19,1206,117,111,228,合興,招呼
2020-09-20,1206,197,236,433,合興,招呼
2020-09-21,1206,28,33,61,合興,招呼
2020-09-22,1206,40,51,91,合興,招呼
2020-09-23,1206,26,32,58,合興,招呼
2020-09-24,1206,22,30,52,合興,招呼
2020-09-25,1206,29,29,58,合興,招呼
2020-09-26,1206,74,124,198,合興,招呼
2020-09-27,1206,57,79,136,合興,招呼
2020-09-28,1206,47,23,70,合興,招呼
2020-09-29,1206,18,21,39,合興,招呼
2020-09-30,1206,18,46,64,合興,招呼
2020-10-01,1206,144,172,316,合興,招呼
2020-10-02,1206,282,336,618,合興,招呼
2020-10-03,1206,208,271,479,合興,招呼
2020-10-04,1206,161,183,344,合興,招呼
2020-10-05,1206,38,46,84,合興,招呼
2020-10-06,1206,36,37,73,合興,招呼
2020-10-07,1206,34,232,266,合興,招呼
2020-10-08,1206,29,30,59,合興,招呼
2020-10-09,1206,236,295,531,合興,招呼
2020-10-10,1206,406,523,929,合興,招呼
2020-10-11,1206,158,276,434,合興,招呼
2020-10-12,1206,28,42,70,合興,招呼
2020-10-13,1206,51,48,99,合興,招呼
2020-10-14,1206,52,48,100,合興,招呼
2020-10-15,1206,49,42,91,合興,招呼
2020-10-16,1206,42,50,92,合興,招呼
2020-10-17,1206,238,299,537,合興,招呼
2020-10-18,1206,191,270,461,合興,招呼
2020-10-19,1206,89,50,139,合興,招呼
2020-10-20,1206,31,75,106,合興,招呼
2020-10-21,1206,49,35,84,合興,招呼
2020-10-22,1206,63,34,97,合興,招呼
2020-10-23,1206,31,26,57,合興,招呼
2020-10-24,1206,166,208,374,合興,招呼
2020-10-25,1206,188,224,412,合興,招呼
2020-10-26,1206,55,59,114,合興,招呼
2020-10-27,1206,42,50,92,合興,招呼
2020-10-28,1206,35,41,76,合興,招呼
2020-10-29,1206,36,32,68,合興,招呼
2020-10-30,1206,29,33,62,合興,招呼
2020-10-31,1206,131,185,316,合興,招呼
2020-11-01,1206,172,193,365,合興,招呼
2020-11-02,1206,49,32,81,合興,招呼
2020-11-03,1206,47,48,95,合興,招呼
2020-11-04,1206,42,47,89,合興,招呼
2020-11-05,1206,58,44,102,合興,招呼
2020-11-06,1206,60,40,100,合興,招呼
2020-11-07,1206,173,193,366,合興,招呼
2020-11-08,1206,186,167,353,合興,招呼
2020-11-09,1206,57,56,113,合興,招呼
2020-11-10,1206,32,28,60,合興,招呼
2020-11-11,1206,23,35,58,合興,招呼
2020-11-12,1206,36,39,75,合興,招呼
2020-11-13,1206,69,40,109,合興,招呼
2020-11-14,1206,123,183,306,合興,招呼
2020-11-15,1206,537,612,1149,合興,招呼
2020-11-16,1206,50,51,101,合興,招呼
2020-11-17,1206,23,15,38,合興,招呼
2020-11-18,1206,35,34,69,合興,招呼
2020-11-19,1206,32,41,73,合興,招呼
2020-11-20,1206,28,64,92,合興,招呼
2020-11-21,1206,200,203,403,合興,招呼
2020-11-22,1206,243,270,513,合興,招呼
2020-11-23,1206,70,99,169,合興,招呼
2020-11-24,1206,21,20,41,合興,招呼
2020-11-25,1206,48,60,108,合興,招呼
2020-11-26,1206,28,55,83,合興,招呼
2020-11-27,1206,67,43,110,合興,招呼
2020-11-28,1206,226,242,468,合興,招呼
2020-11-29,1206,209,262,471,合興,招呼
2020-11-30,1206,49,43,92,合興,招呼
2020-12-01,1206,28,32,60,合興,招呼
2020-12-02,1206,32,57,89,合興,招呼
2020-12-03,1206,35,39,74,合興,招呼
2020-12-04,1206,46,189,235,合興,招呼
2020-12-05,1206,124,171,295,合興,招呼
2020-12-06,1206,107,240,347,合興,招呼
2020-12-07,1206,39,62,101,合興,招呼
2020-12-08,1206,23,28,51,合興,招呼
2020-12-09,1206,34,57,91,合興,招呼
2020-12-10,1206,34,35,69,合興,招呼
2020-12-11,1206,78,50,128,合興,招呼
2020-12-12,1206,106,189,295,合興,招呼
2020-12-13,1206,187,246,433,合興,招呼
2020-12-14,1206,33,64,97,合興,招呼
2020-12-15,1206,25,47,72,合興,招呼
2020-12-16,1206,30,32,62,合興,招呼
2020-12-17,1206,69,71,140,合興,招呼
2020-12-18,1206,38,50,88,合興,招呼
2020-12-19,1206,91,109,200,合興,招呼
2020-12-20,1206,88,173,261,合興,招呼
2020-12-21,1206,29,109,138,合興,招呼
2020-12-22,1206,29,59,88,合興,招呼
2020-12-23,1206,10,96,106,合興,招呼
2020-12-24,1206,21,16,37,合興,招呼
2020-12-25,1206,120,169,289,合興,招呼
2020-12-26,1206,261,253,514,合興,招呼
2020-12-27,1206,89,120,209,合興,招呼
2020-12-28,1206,77,68,145,合興,招呼
2020-12-29,1206,30,46,76,合興,招呼
2020-12-30,1206,29,33,62,合興,招呼
2020-12-31,1206,58,57,115,合興,招呼
2020-01-01,1207,21,518,539,富貴,招呼
2020-01-02,1207,5,8,13,富貴,招呼
2020-01-03,1207,4,5,9,富貴,招呼
2020-01-04,1207,9,21,30,富貴,招呼
2020-01-05,1207,13,44,57,富貴,招呼
2020-01-06,1207,6,8,14,富貴,招呼
2020-01-07,1207,7,10,17,富貴,招呼
2020-01-08,1207,5,5,10,富貴,招呼
2020-01-09,1207,10,14,24,富貴,招呼
2020-01-10,1207,7,28,35,富貴,招呼
2020-01-11,1207,7,9,16,富貴,招呼
2020-01-12,1207,4,7,11,富貴,招呼
2020-01-13,1207,10,30,40,富貴,招呼
2020-01-14,1207,9,36,45,富貴,招呼
2020-01-15,1207,5,23,28,富貴,招呼
2020-01-16,1207,8,19,27,富貴,招呼
2020-01-17,1207,6,17,23,富貴,招呼
2020-01-18,1207,28,33,61,富貴,招呼
2020-01-19,1207,13,13,26,富貴,招呼
2020-01-20,1207,16,17,33,富貴,招呼
2020-01-21,1207,4,16,20,富貴,招呼
2020-01-22,1207,8,18,26,富貴,招呼
2020-01-23,1207,9,13,22,富貴,招呼
2020-01-24,1207,3,7,10,富貴,招呼
2020-01-25,1207,19,60,79,富貴,招呼
2020-01-26,1207,31,37,68,富貴,招呼
2020-01-27,1207,32,32,64,富貴,招呼
2020-01-28,1207,25,28,53,富貴,招呼
2020-01-29,1207,9,9,18,富貴,招呼
2020-01-30,1207,7,7,14,富貴,招呼
2020-01-31,1207,14,11,25,富貴,招呼
2020-02-01,1207,10,13,23,富貴,招呼
2020-02-02,1207,10,90,100,富貴,招呼
2020-02-03,1207,23,26,49,富貴,招呼
2020-02-04,1207,7,9,16,富貴,招呼
2020-02-05,1207,6,17,23,富貴,招呼
2020-02-06,1207,12,10,22,富貴,招呼
2020-02-07,1207,8,9,17,富貴,招呼
2020-02-08,1207,16,19,35,富貴,招呼
2020-02-09,1207,9,23,32,富貴,招呼
2020-02-10,1207,11,8,19,富貴,招呼
2020-02-11,1207,15,10,25,富貴,招呼
2020-02-12,1207,9,11,20,富貴,招呼
2020-02-13,1207,4,10,14,富貴,招呼
2020-02-14,1207,17,43,60,富貴,招呼
2020-02-15,1207,15,16,31,富貴,招呼
2020-02-16,1207,10,9,19,富貴,招呼
2020-02-17,1207,13,7,20,富貴,招呼
2020-02-18,1207,6,6,12,富貴,招呼
2020-02-19,1207,12,18,30,富貴,招呼
2020-02-20,1207,5,23,28,富貴,招呼
2020-02-21,1207,5,6,11,富貴,招呼
2020-02-22,1207,12,17,29,富貴,招呼
2020-02-23,1207,12,11,23,富貴,招呼
2020-02-24,1207,8,7,15,富貴,招呼
2020-02-25,1207,7,12,19,富貴,招呼
2020-02-26,1207,6,7,13,富貴,招呼
2020-02-27,1207,3,8,11,富貴,招呼
2020-02-28,1207,13,32,45,富貴,招呼
2020-02-29,1207,14,26,40,富貴,招呼
2020-03-01,1207,8,6,14,富貴,招呼
2020-03-02,1207,7,6,13,富貴,招呼
2020-03-03,1207,5,7,12,富貴,招呼
2020-03-04,1207,6,6,12,富貴,招呼
2020-03-05,1207,2,5,7,富貴,招呼
2020-03-06,1207,14,25,39,富貴,招呼
2020-03-07,1207,21,31,52,富貴,招呼
2020-03-08,1207,15,17,32,富貴,招呼
2020-03-09,1207,12,10,22,富貴,招呼
2020-03-10,1207,4,4,8,富貴,招呼
2020-03-11,1207,3,6,9,富貴,招呼
2020-03-12,1207,9,8,17,富貴,招呼
2020-03-13,1207,4,8,12,富貴,招呼
2020-03-14,1207,11,12,23,富貴,招呼
2020-03-15,1207,10,13,23,富貴,招呼
2020-03-16,1207,10,6,16,富貴,招呼
2020-03-17,1207,8,7,15,富貴,招呼
2020-03-18,1207,3,5,8,富貴,招呼
2020-03-19,1207,3,7,10,富貴,招呼
2020-03-20,1207,3,11,14,富貴,招呼
2020-03-21,1207,11,17,28,富貴,招呼
2020-03-22,1207,7,7,14,富貴,招呼
2020-03-23,1207,9,7,16,富貴,招呼
2020-03-24,1207,5,6,11,富貴,招呼
2020-03-25,1207,1,6,7,富貴,招呼
2020-03-26,1207,3,5,8,富貴,招呼
2020-03-27,1207,3,6,9,富貴,招呼
2020-03-28,1207,1,4,5,富貴,招呼
2020-03-29,1207,7,4,11,富貴,招呼
2020-03-30,1207,3,3,6,富貴,招呼
2020-03-31,1207,13,12,25,富貴,招呼
2020-04-01,1207,9,13,22,富貴,招呼
2020-04-02,1207,4,9,13,富貴,招呼
2020-04-03,1207,16,23,39,富貴,招呼
2020-04-04,1207,6,11,17,富貴,招呼
2020-04-05,1207,11,7,18,富貴,招呼
2020-04-06,1207,5,2,7,富貴,招呼
2020-04-07,1207,2,4,6,富貴,招呼
2020-04-08,1207,3,7,10,富貴,招呼
2020-04-09,1207,3,4,7,富貴,招呼
2020-04-10,1207,2,28,30,富貴,招呼
2020-04-11,1207,7,7,14,富貴,招呼
2020-04-12,1207,7,6,13,富貴,招呼
2020-04-13,1207,4,6,10,富貴,招呼
2020-04-14,1207,4,3,7,富貴,招呼
2020-04-15,1207,2,6,8,富貴,招呼
2020-04-16,1207,3,4,7,富貴,招呼
2020-04-17,1207,2,6,8,富貴,招呼
2020-04-18,1207,7,14,21,富貴,招呼
2020-04-19,1207,8,8,16,富貴,招呼
2020-04-20,1207,5,7,12,富貴,招呼
2020-04-21,1207,2,4,6,富貴,招呼
2020-04-22,1207,4,5,9,富貴,招呼
2020-04-23,1207,5,8,13,富貴,招呼
2020-04-24,1207,1,11,12,富貴,招呼
2020-04-25,1207,9,10,19,富貴,招呼
2020-04-26,1207,5,5,10,富貴,招呼
2020-04-27,1207,5,9,14,富貴,招呼
2020-04-28,1207,1,6,7,富貴,招呼
2020-04-29,1207,5,6,11,富貴,招呼
2020-04-30,1207,6,13,19,富貴,招呼
2020-05-01,1207,10,22,32,富貴,招呼
2020-05-02,1207,29,21,50,富貴,招呼
2020-05-03,1207,6,18,24,富貴,招呼
2020-05-04,1207,3,4,7,富貴,招呼
2020-05-05,1207,4,7,11,富貴,招呼
2020-05-06,1207,6,4,10,富貴,招呼
2020-05-07,1207,14,10,24,富貴,招呼
2020-05-08,1207,4,8,12,富貴,招呼
2020-05-09,1207,10,8,18,富貴,招呼
2020-05-10,1207,3,8,11,富貴,招呼
2020-05-11,1207,9,4,13,富貴,招呼
2020-05-12,1207,1,4,5,富貴,招呼
2020-05-13,1207,18,22,40,富貴,招呼
2020-05-14,1207,1,6,7,富貴,招呼
2020-05-15,1207,3,12,15,富貴,招呼
2020-05-16,1207,3,4,7,富貴,招呼
2020-05-17,1207,13,16,29,富貴,招呼
2020-05-18,1207,5,2,7,富貴,招呼
2020-05-19,1207,4,10,14,富貴,招呼
2020-05-20,1207,5,62,67,富貴,招呼
2020-05-21,1207,3,3,6,富貴,招呼
2020-05-22,1207,3,11,14,富貴,招呼
2020-05-23,1207,8,5,13,富貴,招呼
2020-05-24,1207,27,24,51,富貴,招呼
2020-05-25,1207,5,7,12,富貴,招呼
2020-05-26,1207,3,4,7,富貴,招呼
2020-05-27,1207,3,13,16,富貴,招呼
2020-05-28,1207,4,6,10,富貴,招呼
2020-05-29,1207,2,9,11,富貴,招呼
2020-05-30,1207,28,56,84,富貴,招呼
2020-05-31,1207,8,19,27,富貴,招呼
2020-06-01,1207,3,1,4,富貴,招呼
2020-06-02,1207,5,8,13,富貴,招呼
2020-06-03,1207,4,15,19,富貴,招呼
2020-06-04,1207,8,4,12,富貴,招呼
2020-06-05,1207,3,11,14,富貴,招呼
2020-06-06,1207,24,25,49,富貴,招呼
2020-06-07,1207,10,10,20,富貴,招呼
2020-06-08,1207,4,5,9,富貴,招呼
2020-06-09,1207,5,7,12,富貴,招呼
2020-06-10,1207,4,2,6,富貴,招呼
2020-06-11,1207,105,109,214,富貴,招呼
2020-06-12,1207,3,9,12,富貴,招呼
2020-06-13,1207,9,11,20,富貴,招呼
2020-06-14,1207,14,13,27,富貴,招呼
2020-06-15,1207,3,10,13,富貴,招呼
2020-06-16,1207,33,37,70,富貴,招呼
2020-06-17,1207,6,10,16,富貴,招呼
2020-06-18,1207,6,4,10,富貴,招呼
2020-06-19,1207,7,9,16,富貴,招呼
2020-06-20,1207,6,16,22,富貴,招呼
2020-06-21,1207,19,19,38,富貴,招呼
2020-06-22,1207,16,19,35,富貴,招呼
2020-06-23,1207,6,20,26,富貴,招呼
2020-06-24,1207,7,11,18,富貴,招呼
2020-06-25,1207,10,19,29,富貴,招呼
2020-06-26,1207,11,18,29,富貴,招呼
2020-06-27,1207,5,10,15,富貴,招呼
2020-06-28,1207,4,12,16,富貴,招呼
2020-06-29,1207,9,9,18,富貴,招呼
2020-06-30,1207,7,7,14,富貴,招呼
2020-07-01,1207,4,5,9,富貴,招呼
2020-07-02,1207,9,6,15,富貴,招呼
2020-07-03,1207,6,12,18,富貴,招呼
2020-07-04,1207,11,13,24,富貴,招呼
2020-07-05,1207,7,11,18,富貴,招呼
2020-07-06,1207,18,15,33,富貴,招呼
2020-07-07,1207,5,9,14,富貴,招呼
2020-07-08,1207,2,4,6,富貴,招呼
2020-07-09,1207,4,4,8,富貴,招呼
2020-07-10,1207,5,7,12,富貴,招呼
2020-07-11,1207,25,23,48,富貴,招呼
2020-07-12,1207,11,7,18,富貴,招呼
2020-07-13,1207,2,5,7,富貴,招呼
2020-07-14,1207,16,20,36,富貴,招呼
2020-07-15,1207,33,41,74,富貴,招呼
2020-07-16,1207,10,10,20,富貴,招呼
2020-07-17,1207,7,42,49,富貴,招呼
2020-07-18,1207,13,12,25,富貴,招呼
2020-07-19,1207,7,16,23,富貴,招呼
2020-07-20,1207,9,8,17,富貴,招呼
2020-07-21,1207,8,11,19,富貴,招呼
2020-07-22,1207,7,3,10,富貴,招呼
2020-07-23,1207,9,8,17,富貴,招呼
2020-07-24,1207,10,15,25,富貴,招呼
2020-07-25,1207,7,10,17,富貴,招呼
2020-07-26,1207,40,38,78,富貴,招呼
2020-07-27,1207,18,25,43,富貴,招呼
2020-07-28,1207,12,12,24,富貴,招呼
2020-07-29,1207,17,12,29,富貴,招呼
2020-07-30,1207,10,8,18,富貴,招呼
2020-07-31,1207,6,5,11,富貴,招呼
2020-08-01,1207,10,16,26,富貴,招呼
2020-08-02,1207,15,11,26,富貴,招呼
2020-08-03,1207,16,25,41,富貴,招呼
2020-08-04,1207,5,9,14,富貴,招呼
2020-08-05,1207,9,6,15,富貴,招呼
2020-08-06,1207,6,7,13,富貴,招呼
2020-08-07,1207,8,16,24,富貴,招呼
2020-08-08,1207,18,38,56,富貴,招呼
2020-08-09,1207,8,2,10,富貴,招呼
2020-08-10,1207,8,7,15,富貴,招呼
2020-08-11,1207,9,9,18,富貴,招呼
2020-08-12,1207,7,15,22,富貴,招呼
2020-08-13,1207,12,14,26,富貴,招呼
2020-08-14,1207,6,6,12,富貴,招呼
2020-08-15,1207,11,14,25,富貴,招呼
2020-08-16,1207,7,23,30,富貴,招呼
2020-08-17,1207,10,8,18,富貴,招呼
2020-08-18,1207,12,9,21,富貴,招呼
2020-08-19,1207,10,2,12,富貴,招呼
2020-08-20,1207,11,10,21,富貴,招呼
2020-08-21,1207,5,4,9,富貴,招呼
2020-08-22,1207,10,17,27,富貴,招呼
2020-08-23,1207,13,14,27,富貴,招呼
2020-08-24,1207,11,6,17,富貴,招呼
2020-08-25,1207,10,15,25,富貴,招呼
2020-08-26,1207,9,8,17,富貴,招呼
2020-08-27,1207,6,10,16,富貴,招呼
2020-08-28,1207,10,9,19,富貴,招呼
2020-08-29,1207,9,13,22,富貴,招呼
2020-08-30,1207,8,13,21,富貴,招呼
2020-08-31,1207,9,7,16,富貴,招呼
2020-09-01,1207,4,7,11,富貴,招呼
2020-09-02,1207,5,8,13,富貴,招呼
2020-09-03,1207,5,4,9,富貴,招呼
2020-09-04,1207,7,7,14,富貴,招呼
2020-09-05,1207,18,8,26,富貴,招呼
2020-09-06,1207,16,20,36,富貴,招呼
2020-09-07,1207,4,10,14,富貴,招呼
2020-09-08,1207,7,14,21,富貴,招呼
2020-09-09,1207,8,21,29,富貴,招呼
2020-09-10,1207,9,7,16,富貴,招呼
2020-09-11,1207,9,12,21,富貴,招呼
2020-09-12,1207,12,17,29,富貴,招呼
2020-09-13,1207,14,11,25,富貴,招呼
2020-09-14,1207,4,5,9,富貴,招呼
2020-09-15,1207,4,6,10,富貴,招呼
2020-09-16,1207,6,10,16,富貴,招呼
2020-09-17,1207,9,6,15,富貴,招呼
2020-09-18,1207,7,7,14,富貴,招呼
2020-09-19,1207,8,27,35,富貴,招呼
2020-09-20,1207,14,7,21,富貴,招呼
2020-09-21,1207,12,20,32,富貴,招呼
2020-09-22,1207,8,10,18,富貴,招呼
2020-09-23,1207,3,6,9,富貴,招呼
2020-09-24,1207,7,8,15,富貴,招呼
2020-09-25,1207,6,10,16,富貴,招呼
2020-09-26,1207,27,58,85,富貴,招呼
2020-09-27,1207,5,16,21,富貴,招呼
2020-09-28,1207,10,7,17,富貴,招呼
2020-09-29,1207,7,12,19,富貴,招呼
2020-09-30,1207,6,12,18,富貴,招呼
2020-10-01,1207,7,23,30,富貴,招呼
2020-10-02,1207,11,12,23,富貴,招呼
2020-10-03,1207,15,15,30,富貴,招呼
2020-10-04,1207,15,10,25,富貴,招呼
2020-10-05,1207,5,5,10,富貴,招呼
2020-10-06,1207,8,12,20,富貴,招呼
2020-10-07,1207,10,7,17,富貴,招呼
2020-10-08,1207,6,13,19,富貴,招呼
2020-10-09,1207,11,15,26,富貴,招呼
2020-10-10,1207,28,51,79,富貴,招呼
2020-10-11,1207,23,17,40,富貴,招呼
2020-10-12,1207,5,4,9,富貴,招呼
2020-10-13,1207,7,9,16,富貴,招呼
2020-10-14,1207,6,8,14,富貴,招呼
2020-10-15,1207,9,10,19,富貴,招呼
2020-10-16,1207,8,17,25,富貴,招呼
2020-10-17,1207,14,71,85,富貴,招呼
2020-10-18,1207,11,11,22,富貴,招呼
2020-10-19,1207,11,7,18,富貴,招呼
2020-10-20,1207,5,10,15,富貴,招呼
2020-10-21,1207,11,19,30,富貴,招呼
2020-10-22,1207,6,76,82,富貴,招呼
2020-10-23,1207,11,11,22,富貴,招呼
2020-10-24,1207,12,38,50,富貴,招呼
2020-10-25,1207,22,17,39,富貴,招呼
2020-10-26,1207,5,7,12,富貴,招呼
2020-10-27,1207,5,9,14,富貴,招呼
2020-10-28,1207,8,13,21,富貴,招呼
2020-10-29,1207,18,17,35,富貴,招呼
2020-10-30,1207,12,14,26,富貴,招呼
2020-10-31,1207,19,18,37,富貴,招呼
2020-11-01,1207,14,23,37,富貴,招呼
2020-11-02,1207,5,4,9,富貴,招呼
2020-11-03,1207,9,11,20,富貴,招呼
2020-11-04,1207,7,8,15,富貴,招呼
2020-11-05,1207,5,6,11,富貴,招呼
2020-11-06,1207,5,15,20,富貴,招呼
2020-11-07,1207,21,12,33,富貴,招呼
2020-11-08,1207,8,13,21,富貴,招呼
2020-11-09,1207,8,8,16,富貴,招呼
2020-11-10,1207,2,9,11,富貴,招呼
2020-11-11,1207,4,50,54,富貴,招呼
2020-11-12,1207,5,6,11,富貴,招呼
2020-11-13,1207,6,18,24,富貴,招呼
2020-11-14,1207,12,66,78,富貴,招呼
2020-11-15,1207,17,18,35,富貴,招呼
2020-11-16,1207,8,4,12,富貴,招呼
2020-11-17,1207,6,8,14,富貴,招呼
2020-11-18,1207,4,7,11,富貴,招呼
2020-11-19,1207,7,9,16,富貴,招呼
2020-11-20,1207,5,11,16,富貴,招呼
2020-11-21,1207,58,85,143,富貴,招呼
2020-11-22,1207,21,24,45,富貴,招呼
2020-11-23,1207,15,3,18,富貴,招呼
2020-11-24,1207,8,8,16,富貴,招呼
2020-11-25,1207,6,11,17,富貴,招呼
2020-11-26,1207,7,17,24,富貴,招呼
2020-11-27,1207,5,8,13,富貴,招呼
2020-11-28,1207,43,47,90,富貴,招呼
2020-11-29,1207,9,15,24,富貴,招呼
2020-11-30,1207,7,7,14,富貴,招呼
2020-12-01,1207,3,8,11,富貴,招呼
2020-12-02,1207,6,12,18,富貴,招呼
2020-12-03,1207,6,8,14,富貴,招呼
2020-12-04,1207,8,18,26,富貴,招呼
2020-12-05,1207,16,27,43,富貴,招呼
2020-12-06,1207,27,25,52,富貴,招呼
2020-12-07,1207,6,4,10,富貴,招呼
2020-12-08,1207,2,5,7,富貴,招呼
2020-12-09,1207,5,7,12,富貴,招呼
2020-12-10,1207,6,8,14,富貴,招呼
2020-12-11,1207,3,14,17,富貴,招呼
2020-12-12,1207,21,76,97,富貴,招呼
2020-12-13,1207,20,18,38,富貴,招呼
2020-12-14,1207,6,11,17,富貴,招呼
2020-12-15,1207,4,8,12,富貴,招呼
2020-12-16,1207,9,11,20,富貴,招呼
2020-12-17,1207,6,7,13,富貴,招呼
2020-12-18,1207,10,16,26,富貴,招呼
2020-12-19,1207,11,27,38,富貴,招呼
2020-12-20,1207,16,11,27,富貴,招呼
2020-12-21,1207,2,54,56,富貴,招呼
2020-12-22,1207,6,7,13,富貴,招呼
2020-12-23,1207,2,4,6,富貴,招呼
2020-12-24,1207,3,8,11,富貴,招呼
2020-12-25,1207,5,12,17,富貴,招呼
2020-12-26,1207,47,68,115,富貴,招呼
2020-12-27,1207,8,7,15,富貴,招呼
2020-12-28,1207,6,7,13,富貴,招呼
2020-12-29,1207,11,13,24,富貴,招呼
2020-12-30,1207,4,6,10,富貴,招呼
2020-12-31,1207,3,10,13,富貴,招呼
2020-01-01,1208,1294,1154,2448,內灣,乙簡
2020-01-02,1208,286,489,775,內灣,乙簡
2020-01-03,1208,248,323,571,內灣,乙簡
2020-01-04,1208,879,878,1757,內灣,乙簡
2020-01-05,1208,1051,468,1519,內灣,乙簡
2020-01-06,1208,193,115,308,內灣,乙簡
2020-01-07,1208,197,98,295,內灣,乙簡
2020-01-08,1208,254,233,487,內灣,乙簡
2020-01-09,1208,201,156,357,內灣,乙簡
2020-01-10,1208,221,240,461,內灣,乙簡
2020-01-11,1208,553,511,1064,內灣,乙簡
2020-01-12,1208,483,473,956,內灣,乙簡
2020-01-13,1208,206,225,431,內灣,乙簡
2020-01-14,1208,243,271,514,內灣,乙簡
2020-01-15,1208,225,218,443,內灣,乙簡
2020-01-16,1208,343,324,667,內灣,乙簡
2020-01-17,1208,290,311,601,內灣,乙簡
2020-01-18,1208,747,805,1552,內灣,乙簡
2020-01-19,1208,684,521,1205,內灣,乙簡
2020-01-20,1208,377,351,728,內灣,乙簡
2020-01-21,1208,448,552,1000,內灣,乙簡
2020-01-22,1208,597,395,992,內灣,乙簡
2020-01-23,1208,417,397,814,內灣,乙簡
2020-01-24,1208,205,258,463,內灣,乙簡
2020-01-25,1208,1218,1239,2457,內灣,乙簡
2020-01-26,1208,480,386,866,內灣,乙簡
2020-01-27,1208,1201,1095,2296,內灣,乙簡
2020-01-28,1208,1370,1269,2639,內灣,乙簡
2020-01-29,1208,803,767,1570,內灣,乙簡
2020-01-30,1208,528,495,1023,內灣,乙簡
2020-01-31,1208,549,295,844,內灣,乙簡
2020-02-01,1208,833,761,1594,內灣,乙簡
2020-02-02,1208,859,767,1626,內灣,乙簡
2020-02-03,1208,384,405,789,內灣,乙簡
2020-02-04,1208,298,229,527,內灣,乙簡
2020-02-05,1208,329,309,638,內灣,乙簡
2020-02-06,1208,387,400,787,內灣,乙簡
2020-02-07,1208,285,282,567,內灣,乙簡
2020-02-08,1208,555,555,1110,內灣,乙簡
2020-02-09,1208,629,595,1224,內灣,乙簡
2020-02-10,1208,265,289,554,內灣,乙簡
2020-02-11,1208,484,515,999,內灣,乙簡
2020-02-12,1208,459,465,924,內灣,乙簡
2020-02-13,1208,367,322,689,內灣,乙簡
2020-02-14,1208,397,397,794,內灣,乙簡
2020-02-15,1208,807,766,1573,內灣,乙簡
2020-02-16,1208,247,212,459,內灣,乙簡
2020-02-17,1208,290,294,584,內灣,乙簡
2020-02-18,1208,360,373,733,內灣,乙簡
2020-02-19,1208,368,366,734,內灣,乙簡
2020-02-20,1208,471,440,911,內灣,乙簡
2020-02-21,1208,379,397,776,內灣,乙簡
2020-02-22,1208,745,710,1455,內灣,乙簡
2020-02-23,1208,771,688,1459,內灣,乙簡
2020-02-24,1208,341,296,637,內灣,乙簡
2020-02-25,1208,237,217,454,內灣,乙簡
2020-02-26,1208,239,278,517,內灣,乙簡
2020-02-27,1208,246,268,514,內灣,乙簡
2020-02-28,1208,1031,1029,2060,內灣,乙簡
2020-02-29,1208,1135,1082,2217,內灣,乙簡
2020-03-01,1208,652,559,1211,內灣,乙簡
2020-03-02,1208,135,143,278,內灣,乙簡
2020-03-03,1208,151,144,295,內灣,乙簡
2020-03-04,1208,129,127,256,內灣,乙簡
2020-03-05,1208,94,104,198,內灣,乙簡
2020-03-06,1208,145,182,327,內灣,乙簡
2020-03-07,1208,710,711,1421,內灣,乙簡
2020-03-08,1208,645,575,1220,內灣,乙簡
2020-03-09,1208,167,133,300,內灣,乙簡
2020-03-10,1208,80,93,173,內灣,乙簡
2020-03-11,1208,157,172,329,內灣,乙簡
2020-03-12,1208,127,127,254,內灣,乙簡
2020-03-13,1208,127,157,284,內灣,乙簡
2020-03-14,1208,403,428,831,內灣,乙簡
2020-03-15,1208,689,630,1319,內灣,乙簡
2020-03-16,1208,148,136,284,內灣,乙簡
2020-03-17,1208,149,98,247,內灣,乙簡
2020-03-18,1208,139,129,268,內灣,乙簡
2020-03-19,1208,97,103,200,內灣,乙簡
2020-03-20,1208,142,168,310,內灣,乙簡
2020-03-21,1208,376,389,765,內灣,乙簡
2020-03-22,1208,481,425,906,內灣,乙簡
2020-03-23,1208,121,88,209,內灣,乙簡
2020-03-24,1208,116,106,222,內灣,乙簡
2020-03-25,1208,144,125,269,內灣,乙簡
2020-03-26,1208,133,140,273,內灣,乙簡
2020-03-27,1208,138,159,297,內灣,乙簡
2020-03-28,1208,182,206,388,內灣,乙簡
2020-03-29,1208,481,408,889,內灣,乙簡
2020-03-30,1208,134,104,238,內灣,乙簡
2020-03-31,1208,179,181,360,內灣,乙簡
2020-04-01,1208,149,132,281,內灣,乙簡
2020-04-02,1208,280,297,577,內灣,乙簡
2020-04-03,1208,459,475,934,內灣,乙簡
2020-04-04,1208,381,348,729,內灣,乙簡
2020-04-05,1208,347,275,622,內灣,乙簡
2020-04-06,1208,107,97,204,內灣,乙簡
2020-04-07,1208,93,95,188,內灣,乙簡
2020-04-08,1208,113,102,215,內灣,乙簡
2020-04-09,1208,101,99,200,內灣,乙簡
2020-04-10,1208,149,152,301,內灣,乙簡
2020-04-11,1208,195,252,447,內灣,乙簡
2020-04-12,1208,206,172,378,內灣,乙簡
2020-04-13,1208,141,128,269,內灣,乙簡
2020-04-14,1208,134,128,262,內灣,乙簡
2020-04-15,1208,126,110,236,內灣,乙簡
2020-04-16,1208,144,153,297,內灣,乙簡
2020-04-17,1208,142,166,308,內灣,乙簡
2020-04-18,1208,456,466,922,內灣,乙簡
2020-04-19,1208,422,388,810,內灣,乙簡
2020-04-20,1208,159,141,300,內灣,乙簡
2020-04-21,1208,91,105,196,內灣,乙簡
2020-04-22,1208,93,96,189,內灣,乙簡
2020-04-23,1208,114,98,212,內灣,乙簡
2020-04-24,1208,90,110,200,內灣,乙簡
2020-04-25,1208,385,443,828,內灣,乙簡
2020-04-26,1208,324,286,610,內灣,乙簡
2020-04-27,1208,102,87,189,內灣,乙簡
2020-04-28,1208,154,155,309,內灣,乙簡
2020-04-29,1208,160,152,312,內灣,乙簡
2020-04-30,1208,187,190,377,內灣,乙簡
2020-05-01,1208,445,504,949,內灣,乙簡
2020-05-02,1208,727,701,1428,內灣,乙簡
2020-05-03,1208,584,489,1073,內灣,乙簡
2020-05-04,1208,159,155,314,內灣,乙簡
2020-05-05,1208,138,124,262,內灣,乙簡
2020-05-06,1208,159,169,328,內灣,乙簡
2020-05-07,1208,139,131,270,內灣,乙簡
2020-05-08,1208,179,209,388,內灣,乙簡
2020-05-09,1208,464,443,907,內灣,乙簡
2020-05-10,1208,466,370,836,內灣,乙簡
2020-05-11,1208,136,120,256,內灣,乙簡
2020-05-12,1208,128,101,229,內灣,乙簡
2020-05-13,1208,184,169,353,內灣,乙簡
2020-05-14,1208,192,215,407,內灣,乙簡
2020-05-15,1208,251,251,502,內灣,乙簡
2020-05-16,1208,602,590,1192,內灣,乙簡
2020-05-17,1208,621,512,1133,內灣,乙簡
2020-05-18,1208,122,120,242,內灣,乙簡
2020-05-19,1208,122,181,303,內灣,乙簡
2020-05-20,1208,115,115,230,內灣,乙簡
2020-05-21,1208,103,112,215,內灣,乙簡
2020-05-22,1208,110,115,225,內灣,乙簡
2020-05-23,1208,265,233,498,內灣,乙簡
2020-05-24,1208,790,705,1495,內灣,乙簡
2020-05-25,1208,164,168,332,內灣,乙簡
2020-05-26,1208,141,138,279,內灣,乙簡
2020-05-27,1208,95,100,195,內灣,乙簡
2020-05-28,1208,77,85,162,內灣,乙簡
2020-05-29,1208,179,201,380,內灣,乙簡
2020-05-30,1208,886,916,1802,內灣,乙簡
2020-05-31,1208,945,861,1806,內灣,乙簡
2020-06-01,1208,169,149,318,內灣,乙簡
2020-06-02,1208,180,194,374,內灣,乙簡
2020-06-03,1208,200,191,391,內灣,乙簡
2020-06-04,1208,151,152,303,內灣,乙簡
2020-06-05,1208,298,255,553,內灣,乙簡
2020-06-06,1208,749,736,1485,內灣,乙簡
2020-06-07,1208,515,498,1013,內灣,乙簡
2020-06-08,1208,217,171,388,內灣,乙簡
2020-06-09,1208,196,171,367,內灣,乙簡
2020-06-10,1208,201,221,422,內灣,乙簡
2020-06-11,1208,373,371,744,內灣,乙簡
2020-06-12,1208,302,310,612,內灣,乙簡
2020-06-13,1208,782,840,1622,內灣,乙簡
2020-06-14,1208,849,704,1553,內灣,乙簡
2020-06-15,1208,189,253,442,內灣,乙簡
2020-06-16,1208,240,200,440,內灣,乙簡
2020-06-17,1208,276,245,521,內灣,乙簡
2020-06-18,1208,344,399,743,內灣,乙簡
2020-06-19,1208,369,355,724,內灣,乙簡
2020-06-20,1208,549,558,1107,內灣,乙簡
2020-06-21,1208,747,733,1480,內灣,乙簡
2020-06-22,1208,199,442,641,內灣,乙簡
2020-06-23,1208,191,321,512,內灣,乙簡
2020-06-24,1208,196,213,409,內灣,乙簡
2020-06-25,1208,790,785,1575,內灣,乙簡
2020-06-26,1208,1578,1422,3000,內灣,乙簡
2020-06-27,1208,1263,1229,2492,內灣,乙簡
2020-06-28,1208,828,731,1559,內灣,乙簡
2020-06-29,1208,224,232,456,內灣,乙簡
2020-06-30,1208,304,249,553,內灣,乙簡
2020-07-01,1208,225,174,399,內灣,乙簡
2020-07-02,1208,250,244,494,內灣,乙簡
2020-07-03,1208,278,345,623,內灣,乙簡
2020-07-04,1208,716,705,1421,內灣,乙簡
2020-07-05,1208,687,638,1325,內灣,乙簡
2020-07-06,1208,273,268,541,內灣,乙簡
2020-07-07,1208,299,283,582,內灣,乙簡
2020-07-08,1208,280,271,551,內灣,乙簡
2020-07-09,1208,272,257,529,內灣,乙簡
2020-07-10,1208,328,334,662,內灣,乙簡
2020-07-11,1208,946,1513,2459,內灣,乙簡
2020-07-12,1208,886,791,1677,內灣,乙簡
2020-07-13,1208,295,285,580,內灣,乙簡
2020-07-14,1208,315,364,679,內灣,乙簡
2020-07-15,1208,449,414,863,內灣,乙簡
2020-07-16,1208,576,433,1009,內灣,乙簡
2020-07-17,1208,465,403,868,內灣,乙簡
2020-07-18,1208,816,798,1614,內灣,乙簡
2020-07-19,1208,844,910,1754,內灣,乙簡
2020-07-20,1208,263,256,519,內灣,乙簡
2020-07-21,1208,301,269,570,內灣,乙簡
2020-07-22,1208,334,334,668,內灣,乙簡
2020-07-23,1208,263,303,566,內灣,乙簡
2020-07-24,1208,433,454,887,內灣,乙簡
2020-07-25,1208,706,708,1414,內灣,乙簡
2020-07-26,1208,800,730,1530,內灣,乙簡
2020-07-27,1208,437,356,793,內灣,乙簡
2020-07-28,1208,403,297,700,內灣,乙簡
2020-07-29,1208,361,445,806,內灣,乙簡
2020-07-30,1208,347,329,676,內灣,乙簡
2020-07-31,1208,584,544,1128,內灣,乙簡
2020-08-01,1208,884,865,1749,內灣,乙簡
2020-08-02,1208,859,744,1603,內灣,乙簡
2020-08-03,1208,267,234,501,內灣,乙簡
2020-08-04,1208,327,360,687,內灣,乙簡
2020-08-05,1208,322,233,555,內灣,乙簡
2020-08-06,1208,371,403,774,內灣,乙簡
2020-08-07,1208,415,364,779,內灣,乙簡
2020-08-08,1208,754,711,1465,內灣,乙簡
2020-08-09,1208,861,792,1653,內灣,乙簡
2020-08-10,1208,252,290,542,內灣,乙簡
2020-08-11,1208,304,235,539,內灣,乙簡
2020-08-12,1208,378,282,660,內灣,乙簡
2020-08-13,1208,301,295,596,內灣,乙簡
2020-08-14,1208,553,478,1031,內灣,乙簡
2020-08-15,1208,728,740,1468,內灣,乙簡
2020-08-16,1208,1006,818,1824,內灣,乙簡
2020-08-17,1208,365,410,775,內灣,乙簡
2020-08-18,1208,315,347,662,內灣,乙簡
2020-08-19,1208,418,393,811,內灣,乙簡
2020-08-20,1208,403,365,768,內灣,乙簡
2020-08-21,1208,410,560,970,內灣,乙簡
2020-08-22,1208,868,857,1725,內灣,乙簡
2020-08-23,1208,1051,904,1955,內灣,乙簡
2020-08-24,1208,365,433,798,內灣,乙簡
2020-08-25,1208,574,399,973,內灣,乙簡
2020-08-26,1208,468,400,868,內灣,乙簡
2020-08-27,1208,357,361,718,內灣,乙簡
2020-08-28,1208,337,358,695,內灣,乙簡
2020-08-29,1208,574,571,1145,內灣,乙簡
2020-08-30,1208,745,791,1536,內灣,乙簡
2020-08-31,1208,202,184,386,內灣,乙簡
2020-09-01,1208,168,137,305,內灣,乙簡
2020-09-02,1208,209,202,411,內灣,乙簡
2020-09-03,1208,175,205,380,內灣,乙簡
2020-09-04,1208,225,261,486,內灣,乙簡
2020-09-05,1208,837,827,1664,內灣,乙簡
2020-09-06,1208,1029,1044,2073,內灣,乙簡
2020-09-07,1208,235,212,447,內灣,乙簡
2020-09-08,1208,234,262,496,內灣,乙簡
2020-09-09,1208,190,215,405,內灣,乙簡
2020-09-10,1208,181,247,428,內灣,乙簡
2020-09-11,1208,274,337,611,內灣,乙簡
2020-09-12,1208,833,852,1685,內灣,乙簡
2020-09-13,1208,983,930,1913,內灣,乙簡
2020-09-14,1208,179,150,329,內灣,乙簡
2020-09-15,1208,179,151,330,內灣,乙簡
2020-09-16,1208,198,190,388,內灣,乙簡
2020-09-17,1208,167,171,338,內灣,乙簡
2020-09-18,1208,214,239,453,內灣,乙簡
2020-09-19,1208,664,674,1338,內灣,乙簡
2020-09-20,1208,785,745,1530,內灣,乙簡
2020-09-21,1208,203,171,374,內灣,乙簡
2020-09-22,1208,176,176,352,內灣,乙簡
2020-09-23,1208,213,230,443,內灣,乙簡
2020-09-24,1208,169,157,326,內灣,乙簡
2020-09-25,1208,179,186,365,內灣,乙簡
2020-09-26,1208,582,510,1092,內灣,乙簡
2020-09-27,1208,430,441,871,內灣,乙簡
2020-09-28,1208,143,250,393,內灣,乙簡
2020-09-29,1208,188,162,350,內灣,乙簡
2020-09-30,1208,137,90,227,內灣,乙簡
2020-10-01,1208,764,806,1570,內灣,乙簡
2020-10-02,1208,1427,1308,2735,內灣,乙簡
2020-10-03,1208,1335,1217,2552,內灣,乙簡
2020-10-04,1208,819,716,1535,內灣,乙簡
2020-10-05,1208,170,200,370,內灣,乙簡
2020-10-06,1208,195,200,395,內灣,乙簡
2020-10-07,1208,377,193,570,內灣,乙簡
2020-10-08,1208,209,260,469,內灣,乙簡
2020-10-09,1208,1326,1382,2708,內灣,乙簡
2020-10-10,1208,1809,1727,3536,內灣,乙簡
2020-10-11,1208,1114,866,1980,內灣,乙簡
2020-10-12,1208,163,141,304,內灣,乙簡
2020-10-13,1208,237,239,476,內灣,乙簡
2020-10-14,1208,224,230,454,內灣,乙簡
2020-10-15,1208,251,368,619,內灣,乙簡
2020-10-16,1208,250,331,581,內灣,乙簡
2020-10-17,1208,1110,1095,2205,內灣,乙簡
2020-10-18,1208,1190,1091,2281,內灣,乙簡
2020-10-19,1208,213,261,474,內灣,乙簡
2020-10-20,1208,307,302,609,內灣,乙簡
2020-10-21,1208,253,268,521,內灣,乙簡
2020-10-22,1208,179,291,470,內灣,乙簡
2020-10-23,1208,165,168,333,內灣,乙簡
2020-10-24,1208,848,953,1801,內灣,乙簡
2020-10-25,1208,863,824,1687,內灣,乙簡
2020-10-26,1208,240,221,461,內灣,乙簡
2020-10-27,1208,238,332,570,內灣,乙簡
2020-10-28,1208,269,278,547,內灣,乙簡
2020-10-29,1208,208,259,467,內灣,乙簡
2020-10-30,1208,237,309,546,內灣,乙簡
2020-10-31,1208,994,941,1935,內灣,乙簡
2020-11-01,1208,1116,1035,2151,內灣,乙簡
2020-11-02,1208,160,182,342,內灣,乙簡
2020-11-03,1208,165,152,317,內灣,乙簡
2020-11-04,1208,225,255,480,內灣,乙簡
2020-11-05,1208,197,241,438,內灣,乙簡
2020-11-06,1208,239,297,536,內灣,乙簡
2020-11-07,1208,895,928,1823,內灣,乙簡
2020-11-08,1208,1023,1057,2080,內灣,乙簡
2020-11-09,1208,203,199,402,內灣,乙簡
2020-11-10,1208,162,160,322,內灣,乙簡
2020-11-11,1208,227,201,428,內灣,乙簡
2020-11-12,1208,264,241,505,內灣,乙簡
2020-11-13,1208,229,288,517,內灣,乙簡
2020-11-14,1208,787,860,1647,內灣,乙簡
2020-11-15,1208,1203,1274,2477,內灣,乙簡
2020-11-16,1208,244,257,501,內灣,乙簡
2020-11-17,1208,221,198,419,內灣,乙簡
2020-11-18,1208,199,203,402,內灣,乙簡
2020-11-19,1208,271,239,510,內灣,乙簡
2020-11-20,1208,312,318,630,內灣,乙簡
2020-11-21,1208,1002,1019,2021,內灣,乙簡
2020-11-22,1208,1081,984,2065,內灣,乙簡
2020-11-23,1208,313,305,618,內灣,乙簡
2020-11-24,1208,219,203,422,內灣,乙簡
2020-11-25,1208,369,375,744,內灣,乙簡
2020-11-26,1208,278,287,565,內灣,乙簡
2020-11-27,1208,363,369,732,內灣,乙簡
2020-11-28,1208,1024,1008,2032,內灣,乙簡
2020-11-29,1208,1224,1075,2299,內灣,乙簡
2020-11-30,1208,237,217,454,內灣,乙簡
2020-12-01,1208,178,166,344,內灣,乙簡
2020-12-02,1208,182,185,367,內灣,乙簡
2020-12-03,1208,160,170,330,內灣,乙簡
2020-12-04,1208,183,212,395,內灣,乙簡
2020-12-05,1208,787,771,1558,內灣,乙簡
2020-12-06,1208,1112,1098,2210,內灣,乙簡
2020-12-07,1208,271,230,501,內灣,乙簡
2020-12-08,1208,175,177,352,內灣,乙簡
2020-12-09,1208,161,123,284,內灣,乙簡
2020-12-10,1208,136,148,284,內灣,乙簡
2020-12-11,1208,263,311,574,內灣,乙簡
2020-12-12,1208,845,786,1631,內灣,乙簡
2020-12-13,1208,990,917,1907,內灣,乙簡
2020-12-14,1208,237,178,415,內灣,乙簡
2020-12-15,1208,189,166,355,內灣,乙簡
2020-12-16,1208,206,235,441,內灣,乙簡
2020-12-17,1208,306,290,596,內灣,乙簡
2020-12-18,1208,241,264,505,內灣,乙簡
2020-12-19,1208,597,607,1204,內灣,乙簡
2020-12-20,1208,890,773,1663,內灣,乙簡
2020-12-21,1208,233,146,379,內灣,乙簡
2020-12-22,1208,238,231,469,內灣,乙簡
2020-12-23,1208,133,117,250,內灣,乙簡
2020-12-24,1208,151,205,356,內灣,乙簡
2020-12-25,1208,395,386,781,內灣,乙簡
2020-12-26,1208,960,961,1921,內灣,乙簡
2020-12-27,1208,759,654,1413,內灣,乙簡
2020-12-28,1208,214,209,423,內灣,乙簡
2020-12-29,1208,211,213,424,內灣,乙簡
2020-12-30,1208,152,146,298,內灣,乙簡
2020-12-31,1208,250,309,559,內灣,乙簡
2020-01-01,1210,25068,27375,52443,新竹,一等
2020-01-02,1210,17937,17365,35302,新竹,一等
2020-01-03,1210,21135,20077,41212,新竹,一等
2020-01-04,1210,22856,22559,45415,新竹,一等
2020-01-05,1210,23210,24728,47938,新竹,一等
2020-01-06,1210,17650,17720,35370,新竹,一等
2020-01-07,1210,16908,16893,33801,新竹,一等
2020-01-08,1210,17113,17069,34182,新竹,一等
2020-01-09,1210,18331,17879,36210,新竹,一等
2020-01-10,1210,27296,23998,51294,新竹,一等
2020-01-11,1210,24227,25212,49439,新竹,一等
2020-01-12,1210,23759,27309,51068,新竹,一等
2020-01-13,1210,18785,20288,39073,新竹,一等
2020-01-14,1210,17721,17679,35400,新竹,一等
2020-01-15,1210,18657,18440,37097,新竹,一等
2020-01-16,1210,21513,22040,43553,新竹,一等
2020-01-17,1210,23221,22352,45573,新竹,一等
2020-01-18,1210,23371,23858,47229,新竹,一等
2020-01-19,1210,22766,23748,46514,新竹,一等
2020-01-20,1210,20643,20763,41406,新竹,一等
2020-01-21,1210,22183,21592,43775,新竹,一等
2020-01-22,1210,23992,22395,46387,新竹,一等
2020-01-23,1210,20526,18998,39524,新竹,一等
2020-01-24,1210,15701,14527,30228,新竹,一等
2020-01-25,1210,19766,20982,40748,新竹,一等
2020-01-26,1210,17610,17721,35331,新竹,一等
2020-01-27,1210,21311,22558,43869,新竹,一等
2020-01-28,1210,21316,22861,44177,新竹,一等
2020-01-29,1210,18225,20177,38402,新竹,一等
2020-01-30,1210,16774,18603,35377,新竹,一等
2020-01-31,1210,18903,19033,37936,新竹,一等
2020-02-01,1210,17483,17713,35196,新竹,一等
2020-02-02,1210,17355,18897,36252,新竹,一等
2020-02-03,1210,16664,18329,34993,新竹,一等
2020-02-04,1210,14990,16406,31396,新竹,一等
2020-02-05,1210,17786,17314,35100,新竹,一等
2020-02-06,1210,18401,17948,36349,新竹,一等
2020-02-07,1210,19243,18774,38017,新竹,一等
2020-02-08,1210,18717,19123,37840,新竹,一等
2020-02-09,1210,19051,20850,39901,新竹,一等
2020-02-10,1210,16525,17460,33985,新竹,一等
2020-02-11,1210,16265,16631,32896,新竹,一等
2020-02-12,1210,17175,17676,34851,新竹,一等
2020-02-13,1210,15712,15895,31607,新竹,一等
2020-02-14,1210,19730,19512,39242,新竹,一等
2020-02-15,1210,19348,19105,38453,新竹,一等
2020-02-16,1210,15628,16964,32592,新竹,一等
2020-02-17,1210,14853,15642,30495,新竹,一等
2020-02-18,1210,14450,15151,29601,新竹,一等
2020-02-19,1210,15619,16048,31667,新竹,一等
2020-02-20,1210,15837,16194,32031,新竹,一等
2020-02-21,1210,18815,18244,37059,新竹,一等
2020-02-22,1210,17985,18022,36007,新竹,一等
2020-02-23,1210,18331,19675,38006,新竹,一等
2020-02-24,1210,15600,16499,32099,新竹,一等
2020-02-25,1210,15604,15182,30786,新竹,一等
2020-02-26,1210,16077,15405,31482,新竹,一等
2020-02-27,1210,21033,19176,40209,新竹,一等
2020-02-28,1210,20443,19320,39763,新竹,一等
2020-02-29,1210,17079,17501,34580,新竹,一等
2020-03-01,1210,17818,20136,37954,新竹,一等
2020-03-02,1210,15075,15302,30377,新竹,一等
2020-03-03,1210,13716,13457,27173,新竹,一等
2020-03-04,1210,13594,13337,26931,新竹,一等
2020-03-05,1210,13616,13253,26869,新竹,一等
2020-03-06,1210,20111,18740,38851,新竹,一等
2020-03-07,1210,18154,18141,36295,新竹,一等
2020-03-08,1210,18157,19546,37703,新竹,一等
2020-03-09,1210,15277,15382,30659,新竹,一等
2020-03-10,1210,12860,12518,25378,新竹,一等
2020-03-11,1210,14801,14543,29344,新竹,一等
2020-03-12,1210,14230,13814,28044,新竹,一等
2020-03-13,1210,19780,18339,38119,新竹,一等
2020-03-14,1210,17353,17158,34511,新竹,一等
2020-03-15,1210,18815,20388,39203,新竹,一等
2020-03-16,1210,15165,14994,30159,新竹,一等
2020-03-17,1210,13819,13506,27325,新竹,一等
2020-03-18,1210,13499,13237,26736,新竹,一等
2020-03-19,1210,12783,12487,25270,新竹,一等
2020-03-20,1210,18809,17264,36073,新竹,一等
2020-03-21,1210,14612,14350,28962,新竹,一等
2020-03-22,1210,14277,15898,30175,新竹,一等
2020-03-23,1210,13502,13533,27035,新竹,一等
2020-03-24,1210,12374,11967,24341,新竹,一等
2020-03-25,1210,12371,12132,24503,新竹,一等
2020-03-26,1210,12748,12058,24806,新竹,一等
2020-03-27,1210,16696,15745,32441,新竹,一等
2020-03-28,1210,11457,11446,22903,新竹,一等
2020-03-29,1210,12490,13907,26397,新竹,一等
2020-03-30,1210,12826,12950,25776,新竹,一等
2020-03-31,1210,12719,12527,25246,新竹,一等
2020-04-01,1210,18359,16311,34670,新竹,一等
2020-04-02,1210,14153,12620,26773,新竹,一等
2020-04-03,1210,12641,12226,24867,新竹,一等
2020-04-04,1210,10179,11141,21320,新竹,一等
2020-04-05,1210,13242,15449,28691,新竹,一等
2020-04-06,1210,13140,13942,27082,新竹,一等
2020-04-07,1210,11473,11251,22724,新竹,一等
2020-04-08,1210,11657,11497,23154,新竹,一等
2020-04-09,1210,11866,11372,23238,新竹,一等
2020-04-10,1210,16141,15203,31344,新竹,一等
2020-04-11,1210,12083,11760,23843,新竹,一等
2020-04-12,1210,12090,13086,25176,新竹,一等
2020-04-13,1210,12817,12730,25547,新竹,一等
2020-04-14,1210,11857,11781,23638,新竹,一等
2020-04-15,1210,12562,12275,24837,新竹,一等
2020-04-16,1210,12702,12339,25041,新竹,一等
2020-04-17,1210,17697,16458,34155,新竹,一等
2020-04-18,1210,14523,14359,28882,新竹,一等
2020-04-19,1210,14435,15593,30028,新竹,一等
2020-04-20,1210,13112,12995,26107,新竹,一等
2020-04-21,1210,11509,11316,22825,新竹,一等
2020-04-22,1210,11606,11324,22930,新竹,一等
2020-04-23,1210,11655,11185,22840,新竹,一等
2020-04-24,1210,16115,14922,31037,新竹,一等
2020-04-25,1210,12365,12173,24538,新竹,一等
2020-04-26,1210,12065,13283,25348,新竹,一等
2020-04-27,1210,12792,12708,25500,新竹,一等
2020-04-28,1210,12019,11884,23903,新竹,一等
2020-04-29,1210,12280,12112,24392,新竹,一等
2020-04-30,1210,15274,14433,29707,新竹,一等
2020-05-01,1210,18337,17276,35613,新竹,一等
2020-05-02,1210,13906,13942,27848,新竹,一等
2020-05-03,1210,14981,16870,31851,新竹,一等
2020-05-04,1210,13662,13814,27476,新竹,一等
2020-05-05,1210,13008,12975,25983,新竹,一等
2020-05-06,1210,13327,13013,26340,新竹,一等
2020-05-07,1210,13691,13353,27044,新竹,一等
2020-05-08,1210,20715,19316,40031,新竹,一等
2020-05-09,1210,17170,16390,33560,新竹,一等
2020-05-10,1210,17150,19467,36617,新竹,一等
2020-05-11,1210,14824,15160,29984,新竹,一等
2020-05-12,1210,12981,12818,25799,新竹,一等
2020-05-13,1210,13835,13655,27490,新竹,一等
2020-05-14,1210,13974,13550,27524,新竹,一等
2020-05-15,1210,20628,19748,40376,新竹,一等
2020-05-16,1210,16104,16402,32506,新竹,一等
2020-05-17,1210,16895,18022,34917,新竹,一等
2020-05-18,1210,13729,13697,27426,新竹,一等
2020-05-19,1210,11938,11863,23801,新竹,一等
2020-05-20,1210,13440,13786,27226,新竹,一等
2020-05-21,1210,13106,12949,26055,新竹,一等
2020-05-22,1210,16472,15911,32383,新竹,一等
2020-05-23,1210,14277,14060,28337,新竹,一等
2020-05-24,1210,17984,19198,37182,新竹,一等
2020-05-25,1210,14888,14657,29545,新竹,一等
2020-05-26,1210,13168,13028,26196,新竹,一等
2020-05-27,1210,12702,12422,25124,新竹,一等
2020-05-28,1210,12904,12475,25379,新竹,一等
2020-05-29,1210,19490,18351,37841,新竹,一等
2020-05-30,1210,18968,19220,38188,新竹,一等
2020-05-31,1210,18933,20367,39300,新竹,一等
2020-06-01,1210,15009,14946,29955,新竹,一等
2020-06-02,1210,13763,13689,27452,新竹,一等
2020-06-03,1210,14226,14032,28258,新竹,一等
2020-06-04,1210,14416,13794,28210,新竹,一等
2020-06-05,1210,20466,19150,39616,新竹,一等
2020-06-06,1210,19704,19806,39510,新竹,一等
2020-06-07,1210,18536,20121,38657,新竹,一等
2020-06-08,1210,14693,14922,29615,新竹,一等
2020-06-09,1210,14243,14165,28408,新竹,一等
2020-06-10,1210,15192,15012,30204,新竹,一等
2020-06-11,1210,15771,15538,31309,新竹,一等
2020-06-12,1210,20838,19929,40767,新竹,一等
2020-06-13,1210,21660,21467,43127,新竹,一等
2020-06-14,1210,20897,22434,43331,新竹,一等
2020-06-15,1210,17404,16994,34398,新竹,一等
2020-06-16,1210,15773,15400,31173,新竹,一等
2020-06-17,1210,15305,15202,30507,新竹,一等
2020-06-18,1210,15446,15294,30740,新竹,一等
2020-06-19,1210,18003,17257,35260,新竹,一等
2020-06-20,1210,18911,18587,37498,新竹,一等
2020-06-21,1210,19186,20414,39600,新竹,一等
2020-06-22,1210,16013,15894,31907,新竹,一等
2020-06-23,1210,15876,16185,32061,新竹,一等
2020-06-24,1210,22133,20988,43121,新竹,一等
2020-06-25,1210,20940,19860,40800,新竹,一等
2020-06-26,1210,21743,21871,43614,新竹,一等
2020-06-27,1210,20900,22159,43059,新竹,一等
2020-06-28,1210,20774,23071,43845,新竹,一等
2020-06-29,1210,17131,17884,35015,新竹,一等
2020-06-30,1210,15693,15873,31566,新竹,一等
2020-07-01,1210,15113,14984,30097,新竹,一等
2020-07-02,1210,15450,15329,30779,新竹,一等
2020-07-03,1210,19084,18964,38048,新竹,一等
2020-07-04,1210,20432,19892,40324,新竹,一等
2020-07-05,1210,19706,21049,40755,新竹,一等
2020-07-06,1210,16938,17117,34055,新竹,一等
2020-07-07,1210,16265,16352,32617,新竹,一等
2020-07-08,1210,16403,16582,32985,新竹,一等
2020-07-09,1210,16785,16716,33501,新竹,一等
2020-07-10,1210,21806,21214,43020,新竹,一等
2020-07-11,1210,22090,21533,43623,新竹,一等
2020-07-12,1210,20672,22411,43083,新竹,一等
2020-07-13,1210,18162,18081,36243,新竹,一等
2020-07-14,1210,19036,19452,38488,新竹,一等
2020-07-15,1210,18360,18065,36425,新竹,一等
2020-07-16,1210,18326,18276,36602,新竹,一等
2020-07-17,1210,21855,21124,42979,新竹,一等
2020-07-18,1210,22178,21706,43884,新竹,一等
2020-07-19,1210,21135,22670,43805,新竹,一等
2020-07-20,1210,17795,18472,36267,新竹,一等
2020-07-21,1210,16788,17417,34205,新竹,一等
2020-07-22,1210,17521,17758,35279,新竹,一等
2020-07-23,1210,17546,18068,35614,新竹,一等
2020-07-24,1210,21622,20654,42276,新竹,一等
2020-07-25,1210,21153,21394,42547,新竹,一等
2020-07-26,1210,20284,21914,42198,新竹,一等
2020-07-27,1210,17368,18101,35469,新竹,一等
2020-07-28,1210,16407,16580,32987,新竹,一等
2020-07-29,1210,16657,16811,33468,新竹,一等
2020-07-30,1210,17185,17432,34617,新竹,一等
2020-07-31,1210,21728,20875,42603,新竹,一等
2020-08-01,1210,21171,20844,42015,新竹,一等
2020-08-02,1210,18721,20839,39560,新竹,一等
2020-08-03,1210,16008,16331,32339,新竹,一等
2020-08-04,1210,15870,16266,32136,新竹,一等
2020-08-05,1210,16774,17060,33834,新竹,一等
2020-08-06,1210,18240,17667,35907,新竹,一等
2020-08-07,1210,23041,21388,44429,新竹,一等
2020-08-08,1210,20149,19784,39933,新竹,一等
2020-08-09,1210,21502,24316,45818,新竹,一等
2020-08-10,1210,17712,18510,36222,新竹,一等
2020-08-11,1210,15962,16427,32389,新竹,一等
2020-08-12,1210,17254,17478,34732,新竹,一等
2020-08-13,1210,18186,18064,36250,新竹,一等
2020-08-14,1210,22746,22044,44790,新竹,一等
2020-08-15,1210,22895,23128,46023,新竹,一等
2020-08-16,1210,22910,24319,47229,新竹,一等
2020-08-17,1210,18848,19282,38130,新竹,一等
2020-08-18,1210,18343,18372,36715,新竹,一等
2020-08-19,1210,17970,18138,36108,新竹,一等
2020-08-20,1210,18157,18268,36425,新竹,一等
2020-08-21,1210,23162,21828,44990,新竹,一等
2020-08-22,1210,21365,21055,42420,新竹,一等
2020-08-23,1210,20162,22052,42214,新竹,一等
2020-08-24,1210,17931,18778,36709,新竹,一等
2020-08-25,1210,17916,18170,36086,新竹,一等
2020-08-26,1210,17497,17820,35317,新竹,一等
2020-08-27,1210,17341,17748,35089,新竹,一等
2020-08-28,1210,20863,19945,40808,新竹,一等
2020-08-29,1210,19848,19563,39411,新竹,一等
2020-08-30,1210,19390,21228,40618,新竹,一等
2020-08-31,1210,16329,16277,32606,新竹,一等
2020-09-01,1210,15050,14838,29888,新竹,一等
2020-09-02,1210,15536,15135,30671,新竹,一等
2020-09-03,1210,16142,15795,31937,新竹,一等
2020-09-04,1210,21074,19857,40931,新竹,一等
2020-09-05,1210,21267,21473,42740,新竹,一等
2020-09-06,1210,20723,22614,43337,新竹,一等
2020-09-07,1210,17272,17577,34849,新竹,一等
2020-09-08,1210,15870,15778,31648,新竹,一等
2020-09-09,1210,16249,16314,32563,新竹,一等
2020-09-10,1210,16956,16586,33542,新竹,一等
2020-09-11,1210,21501,20615,42116,新竹,一等
2020-09-12,1210,22387,22208,44595,新竹,一等
2020-09-13,1210,22798,24308,47106,新竹,一等
2020-09-14,1210,16405,16366,32771,新竹,一等
2020-09-15,1210,15017,15808,30825,新竹,一等
2020-09-16,1210,15333,14961,30294,新竹,一等
2020-09-17,1210,15506,15201,30707,新竹,一等
2020-09-18,1210,21939,20458,42397,新竹,一等
2020-09-19,1210,22840,21991,44831,新竹,一等
2020-09-20,1210,21622,23155,44777,新竹,一等
2020-09-21,1210,16212,16621,32833,新竹,一等
2020-09-22,1210,14913,14792,29705,新竹,一等
2020-09-23,1210,15496,15269,30765,新竹,一等
2020-09-24,1210,15301,14873,30174,新竹,一等
2020-09-25,1210,19480,17814,37294,新竹,一等
2020-09-26,1210,19124,18874,37998,新竹,一等
2020-09-27,1210,17840,19111,36951,新竹,一等
2020-09-28,1210,15036,15398,30434,新竹,一等
2020-09-29,1210,15663,15353,31016,新竹,一等
2020-09-30,1210,24336,22476,46812,新竹,一等
2020-10-01,1210,24282,22984,47266,新竹,一等
2020-10-02,1210,24917,24918,49835,新竹,一等
2020-10-03,1210,24298,25687,49985,新竹,一等
2020-10-04,1210,24245,27239,51484,新竹,一等
2020-10-05,1210,17214,18105,35319,新竹,一等
2020-10-06,1210,16032,15989,32021,新竹,一等
2020-10-07,1210,16807,16737,33544,新竹,一等
2020-10-08,1210,23528,22724,46252,新竹,一等
2020-10-09,1210,29998,29885,59883,新竹,一等
2020-10-10,1210,28627,29197,57824,新竹,一等
2020-10-11,1210,27750,29880,57630,新竹,一等
2020-10-12,1210,16762,17073,33835,新竹,一等
2020-10-13,1210,15556,15281,30837,新竹,一等
2020-10-14,1210,16156,16027,32183,新竹,一等
2020-10-15,1210,16955,16672,33627,新竹,一等
2020-10-16,1210,22258,20954,43212,新竹,一等
2020-10-17,1210,24886,24928,49814,新竹,一等
2020-10-18,1210,24047,25670,49717,新竹,一等
2020-10-19,1210,16650,16981,33631,新竹,一等
2020-10-20,1210,15976,15934,31910,新竹,一等
2020-10-21,1210,15995,15892,31887,新竹,一等
2020-10-22,1210,15545,15275,30820,新竹,一等
2020-10-23,1210,21616,20216,41832,新竹,一等
2020-10-24,1210,23665,22683,46348,新竹,一等
2020-10-25,1210,22375,24435,46810,新竹,一等
2020-10-26,1210,16336,16663,32999,新竹,一等
2020-10-27,1210,14994,15054,30048,新竹,一等
2020-10-28,1210,15265,15146,30411,新竹,一等
2020-10-29,1210,15478,15120,30598,新竹,一等
2020-10-30,1210,22207,21049,43256,新竹,一等
2020-10-31,1210,23755,23704,47459,新竹,一等
2020-11-01,1210,22291,24317,46608,新竹,一等
2020-11-02,1210,16008,16468,32476,新竹,一等
2020-11-03,1210,14856,14649,29505,新竹,一等
2020-11-04,1210,15464,15300,30764,新竹,一等
2020-11-05,1210,16236,16043,32279,新竹,一等
2020-11-06,1210,22978,21237,44215,新竹,一等
2020-11-07,1210,23759,23177,46936,新竹,一等
2020-11-08,1210,22442,24891,47333,新竹,一等
2020-11-09,1210,17185,17549,34734,新竹,一等
2020-11-10,1210,15649,15434,31083,新竹,一等
2020-11-11,1210,16609,16454,33063,新竹,一等
2020-11-12,1210,16555,16582,33137,新竹,一等
2020-11-13,1210,23088,22228,45316,新竹,一等
2020-11-14,1210,24907,24247,49154,新竹,一等
2020-11-15,1210,25563,27138,52701,新竹,一等
2020-11-16,1210,17722,18278,36000,新竹,一等
2020-11-17,1210,15773,15710,31483,新竹,一等
2020-11-18,1210,16167,15893,32060,新竹,一等
2020-11-19,1210,16638,16136,32774,新竹,一等
2020-11-20,1210,23182,21997,45179,新竹,一等
2020-11-21,1210,23540,23139,46679,新竹,一等
2020-11-22,1210,23066,25124,48190,新竹,一等
2020-11-23,1210,16923,17502,34425,新竹,一等
2020-11-24,1210,15995,15530,31525,新竹,一等
2020-11-25,1210,15813,15827,31640,新竹,一等
2020-11-26,1210,17552,17560,35112,新竹,一等
2020-11-27,1210,23497,22057,45554,新竹,一等
2020-11-28,1210,24345,24079,48424,新竹,一等
2020-11-29,1210,23182,25718,48900,新竹,一等
2020-11-30,1210,17152,17911,35063,新竹,一等
2020-12-01,1210,15690,15507,31197,新竹,一等
2020-12-02,1210,16069,15909,31978,新竹,一等
2020-12-03,1210,16070,15896,31966,新竹,一等
2020-12-04,1210,24091,23109,47200,新竹,一等
2020-12-05,1210,27387,26133,53520,新竹,一等
2020-12-06,1210,26427,28478,54905,新竹,一等
2020-12-07,1210,17375,18252,35627,新竹,一等
2020-12-08,1210,15019,15385,30404,新竹,一等
2020-12-09,1210,14432,14655,29087,新竹,一等
2020-12-10,1210,15676,15616,31292,新竹,一等
2020-12-11,1210,22946,21744,44690,新竹,一等
2020-12-12,1210,25772,25329,51101,新竹,一等
2020-12-13,1210,24961,27098,52059,新竹,一等
2020-12-14,1210,17151,17427,34578,新竹,一等
2020-12-15,1210,15183,15071,30254,新竹,一等
2020-12-16,1210,15830,15728,31558,新竹,一等
2020-12-17,1210,16708,16385,33093,新竹,一等
2020-12-18,1210,23347,21753,45100,新竹,一等
2020-12-19,1210,23962,23207,47169,新竹,一等
2020-12-20,1210,23574,25561,49135,新竹,一等
2020-12-21,1210,16547,16896,33443,新竹,一等
2020-12-22,1210,15765,15825,31590,新竹,一等
2020-12-23,1210,14930,14691,29621,新竹,一等
2020-12-24,1210,16283,16073,32356,新竹,一等
2020-12-25,1210,24108,22766,46874,新竹,一等
2020-12-26,1210,22426,22419,44845,新竹,一等
2020-12-27,1210,21655,23254,44909,新竹,一等
2020-12-28,1210,16288,16685,32973,新竹,一等
2020-12-29,1210,16042,15882,31924,新竹,一等
2020-12-30,1210,16143,15467,31610,新竹,一等
2020-12-31,1210,25107,22835,47942,新竹,一等
2020-01-01,1220,929,1041,1970,三姓橋,簡易
2020-01-02,1220,1251,1204,2455,三姓橋,簡易
2020-01-03,1220,1588,1130,2718,三姓橋,簡易
2020-01-04,1220,1392,1086,2478,三姓橋,簡易
2020-01-05,1220,919,1048,1967,三姓橋,簡易
2020-01-06,1220,1191,1222,2413,三姓橋,簡易
2020-01-07,1220,1217,1017,2234,三姓橋,簡易
2020-01-08,1220,1237,1102,2339,三姓橋,簡易
2020-01-09,1220,1385,1109,2494,三姓橋,簡易
2020-01-10,1220,1703,1287,2990,三姓橋,簡易
2020-01-11,1220,1086,925,2011,三姓橋,簡易
2020-01-12,1220,947,1037,1984,三姓橋,簡易
2020-01-13,1220,1163,1064,2227,三姓橋,簡易
2020-01-14,1220,1155,1036,2191,三姓橋,簡易
2020-01-15,1220,1092,994,2086,三姓橋,簡易
2020-01-16,1220,1467,1144,2611,三姓橋,簡易
2020-01-17,1220,969,945,1914,三姓橋,簡易
2020-01-18,1220,768,759,1527,三姓橋,簡易
2020-01-19,1220,784,809,1593,三姓橋,簡易
2020-01-20,1220,882,896,1778,三姓橋,簡易
2020-01-21,1220,884,832,1716,三姓橋,簡易
2020-01-22,1220,955,920,1875,三姓橋,簡易
2020-01-23,1220,785,648,1433,三姓橋,簡易
2020-01-24,1220,648,541,1189,三姓橋,簡易
2020-01-25,1220,641,541,1182,三姓橋,簡易
2020-01-26,1220,512,519,1031,三姓橋,簡易
2020-01-27,1220,646,678,1324,三姓橋,簡易
2020-01-28,1220,694,727,1421,三姓橋,簡易
2020-01-29,1220,626,700,1326,三姓橋,簡易
2020-01-30,1220,713,669,1382,三姓橋,簡易
2020-01-31,1220,930,810,1740,三姓橋,簡易
2020-02-01,1220,635,647,1282,三姓橋,簡易
2020-02-02,1220,725,706,1431,三姓橋,簡易
2020-02-03,1220,708,679,1387,三姓橋,簡易
2020-02-04,1220,625,622,1247,三姓橋,簡易
2020-02-05,1220,721,669,1390,三姓橋,簡易
2020-02-06,1220,710,637,1347,三姓橋,簡易
2020-02-07,1220,775,708,1483,三姓橋,簡易
2020-02-08,1220,670,657,1327,三姓橋,簡易
2020-02-09,1220,743,778,1521,三姓橋,簡易
2020-02-10,1220,726,666,1392,三姓橋,簡易
2020-02-11,1220,712,662,1374,三姓橋,簡易
2020-02-12,1220,722,715,1437,三姓橋,簡易
2020-02-13,1220,679,631,1310,三姓橋,簡易
2020-02-14,1220,807,718,1525,三姓橋,簡易
2020-02-15,1220,758,688,1446,三姓橋,簡易
2020-02-16,1220,536,649,1185,三姓橋,簡易
2020-02-17,1220,720,686,1406,三姓橋,簡易
2020-02-18,1220,667,623,1290,三姓橋,簡易
2020-02-19,1220,701,676,1377,三姓橋,簡易
2020-02-20,1220,731,696,1427,三姓橋,簡易
2020-02-21,1220,850,769,1619,三姓橋,簡易
2020-02-22,1220,742,687,1429,三姓橋,簡易
2020-02-23,1220,743,801,1544,三姓橋,簡易
2020-02-24,1220,775,843,1618,三姓橋,簡易
2020-02-25,1220,1128,1072,2200,三姓橋,簡易
2020-02-26,1220,1129,1028,2157,三姓橋,簡易
2020-02-27,1220,1726,1133,2859,三姓橋,簡易
2020-02-28,1220,913,675,1588,三姓橋,簡易
2020-02-29,1220,640,628,1268,三姓橋,簡易
2020-03-01,1220,788,1012,1800,三姓橋,簡易
2020-03-02,1220,1177,1138,2315,三姓橋,簡易
2020-03-03,1220,1113,1002,2115,三姓橋,簡易
2020-03-04,1220,1150,996,2146,三姓橋,簡易
2020-03-05,1220,1261,1038,2299,三姓橋,簡易
2020-03-06,1220,1637,1183,2820,三姓橋,簡易
2020-03-07,1220,902,741,1643,三姓橋,簡易
2020-03-08,1220,774,1026,1800,三姓橋,簡易
2020-03-09,1220,1213,1131,2344,三姓橋,簡易
2020-03-10,1220,1032,922,1954,三姓橋,簡易
2020-03-11,1220,1188,1061,2249,三姓橋,簡易
2020-03-12,1220,1254,1022,2276,三姓橋,簡易
2020-03-13,1220,1712,1129,2841,三姓橋,簡易
2020-03-14,1220,824,699,1523,三姓橋,簡易
2020-03-15,1220,784,1120,1904,三姓橋,簡易
2020-03-16,1220,1169,1108,2277,三姓橋,簡易
2020-03-17,1220,1159,1017,2176,三姓橋,簡易
2020-03-18,1220,1142,1047,2189,三姓橋,簡易
2020-03-19,1220,1283,993,2276,三姓橋,簡易
2020-03-20,1220,1652,1164,2816,三姓橋,簡易
2020-03-21,1220,809,704,1513,三姓橋,簡易
2020-03-22,1220,757,943,1700,三姓橋,簡易
2020-03-23,1220,1121,1049,2170,三姓橋,簡易
2020-03-24,1220,1081,947,2028,三姓橋,簡易
2020-03-25,1220,1125,960,2085,三姓橋,簡易
2020-03-26,1220,1146,933,2079,三姓橋,簡易
2020-03-27,1220,1540,1039,2579,三姓橋,簡易
2020-03-28,1220,561,486,1047,三姓橋,簡易
2020-03-29,1220,587,853,1440,三姓橋,簡易
2020-03-30,1220,1062,1056,2118,三姓橋,簡易
2020-03-31,1220,1079,980,2059,三姓橋,簡易
2020-04-01,1220,1712,1109,2821,三姓橋,簡易
2020-04-02,1220,815,548,1363,三姓橋,簡易
2020-04-03,1220,570,496,1066,三姓橋,簡易
2020-04-04,1220,459,460,919,三姓橋,簡易
2020-04-05,1220,608,951,1559,三姓橋,簡易
2020-04-06,1220,1032,1061,2093,三姓橋,簡易
2020-04-07,1220,1020,884,1904,三姓橋,簡易
2020-04-08,1220,1051,959,2010,三姓橋,簡易
2020-04-09,1220,1110,952,2062,三姓橋,簡易
2020-04-10,1220,1426,1014,2440,三姓橋,簡易
2020-04-11,1220,696,585,1281,三姓橋,簡易
2020-04-12,1220,598,747,1345,三姓橋,簡易
2020-04-13,1220,1034,1031,2065,三姓橋,簡易
2020-04-14,1220,1045,921,1966,三姓橋,簡易
2020-04-15,1220,1122,993,2115,三姓橋,簡易
2020-04-16,1220,1218,969,2187,三姓橋,簡易
2020-04-17,1220,1553,1019,2572,三姓橋,簡易
2020-04-18,1220,733,606,1339,三姓橋,簡易
2020-04-19,1220,649,959,1608,三姓橋,簡易
2020-04-20,1220,1020,1023,2043,三姓橋,簡易
2020-04-21,1220,1020,911,1931,三姓橋,簡易
2020-04-22,1220,1070,939,2009,三姓橋,簡易
2020-04-23,1220,1087,878,1965,三姓橋,簡易
2020-04-24,1220,1497,989,2486,三姓橋,簡易
2020-04-25,1220,649,544,1193,三姓橋,簡易
2020-04-26,1220,561,824,1385,三姓橋,簡易
2020-04-27,1220,1044,1043,2087,三姓橋,簡易
2020-04-28,1220,1039,968,2007,三姓橋,簡易
2020-04-29,1220,1053,933,1986,三姓橋,簡易
2020-04-30,1220,1409,985,2394,三姓橋,簡易
2020-05-01,1220,1263,997,2260,三姓橋,簡易
2020-05-02,1220,753,606,1359,三姓橋,簡易
2020-05-03,1220,722,943,1665,三姓橋,簡易
2020-05-04,1220,1098,1077,2175,三姓橋,簡易
2020-05-05,1220,1070,954,2024,三姓橋,簡易
2020-05-06,1220,1130,1018,2148,三姓橋,簡易
2020-05-07,1220,1192,962,2154,三姓橋,簡易
2020-05-08,1220,1741,1116,2857,三姓橋,簡易
2020-05-09,1220,861,621,1482,三姓橋,簡易
2020-05-10,1220,763,1045,1808,三姓橋,簡易
2020-05-11,1220,1067,1146,2213,三姓橋,簡易
2020-05-12,1220,1076,999,2075,三姓橋,簡易
2020-05-13,1220,1104,1009,2113,三姓橋,簡易
2020-05-14,1220,1206,979,2185,三姓橋,簡易
2020-05-15,1220,1562,1138,2700,三姓橋,簡易
2020-05-16,1220,867,702,1569,三姓橋,簡易
2020-05-17,1220,738,976,1714,三姓橋,簡易
2020-05-18,1220,1030,1059,2089,三姓橋,簡易
2020-05-19,1220,1043,932,1975,三姓橋,簡易
2020-05-20,1220,1074,1004,2078,三姓橋,簡易
2020-05-21,1220,1119,935,2054,三姓橋,簡易
2020-05-22,1220,1413,980,2393,三姓橋,簡易
2020-05-23,1220,735,616,1351,三姓橋,簡易
2020-05-24,1220,689,914,1603,三姓橋,簡易
2020-05-25,1220,1124,1106,2230,三姓橋,簡易
2020-05-26,1220,1066,988,2054,三姓橋,簡易
2020-05-27,1220,1036,975,2011,三姓橋,簡易
2020-05-28,1220,1145,993,2138,三姓橋,簡易
2020-05-29,1220,1585,1103,2688,三姓橋,簡易
2020-05-30,1220,803,631,1434,三姓橋,簡易
2020-05-31,1220,806,997,1803,三姓橋,簡易
2020-06-01,1220,1095,1128,2223,三姓橋,簡易
2020-06-02,1220,1079,953,2032,三姓橋,簡易
2020-06-03,1220,1147,968,2115,三姓橋,簡易
2020-06-04,1220,1199,981,2180,三姓橋,簡易
2020-06-05,1220,1499,1094,2593,三姓橋,簡易
2020-06-06,1220,911,781,1692,三姓橋,簡易
2020-06-07,1220,719,905,1624,三姓橋,簡易
2020-06-08,1220,1042,1039,2081,三姓橋,簡易
2020-06-09,1220,1038,944,1982,三姓橋,簡易
2020-06-10,1220,1183,1040,2223,三姓橋,簡易
2020-06-11,1220,1162,994,2156,三姓橋,簡易
2020-06-12,1220,1499,1152,2651,三姓橋,簡易
2020-06-13,1220,963,831,1794,三姓橋,簡易
2020-06-14,1220,871,1033,1904,三姓橋,簡易
2020-06-15,1220,1073,1079,2152,三姓橋,簡易
2020-06-16,1220,1082,980,2062,三姓橋,簡易
2020-06-17,1220,1073,976,2049,三姓橋,簡易
2020-06-18,1220,1098,930,2028,三姓橋,簡易
2020-06-19,1220,1288,998,2286,三姓橋,簡易
2020-06-20,1220,1102,885,1987,三姓橋,簡易
2020-06-21,1220,767,824,1591,三姓橋,簡易
2020-06-22,1220,1043,1045,2088,三姓橋,簡易
2020-06-23,1220,1026,945,1971,三姓橋,簡易
2020-06-24,1220,1455,1158,2613,三姓橋,簡易
2020-06-25,1220,1014,789,1803,三姓橋,簡易
2020-06-26,1220,819,767,1586,三姓橋,簡易
2020-06-27,1220,799,774,1573,三姓橋,簡易
2020-06-28,1220,815,928,1743,三姓橋,簡易
2020-06-29,1220,1020,996,2016,三姓橋,簡易
2020-06-30,1220,956,887,1843,三姓橋,簡易
2020-07-01,1220,954,847,1801,三姓橋,簡易
2020-07-02,1220,954,836,1790,三姓橋,簡易
2020-07-03,1220,1070,898,1968,三姓橋,簡易
2020-07-04,1220,826,716,1542,三姓橋,簡易
2020-07-05,1220,677,760,1437,三姓橋,簡易
2020-07-06,1220,1018,915,1933,三姓橋,簡易
2020-07-07,1220,1005,871,1876,三姓橋,簡易
2020-07-08,1220,1007,933,1940,三姓橋,簡易
2020-07-09,1220,1013,874,1887,三姓橋,簡易
2020-07-10,1220,1221,1043,2264,三姓橋,簡易
2020-07-11,1220,813,682,1495,三姓橋,簡易
2020-07-12,1220,791,826,1617,三姓橋,簡易
2020-07-13,1220,1010,962,1972,三姓橋,簡易
2020-07-14,1220,1288,1005,2293,三姓橋,簡易
2020-07-15,1220,722,695,1417,三姓橋,簡易
2020-07-16,1220,741,657,1398,三姓橋,簡易
2020-07-17,1220,838,737,1575,三姓橋,簡易
2020-07-18,1220,750,677,1427,三姓橋,簡易
2020-07-19,1220,743,793,1536,三姓橋,簡易
2020-07-20,1220,790,775,1565,三姓橋,簡易
2020-07-21,1220,752,722,1474,三姓橋,簡易
2020-07-22,1220,719,669,1388,三姓橋,簡易
2020-07-23,1220,828,752,1580,三姓橋,簡易
2020-07-24,1220,981,851,1832,三姓橋,簡易
2020-07-25,1220,716,626,1342,三姓橋,簡易
2020-07-26,1220,713,750,1463,三姓橋,簡易
2020-07-27,1220,929,856,1785,三姓橋,簡易
2020-07-28,1220,1003,859,1862,三姓橋,簡易
2020-07-29,1220,959,865,1824,三姓橋,簡易
2020-07-30,1220,999,840,1839,三姓橋,簡易
2020-07-31,1220,1093,951,2044,三姓橋,簡易
2020-08-01,1220,764,696,1460,三姓橋,簡易
2020-08-02,1220,768,715,1483,三姓橋,簡易
2020-08-03,1220,943,896,1839,三姓橋,簡易
2020-08-04,1220,905,827,1732,三姓橋,簡易
2020-08-05,1220,964,857,1821,三姓橋,簡易
2020-08-06,1220,1009,889,1898,三姓橋,簡易
2020-08-07,1220,1133,1010,2143,三姓橋,簡易
2020-08-08,1220,749,657,1406,三姓橋,簡易
2020-08-09,1220,793,860,1653,三姓橋,簡易
2020-08-10,1220,1025,903,1928,三姓橋,簡易
2020-08-11,1220,894,816,1710,三姓橋,簡易
2020-08-12,1220,940,855,1795,三姓橋,簡易
2020-08-13,1220,1074,906,1980,三姓橋,簡易
2020-08-14,1220,1075,990,2065,三姓橋,簡易
2020-08-15,1220,849,784,1633,三姓橋,簡易
2020-08-16,1220,728,729,1457,三姓橋,簡易
2020-08-17,1220,891,854,1745,三姓橋,簡易
2020-08-18,1220,889,815,1704,三姓橋,簡易
2020-08-19,1220,824,800,1624,三姓橋,簡易
2020-08-20,1220,813,750,1563,三姓橋,簡易
2020-08-21,1220,884,786,1670,三姓橋,簡易
2020-08-22,1220,767,727,1494,三姓橋,簡易
2020-08-23,1220,815,839,1654,三姓橋,簡易
2020-08-24,1220,714,725,1439,三姓橋,簡易
2020-08-25,1220,746,691,1437,三姓橋,簡易
2020-08-26,1220,784,730,1514,三姓橋,簡易
2020-08-27,1220,799,741,1540,三姓橋,簡易
2020-08-28,1220,905,816,1721,三姓橋,簡易
2020-08-29,1220,703,640,1343,三姓橋,簡易
2020-08-30,1220,721,738,1459,三姓橋,簡易
2020-08-31,1220,1120,1031,2151,三姓橋,簡易
2020-09-01,1220,1032,999,2031,三姓橋,簡易
2020-09-02,1220,1077,964,2041,三姓橋,簡易
2020-09-03,1220,1124,972,2096,三姓橋,簡易
2020-09-04,1220,1428,1098,2526,三姓橋,簡易
2020-09-05,1220,842,723,1565,三姓橋,簡易
2020-09-06,1220,815,999,1814,三姓橋,簡易
2020-09-07,1220,1125,1053,2178,三姓橋,簡易
2020-09-08,1220,1203,1079,2282,三姓橋,簡易
2020-09-09,1220,1139,1025,2164,三姓橋,簡易
2020-09-10,1220,1212,1036,2248,三姓橋,簡易
2020-09-11,1220,1682,1173,2855,三姓橋,簡易
2020-09-12,1220,934,857,1791,三姓橋,簡易
2020-09-13,1220,908,1184,2092,三姓橋,簡易
2020-09-14,1220,1191,1103,2294,三姓橋,簡易
2020-09-15,1220,1149,1035,2184,三姓橋,簡易
2020-09-16,1220,1184,1021,2205,三姓橋,簡易
2020-09-17,1220,1231,1006,2237,三姓橋,簡易
2020-09-18,1220,1759,1144,2903,三姓橋,簡易
2020-09-19,1220,1043,862,1905,三姓橋,簡易
2020-09-20,1220,876,1160,2036,三姓橋,簡易
2020-09-21,1220,1223,1147,2370,三姓橋,簡易
2020-09-22,1220,1174,1048,2222,三姓橋,簡易
2020-09-23,1220,1196,1012,2208,三姓橋,簡易
2020-09-24,1220,1251,1034,2285,三姓橋,簡易
2020-09-25,1220,1630,1066,2696,三姓橋,簡易
2020-09-26,1220,1215,938,2153,三姓橋,簡易
2020-09-27,1220,689,921,1610,三姓橋,簡易
2020-09-28,1220,1147,1081,2228,三姓橋,簡易
2020-09-29,1220,1235,1034,2269,三姓橋,簡易
2020-09-30,1220,2073,1324,3397,三姓橋,簡易
2020-10-01,1220,1111,940,2051,三姓橋,簡易
2020-10-02,1220,954,868,1822,三姓橋,簡易
2020-10-03,1220,830,917,1747,三姓橋,簡易
2020-10-04,1220,952,1295,2247,三姓橋,簡易
2020-10-05,1220,1213,1189,2402,三姓橋,簡易
2020-10-06,1220,1169,1033,2202,三姓橋,簡易
2020-10-07,1220,1235,1105,2340,三姓橋,簡易
2020-10-08,1220,1836,1239,3075,三姓橋,簡易
2020-10-09,1220,1200,939,2139,三姓橋,簡易
2020-10-10,1220,858,789,1647,三姓橋,簡易
2020-10-11,1220,880,1229,2109,三姓橋,簡易
2020-10-12,1220,1204,1147,2351,三姓橋,簡易
2020-10-13,1220,1200,1032,2232,三姓橋,簡易
2020-10-14,1220,1147,1008,2155,三姓橋,簡易
2020-10-15,1220,1310,1071,2381,三姓橋,簡易
2020-10-16,1220,1706,1198,2904,三姓橋,簡易
2020-10-17,1220,1042,907,1949,三姓橋,簡易
2020-10-18,1220,902,1138,2040,三姓橋,簡易
2020-10-19,1220,1168,1101,2269,三姓橋,簡易
2020-10-20,1220,1160,1077,2237,三姓橋,簡易
2020-10-21,1220,1217,1030,2247,三姓橋,簡易
2020-10-22,1220,1248,1048,2296,三姓橋,簡易
2020-10-23,1220,1717,1234,2951,三姓橋,簡易
2020-10-24,1220,963,839,1802,三姓橋,簡易
2020-10-25,1220,925,1110,2035,三姓橋,簡易
2020-10-26,1220,1194,1091,2285,三姓橋,簡易
2020-10-27,1220,1146,975,2121,三姓橋,簡易
2020-10-28,1220,1123,997,2120,三姓橋,簡易
2020-10-29,1220,1294,1102,2396,三姓橋,簡易
2020-10-30,1220,1910,1215,3125,三姓橋,簡易
2020-10-31,1220,1101,934,2035,三姓橋,簡易
2020-11-01,1220,965,1290,2255,三姓橋,簡易
2020-11-02,1220,1194,1145,2339,三姓橋,簡易
2020-11-03,1220,1157,1008,2165,三姓橋,簡易
2020-11-04,1220,1166,997,2163,三姓橋,簡易
2020-11-05,1220,1252,1012,2264,三姓橋,簡易
2020-11-06,1220,1523,1222,2745,三姓橋,簡易
2020-11-07,1220,1770,1338,3108,三姓橋,簡易
2020-11-08,1220,891,1020,1911,三姓橋,簡易
2020-11-09,1220,943,1025,1968,三姓橋,簡易
2020-11-10,1220,1166,1021,2187,三姓橋,簡易
2020-11-11,1220,1195,1075,2270,三姓橋,簡易
2020-11-12,1220,1297,1068,2365,三姓橋,簡易
2020-11-13,1220,1889,1199,3088,三姓橋,簡易
2020-11-14,1220,1077,919,1996,三姓橋,簡易
2020-11-15,1220,1015,1328,2343,三姓橋,簡易
2020-11-16,1220,1183,1176,2359,三姓橋,簡易
2020-11-17,1220,1185,1035,2220,三姓橋,簡易
2020-11-18,1220,1214,1089,2303,三姓橋,簡易
2020-11-19,1220,1392,1136,2528,三姓橋,簡易
2020-11-20,1220,1869,1239,3108,三姓橋,簡易
2020-11-21,1220,1027,855,1882,三姓橋,簡易
2020-11-22,1220,919,1190,2109,三姓橋,簡易
2020-11-23,1220,1251,1215,2466,三姓橋,簡易
2020-11-24,1220,1222,1109,2331,三姓橋,簡易
2020-11-25,1220,1204,1077,2281,三姓橋,簡易
2020-11-26,1220,1240,1060,2300,三姓橋,簡易
2020-11-27,1220,1785,1238,3023,三姓橋,簡易
2020-11-28,1220,979,866,1845,三姓橋,簡易
2020-11-29,1220,927,1185,2112,三姓橋,簡易
2020-11-30,1220,1249,1148,2397,三姓橋,簡易
2020-12-01,1220,1175,1021,2196,三姓橋,簡易
2020-12-02,1220,1259,1055,2314,三姓橋,簡易
2020-12-03,1220,1318,1045,2363,三姓橋,簡易
2020-12-04,1220,1812,1252,3064,三姓橋,簡易
2020-12-05,1220,1022,908,1930,三姓橋,簡易
2020-12-06,1220,1011,1228,2239,三姓橋,簡易
2020-12-07,1220,1219,1134,2353,三姓橋,簡易
2020-12-08,1220,1154,1049,2203,三姓橋,簡易
2020-12-09,1220,1107,980,2087,三姓橋,簡易
2020-12-10,1220,1201,1032,2233,三姓橋,簡易
2020-12-11,1220,1804,1195,2999,三姓橋,簡易
2020-12-12,1220,1101,908,2009,三姓橋,簡易
2020-12-13,1220,1031,1292,2323,三姓橋,簡易
2020-12-14,1220,1228,1147,2375,三姓橋,簡易
2020-12-15,1220,1165,1040,2205,三姓橋,簡易
2020-12-16,1220,1193,1029,2222,三姓橋,簡易
2020-12-17,1220,1332,1053,2385,三姓橋,簡易
2020-12-18,1220,1802,1180,2982,三姓橋,簡易
2020-12-19,1220,961,815,1776,三姓橋,簡易
2020-12-20,1220,861,1184,2045,三姓橋,簡易
2020-12-21,1220,1172,1104,2276,三姓橋,簡易
2020-12-22,1220,1202,1047,2249,三姓橋,簡易
2020-12-23,1220,1152,1003,2155,三姓橋,簡易
2020-12-24,1220,1302,1039,2341,三姓橋,簡易
2020-12-25,1220,1883,1210,3093,三姓橋,簡易
2020-12-26,1220,910,780,1690,三姓橋,簡易
2020-12-27,1220,806,1110,1916,三姓橋,簡易
2020-12-28,1220,1239,1185,2424,三姓橋,簡易
2020-12-29,1220,1309,1185,2494,三姓橋,簡易
2020-12-30,1220,1182,980,2162,三姓橋,簡易
2020-12-31,1220,2062,1266,3328,三姓橋,簡易
2020-01-01,1230,593,669,1262,香山,甲簡
2020-01-02,1230,605,608,1213,香山,甲簡
2020-01-03,1230,632,660,1292,香山,甲簡
2020-01-04,1230,632,643,1275,香山,甲簡
2020-01-05,1230,620,572,1192,香山,甲簡
2020-01-06,1230,599,598,1197,香山,甲簡
2020-01-07,1230,586,599,1185,香山,甲簡
2020-01-08,1230,581,573,1154,香山,甲簡
2020-01-09,1230,580,586,1166,香山,甲簡
2020-01-10,1230,639,752,1391,香山,甲簡
2020-01-11,1230,583,587,1170,香山,甲簡
2020-01-12,1230,590,545,1135,香山,甲簡
2020-01-13,1230,633,614,1247,香山,甲簡
2020-01-14,1230,624,619,1243,香山,甲簡
2020-01-15,1230,615,619,1234,香山,甲簡
2020-01-16,1230,660,676,1336,香山,甲簡
2020-01-17,1230,568,607,1175,香山,甲簡
2020-01-18,1230,561,560,1121,香山,甲簡
2020-01-19,1230,536,522,1058,香山,甲簡
2020-01-20,1230,586,545,1131,香山,甲簡
2020-01-21,1230,592,542,1134,香山,甲簡
2020-01-22,1230,603,648,1251,香山,甲簡
2020-01-23,1230,482,494,976,香山,甲簡
2020-01-24,1230,418,423,841,香山,甲簡
2020-01-25,1230,485,401,886,香山,甲簡
2020-01-26,1230,385,423,808,香山,甲簡
2020-01-27,1230,521,432,953,香山,甲簡
2020-01-28,1230,524,523,1047,香山,甲簡
2020-01-29,1230,452,437,889,香山,甲簡
2020-01-30,1230,469,441,910,香山,甲簡
2020-01-31,1230,499,485,984,香山,甲簡
2020-02-01,1230,422,456,878,香山,甲簡
2020-02-02,1230,455,437,892,香山,甲簡
2020-02-03,1230,512,448,960,香山,甲簡
2020-02-04,1230,405,383,788,香山,甲簡
2020-02-05,1230,494,479,973,香山,甲簡
2020-02-06,1230,456,473,929,香山,甲簡
2020-02-07,1230,490,508,998,香山,甲簡
2020-02-08,1230,446,428,874,香山,甲簡
2020-02-09,1230,467,478,945,香山,甲簡
2020-02-10,1230,529,499,1028,香山,甲簡
2020-02-11,1230,485,485,970,香山,甲簡
2020-02-12,1230,497,463,960,香山,甲簡
2020-02-13,1230,462,443,905,香山,甲簡
2020-02-14,1230,509,469,978,香山,甲簡
2020-02-15,1230,470,460,930,香山,甲簡
2020-02-16,1230,368,375,743,香山,甲簡
2020-02-17,1230,466,449,915,香山,甲簡
2020-02-18,1230,444,441,885,香山,甲簡
2020-02-19,1230,471,446,917,香山,甲簡
2020-02-20,1230,533,512,1045,香山,甲簡
2020-02-21,1230,538,511,1049,香山,甲簡
2020-02-22,1230,445,435,880,香山,甲簡
2020-02-23,1230,547,558,1105,香山,甲簡
2020-02-24,1230,541,493,1034,香山,甲簡
2020-02-25,1230,540,575,1115,香山,甲簡
2020-02-26,1230,522,537,1059,香山,甲簡
2020-02-27,1230,592,617,1209,香山,甲簡
2020-02-28,1230,441,471,912,香山,甲簡
2020-02-29,1230,472,429,901,香山,甲簡
2020-03-01,1230,482,409,891,香山,甲簡
2020-03-02,1230,546,559,1105,香山,甲簡
2020-03-03,1230,506,519,1025,香山,甲簡
2020-03-04,1230,503,508,1011,香山,甲簡
2020-03-05,1230,476,518,994,香山,甲簡
2020-03-06,1230,573,694,1267,香山,甲簡
2020-03-07,1230,424,498,922,香山,甲簡
2020-03-08,1230,508,450,958,香山,甲簡
2020-03-09,1230,572,551,1123,香山,甲簡
2020-03-10,1230,488,480,968,香山,甲簡
2020-03-11,1230,557,555,1112,香山,甲簡
2020-03-12,1230,512,535,1047,香山,甲簡
2020-03-13,1230,524,626,1150,香山,甲簡
2020-03-14,1230,426,430,856,香山,甲簡
2020-03-15,1230,518,489,1007,香山,甲簡
2020-03-16,1230,549,512,1061,香山,甲簡
2020-03-17,1230,502,516,1018,香山,甲簡
2020-03-18,1230,508,508,1016,香山,甲簡
2020-03-19,1230,453,499,952,香山,甲簡
2020-03-20,1230,537,622,1159,香山,甲簡
2020-03-21,1230,400,437,837,香山,甲簡
2020-03-22,1230,435,378,813,香山,甲簡
2020-03-23,1230,519,518,1037,香山,甲簡
2020-03-24,1230,508,496,1004,香山,甲簡
2020-03-25,1230,469,497,966,香山,甲簡
2020-03-26,1230,467,490,957,香山,甲簡
2020-03-27,1230,532,601,1133,香山,甲簡
2020-03-28,1230,277,296,573,香山,甲簡
2020-03-29,1230,376,326,702,香山,甲簡
2020-03-30,1230,501,502,1003,香山,甲簡
2020-03-31,1230,487,513,1000,香山,甲簡
2020-04-01,1230,484,575,1059,香山,甲簡
2020-04-02,1230,328,375,703,香山,甲簡
2020-04-03,1230,376,379,755,香山,甲簡
2020-04-04,1230,281,264,545,香山,甲簡
2020-04-05,1230,408,339,747,香山,甲簡
2020-04-06,1230,480,423,903,香山,甲簡
2020-04-07,1230,477,480,957,香山,甲簡
2020-04-08,1230,469,451,920,香山,甲簡
2020-04-09,1230,474,493,967,香山,甲簡
2020-04-10,1230,531,566,1097,香山,甲簡
2020-04-11,1230,314,339,653,香山,甲簡
2020-04-12,1230,348,345,693,香山,甲簡
2020-04-13,1230,509,494,1003,香山,甲簡
2020-04-14,1230,478,504,982,香山,甲簡
2020-04-15,1230,507,506,1013,香山,甲簡
2020-04-16,1230,489,531,1020,香山,甲簡
2020-04-17,1230,516,592,1108,香山,甲簡
2020-04-18,1230,390,382,772,香山,甲簡
2020-04-19,1230,422,372,794,香山,甲簡
2020-04-20,1230,530,517,1047,香山,甲簡
2020-04-21,1230,501,466,967,香山,甲簡
2020-04-22,1230,452,464,916,香山,甲簡
2020-04-23,1230,459,464,923,香山,甲簡
2020-04-24,1230,474,558,1032,香山,甲簡
2020-04-25,1230,334,341,675,香山,甲簡
2020-04-26,1230,354,329,683,香山,甲簡
2020-04-27,1230,515,487,1002,香山,甲簡
2020-04-28,1230,492,519,1011,香山,甲簡
2020-04-29,1230,487,492,979,香山,甲簡
2020-04-30,1230,514,557,1071,香山,甲簡
2020-05-01,1230,481,567,1048,香山,甲簡
2020-05-02,1230,360,394,754,香山,甲簡
2020-05-03,1230,490,403,893,香山,甲簡
2020-05-04,1230,544,520,1064,香山,甲簡
2020-05-05,1230,520,510,1030,香山,甲簡
2020-05-06,1230,496,506,1002,香山,甲簡
2020-05-07,1230,487,515,1002,香山,甲簡
2020-05-08,1230,541,644,1185,香山,甲簡
2020-05-09,1230,429,491,920,香山,甲簡
2020-05-10,1230,523,385,908,香山,甲簡
2020-05-11,1230,598,512,1110,香山,甲簡
2020-05-12,1230,514,542,1056,香山,甲簡
2020-05-13,1230,517,514,1031,香山,甲簡
2020-05-14,1230,502,529,1031,香山,甲簡
2020-05-15,1230,569,624,1193,香山,甲簡
2020-05-16,1230,388,410,798,香山,甲簡
2020-05-17,1230,454,414,868,香山,甲簡
2020-05-18,1230,503,480,983,香山,甲簡
2020-05-19,1230,455,471,926,香山,甲簡
2020-05-20,1230,499,517,1016,香山,甲簡
2020-05-21,1230,458,491,949,香山,甲簡
2020-05-22,1230,485,548,1033,香山,甲簡
2020-05-23,1230,378,349,727,香山,甲簡
2020-05-24,1230,481,439,920,香山,甲簡
2020-05-25,1230,555,546,1101,香山,甲簡
2020-05-26,1230,507,519,1026,香山,甲簡
2020-05-27,1230,472,488,960,香山,甲簡
2020-05-28,1230,463,494,957,香山,甲簡
2020-05-29,1230,537,616,1153,香山,甲簡
2020-05-30,1230,565,492,1057,香山,甲簡
2020-05-31,1230,474,499,973,香山,甲簡
2020-06-01,1230,579,558,1137,香山,甲簡
2020-06-02,1230,534,538,1072,香山,甲簡
2020-06-03,1230,510,534,1044,香山,甲簡
2020-06-04,1230,497,539,1036,香山,甲簡
2020-06-05,1230,584,670,1254,香山,甲簡
2020-06-06,1230,467,474,941,香山,甲簡
2020-06-07,1230,447,378,825,香山,甲簡
2020-06-08,1230,533,482,1015,香山,甲簡
2020-06-09,1230,534,535,1069,香山,甲簡
2020-06-10,1230,562,578,1140,香山,甲簡
2020-06-11,1230,481,512,993,香山,甲簡
2020-06-12,1230,572,643,1215,香山,甲簡
2020-06-13,1230,495,535,1030,香山,甲簡
2020-06-14,1230,513,439,952,香山,甲簡
2020-06-15,1230,591,607,1198,香山,甲簡
2020-06-16,1230,496,508,1004,香山,甲簡
2020-06-17,1230,509,535,1044,香山,甲簡
2020-06-18,1230,510,537,1047,香山,甲簡
2020-06-19,1230,547,591,1138,香山,甲簡
2020-06-20,1230,480,518,998,香山,甲簡
2020-06-21,1230,501,445,946,香山,甲簡
2020-06-22,1230,563,530,1093,香山,甲簡
2020-06-23,1230,489,513,1002,香山,甲簡
2020-06-24,1230,575,608,1183,香山,甲簡
2020-06-25,1230,423,498,921,香山,甲簡
2020-06-26,1230,574,544,1118,香山,甲簡
2020-06-27,1230,492,491,983,香山,甲簡
2020-06-28,1230,491,440,931,香山,甲簡
2020-06-29,1230,561,500,1061,香山,甲簡
2020-06-30,1230,492,524,1016,香山,甲簡
2020-07-01,1230,497,499,996,香山,甲簡
2020-07-02,1230,526,507,1033,香山,甲簡
2020-07-03,1230,542,512,1054,香山,甲簡
2020-07-04,1230,499,476,975,香山,甲簡
2020-07-05,1230,482,477,959,香山,甲簡
2020-07-06,1230,519,512,1031,香山,甲簡
2020-07-07,1230,514,534,1048,香山,甲簡
2020-07-08,1230,497,526,1023,香山,甲簡
2020-07-09,1230,507,511,1018,香山,甲簡
2020-07-10,1230,643,606,1249,香山,甲簡
2020-07-11,1230,476,463,939,香山,甲簡
2020-07-12,1230,425,437,862,香山,甲簡
2020-07-13,1230,597,541,1138,香山,甲簡
2020-07-14,1230,561,597,1158,香山,甲簡
2020-07-15,1230,490,498,988,香山,甲簡
2020-07-16,1230,490,482,972,香山,甲簡
2020-07-17,1230,539,535,1074,香山,甲簡
2020-07-18,1230,546,542,1088,香山,甲簡
2020-07-19,1230,442,443,885,香山,甲簡
2020-07-20,1230,491,492,983,香山,甲簡
2020-07-21,1230,480,449,929,香山,甲簡
2020-07-22,1230,527,515,1042,香山,甲簡
2020-07-23,1230,556,514,1070,香山,甲簡
2020-07-24,1230,601,547,1148,香山,甲簡
2020-07-25,1230,480,486,966,香山,甲簡
2020-07-26,1230,502,459,961,香山,甲簡
2020-07-27,1230,520,510,1030,香山,甲簡
2020-07-28,1230,468,503,971,香山,甲簡
2020-07-29,1230,482,472,954,香山,甲簡
2020-07-30,1230,531,521,1052,香山,甲簡
2020-07-31,1230,590,538,1128,香山,甲簡
2020-08-01,1230,478,539,1017,香山,甲簡
2020-08-02,1230,439,423,862,香山,甲簡
2020-08-03,1230,497,456,953,香山,甲簡
2020-08-04,1230,503,471,974,香山,甲簡
2020-08-05,1230,526,507,1033,香山,甲簡
2020-08-06,1230,540,570,1110,香山,甲簡
2020-08-07,1230,600,626,1226,香山,甲簡
2020-08-08,1230,459,445,904,香山,甲簡
2020-08-09,1230,487,416,903,香山,甲簡
2020-08-10,1230,568,534,1102,香山,甲簡
2020-08-11,1230,466,462,928,香山,甲簡
2020-08-12,1230,488,465,953,香山,甲簡
2020-08-13,1230,497,514,1011,香山,甲簡
2020-08-14,1230,644,633,1277,香山,甲簡
2020-08-15,1230,507,458,965,香山,甲簡
2020-08-16,1230,502,468,970,香山,甲簡
2020-08-17,1230,504,492,996,香山,甲簡
2020-08-18,1230,570,557,1127,香山,甲簡
2020-08-19,1230,526,503,1029,香山,甲簡
2020-08-20,1230,592,552,1144,香山,甲簡
2020-08-21,1230,573,566,1139,香山,甲簡
2020-08-22,1230,537,515,1052,香山,甲簡
2020-08-23,1230,495,416,911,香山,甲簡
2020-08-24,1230,508,463,971,香山,甲簡
2020-08-25,1230,445,423,868,香山,甲簡
2020-08-26,1230,541,506,1047,香山,甲簡
2020-08-27,1230,516,482,998,香山,甲簡
2020-08-28,1230,594,557,1151,香山,甲簡
2020-08-29,1230,484,470,954,香山,甲簡
2020-08-30,1230,454,419,873,香山,甲簡
2020-08-31,1230,586,566,1152,香山,甲簡
2020-09-01,1230,555,549,1104,香山,甲簡
2020-09-02,1230,558,550,1108,香山,甲簡
2020-09-03,1230,575,598,1173,香山,甲簡
2020-09-04,1230,668,655,1323,香山,甲簡
2020-09-05,1230,497,512,1009,香山,甲簡
2020-09-06,1230,522,488,1010,香山,甲簡
2020-09-07,1230,717,705,1422,香山,甲簡
2020-09-08,1230,656,652,1308,香山,甲簡
2020-09-09,1230,692,749,1441,香山,甲簡
2020-09-10,1230,689,728,1417,香山,甲簡
2020-09-11,1230,642,672,1314,香山,甲簡
2020-09-12,1230,533,519,1052,香山,甲簡
2020-09-13,1230,527,480,1007,香山,甲簡
2020-09-14,1230,583,568,1151,香山,甲簡
2020-09-15,1230,553,572,1125,香山,甲簡
2020-09-16,1230,573,563,1136,香山,甲簡
2020-09-17,1230,566,612,1178,香山,甲簡
2020-09-18,1230,599,687,1286,香山,甲簡
2020-09-19,1230,543,617,1160,香山,甲簡
2020-09-20,1230,520,458,978,香山,甲簡
2020-09-21,1230,634,593,1227,香山,甲簡
2020-09-22,1230,576,604,1180,香山,甲簡
2020-09-23,1230,587,610,1197,香山,甲簡
2020-09-24,1230,580,558,1138,香山,甲簡
2020-09-25,1230,601,650,1251,香山,甲簡
2020-09-26,1230,563,582,1145,香山,甲簡
2020-09-27,1230,394,357,751,香山,甲簡
2020-09-28,1230,572,586,1158,香山,甲簡
2020-09-29,1230,578,601,1179,香山,甲簡
2020-09-30,1230,628,808,1436,香山,甲簡
2020-10-01,1230,566,708,1274,香山,甲簡
2020-10-02,1230,668,624,1292,香山,甲簡
2020-10-03,1230,611,575,1186,香山,甲簡
2020-10-04,1230,609,446,1055,香山,甲簡
2020-10-05,1230,666,593,1259,香山,甲簡
2020-10-06,1230,590,577,1167,香山,甲簡
2020-10-07,1230,598,594,1192,香山,甲簡
2020-10-08,1230,666,745,1411,香山,甲簡
2020-10-09,1230,635,661,1296,香山,甲簡
2020-10-10,1230,600,582,1182,香山,甲簡
2020-10-11,1230,600,525,1125,香山,甲簡
2020-10-12,1230,605,596,1201,香山,甲簡
2020-10-13,1230,596,598,1194,香山,甲簡
2020-10-14,1230,613,601,1214,香山,甲簡
2020-10-15,1230,565,589,1154,香山,甲簡
2020-10-16,1230,620,713,1333,香山,甲簡
2020-10-17,1230,620,613,1233,香山,甲簡
2020-10-18,1230,591,535,1126,香山,甲簡
2020-10-19,1230,661,580,1241,香山,甲簡
2020-10-20,1230,587,583,1170,香山,甲簡
2020-10-21,1230,564,586,1150,香山,甲簡
2020-10-22,1230,584,610,1194,香山,甲簡
2020-10-23,1230,629,674,1303,香山,甲簡
2020-10-24,1230,568,561,1129,香山,甲簡
2020-10-25,1230,524,501,1025,香山,甲簡
2020-10-26,1230,637,596,1233,香山,甲簡
2020-10-27,1230,612,626,1238,香山,甲簡
2020-10-28,1230,572,539,1111,香山,甲簡
2020-10-29,1230,604,600,1204,香山,甲簡
2020-10-30,1230,634,730,1364,香山,甲簡
2020-10-31,1230,560,662,1222,香山,甲簡
2020-11-01,1230,606,538,1144,香山,甲簡
2020-11-02,1230,630,590,1220,香山,甲簡
2020-11-03,1230,565,603,1168,香山,甲簡
2020-11-04,1230,602,577,1179,香山,甲簡
2020-11-05,1230,572,615,1187,香山,甲簡
2020-11-06,1230,726,710,1436,香山,甲簡
2020-11-07,1230,643,693,1336,香山,甲簡
2020-11-08,1230,518,491,1009,香山,甲簡
2020-11-09,1230,610,575,1185,香山,甲簡
2020-11-10,1230,590,603,1193,香山,甲簡
2020-11-11,1230,588,594,1182,香山,甲簡
2020-11-12,1230,592,612,1204,香山,甲簡
2020-11-13,1230,639,738,1377,香山,甲簡
2020-11-14,1230,610,611,1221,香山,甲簡
2020-11-15,1230,638,587,1225,香山,甲簡
2020-11-16,1230,629,609,1238,香山,甲簡
2020-11-17,1230,594,593,1187,香山,甲簡
2020-11-18,1230,586,602,1188,香山,甲簡
2020-11-19,1230,591,605,1196,香山,甲簡
2020-11-20,1230,667,718,1385,香山,甲簡
2020-11-21,1230,609,584,1193,香山,甲簡
2020-11-22,1230,569,519,1088,香山,甲簡
2020-11-23,1230,644,616,1260,香山,甲簡
2020-11-24,1230,625,615,1240,香山,甲簡
2020-11-25,1230,591,590,1181,香山,甲簡
2020-11-26,1230,575,625,1200,香山,甲簡
2020-11-27,1230,651,742,1393,香山,甲簡
2020-11-28,1230,477,539,1016,香山,甲簡
2020-11-29,1230,573,509,1082,香山,甲簡
2020-11-30,1230,651,620,1271,香山,甲簡
2020-12-01,1230,589,577,1166,香山,甲簡
2020-12-02,1230,574,623,1197,香山,甲簡
2020-12-03,1230,561,578,1139,香山,甲簡
2020-12-04,1230,627,747,1374,香山,甲簡
2020-12-05,1230,623,628,1251,香山,甲簡
2020-12-06,1230,580,626,1206,香山,甲簡
2020-12-07,1230,646,604,1250,香山,甲簡
2020-12-08,1230,576,614,1190,香山,甲簡
2020-12-09,1230,540,571,1111,香山,甲簡
2020-12-10,1230,604,642,1246,香山,甲簡
2020-12-11,1230,656,749,1405,香山,甲簡
2020-12-12,1230,590,620,1210,香山,甲簡
2020-12-13,1230,654,517,1171,香山,甲簡
2020-12-14,1230,609,593,1202,香山,甲簡
2020-12-15,1230,560,571,1131,香山,甲簡
2020-12-16,1230,587,581,1168,香山,甲簡
2020-12-17,1230,543,587,1130,香山,甲簡
2020-12-18,1230,617,672,1289,香山,甲簡
2020-12-19,1230,476,533,1009,香山,甲簡
2020-12-20,1230,513,494,1007,香山,甲簡
2020-12-21,1230,592,548,1140,香山,甲簡
2020-12-22,1230,590,621,1211,香山,甲簡
2020-12-23,1230,536,555,1091,香山,甲簡
2020-12-24,1230,538,608,1146,香山,甲簡
2020-12-25,1230,671,771,1442,香山,甲簡
2020-12-26,1230,530,543,1073,香山,甲簡
2020-12-27,1230,506,463,969,香山,甲簡
2020-12-28,1230,663,650,1313,香山,甲簡
2020-12-29,1230,746,776,1522,香山,甲簡
2020-12-30,1230,524,552,1076,香山,甲簡
2020-12-31,1230,646,689,1335,香山,甲簡
2020-01-01,1240,215,283,498,崎頂,招呼
2020-01-02,1240,140,244,384,崎頂,招呼
2020-01-03,1240,203,258,461,崎頂,招呼
2020-01-04,1240,226,299,525,崎頂,招呼
2020-01-05,1240,223,248,471,崎頂,招呼
2020-01-06,1240,207,232,439,崎頂,招呼
2020-01-07,1240,188,209,397,崎頂,招呼
2020-01-08,1240,216,252,468,崎頂,招呼
2020-01-09,1240,224,245,469,崎頂,招呼
2020-01-10,1240,216,296,512,崎頂,招呼
2020-01-11,1240,214,274,488,崎頂,招呼
2020-01-12,1240,236,272,508,崎頂,招呼
2020-01-13,1240,229,266,495,崎頂,招呼
2020-01-14,1240,210,221,431,崎頂,招呼
2020-01-15,1240,205,217,422,崎頂,招呼
2020-01-16,1240,240,243,483,崎頂,招呼
2020-01-17,1240,208,242,450,崎頂,招呼
2020-01-18,1240,213,373,586,崎頂,招呼
2020-01-19,1240,184,213,397,崎頂,招呼
2020-01-20,1240,210,250,460,崎頂,招呼
2020-01-21,1240,244,308,552,崎頂,招呼
2020-01-22,1240,201,316,517,崎頂,招呼
2020-01-23,1240,176,234,410,崎頂,招呼
2020-01-24,1240,140,183,323,崎頂,招呼
2020-01-25,1240,197,277,474,崎頂,招呼
2020-01-26,1240,116,168,284,崎頂,招呼
2020-01-27,1240,223,286,509,崎頂,招呼
2020-01-28,1240,235,266,501,崎頂,招呼
2020-01-29,1240,189,246,435,崎頂,招呼
2020-01-30,1240,158,179,337,崎頂,招呼
2020-01-31,1240,236,263,499,崎頂,招呼
2020-02-01,1240,169,221,390,崎頂,招呼
2020-02-02,1240,218,240,458,崎頂,招呼
2020-02-03,1240,174,185,359,崎頂,招呼
2020-02-04,1240,166,187,353,崎頂,招呼
2020-02-05,1240,185,181,366,崎頂,招呼
2020-02-06,1240,188,230,418,崎頂,招呼
2020-02-07,1240,169,217,386,崎頂,招呼
2020-02-08,1240,210,233,443,崎頂,招呼
2020-02-09,1240,212,246,458,崎頂,招呼
2020-02-10,1240,185,208,393,崎頂,招呼
2020-02-11,1240,168,184,352,崎頂,招呼
2020-02-12,1240,235,250,485,崎頂,招呼
2020-02-13,1240,160,176,336,崎頂,招呼
2020-02-14,1240,202,248,450,崎頂,招呼
2020-02-15,1240,216,236,452,崎頂,招呼
2020-02-16,1240,133,166,299,崎頂,招呼
2020-02-17,1240,155,177,332,崎頂,招呼
2020-02-18,1240,138,120,258,崎頂,招呼
2020-02-19,1240,160,200,360,崎頂,招呼
2020-02-20,1240,192,218,410,崎頂,招呼
2020-02-21,1240,213,235,448,崎頂,招呼
2020-02-22,1240,184,245,429,崎頂,招呼
2020-02-23,1240,189,210,399,崎頂,招呼
2020-02-24,1240,180,190,370,崎頂,招呼
2020-02-25,1240,198,224,422,崎頂,招呼
2020-02-26,1240,222,229,451,崎頂,招呼
2020-02-27,1240,197,242,439,崎頂,招呼
2020-02-28,1240,197,231,428,崎頂,招呼
2020-02-29,1240,209,237,446,崎頂,招呼
2020-03-01,1240,199,226,425,崎頂,招呼
2020-03-02,1240,187,205,392,崎頂,招呼
2020-03-03,1240,178,193,371,崎頂,招呼
2020-03-04,1240,197,211,408,崎頂,招呼
2020-03-05,1240,186,204,390,崎頂,招呼
2020-03-06,1240,202,259,461,崎頂,招呼
2020-03-07,1240,211,240,451,崎頂,招呼
2020-03-08,1240,196,233,429,崎頂,招呼
2020-03-09,1240,196,210,406,崎頂,招呼
2020-03-10,1240,161,178,339,崎頂,招呼
2020-03-11,1240,200,216,416,崎頂,招呼
2020-03-12,1240,206,213,419,崎頂,招呼
2020-03-13,1240,200,260,460,崎頂,招呼
2020-03-14,1240,165,173,338,崎頂,招呼
2020-03-15,1240,202,239,441,崎頂,招呼
2020-03-16,1240,195,182,377,崎頂,招呼
2020-03-17,1240,168,198,366,崎頂,招呼
2020-03-18,1240,186,188,374,崎頂,招呼
2020-03-19,1240,178,170,348,崎頂,招呼
2020-03-20,1240,204,220,424,崎頂,招呼
2020-03-21,1240,169,207,376,崎頂,招呼
2020-03-22,1240,134,178,312,崎頂,招呼
2020-03-23,1240,184,190,374,崎頂,招呼
2020-03-24,1240,180,190,370,崎頂,招呼
2020-03-25,1240,170,175,345,崎頂,招呼
2020-03-26,1240,170,188,358,崎頂,招呼
2020-03-27,1240,177,208,385,崎頂,招呼
2020-03-28,1240,90,106,196,崎頂,招呼
2020-03-29,1240,166,191,357,崎頂,招呼
2020-03-30,1240,165,177,342,崎頂,招呼
2020-03-31,1240,179,197,376,崎頂,招呼
2020-04-01,1240,175,213,388,崎頂,招呼
2020-04-02,1240,110,150,260,崎頂,招呼
2020-04-03,1240,162,201,363,崎頂,招呼
2020-04-04,1240,107,127,234,崎頂,招呼
2020-04-05,1240,147,134,281,崎頂,招呼
2020-04-06,1240,162,173,335,崎頂,招呼
2020-04-07,1240,150,153,303,崎頂,招呼
2020-04-08,1240,165,185,350,崎頂,招呼
2020-04-09,1240,170,178,348,崎頂,招呼
2020-04-10,1240,178,209,387,崎頂,招呼
2020-04-11,1240,142,195,337,崎頂,招呼
2020-04-12,1240,127,146,273,崎頂,招呼
2020-04-13,1240,172,189,361,崎頂,招呼
2020-04-14,1240,184,187,371,崎頂,招呼
2020-04-15,1240,183,196,379,崎頂,招呼
2020-04-16,1240,178,182,360,崎頂,招呼
2020-04-17,1240,195,234,429,崎頂,招呼
2020-04-18,1240,181,198,379,崎頂,招呼
2020-04-19,1240,163,199,362,崎頂,招呼
2020-04-20,1240,174,182,356,崎頂,招呼
2020-04-21,1240,162,188,350,崎頂,招呼
2020-04-22,1240,157,162,319,崎頂,招呼
2020-04-23,1240,161,172,333,崎頂,招呼
2020-04-24,1240,176,198,374,崎頂,招呼
2020-04-25,1240,147,154,301,崎頂,招呼
2020-04-26,1240,150,169,319,崎頂,招呼
2020-04-27,1240,185,181,366,崎頂,招呼
2020-04-28,1240,193,209,402,崎頂,招呼
2020-04-29,1240,191,184,375,崎頂,招呼
2020-04-30,1240,169,185,354,崎頂,招呼
2020-05-01,1240,221,260,481,崎頂,招呼
2020-05-02,1240,152,193,345,崎頂,招呼
2020-05-03,1240,201,201,402,崎頂,招呼
2020-05-04,1240,183,184,367,崎頂,招呼
2020-05-05,1240,179,196,375,崎頂,招呼
2020-05-06,1240,171,176,347,崎頂,招呼
2020-05-07,1240,183,194,377,崎頂,招呼
2020-05-08,1240,211,253,464,崎頂,招呼
2020-05-09,1240,159,201,360,崎頂,招呼
2020-05-10,1240,208,214,422,崎頂,招呼
2020-05-11,1240,169,184,353,崎頂,招呼
2020-05-12,1240,173,196,369,崎頂,招呼
2020-05-13,1240,195,183,378,崎頂,招呼
2020-05-14,1240,187,201,388,崎頂,招呼
2020-05-15,1240,218,261,479,崎頂,招呼
2020-05-16,1240,167,202,369,崎頂,招呼
2020-05-17,1240,196,244,440,崎頂,招呼
2020-05-18,1240,167,176,343,崎頂,招呼
2020-05-19,1240,139,155,294,崎頂,招呼
2020-05-20,1240,177,175,352,崎頂,招呼
2020-05-21,1240,160,180,340,崎頂,招呼
2020-05-22,1240,150,173,323,崎頂,招呼
2020-05-23,1240,158,182,340,崎頂,招呼
2020-05-24,1240,235,260,495,崎頂,招呼
2020-05-25,1240,178,182,360,崎頂,招呼
2020-05-26,1240,169,167,336,崎頂,招呼
2020-05-27,1240,172,182,354,崎頂,招呼
2020-05-28,1240,161,163,324,崎頂,招呼
2020-05-29,1240,185,212,397,崎頂,招呼
2020-05-30,1240,203,255,458,崎頂,招呼
2020-05-31,1240,347,351,698,崎頂,招呼
2020-06-01,1240,203,196,399,崎頂,招呼
2020-06-02,1240,223,226,449,崎頂,招呼
2020-06-03,1240,196,191,387,崎頂,招呼
2020-06-04,1240,188,187,375,崎頂,招呼
2020-06-05,1240,199,230,429,崎頂,招呼
2020-06-06,1240,176,216,392,崎頂,招呼
2020-06-07,1240,189,203,392,崎頂,招呼
2020-06-08,1240,180,208,388,崎頂,招呼
2020-06-09,1240,201,195,396,崎頂,招呼
2020-06-10,1240,219,222,441,崎頂,招呼
2020-06-11,1240,183,199,382,崎頂,招呼
2020-06-12,1240,214,248,462,崎頂,招呼
2020-06-13,1240,198,258,456,崎頂,招呼
2020-06-14,1240,230,294,524,崎頂,招呼
2020-06-15,1240,219,222,441,崎頂,招呼
2020-06-16,1240,219,214,433,崎頂,招呼
2020-06-17,1240,216,212,428,崎頂,招呼
2020-06-18,1240,164,215,379,崎頂,招呼
2020-06-19,1240,209,241,450,崎頂,招呼
2020-06-20,1240,218,212,430,崎頂,招呼
2020-06-21,1240,246,292,538,崎頂,招呼
2020-06-22,1240,177,206,383,崎頂,招呼
2020-06-23,1240,187,182,369,崎頂,招呼
2020-06-24,1240,185,236,421,崎頂,招呼
2020-06-25,1240,202,285,487,崎頂,招呼
2020-06-26,1240,277,306,583,崎頂,招呼
2020-06-27,1240,251,281,532,崎頂,招呼
2020-06-28,1240,235,243,478,崎頂,招呼
2020-06-29,1240,237,240,477,崎頂,招呼
2020-06-30,1240,176,187,363,崎頂,招呼
2020-07-01,1240,186,184,370,崎頂,招呼
2020-07-02,1240,177,199,376,崎頂,招呼
2020-07-03,1240,190,226,416,崎頂,招呼
2020-07-04,1240,175,228,403,崎頂,招呼
2020-07-05,1240,245,317,562,崎頂,招呼
2020-07-06,1240,207,203,410,崎頂,招呼
2020-07-07,1240,193,208,401,崎頂,招呼
2020-07-08,1240,217,217,434,崎頂,招呼
2020-07-09,1240,203,202,405,崎頂,招呼
2020-07-10,1240,238,242,480,崎頂,招呼
2020-07-11,1240,235,289,524,崎頂,招呼
2020-07-12,1240,216,248,464,崎頂,招呼
2020-07-13,1240,217,233,450,崎頂,招呼
2020-07-14,1240,201,225,426,崎頂,招呼
2020-07-15,1240,196,213,409,崎頂,招呼
2020-07-16,1240,211,209,420,崎頂,招呼
2020-07-17,1240,201,244,445,崎頂,招呼
2020-07-18,1240,203,260,463,崎頂,招呼
2020-07-19,1240,240,293,533,崎頂,招呼
2020-07-20,1240,181,205,386,崎頂,招呼
2020-07-21,1240,205,219,424,崎頂,招呼
2020-07-22,1240,233,240,473,崎頂,招呼
2020-07-23,1240,189,200,389,崎頂,招呼
2020-07-24,1240,203,272,475,崎頂,招呼
2020-07-25,1240,181,215,396,崎頂,招呼
2020-07-26,1240,219,278,497,崎頂,招呼
2020-07-27,1240,206,213,419,崎頂,招呼
2020-07-28,1240,185,195,380,崎頂,招呼
2020-07-29,1240,182,196,378,崎頂,招呼
2020-07-30,1240,176,204,380,崎頂,招呼
2020-07-31,1240,224,261,485,崎頂,招呼
2020-08-01,1240,189,202,391,崎頂,招呼
2020-08-02,1240,150,255,405,崎頂,招呼
2020-08-03,1240,155,185,340,崎頂,招呼
2020-08-04,1240,215,227,442,崎頂,招呼
2020-08-05,1240,204,232,436,崎頂,招呼
2020-08-06,1240,226,253,479,崎頂,招呼
2020-08-07,1240,230,282,512,崎頂,招呼
2020-08-08,1240,211,228,439,崎頂,招呼
2020-08-09,1240,191,265,456,崎頂,招呼
2020-08-10,1240,175,192,367,崎頂,招呼
2020-08-11,1240,161,173,334,崎頂,招呼
2020-08-12,1240,184,179,363,崎頂,招呼
2020-08-13,1240,208,214,422,崎頂,招呼
2020-08-14,1240,212,209,421,崎頂,招呼
2020-08-15,1240,260,295,555,崎頂,招呼
2020-08-16,1240,242,299,541,崎頂,招呼
2020-08-17,1240,173,182,355,崎頂,招呼
2020-08-18,1240,176,285,461,崎頂,招呼
2020-08-19,1240,229,241,470,崎頂,招呼
2020-08-20,1240,230,237,467,崎頂,招呼
2020-08-21,1240,265,313,578,崎頂,招呼
2020-08-22,1240,320,307,627,崎頂,招呼
2020-08-23,1240,244,268,512,崎頂,招呼
2020-08-24,1240,196,204,400,崎頂,招呼
2020-08-25,1240,236,252,488,崎頂,招呼
2020-08-26,1240,205,206,411,崎頂,招呼
2020-08-27,1240,215,261,476,崎頂,招呼
2020-08-28,1240,173,204,377,崎頂,招呼
2020-08-29,1240,183,194,377,崎頂,招呼
2020-08-30,1240,204,229,433,崎頂,招呼
2020-08-31,1240,191,214,405,崎頂,招呼
2020-09-01,1240,254,284,538,崎頂,招呼
2020-09-02,1240,186,230,416,崎頂,招呼
2020-09-03,1240,204,206,410,崎頂,招呼
2020-09-04,1240,225,232,457,崎頂,招呼
2020-09-05,1240,221,224,445,崎頂,招呼
2020-09-06,1240,206,236,442,崎頂,招呼
2020-09-07,1240,197,224,421,崎頂,招呼
2020-09-08,1240,188,187,375,崎頂,招呼
2020-09-09,1240,152,182,334,崎頂,招呼
2020-09-10,1240,176,203,379,崎頂,招呼
2020-09-11,1240,253,283,536,崎頂,招呼
2020-09-12,1240,241,247,488,崎頂,招呼
2020-09-13,1240,248,290,538,崎頂,招呼
2020-09-14,1240,203,198,401,崎頂,招呼
2020-09-15,1240,186,210,396,崎頂,招呼
2020-09-16,1240,189,199,388,崎頂,招呼
2020-09-17,1240,186,218,404,崎頂,招呼
2020-09-18,1240,243,267,510,崎頂,招呼
2020-09-19,1240,235,249,484,崎頂,招呼
2020-09-20,1240,258,288,546,崎頂,招呼
2020-09-21,1240,225,209,434,崎頂,招呼
2020-09-22,1240,187,210,397,崎頂,招呼
2020-09-23,1240,200,203,403,崎頂,招呼
2020-09-24,1240,194,204,398,崎頂,招呼
2020-09-25,1240,184,217,401,崎頂,招呼
2020-09-26,1240,232,230,462,崎頂,招呼
2020-09-27,1240,166,206,372,崎頂,招呼
2020-09-28,1240,172,180,352,崎頂,招呼
2020-09-29,1240,183,197,380,崎頂,招呼
2020-09-30,1240,193,259,452,崎頂,招呼
2020-10-01,1240,234,327,561,崎頂,招呼
2020-10-02,1240,302,333,635,崎頂,招呼
2020-10-03,1240,310,346,656,崎頂,招呼
2020-10-04,1240,251,261,512,崎頂,招呼
2020-10-05,1240,210,230,440,崎頂,招呼
2020-10-06,1240,208,219,427,崎頂,招呼
2020-10-07,1240,224,231,455,崎頂,招呼
2020-10-08,1240,236,294,530,崎頂,招呼
2020-10-09,1240,284,316,600,崎頂,招呼
2020-10-10,1240,343,365,708,崎頂,招呼
2020-10-11,1240,299,307,606,崎頂,招呼
2020-10-12,1240,218,231,449,崎頂,招呼
2020-10-13,1240,210,296,506,崎頂,招呼
2020-10-14,1240,243,235,478,崎頂,招呼
2020-10-15,1240,236,237,473,崎頂,招呼
2020-10-16,1240,225,286,511,崎頂,招呼
2020-10-17,1240,751,788,1539,崎頂,招呼
2020-10-18,1240,272,301,573,崎頂,招呼
2020-10-19,1240,201,215,416,崎頂,招呼
2020-10-20,1240,296,318,614,崎頂,招呼
2020-10-21,1240,189,187,376,崎頂,招呼
2020-10-22,1240,200,223,423,崎頂,招呼
2020-10-23,1240,193,237,430,崎頂,招呼
2020-10-24,1240,238,289,527,崎頂,招呼
2020-10-25,1240,222,243,465,崎頂,招呼
2020-10-26,1240,202,220,422,崎頂,招呼
2020-10-27,1240,199,200,399,崎頂,招呼
2020-10-28,1240,203,209,412,崎頂,招呼
2020-10-29,1240,220,258,478,崎頂,招呼
2020-10-30,1240,211,241,452,崎頂,招呼
2020-10-31,1240,206,257,463,崎頂,招呼
2020-11-01,1240,235,323,558,崎頂,招呼
2020-11-02,1240,235,242,477,崎頂,招呼
2020-11-03,1240,228,244,472,崎頂,招呼
2020-11-04,1240,198,206,404,崎頂,招呼
2020-11-05,1240,219,228,447,崎頂,招呼
2020-11-06,1240,230,247,477,崎頂,招呼
2020-11-07,1240,220,262,482,崎頂,招呼
2020-11-08,1240,235,294,529,崎頂,招呼
2020-11-09,1240,236,236,472,崎頂,招呼
2020-11-10,1240,189,203,392,崎頂,招呼
2020-11-11,1240,211,228,439,崎頂,招呼
2020-11-12,1240,234,250,484,崎頂,招呼
2020-11-13,1240,227,255,482,崎頂,招呼
2020-11-14,1240,241,279,520,崎頂,招呼
2020-11-15,1240,294,343,637,崎頂,招呼
2020-11-16,1240,221,239,460,崎頂,招呼
2020-11-17,1240,210,232,442,崎頂,招呼
2020-11-18,1240,212,219,431,崎頂,招呼
2020-11-19,1240,233,248,481,崎頂,招呼
2020-11-20,1240,244,278,522,崎頂,招呼
2020-11-21,1240,263,303,566,崎頂,招呼
2020-11-22,1240,277,295,572,崎頂,招呼
2020-11-23,1240,201,228,429,崎頂,招呼
2020-11-24,1240,273,286,559,崎頂,招呼
2020-11-25,1240,212,211,423,崎頂,招呼
2020-11-26,1240,207,232,439,崎頂,招呼
2020-11-27,1240,223,262,485,崎頂,招呼
2020-11-28,1240,191,243,434,崎頂,招呼
2020-11-29,1240,272,322,594,崎頂,招呼
2020-11-30,1240,207,212,419,崎頂,招呼
2020-12-01,1240,205,214,419,崎頂,招呼
2020-12-02,1240,203,227,430,崎頂,招呼
2020-12-03,1240,258,282,540,崎頂,招呼
2020-12-04,1240,238,282,520,崎頂,招呼
2020-12-05,1240,214,237,451,崎頂,招呼
2020-12-06,1240,372,413,785,崎頂,招呼
2020-12-07,1240,209,215,424,崎頂,招呼
2020-12-08,1240,232,252,484,崎頂,招呼
2020-12-09,1240,199,193,392,崎頂,招呼
2020-12-10,1240,190,213,403,崎頂,招呼
2020-12-11,1240,207,266,473,崎頂,招呼
2020-12-12,1240,256,268,524,崎頂,招呼
2020-12-13,1240,248,276,524,崎頂,招呼
2020-12-14,1240,201,207,408,崎頂,招呼
2020-12-15,1240,200,216,416,崎頂,招呼
2020-12-16,1240,182,185,367,崎頂,招呼
2020-12-17,1240,212,227,439,崎頂,招呼
2020-12-18,1240,200,231,431,崎頂,招呼
2020-12-19,1240,200,220,420,崎頂,招呼
2020-12-20,1240,193,250,443,崎頂,招呼
2020-12-21,1240,195,386,581,崎頂,招呼
2020-12-22,1240,204,233,437,崎頂,招呼
2020-12-23,1240,192,199,391,崎頂,招呼
2020-12-24,1240,186,192,378,崎頂,招呼
2020-12-25,1240,232,244,476,崎頂,招呼
2020-12-26,1240,223,294,517,崎頂,招呼
2020-12-27,1240,192,212,404,崎頂,招呼
2020-12-28,1240,237,224,461,崎頂,招呼
2020-12-29,1240,203,204,407,崎頂,招呼
2020-12-30,1240,178,210,388,崎頂,招呼
2020-12-31,1240,202,228,430,崎頂,招呼
2020-01-01,1250,8516,9140,17656,竹南,一等
2020-01-02,1250,7952,8062,16014,竹南,一等
2020-01-03,1250,9326,9589,18915,竹南,一等
2020-01-04,1250,8661,8595,17256,竹南,一等
2020-01-05,1250,8298,8247,16545,竹南,一等
2020-01-06,1250,8145,8204,16349,竹南,一等
2020-01-07,1250,8001,8074,16075,竹南,一等
2020-01-08,1250,8033,8033,16066,竹南,一等
2020-01-09,1250,8021,8331,16352,竹南,一等
2020-01-10,1250,10859,11570,22429,竹南,一等
2020-01-11,1250,9256,9100,18356,竹南,一等
2020-01-12,1250,9350,9274,18624,竹南,一等
2020-01-13,1250,8500,8454,16954,竹南,一等
2020-01-14,1250,7998,8084,16082,竹南,一等
2020-01-15,1250,8062,8073,16135,竹南,一等
2020-01-16,1250,8670,8802,17472,竹南,一等
2020-01-17,1250,8691,8707,17398,竹南,一等
2020-01-18,1250,8455,8413,16868,竹南,一等
2020-01-19,1250,7912,8056,15968,竹南,一等
2020-01-20,1250,7903,8018,15921,竹南,一等
2020-01-21,1250,8099,8154,16253,竹南,一等
2020-01-22,1250,9493,8949,18442,竹南,一等
2020-01-23,1250,7064,7833,14897,竹南,一等
2020-01-24,1250,5927,6551,12478,竹南,一等
2020-01-25,1250,7312,6928,14240,竹南,一等
2020-01-26,1250,6830,6937,13767,竹南,一等
2020-01-27,1250,8408,8139,16547,竹南,一等
2020-01-28,1250,7855,7404,15259,竹南,一等
2020-01-29,1250,7146,7138,14284,竹南,一等
2020-01-30,1250,6743,6631,13374,竹南,一等
2020-01-31,1250,7534,7235,14769,竹南,一等
2020-02-01,1250,6500,6006,12506,竹南,一等
2020-02-02,1250,6385,6597,12982,竹南,一等
2020-02-03,1250,6991,6966,13957,竹南,一等
2020-02-04,1250,6202,6159,12361,竹南,一等
2020-02-05,1250,6568,6563,13131,竹南,一等
2020-02-06,1250,6942,6826,13768,竹南,一等
2020-02-07,1250,7960,7779,15739,竹南,一等
2020-02-08,1250,6851,6863,13714,竹南,一等
2020-02-09,1250,7069,7214,14283,竹南,一等
2020-02-10,1250,7117,7228,14345,竹南,一等
2020-02-11,1250,6893,6656,13549,竹南,一等
2020-02-12,1250,6859,6714,13573,竹南,一等
2020-02-13,1250,6398,6313,12711,竹南,一等
2020-02-14,1250,7673,7388,15061,竹南,一等
2020-02-15,1250,7136,7075,14211,竹南,一等
2020-02-16,1250,6423,6505,12928,竹南,一等
2020-02-17,1250,6509,6425,12934,竹南,一等
2020-02-18,1250,6411,6309,12720,竹南,一等
2020-02-19,1250,6792,6597,13389,竹南,一等
2020-02-20,1250,6629,6789,13418,竹南,一等
2020-02-21,1250,7973,7826,15799,竹南,一等
2020-02-22,1250,6891,6630,13521,竹南,一等
2020-02-23,1250,6887,7025,13912,竹南,一等
2020-02-24,1250,6847,6548,13395,竹南,一等
2020-02-25,1250,7324,7391,14715,竹南,一等
2020-02-26,1250,7357,7279,14636,竹南,一等
2020-02-27,1250,9103,9166,18269,竹南,一等
2020-02-28,1250,6954,6911,13865,竹南,一等
2020-02-29,1250,5951,5727,11678,竹南,一等
2020-03-01,1250,7471,7120,14591,竹南,一等
2020-03-02,1250,7450,7513,14963,竹南,一等
2020-03-03,1250,6841,6877,13718,竹南,一等
2020-03-04,1250,6902,6914,13816,竹南,一等
2020-03-05,1250,6638,6846,13484,竹南,一等
2020-03-06,1250,8681,9404,18085,竹南,一等
2020-03-07,1250,6216,6179,12395,竹南,一等
2020-03-08,1250,7195,6654,13849,竹南,一等
2020-03-09,1250,7537,7430,14967,竹南,一等
2020-03-10,1250,6496,6597,13093,竹南,一等
2020-03-11,1250,7297,7406,14703,竹南,一等
2020-03-12,1250,6986,7165,14151,竹南,一等
2020-03-13,1250,8725,9623,18348,竹南,一等
2020-03-14,1250,6017,6257,12274,竹南,一等
2020-03-15,1250,7434,6874,14308,竹南,一等
2020-03-16,1250,7541,7378,14919,竹南,一等
2020-03-17,1250,7010,7173,14183,竹南,一等
2020-03-18,1250,6780,6881,13661,竹南,一等
2020-03-19,1250,6329,6481,12810,竹南,一等
2020-03-20,1250,8068,8946,17014,竹南,一等
2020-03-21,1250,5256,5482,10738,竹南,一等
2020-03-22,1250,6168,5530,11698,竹南,一等
2020-03-23,1250,7054,6976,14030,竹南,一等
2020-03-24,1250,6489,6495,12984,竹南,一等
2020-03-25,1250,6453,6535,12988,竹南,一等
2020-03-26,1250,6446,6582,13028,竹南,一等
2020-03-27,1250,7627,8377,16004,竹南,一等
2020-03-28,1250,4145,4389,8534,竹南,一等
2020-03-29,1250,5221,4905,10126,竹南,一等
2020-03-30,1250,6579,6567,13146,竹南,一等
2020-03-31,1250,6245,6605,12850,竹南,一等
2020-04-01,1250,7617,8291,15908,竹南,一等
2020-04-02,1250,5144,5347,10491,竹南,一等
2020-04-03,1250,4798,5116,9914,竹南,一等
2020-04-04,1250,3949,3823,7772,竹南,一等
2020-04-05,1250,5954,5218,11172,竹南,一等
2020-04-06,1250,6736,6382,13118,竹南,一等
2020-04-07,1250,5980,5944,11924,竹南,一等
2020-04-08,1250,6246,6332,12578,竹南,一等
2020-04-09,1250,6087,6291,12378,竹南,一等
2020-04-10,1250,7529,8133,15662,竹南,一等
2020-04-11,1250,4432,4530,8962,竹南,一等
2020-04-12,1250,5300,4953,10253,竹南,一等
2020-04-13,1250,6592,6490,13082,竹南,一等
2020-04-14,1250,6292,6322,12614,竹南,一等
2020-04-15,1250,6387,6557,12944,竹南,一等
2020-04-16,1250,6269,6440,12709,竹南,一等
2020-04-17,1250,7896,8519,16415,竹南,一等
2020-04-18,1250,5315,5551,10866,竹南,一等
2020-04-19,1250,5980,5528,11508,竹南,一等
2020-04-20,1250,6703,6641,13344,竹南,一等
2020-04-21,1250,6106,6140,12246,竹南,一等
2020-04-22,1250,5990,6083,12073,竹南,一等
2020-04-23,1250,5731,5916,11647,竹南,一等
2020-04-24,1250,7174,7808,14982,竹南,一等
2020-04-25,1250,4510,4681,9191,竹南,一等
2020-04-26,1250,4978,4516,9494,竹南,一等
2020-04-27,1250,6571,6394,12965,竹南,一等
2020-04-28,1250,6344,6484,12828,竹南,一等
2020-04-29,1250,6269,6410,12679,竹南,一等
2020-04-30,1250,7210,7145,14355,竹南,一等
2020-05-01,1250,6982,8238,15220,竹南,一等
2020-05-02,1250,5016,5240,10256,竹南,一等
2020-05-03,1250,6478,5795,12273,竹南,一等
2020-05-04,1250,7049,6856,13905,竹南,一等
2020-05-05,1250,6500,6472,12972,竹南,一等
2020-05-06,1250,6567,6599,13166,竹南,一等
2020-05-07,1250,6605,6794,13399,竹南,一等
2020-05-08,1250,8373,9750,18123,竹南,一等
2020-05-09,1250,5731,6442,12173,竹南,一等
2020-05-10,1250,7692,6207,13899,竹南,一等
2020-05-11,1250,7383,7130,14513,竹南,一等
2020-05-12,1250,6578,6593,13171,竹南,一等
2020-05-13,1250,6752,6844,13596,竹南,一等
2020-05-14,1250,6832,7048,13880,竹南,一等
2020-05-15,1250,8818,9677,18495,竹南,一等
2020-05-16,1250,5704,5765,11469,竹南,一等
2020-05-17,1250,6887,6274,13161,竹南,一等
2020-05-18,1250,6817,6740,13557,竹南,一等
2020-05-19,1250,6109,6274,12383,竹南,一等
2020-05-20,1250,6743,7123,13866,竹南,一等
2020-05-21,1250,6360,6454,12814,竹南,一等
2020-05-22,1250,7284,8029,15313,竹南,一等
2020-05-23,1250,5114,5302,10416,竹南,一等
2020-05-24,1250,7162,6582,13744,竹南,一等
2020-05-25,1250,7392,7241,14633,竹南,一等
2020-05-26,1250,6602,6607,13209,竹南,一等
2020-05-27,1250,6326,6492,12818,竹南,一等
2020-05-28,1250,6237,6402,12639,竹南,一等
2020-05-29,1250,8348,9025,17373,竹南,一等
2020-05-30,1250,6685,6711,13396,竹南,一等
2020-05-31,1250,7543,7078,14621,竹南,一等
2020-06-01,1250,7357,7312,14669,竹南,一等
2020-06-02,1250,6865,6806,13671,竹南,一等
2020-06-03,1250,6783,6868,13651,竹南,一等
2020-06-04,1250,6748,6821,13569,竹南,一等
2020-06-05,1250,8655,9233,17888,竹南,一等
2020-06-06,1250,6928,6863,13791,竹南,一等
2020-06-07,1250,7335,7030,14365,竹南,一等
2020-06-08,1250,7034,6868,13902,竹南,一等
2020-06-09,1250,6803,6814,13617,竹南,一等
2020-06-10,1250,7178,7345,14523,竹南,一等
2020-06-11,1250,7203,7269,14472,竹南,一等
2020-06-12,1250,8903,9438,18341,竹南,一等
2020-06-13,1250,7624,7708,15332,竹南,一等
2020-06-14,1250,7900,7635,15535,竹南,一等
2020-06-15,1250,7896,7818,15714,竹南,一等
2020-06-16,1250,7183,7171,14354,竹南,一等
2020-06-17,1250,7046,7207,14253,竹南,一等
2020-06-18,1250,7033,7060,14093,竹南,一等
2020-06-19,1250,7826,7881,15707,竹南,一等
2020-06-20,1250,7355,7329,14684,竹南,一等
2020-06-21,1250,7089,7319,14408,竹南,一等
2020-06-22,1250,7565,7395,14960,竹南,一等
2020-06-23,1250,7129,7246,14375,竹南,一等
2020-06-24,1250,9097,9752,18849,竹南,一等
2020-06-25,1250,7366,8116,15482,竹南,一等
2020-06-26,1250,8284,8191,16475,竹南,一等
2020-06-27,1250,7595,7320,14915,竹南,一等
2020-06-28,1250,8157,7921,16078,竹南,一等
2020-06-29,1250,7960,7658,15618,竹南,一等
2020-06-30,1250,7247,7177,14424,竹南,一等
2020-07-01,1250,6905,6901,13806,竹南,一等
2020-07-02,1250,6798,6866,13664,竹南,一等
2020-07-03,1250,8128,8352,16480,竹南,一等
2020-07-04,1250,8272,8270,16542,竹南,一等
2020-07-05,1250,7495,7912,15407,竹南,一等
2020-07-06,1250,7468,7521,14989,竹南,一等
2020-07-07,1250,7252,6986,14238,竹南,一等
2020-07-08,1250,7212,7331,14543,竹南,一等
2020-07-09,1250,7178,7405,14583,竹南,一等
2020-07-10,1250,9077,8996,18073,竹南,一等
2020-07-11,1250,7834,7692,15526,竹南,一等
2020-07-12,1250,8601,8772,17373,竹南,一等
2020-07-13,1250,8845,8634,17479,竹南,一等
2020-07-14,1250,7665,7815,15480,竹南,一等
2020-07-15,1250,7281,7179,14460,竹南,一等
2020-07-16,1250,7139,6960,14099,竹南,一等
2020-07-17,1250,8745,8400,17145,竹南,一等
2020-07-18,1250,8012,7911,15923,竹南,一等
2020-07-19,1250,7756,8116,15872,竹南,一等
2020-07-20,1250,7713,7393,15106,竹南,一等
2020-07-21,1250,7128,6934,14062,竹南,一等
2020-07-22,1250,7285,7307,14592,竹南,一等
2020-07-23,1250,7418,7265,14683,竹南,一等
2020-07-24,1250,9050,8720,17770,竹南,一等
2020-07-25,1250,7743,7511,15254,竹南,一等
2020-07-26,1250,7643,7901,15544,竹南,一等
2020-07-27,1250,7538,7408,14946,竹南,一等
2020-07-28,1250,7240,7014,14254,竹南,一等
2020-07-29,1250,7204,7174,14378,竹南,一等
2020-07-30,1250,7276,7144,14420,竹南,一等
2020-07-31,1250,8831,8588,17419,竹南,一等
2020-08-01,1250,7709,7384,15093,竹南,一等
2020-08-02,1250,7290,7555,14845,竹南,一等
2020-08-03,1250,7077,7111,14188,竹南,一等
2020-08-04,1250,7053,6936,13989,竹南,一等
2020-08-05,1250,7299,7307,14606,竹南,一等
2020-08-06,1250,7554,7604,15158,竹南,一等
2020-08-07,1250,9442,9329,18771,竹南,一等
2020-08-08,1250,7353,7368,14721,竹南,一等
2020-08-09,1250,8206,8118,16324,竹南,一等
2020-08-10,1250,7785,7753,15538,竹南,一等
2020-08-11,1250,6986,7102,14088,竹南,一等
2020-08-12,1250,7285,7109,14394,竹南,一等
2020-08-13,1250,7482,7434,14916,竹南,一等
2020-08-14,1250,9023,9027,18050,竹南,一等
2020-08-15,1250,8059,7842,15901,竹南,一等
2020-08-16,1250,8464,8566,17030,竹南,一等
2020-08-17,1250,7656,7864,15520,竹南,一等
2020-08-18,1250,7358,7365,14723,竹南,一等
2020-08-19,1250,7329,7329,14658,竹南,一等
2020-08-20,1250,7410,7486,14896,竹南,一等
2020-08-21,1250,9059,8578,17637,竹南,一等
2020-08-22,1250,7590,7574,15164,竹南,一等
2020-08-23,1250,7544,7850,15394,竹南,一等
2020-08-24,1250,7590,7481,15071,竹南,一等
2020-08-25,1250,7327,7021,14348,竹南,一等
2020-08-26,1250,7193,7164,14357,竹南,一等
2020-08-27,1250,7226,7242,14468,竹南,一等
2020-08-28,1250,8423,8086,16509,竹南,一等
2020-08-29,1250,7480,7162,14642,竹南,一等
2020-08-30,1250,7042,7461,14503,竹南,一等
2020-08-31,1250,7417,7544,14961,竹南,一等
2020-09-01,1250,7169,7255,14424,竹南,一等
2020-09-02,1250,6920,7052,13972,竹南,一等
2020-09-03,1250,7418,7381,14799,竹南,一等
2020-09-04,1250,8960,9106,18066,竹南,一等
2020-09-05,1250,7356,7418,14774,竹南,一等
2020-09-06,1250,7646,7656,15302,竹南,一等
2020-09-07,1250,7813,8092,15905,竹南,一等
2020-09-08,1250,7261,7898,15159,竹南,一等
2020-09-09,1250,7435,7482,14917,竹南,一等
2020-09-10,1250,7454,7599,15053,竹南,一等
2020-09-11,1250,9367,9544,18911,竹南,一等
2020-09-12,1250,7730,7645,15375,竹南,一等
2020-09-13,1250,8632,7991,16623,竹南,一等
2020-09-14,1250,7732,7706,15438,竹南,一等
2020-09-15,1250,7262,7276,14538,竹南,一等
2020-09-16,1250,7455,7439,14894,竹南,一等
2020-09-17,1250,7279,7436,14715,竹南,一等
2020-09-18,1250,9008,10031,19039,竹南,一等
2020-09-19,1250,8042,8213,16255,竹南,一等
2020-09-20,1250,8480,7940,16420,竹南,一等
2020-09-21,1250,7811,7656,15467,竹南,一等
2020-09-22,1250,7383,7365,14748,竹南,一等
2020-09-23,1250,7246,7401,14647,竹南,一等
2020-09-24,1250,7125,7343,14468,竹南,一等
2020-09-25,1250,8062,8383,16445,竹南,一等
2020-09-26,1250,7401,7679,15080,竹南,一等
2020-09-27,1250,7098,6985,14083,竹南,一等
2020-09-28,1250,7394,7221,14615,竹南,一等
2020-09-29,1250,7403,7405,14808,竹南,一等
2020-09-30,1250,9640,11132,20772,竹南,一等
2020-10-01,1250,8275,9537,17812,竹南,一等
2020-10-02,1250,8905,9053,17958,竹南,一等
2020-10-03,1250,8365,8149,16514,竹南,一等
2020-10-04,1250,9871,8195,18066,竹南,一等
2020-10-05,1250,8193,7764,15957,竹南,一等
2020-10-06,1250,7475,7474,14949,竹南,一等
2020-10-07,1250,7460,7544,15004,竹南,一等
2020-10-08,1250,9191,10231,19422,竹南,一等
2020-10-09,1250,8822,9084,17906,竹南,一等
2020-10-10,1250,7891,7828,15719,竹南,一等
2020-10-11,1250,9544,8531,18075,竹南,一等
2020-10-12,1250,7977,7762,15739,竹南,一等
2020-10-13,1250,7469,7572,15041,竹南,一等
2020-10-14,1250,7555,7728,15283,竹南,一等
2020-10-15,1250,7615,7728,15343,竹南,一等
2020-10-16,1250,9281,10104,19385,竹南,一等
2020-10-17,1250,8401,8615,17016,竹南,一等
2020-10-18,1250,9248,8648,17896,竹南,一等
2020-10-19,1250,8013,7759,15772,竹南,一等
2020-10-20,1250,7633,7746,15379,竹南,一等
2020-10-21,1250,7477,7754,15231,竹南,一等
2020-10-22,1250,7345,7530,14875,竹南,一等
2020-10-23,1250,8783,9721,18504,竹南,一等
2020-10-24,1250,8393,8687,17080,竹南,一等
2020-10-25,1250,8913,8177,17090,竹南,一等
2020-10-26,1250,8010,8083,16093,竹南,一等
2020-10-27,1250,7362,7437,14799,竹南,一等
2020-10-28,1250,7176,7410,14586,竹南,一等
2020-10-29,1250,7180,7447,14627,竹南,一等
2020-10-30,1250,9555,10158,19713,竹南,一等
2020-10-31,1250,7578,7727,15305,竹南,一等
2020-11-01,1250,8836,8204,17040,竹南,一等
2020-11-02,1250,7973,8142,16115,竹南,一等
2020-11-03,1250,7122,7165,14287,竹南,一等
2020-11-04,1250,7240,7416,14656,竹南,一等
2020-11-05,1250,7519,7585,15104,竹南,一等
2020-11-06,1250,9454,10145,19599,竹南,一等
2020-11-07,1250,7835,8139,15974,竹南,一等
2020-11-08,1250,8679,8288,16967,竹南,一等
2020-11-09,1250,8098,8003,16101,竹南,一等
2020-11-10,1250,7415,7378,14793,竹南,一等
2020-11-11,1250,7473,7809,15282,竹南,一等
2020-11-12,1250,7591,7808,15399,竹南,一等
2020-11-13,1250,9287,10353,19640,竹南,一等
2020-11-14,1250,8888,8665,17553,竹南,一等
2020-11-15,1250,10031,9372,19403,竹南,一等
2020-11-16,1250,8348,8437,16785,竹南,一等
2020-11-17,1250,7698,7696,15394,竹南,一等
2020-11-18,1250,7697,7969,15666,竹南,一等
2020-11-19,1250,7784,8003,15787,竹南,一等
2020-11-20,1250,9465,10524,19989,竹南,一等
2020-11-21,1250,8501,8665,17166,竹南,一等
2020-11-22,1250,9673,8883,18556,竹南,一等
2020-11-23,1250,8131,7885,16016,竹南,一等
2020-11-24,1250,7578,7636,15214,竹南,一等
2020-11-25,1250,7598,7691,15289,竹南,一等
2020-11-26,1250,7901,8149,16050,竹南,一等
2020-11-27,1250,9422,10455,19877,竹南,一等
2020-11-28,1250,8168,8333,16501,竹南,一等
2020-11-29,1250,8978,8099,17077,竹南,一等
2020-11-30,1250,8140,7947,16087,竹南,一等
2020-12-01,1250,7522,8420,15942,竹南,一等
2020-12-02,1250,7395,7597,14992,竹南,一等
2020-12-03,1250,7411,7569,14980,竹南,一等
2020-12-04,1250,9190,10250,19440,竹南,一等
2020-12-05,1250,9158,9105,18263,竹南,一等
2020-12-06,1250,9917,9448,19365,竹南,一等
2020-12-07,1250,8309,7937,16246,竹南,一等
2020-12-08,1250,7445,7445,14890,竹南,一等
2020-12-09,1250,6920,7078,13998,竹南,一等
2020-12-10,1250,7319,7430,14749,竹南,一等
2020-12-11,1250,9291,10524,19815,竹南,一等
2020-12-12,1250,9187,9022,18209,竹南,一等
2020-12-13,1250,9687,9510,19197,竹南,一等
2020-12-14,1250,8060,8098,16158,竹南,一等
2020-12-15,1250,7393,7458,14851,竹南,一等
2020-12-16,1250,7528,7771,15299,竹南,一等
2020-12-17,1250,7567,7840,15407,竹南,一等
2020-12-18,1250,9457,10282,19739,竹南,一等
2020-12-19,1250,8708,8563,17271,竹南,一等
2020-12-20,1250,9084,8558,17642,竹南,一等
2020-12-21,1250,7982,7750,15732,竹南,一等
2020-12-22,1250,7511,7523,15034,竹南,一等
2020-12-23,1250,6991,7120,14111,竹南,一等
2020-12-24,1250,7318,7591,14909,竹南,一等
2020-12-25,1250,9565,10333,19898,竹南,一等
2020-12-26,1250,7893,7897,15790,竹南,一等
2020-12-27,1250,8439,7805,16244,竹南,一等
2020-12-28,1250,7973,7845,15818,竹南,一等
2020-12-29,1250,7531,7471,15002,竹南,一等
2020-12-30,1250,7518,7496,15014,竹南,一等
2020-12-31,1250,9664,10078,19742,竹南,一等
2020-01-01,2110,30,43,73,談文,招呼
2020-01-02,2110,42,39,81,談文,招呼
2020-01-03,2110,42,40,82,談文,招呼
2020-01-04,2110,29,32,61,談文,招呼
2020-01-05,2110,50,49,99,談文,招呼
2020-01-06,2110,41,47,88,談文,招呼
2020-01-07,2110,32,31,63,談文,招呼
2020-01-08,2110,37,35,72,談文,招呼
2020-01-09,2110,31,34,65,談文,招呼
2020-01-10,2110,44,46,90,談文,招呼
2020-01-11,2110,44,53,97,談文,招呼
2020-01-12,2110,33,34,67,談文,招呼
2020-01-13,2110,26,36,62,談文,招呼
2020-01-14,2110,18,22,40,談文,招呼
2020-01-15,2110,25,31,56,談文,招呼
2020-01-16,2110,17,26,43,談文,招呼
2020-01-17,2110,17,31,48,談文,招呼
2020-01-18,2110,48,43,91,談文,招呼
2020-01-19,2110,34,34,68,談文,招呼
2020-01-20,2110,22,29,51,談文,招呼
2020-01-21,2110,57,33,90,談文,招呼
2020-01-22,2110,30,39,69,談文,招呼
2020-01-23,2110,29,42,71,談文,招呼
2020-01-24,2110,34,35,69,談文,招呼
2020-01-25,2110,56,38,94,談文,招呼
2020-01-26,2110,20,39,59,談文,招呼
2020-01-27,2110,30,39,69,談文,招呼
2020-01-28,2110,29,41,70,談文,招呼
2020-01-29,2110,43,40,83,談文,招呼
2020-01-30,2110,21,14,35,談文,招呼
2020-01-31,2110,25,37,62,談文,招呼
2020-02-01,2110,20,23,43,談文,招呼
2020-02-02,2110,41,38,79,談文,招呼
2020-02-03,2110,26,21,47,談文,招呼
2020-02-04,2110,17,23,40,談文,招呼
2020-02-05,2110,29,35,64,談文,招呼
2020-02-06,2110,19,35,54,談文,招呼
2020-02-07,2110,21,35,56,談文,招呼
2020-02-08,2110,23,31,54,談文,招呼
2020-02-09,2110,33,40,73,談文,招呼
2020-02-10,2110,24,27,51,談文,招呼
2020-02-11,2110,18,20,38,談文,招呼
2020-02-12,2110,23,26,49,談文,招呼
2020-02-13,2110,19,25,44,談文,招呼
2020-02-14,2110,23,23,46,談文,招呼
2020-02-15,2110,25,37,62,談文,招呼
2020-02-16,2110,21,23,44,談文,招呼
2020-02-17,2110,26,26,52,談文,招呼
2020-02-18,2110,24,29,53,談文,招呼
2020-02-19,2110,19,24,43,談文,招呼
2020-02-20,2110,28,29,57,談文,招呼
2020-02-21,2110,40,39,79,談文,招呼
2020-02-22,2110,29,34,63,談文,招呼
2020-02-23,2110,32,28,60,談文,招呼
2020-02-24,2110,29,34,63,談文,招呼
2020-02-25,2110,35,42,77,談文,招呼
2020-02-26,2110,19,31,50,談文,招呼
2020-02-27,2110,30,35,65,談文,招呼
2020-02-28,2110,29,32,61,談文,招呼
2020-02-29,2110,11,25,36,談文,招呼
2020-03-01,2110,18,30,48,談文,招呼
2020-03-02,2110,35,32,67,談文,招呼
2020-03-03,2110,33,38,71,談文,招呼
2020-03-04,2110,26,29,55,談文,招呼
2020-03-05,2110,33,33,66,談文,招呼
2020-03-06,2110,44,45,89,談文,招呼
2020-03-07,2110,34,38,72,談文,招呼
2020-03-08,2110,36,27,63,談文,招呼
2020-03-09,2110,38,37,75,談文,招呼
2020-03-10,2110,28,29,57,談文,招呼
2020-03-11,2110,36,40,76,談文,招呼
2020-03-12,2110,35,30,65,談文,招呼
2020-03-13,2110,44,46,90,談文,招呼
2020-03-14,2110,16,21,37,談文,招呼
2020-03-15,2110,31,51,82,談文,招呼
2020-03-16,2110,31,33,64,談文,招呼
2020-03-17,2110,34,37,71,談文,招呼
2020-03-18,2110,29,30,59,談文,招呼
2020-03-19,2110,31,28,59,談文,招呼
2020-03-20,2110,40,23,63,談文,招呼
2020-03-21,2110,26,30,56,談文,招呼
2020-03-22,2110,25,30,55,談文,招呼
2020-03-23,2110,30,35,65,談文,招呼
2020-03-24,2110,35,35,70,談文,招呼
2020-03-25,2110,35,30,65,談文,招呼
2020-03-26,2110,28,24,52,談文,招呼
2020-03-27,2110,40,29,69,談文,招呼
2020-03-28,2110,13,15,28,談文,招呼
2020-03-29,2110,16,27,43,談文,招呼
2020-03-30,2110,21,30,51,談文,招呼
2020-03-31,2110,23,25,48,談文,招呼
2020-04-01,2110,28,32,60,談文,招呼
2020-04-02,2110,15,16,31,談文,招呼
2020-04-03,2110,20,18,38,談文,招呼
2020-04-04,2110,19,33,52,談文,招呼
2020-04-05,2110,20,22,42,談文,招呼
2020-04-06,2110,35,28,63,談文,招呼
2020-04-07,2110,27,30,57,談文,招呼
2020-04-08,2110,29,34,63,談文,招呼
2020-04-09,2110,27,18,45,談文,招呼
2020-04-10,2110,41,27,68,談文,招呼
2020-04-11,2110,14,20,34,談文,招呼
2020-04-12,2110,26,39,65,談文,招呼
2020-04-13,2110,26,29,55,談文,招呼
2020-04-14,2110,24,29,53,談文,招呼
2020-04-15,2110,32,24,56,談文,招呼
2020-04-16,2110,29,33,62,談文,招呼
2020-04-17,2110,42,44,86,談文,招呼
2020-04-18,2110,23,34,57,談文,招呼
2020-04-19,2110,31,32,63,談文,招呼
2020-04-20,2110,30,31,61,談文,招呼
2020-04-21,2110,25,27,52,談文,招呼
2020-04-22,2110,25,27,52,談文,招呼
2020-04-23,2110,20,19,39,談文,招呼
2020-04-24,2110,37,34,71,談文,招呼
2020-04-25,2110,19,23,42,談文,招呼
2020-04-26,2110,28,26,54,談文,招呼
2020-04-27,2110,29,36,65,談文,招呼
2020-04-28,2110,32,36,68,談文,招呼
2020-04-29,2110,25,25,50,談文,招呼
2020-04-30,2110,25,28,53,談文,招呼
2020-05-01,2110,40,33,73,談文,招呼
2020-05-02,2110,16,29,45,談文,招呼
2020-05-03,2110,40,31,71,談文,招呼
2020-05-04,2110,30,28,58,談文,招呼
2020-05-05,2110,39,33,72,談文,招呼
2020-05-06,2110,35,38,73,談文,招呼
2020-05-07,2110,31,33,64,談文,招呼
2020-05-08,2110,36,38,74,談文,招呼
2020-05-09,2110,24,32,56,談文,招呼
2020-05-10,2110,30,35,65,談文,招呼
2020-05-11,2110,33,37,70,談文,招呼
2020-05-12,2110,31,27,58,談文,招呼
2020-05-13,2110,28,24,52,談文,招呼
2020-05-14,2110,31,37,68,談文,招呼
2020-05-15,2110,32,27,59,談文,招呼
2020-05-16,2110,20,45,65,談文,招呼
2020-05-17,2110,16,12,28,談文,招呼
2020-05-18,2110,28,23,51,談文,招呼
2020-05-19,2110,22,19,41,談文,招呼
2020-05-20,2110,27,33,60,談文,招呼
2020-05-21,2110,28,31,59,談文,招呼
2020-05-22,2110,34,28,62,談文,招呼
2020-05-23,2110,23,30,53,談文,招呼
2020-05-24,2110,28,40,68,談文,招呼
2020-05-25,2110,32,36,68,談文,招呼
2020-05-26,2110,24,33,57,談文,招呼
2020-05-27,2110,20,31,51,談文,招呼
2020-05-28,2110,31,28,59,談文,招呼
2020-05-29,2110,44,58,102,談文,招呼
2020-05-30,2110,28,38,66,談文,招呼
2020-05-31,2110,115,114,229,談文,招呼
2020-06-01,2110,31,35,66,談文,招呼
2020-06-02,2110,26,26,52,談文,招呼
2020-06-03,2110,24,25,49,談文,招呼
2020-06-04,2110,29,30,59,談文,招呼
2020-06-05,2110,41,34,75,談文,招呼
2020-06-06,2110,25,38,63,談文,招呼
2020-06-07,2110,21,23,44,談文,招呼
2020-06-08,2110,21,19,40,談文,招呼
2020-06-09,2110,27,30,57,談文,招呼
2020-06-10,2110,22,25,47,談文,招呼
2020-06-11,2110,21,25,46,談文,招呼
2020-06-12,2110,37,7,44,談文,招呼
2020-06-13,2110,28,12,40,談文,招呼
2020-06-14,2110,25,31,56,談文,招呼
2020-06-15,2110,28,22,50,談文,招呼
2020-06-16,2110,31,34,65,談文,招呼
2020-06-17,2110,22,19,41,談文,招呼
2020-06-18,2110,28,24,52,談文,招呼
2020-06-19,2110,32,35,67,談文,招呼
2020-06-20,2110,19,32,51,談文,招呼
2020-06-21,2110,28,25,53,談文,招呼
2020-06-22,2110,26,45,71,談文,招呼
2020-06-23,2110,34,39,73,談文,招呼
2020-06-24,2110,26,30,56,談文,招呼
2020-06-25,2110,29,29,58,談文,招呼
2020-06-26,2110,28,33,61,談文,招呼
2020-06-27,2110,31,32,63,談文,招呼
2020-06-28,2110,26,35,61,談文,招呼
2020-06-29,2110,25,28,53,談文,招呼
2020-06-30,2110,32,25,57,談文,招呼
2020-07-01,2110,20,25,45,談文,招呼
2020-07-02,2110,32,26,58,談文,招呼
2020-07-03,2110,30,40,70,談文,招呼
2020-07-04,2110,42,41,83,談文,招呼
2020-07-05,2110,31,45,76,談文,招呼
2020-07-06,2110,36,33,69,談文,招呼
2020-07-07,2110,20,28,48,談文,招呼
2020-07-08,2110,23,33,56,談文,招呼
2020-07-09,2110,25,36,61,談文,招呼
2020-07-10,2110,32,35,67,談文,招呼
2020-07-11,2110,45,45,90,談文,招呼
2020-07-12,2110,51,54,105,談文,招呼
2020-07-13,2110,43,44,87,談文,招呼
2020-07-14,2110,35,40,75,談文,招呼
2020-07-15,2110,27,27,54,談文,招呼
2020-07-16,2110,19,54,73,談文,招呼
2020-07-17,2110,28,33,61,談文,招呼
2020-07-18,2110,28,44,72,談文,招呼
2020-07-19,2110,41,31,72,談文,招呼
2020-07-20,2110,22,24,46,談文,招呼
2020-07-21,2110,25,32,57,談文,招呼
2020-07-22,2110,22,36,58,談文,招呼
2020-07-23,2110,27,32,59,談文,招呼
2020-07-24,2110,38,47,85,談文,招呼
2020-07-25,2110,29,47,76,談文,招呼
2020-07-26,2110,63,47,110,談文,招呼
2020-07-27,2110,25,29,54,談文,招呼
2020-07-28,2110,28,27,55,談文,招呼
2020-07-29,2110,21,21,42,談文,招呼
2020-07-30,2110,27,25,52,談文,招呼
2020-07-31,2110,20,38,58,談文,招呼
2020-08-01,2110,47,58,105,談文,招呼
2020-08-02,2110,27,33,60,談文,招呼
2020-08-03,2110,25,31,56,談文,招呼
2020-08-04,2110,30,36,66,談文,招呼
2020-08-05,2110,33,43,76,談文,招呼
2020-08-06,2110,33,38,71,談文,招呼
2020-08-07,2110,26,33,59,談文,招呼
2020-08-08,2110,16,31,47,談文,招呼
2020-08-09,2110,42,44,86,談文,招呼
2020-08-10,2110,26,30,56,談文,招呼
2020-08-11,2110,30,42,72,談文,招呼
2020-08-12,2110,27,24,51,談文,招呼
2020-08-13,2110,23,27,50,談文,招呼
2020-08-14,2110,21,22,43,談文,招呼
2020-08-15,2110,49,48,97,談文,招呼
2020-08-16,2110,42,53,95,談文,招呼
2020-08-17,2110,24,24,48,談文,招呼
2020-08-18,2110,20,23,43,談文,招呼
2020-08-19,2110,21,25,46,談文,招呼
2020-08-20,2110,30,31,61,談文,招呼
2020-08-21,2110,31,37,68,談文,招呼
2020-08-22,2110,15,27,42,談文,招呼
2020-08-23,2110,49,43,92,談文,招呼
2020-08-24,2110,29,29,58,談文,招呼
2020-08-25,2110,28,38,66,談文,招呼
2020-08-26,2110,27,31,58,談文,招呼
2020-08-27,2110,23,30,53,談文,招呼
2020-08-28,2110,29,41,70,談文,招呼
2020-08-29,2110,29,39,68,談文,招呼
2020-08-30,2110,47,50,97,談文,招呼
2020-08-31,2110,26,28,54,談文,招呼
2020-09-01,2110,32,35,67,談文,招呼
2020-09-02,2110,27,33,60,談文,招呼
2020-09-03,2110,31,35,66,談文,招呼
2020-09-04,2110,30,33,63,談文,招呼
2020-09-05,2110,21,25,46,談文,招呼
2020-09-06,2110,20,26,46,談文,招呼
2020-09-07,2110,34,34,68,談文,招呼
2020-09-08,2110,30,39,69,談文,招呼
2020-09-09,2110,26,33,59,談文,招呼
2020-09-10,2110,34,34,68,談文,招呼
2020-09-11,2110,34,44,78,談文,招呼
2020-09-12,2110,30,29,59,談文,招呼
2020-09-13,2110,40,41,81,談文,招呼
2020-09-14,2110,34,35,69,談文,招呼
2020-09-15,2110,28,37,65,談文,招呼
2020-09-16,2110,50,56,106,談文,招呼
2020-09-17,2110,23,23,46,談文,招呼
2020-09-18,2110,30,37,67,談文,招呼
2020-09-19,2110,32,37,69,談文,招呼
2020-09-20,2110,36,39,75,談文,招呼
2020-09-21,2110,33,31,64,談文,招呼
2020-09-22,2110,23,25,48,談文,招呼
2020-09-23,2110,27,24,51,談文,招呼
2020-09-24,2110,30,29,59,談文,招呼
2020-09-25,2110,36,30,66,談文,招呼
2020-09-26,2110,30,47,77,談文,招呼
2020-09-27,2110,56,48,104,談文,招呼
2020-09-28,2110,27,26,53,談文,招呼
2020-09-29,2110,33,33,66,談文,招呼
2020-09-30,2110,42,43,85,談文,招呼
2020-10-01,2110,26,47,73,談文,招呼
2020-10-02,2110,43,56,99,談文,招呼
2020-10-03,2110,22,39,61,談文,招呼
2020-10-04,2110,28,42,70,談文,招呼
2020-10-05,2110,31,34,65,談文,招呼
2020-10-06,2110,27,27,54,談文,招呼
2020-10-07,2110,43,43,86,談文,招呼
2020-10-08,2110,36,40,76,談文,招呼
2020-10-09,2110,42,46,88,談文,招呼
2020-10-10,2110,30,42,72,談文,招呼
2020-10-11,2110,40,56,96,談文,招呼
2020-10-12,2110,34,27,61,談文,招呼
2020-10-13,2110,29,36,65,談文,招呼
2020-10-14,2110,37,29,66,談文,招呼
2020-10-15,2110,39,32,71,談文,招呼
2020-10-16,2110,47,45,92,談文,招呼
2020-10-17,2110,39,47,86,談文,招呼
2020-10-18,2110,50,51,101,談文,招呼
2020-10-19,2110,33,43,76,談文,招呼
2020-10-20,2110,32,33,65,談文,招呼
2020-10-21,2110,29,36,65,談文,招呼
2020-10-22,2110,35,38,73,談文,招呼
2020-10-23,2110,43,40,83,談文,招呼
2020-10-24,2110,28,34,62,談文,招呼
2020-10-25,2110,42,42,84,談文,招呼
2020-10-26,2110,34,33,67,談文,招呼
2020-10-27,2110,51,61,112,談文,招呼
2020-10-28,2110,36,38,74,談文,招呼
2020-10-29,2110,34,35,69,談文,招呼
2020-10-30,2110,44,49,93,談文,招呼
2020-10-31,2110,32,37,69,談文,招呼
2020-11-01,2110,42,40,82,談文,招呼
2020-11-02,2110,36,35,71,談文,招呼
2020-11-03,2110,29,30,59,談文,招呼
2020-11-04,2110,32,37,69,談文,招呼
2020-11-05,2110,38,46,84,談文,招呼
2020-11-06,2110,48,49,97,談文,招呼
2020-11-07,2110,24,35,59,談文,招呼
2020-11-08,2110,25,26,51,談文,招呼
2020-11-09,2110,51,54,105,談文,招呼
2020-11-10,2110,36,36,72,談文,招呼
2020-11-11,2110,28,34,62,談文,招呼
2020-11-12,2110,30,32,62,談文,招呼
2020-11-13,2110,30,32,62,談文,招呼
2020-11-14,2110,27,33,60,談文,招呼
2020-11-15,2110,30,34,64,談文,招呼
2020-11-16,2110,38,35,73,談文,招呼
2020-11-17,2110,39,44,83,談文,招呼
2020-11-18,2110,30,27,57,談文,招呼
2020-11-19,2110,57,43,100,談文,招呼
2020-11-20,2110,39,47,86,談文,招呼
2020-11-21,2110,21,31,52,談文,招呼
2020-11-22,2110,37,62,99,談文,招呼
2020-11-23,2110,30,29,59,談文,招呼
2020-11-24,2110,37,30,67,談文,招呼
2020-11-25,2110,41,48,89,談文,招呼
2020-11-26,2110,29,40,69,談文,招呼
2020-11-27,2110,40,45,85,談文,招呼
2020-11-28,2110,32,46,78,談文,招呼
2020-11-29,2110,23,32,55,談文,招呼
2020-11-30,2110,27,35,62,談文,招呼
2020-12-01,2110,35,39,74,談文,招呼
2020-12-02,2110,38,42,80,談文,招呼
2020-12-03,2110,31,33,64,談文,招呼
2020-12-04,2110,32,35,67,談文,招呼
2020-12-05,2110,31,38,69,談文,招呼
2020-12-06,2110,123,146,269,談文,招呼
2020-12-07,2110,40,40,80,談文,招呼
2020-12-08,2110,37,40,77,談文,招呼
2020-12-09,2110,25,36,61,談文,招呼
2020-12-10,2110,30,34,64,談文,招呼
2020-12-11,2110,34,35,69,談文,招呼
2020-12-12,2110,46,54,100,談文,招呼
2020-12-13,2110,53,58,111,談文,招呼
2020-12-14,2110,31,38,69,談文,招呼
2020-12-15,2110,64,34,98,談文,招呼
2020-12-16,2110,25,33,58,談文,招呼
2020-12-17,2110,42,44,86,談文,招呼
2020-12-18,2110,51,57,108,談文,招呼
2020-12-19,2110,65,67,132,談文,招呼
2020-12-20,2110,53,56,109,談文,招呼
2020-12-21,2110,30,31,61,談文,招呼
2020-12-22,2110,30,34,64,談文,招呼
2020-12-23,2110,33,29,62,談文,招呼
2020-12-24,2110,45,39,84,談文,招呼
2020-12-25,2110,43,41,84,談文,招呼
2020-12-26,2110,33,31,64,談文,招呼
2020-12-27,2110,41,49,90,談文,招呼
2020-12-28,2110,33,33,66,談文,招呼
2020-12-29,2110,32,43,75,談文,招呼
2020-12-30,2110,31,37,68,談文,招呼
2020-12-31,2110,51,35,86,談文,招呼
2020-01-01,2120,95,111,206,大山,甲簡
2020-01-02,2120,121,130,251,大山,甲簡
2020-01-03,2120,132,142,274,大山,甲簡
2020-01-04,2120,112,127,239,大山,甲簡
2020-01-05,2120,100,101,201,大山,甲簡
2020-01-06,2120,118,128,246,大山,甲簡
2020-01-07,2120,112,142,254,大山,甲簡
2020-01-08,2120,125,134,259,大山,甲簡
2020-01-09,2120,130,128,258,大山,甲簡
2020-01-10,2120,113,140,253,大山,甲簡
2020-01-11,2120,102,116,218,大山,甲簡
2020-01-12,2120,101,109,210,大山,甲簡
2020-01-13,2120,126,132,258,大山,甲簡
2020-01-14,2120,134,153,287,大山,甲簡
2020-01-15,2120,126,130,256,大山,甲簡
2020-01-16,2120,136,145,281,大山,甲簡
2020-01-17,2120,97,106,203,大山,甲簡
2020-01-18,2120,91,103,194,大山,甲簡
2020-01-19,2120,76,79,155,大山,甲簡
2020-01-20,2120,105,105,210,大山,甲簡
2020-01-21,2120,119,105,224,大山,甲簡
2020-01-22,2120,110,133,243,大山,甲簡
2020-01-23,2120,90,131,221,大山,甲簡
2020-01-24,2120,80,88,168,大山,甲簡
2020-01-25,2120,116,135,251,大山,甲簡
2020-01-26,2120,69,66,135,大山,甲簡
2020-01-27,2120,101,109,210,大山,甲簡
2020-01-28,2120,111,105,216,大山,甲簡
2020-01-29,2120,75,69,144,大山,甲簡
2020-01-30,2120,91,98,189,大山,甲簡
2020-01-31,2120,81,85,166,大山,甲簡
2020-02-01,2120,61,81,142,大山,甲簡
2020-02-02,2120,72,60,132,大山,甲簡
2020-02-03,2120,58,74,132,大山,甲簡
2020-02-04,2120,65,72,137,大山,甲簡
2020-02-05,2120,74,69,143,大山,甲簡
2020-02-06,2120,104,101,205,大山,甲簡
2020-02-07,2120,75,87,162,大山,甲簡
2020-02-08,2120,70,80,150,大山,甲簡
2020-02-09,2120,69,65,134,大山,甲簡
2020-02-10,2120,65,74,139,大山,甲簡
2020-02-11,2120,71,78,149,大山,甲簡
2020-02-12,2120,76,90,166,大山,甲簡
2020-02-13,2120,96,90,186,大山,甲簡
2020-02-14,2120,74,77,151,大山,甲簡
2020-02-15,2120,74,72,146,大山,甲簡
2020-02-16,2120,47,47,94,大山,甲簡
2020-02-17,2120,57,68,125,大山,甲簡
2020-02-18,2120,68,70,138,大山,甲簡
2020-02-19,2120,83,82,165,大山,甲簡
2020-02-20,2120,83,88,171,大山,甲簡
2020-02-21,2120,86,108,194,大山,甲簡
2020-02-22,2120,83,92,175,大山,甲簡
2020-02-23,2120,82,76,158,大山,甲簡
2020-02-24,2120,62,68,130,大山,甲簡
2020-02-25,2120,114,116,230,大山,甲簡
2020-02-26,2120,106,117,223,大山,甲簡
2020-02-27,2120,116,137,253,大山,甲簡
2020-02-28,2120,71,86,157,大山,甲簡
2020-02-29,2120,68,88,156,大山,甲簡
2020-03-01,2120,73,65,138,大山,甲簡
2020-03-02,2120,109,125,234,大山,甲簡
2020-03-03,2120,101,125,226,大山,甲簡
2020-03-04,2120,112,123,235,大山,甲簡
2020-03-05,2120,97,110,207,大山,甲簡
2020-03-06,2120,118,147,265,大山,甲簡
2020-03-07,2120,63,71,134,大山,甲簡
2020-03-08,2120,95,71,166,大山,甲簡
2020-03-09,2120,107,106,213,大山,甲簡
2020-03-10,2120,86,109,195,大山,甲簡
2020-03-11,2120,128,137,265,大山,甲簡
2020-03-12,2120,110,122,232,大山,甲簡
2020-03-13,2120,117,139,256,大山,甲簡
2020-03-14,2120,71,76,147,大山,甲簡
2020-03-15,2120,88,88,176,大山,甲簡
2020-03-16,2120,104,106,210,大山,甲簡
2020-03-17,2120,103,122,225,大山,甲簡
2020-03-18,2120,98,116,214,大山,甲簡
2020-03-19,2120,99,112,211,大山,甲簡
2020-03-20,2120,117,134,251,大山,甲簡
2020-03-21,2120,80,80,160,大山,甲簡
2020-03-22,2120,70,57,127,大山,甲簡
2020-03-23,2120,110,116,226,大山,甲簡
2020-03-24,2120,106,106,212,大山,甲簡
2020-03-25,2120,102,113,215,大山,甲簡
2020-03-26,2120,110,125,235,大山,甲簡
2020-03-27,2120,106,111,217,大山,甲簡
2020-03-28,2120,42,60,102,大山,甲簡
2020-03-29,2120,67,59,126,大山,甲簡
2020-03-30,2120,101,105,206,大山,甲簡
2020-03-31,2120,102,106,208,大山,甲簡
2020-04-01,2120,99,124,223,大山,甲簡
2020-04-02,2120,56,81,137,大山,甲簡
2020-04-03,2120,60,83,143,大山,甲簡
2020-04-04,2120,55,69,124,大山,甲簡
2020-04-05,2120,53,37,90,大山,甲簡
2020-04-06,2120,102,95,197,大山,甲簡
2020-04-07,2120,109,109,218,大山,甲簡
2020-04-08,2120,103,109,212,大山,甲簡
2020-04-09,2120,105,104,209,大山,甲簡
2020-04-10,2120,111,133,244,大山,甲簡
2020-04-11,2120,60,63,123,大山,甲簡
2020-04-12,2120,57,53,110,大山,甲簡
2020-04-13,2120,97,106,203,大山,甲簡
2020-04-14,2120,92,93,185,大山,甲簡
2020-04-15,2120,100,108,208,大山,甲簡
2020-04-16,2120,103,108,211,大山,甲簡
2020-04-17,2120,102,119,221,大山,甲簡
2020-04-18,2120,69,70,139,大山,甲簡
2020-04-19,2120,69,67,136,大山,甲簡
2020-04-20,2120,88,103,191,大山,甲簡
2020-04-21,2120,98,96,194,大山,甲簡
2020-04-22,2120,104,109,213,大山,甲簡
2020-04-23,2120,97,98,195,大山,甲簡
2020-04-24,2120,76,115,191,大山,甲簡
2020-04-25,2120,34,50,84,大山,甲簡
2020-04-26,2120,53,50,103,大山,甲簡
2020-04-27,2120,97,91,188,大山,甲簡
2020-04-28,2120,90,97,187,大山,甲簡
2020-04-29,2120,97,109,206,大山,甲簡
2020-04-30,2120,106,120,226,大山,甲簡
2020-05-01,2120,101,128,229,大山,甲簡
2020-05-02,2120,66,79,145,大山,甲簡
2020-05-03,2120,74,64,138,大山,甲簡
2020-05-04,2120,110,118,228,大山,甲簡
2020-05-05,2120,91,100,191,大山,甲簡
2020-05-06,2120,96,102,198,大山,甲簡
2020-05-07,2120,93,100,193,大山,甲簡
2020-05-08,2120,103,123,226,大山,甲簡
2020-05-09,2120,67,87,154,大山,甲簡
2020-05-10,2120,77,70,147,大山,甲簡
2020-05-11,2120,95,99,194,大山,甲簡
2020-05-12,2120,98,108,206,大山,甲簡
2020-05-13,2120,103,107,210,大山,甲簡
2020-05-14,2120,93,95,188,大山,甲簡
2020-05-15,2120,85,121,206,大山,甲簡
2020-05-16,2120,81,90,171,大山,甲簡
2020-05-17,2120,80,78,158,大山,甲簡
2020-05-18,2120,103,98,201,大山,甲簡
2020-05-19,2120,86,97,183,大山,甲簡
2020-05-20,2120,101,100,201,大山,甲簡
2020-05-21,2120,94,90,184,大山,甲簡
2020-05-22,2120,91,97,188,大山,甲簡
2020-05-23,2120,69,73,142,大山,甲簡
2020-05-24,2120,81,94,175,大山,甲簡
2020-05-25,2120,100,105,205,大山,甲簡
2020-05-26,2120,94,119,213,大山,甲簡
2020-05-27,2120,90,104,194,大山,甲簡
2020-05-28,2120,92,104,196,大山,甲簡
2020-05-29,2120,98,129,227,大山,甲簡
2020-05-30,2120,68,80,148,大山,甲簡
2020-05-31,2120,71,59,130,大山,甲簡
2020-06-01,2120,102,111,213,大山,甲簡
2020-06-02,2120,93,100,193,大山,甲簡
2020-06-03,2120,108,124,232,大山,甲簡
2020-06-04,2120,109,115,224,大山,甲簡
2020-06-05,2120,99,120,219,大山,甲簡
2020-06-06,2120,71,88,159,大山,甲簡
2020-06-07,2120,78,86,164,大山,甲簡
2020-06-08,2120,94,87,181,大山,甲簡
2020-06-09,2120,99,95,194,大山,甲簡
2020-06-10,2120,115,121,236,大山,甲簡
2020-06-11,2120,103,105,208,大山,甲簡
2020-06-12,2120,107,138,245,大山,甲簡
2020-06-13,2120,70,87,157,大山,甲簡
2020-06-14,2120,72,74,146,大山,甲簡
2020-06-15,2120,106,114,220,大山,甲簡
2020-06-16,2120,113,117,230,大山,甲簡
2020-06-17,2120,92,105,197,大山,甲簡
2020-06-18,2120,118,119,237,大山,甲簡
2020-06-19,2120,102,121,223,大山,甲簡
2020-06-20,2120,85,118,203,大山,甲簡
2020-06-21,2120,71,73,144,大山,甲簡
2020-06-22,2120,93,97,190,大山,甲簡
2020-06-23,2120,91,107,198,大山,甲簡
2020-06-24,2120,96,116,212,大山,甲簡
2020-06-25,2120,70,100,170,大山,甲簡
2020-06-26,2120,92,95,187,大山,甲簡
2020-06-27,2120,86,86,172,大山,甲簡
2020-06-28,2120,74,68,142,大山,甲簡
2020-06-29,2120,103,105,208,大山,甲簡
2020-06-30,2120,98,103,201,大山,甲簡
2020-07-01,2120,98,115,213,大山,甲簡
2020-07-02,2120,124,134,258,大山,甲簡
2020-07-03,2120,99,98,197,大山,甲簡
2020-07-04,2120,78,81,159,大山,甲簡
2020-07-05,2120,87,95,182,大山,甲簡
2020-07-06,2120,83,89,172,大山,甲簡
2020-07-07,2120,93,97,190,大山,甲簡
2020-07-08,2120,93,109,202,大山,甲簡
2020-07-09,2120,93,90,183,大山,甲簡
2020-07-10,2120,104,122,226,大山,甲簡
2020-07-11,2120,89,99,188,大山,甲簡
2020-07-12,2120,116,107,223,大山,甲簡
2020-07-13,2120,124,133,257,大山,甲簡
2020-07-14,2120,84,101,185,大山,甲簡
2020-07-15,2120,73,78,151,大山,甲簡
2020-07-16,2120,69,63,132,大山,甲簡
2020-07-17,2120,83,93,176,大山,甲簡
2020-07-18,2120,104,115,219,大山,甲簡
2020-07-19,2120,99,88,187,大山,甲簡
2020-07-20,2120,82,88,170,大山,甲簡
2020-07-21,2120,93,106,199,大山,甲簡
2020-07-22,2120,82,89,171,大山,甲簡
2020-07-23,2120,95,98,193,大山,甲簡
2020-07-24,2120,92,105,197,大山,甲簡
2020-07-25,2120,70,100,170,大山,甲簡
2020-07-26,2120,74,69,143,大山,甲簡
2020-07-27,2120,108,99,207,大山,甲簡
2020-07-28,2120,83,86,169,大山,甲簡
2020-07-29,2120,99,108,207,大山,甲簡
2020-07-30,2120,96,98,194,大山,甲簡
2020-07-31,2120,91,112,203,大山,甲簡
2020-08-01,2120,72,88,160,大山,甲簡
2020-08-02,2120,75,66,141,大山,甲簡
2020-08-03,2120,74,92,166,大山,甲簡
2020-08-04,2120,93,103,196,大山,甲簡
2020-08-05,2120,82,92,174,大山,甲簡
2020-08-06,2120,96,96,192,大山,甲簡
2020-08-07,2120,90,114,204,大山,甲簡
2020-08-08,2120,63,78,141,大山,甲簡
2020-08-09,2120,71,64,135,大山,甲簡
2020-08-10,2120,100,94,194,大山,甲簡
2020-08-11,2120,97,89,186,大山,甲簡
2020-08-12,2120,83,87,170,大山,甲簡
2020-08-13,2120,81,88,169,大山,甲簡
2020-08-14,2120,103,105,208,大山,甲簡
2020-08-15,2120,85,74,159,大山,甲簡
2020-08-16,2120,77,78,155,大山,甲簡
2020-08-17,2120,68,70,138,大山,甲簡
2020-08-18,2120,82,85,167,大山,甲簡
2020-08-19,2120,91,90,181,大山,甲簡
2020-08-20,2120,94,85,179,大山,甲簡
2020-08-21,2120,85,83,168,大山,甲簡
2020-08-22,2120,114,124,238,大山,甲簡
2020-08-23,2120,67,70,137,大山,甲簡
2020-08-24,2120,95,106,201,大山,甲簡
2020-08-25,2120,64,85,149,大山,甲簡
2020-08-26,2120,97,96,193,大山,甲簡
2020-08-27,2120,77,89,166,大山,甲簡
2020-08-28,2120,93,97,190,大山,甲簡
2020-08-29,2120,67,70,137,大山,甲簡
2020-08-30,2120,66,73,139,大山,甲簡
2020-08-31,2120,122,87,209,大山,甲簡
2020-09-01,2120,107,107,214,大山,甲簡
2020-09-02,2120,106,110,216,大山,甲簡
2020-09-03,2120,105,113,218,大山,甲簡
2020-09-04,2120,138,138,276,大山,甲簡
2020-09-05,2120,74,86,160,大山,甲簡
2020-09-06,2120,79,77,156,大山,甲簡
2020-09-07,2120,103,109,212,大山,甲簡
2020-09-08,2120,127,129,256,大山,甲簡
2020-09-09,2120,108,109,217,大山,甲簡
2020-09-10,2120,113,119,232,大山,甲簡
2020-09-11,2120,104,134,238,大山,甲簡
2020-09-12,2120,109,107,216,大山,甲簡
2020-09-13,2120,98,107,205,大山,甲簡
2020-09-14,2120,106,110,216,大山,甲簡
2020-09-15,2120,97,121,218,大山,甲簡
2020-09-16,2120,117,114,231,大山,甲簡
2020-09-17,2120,113,116,229,大山,甲簡
2020-09-18,2120,112,140,252,大山,甲簡
2020-09-19,2120,76,90,166,大山,甲簡
2020-09-20,2120,89,79,168,大山,甲簡
2020-09-21,2120,123,118,241,大山,甲簡
2020-09-22,2120,110,125,235,大山,甲簡
2020-09-23,2120,120,124,244,大山,甲簡
2020-09-24,2120,112,118,230,大山,甲簡
2020-09-25,2120,102,113,215,大山,甲簡
2020-09-26,2120,112,122,234,大山,甲簡
2020-09-27,2120,59,56,115,大山,甲簡
2020-09-28,2120,106,100,206,大山,甲簡
2020-09-29,2120,116,168,284,大山,甲簡
2020-09-30,2120,106,129,235,大山,甲簡
2020-10-01,2120,101,162,263,大山,甲簡
2020-10-02,2120,107,117,224,大山,甲簡
2020-10-03,2120,102,86,188,大山,甲簡
2020-10-04,2120,70,71,141,大山,甲簡
2020-10-05,2120,114,109,223,大山,甲簡
2020-10-06,2120,102,110,212,大山,甲簡
2020-10-07,2120,110,119,229,大山,甲簡
2020-10-08,2120,113,128,241,大山,甲簡
2020-10-09,2120,97,116,213,大山,甲簡
2020-10-10,2120,80,90,170,大山,甲簡
2020-10-11,2120,98,85,183,大山,甲簡
2020-10-12,2120,93,108,201,大山,甲簡
2020-10-13,2120,97,110,207,大山,甲簡
2020-10-14,2120,99,118,217,大山,甲簡
2020-10-15,2120,114,128,242,大山,甲簡
2020-10-16,2120,107,133,240,大山,甲簡
2020-10-17,2120,126,137,263,大山,甲簡
2020-10-18,2120,78,64,142,大山,甲簡
2020-10-19,2120,104,107,211,大山,甲簡
2020-10-20,2120,111,123,234,大山,甲簡
2020-10-21,2120,102,115,217,大山,甲簡
2020-10-22,2120,106,113,219,大山,甲簡
2020-10-23,2120,94,135,229,大山,甲簡
2020-10-24,2120,77,109,186,大山,甲簡
2020-10-25,2120,100,84,184,大山,甲簡
2020-10-26,2120,116,112,228,大山,甲簡
2020-10-27,2120,102,99,201,大山,甲簡
2020-10-28,2120,111,121,232,大山,甲簡
2020-10-29,2120,113,112,225,大山,甲簡
2020-10-30,2120,107,127,234,大山,甲簡
2020-10-31,2120,89,100,189,大山,甲簡
2020-11-01,2120,141,95,236,大山,甲簡
2020-11-02,2120,117,115,232,大山,甲簡
2020-11-03,2120,94,111,205,大山,甲簡
2020-11-04,2120,97,113,210,大山,甲簡
2020-11-05,2120,105,115,220,大山,甲簡
2020-11-06,2120,117,144,261,大山,甲簡
2020-11-07,2120,88,96,184,大山,甲簡
2020-11-08,2120,84,71,155,大山,甲簡
2020-11-09,2120,101,119,220,大山,甲簡
2020-11-10,2120,109,129,238,大山,甲簡
2020-11-11,2120,111,117,228,大山,甲簡
2020-11-12,2120,118,124,242,大山,甲簡
2020-11-13,2120,102,139,241,大山,甲簡
2020-11-14,2120,107,110,217,大山,甲簡
2020-11-15,2120,82,79,161,大山,甲簡
2020-11-16,2120,94,97,191,大山,甲簡
2020-11-17,2120,95,107,202,大山,甲簡
2020-11-18,2120,97,109,206,大山,甲簡
2020-11-19,2120,103,110,213,大山,甲簡
2020-11-20,2120,90,120,210,大山,甲簡
2020-11-21,2120,52,87,139,大山,甲簡
2020-11-22,2120,87,77,164,大山,甲簡
2020-11-23,2120,101,105,206,大山,甲簡
2020-11-24,2120,96,112,208,大山,甲簡
2020-11-25,2120,102,114,216,大山,甲簡
2020-11-26,2120,103,113,216,大山,甲簡
2020-11-27,2120,88,119,207,大山,甲簡
2020-11-28,2120,88,101,189,大山,甲簡
2020-11-29,2120,89,76,165,大山,甲簡
2020-11-30,2120,106,105,211,大山,甲簡
2020-12-01,2120,109,112,221,大山,甲簡
2020-12-02,2120,92,111,203,大山,甲簡
2020-12-03,2120,105,114,219,大山,甲簡
2020-12-04,2120,94,119,213,大山,甲簡
2020-12-05,2120,75,86,161,大山,甲簡
2020-12-06,2120,124,92,216,大山,甲簡
2020-12-07,2120,105,116,221,大山,甲簡
2020-12-08,2120,114,139,253,大山,甲簡
2020-12-09,2120,95,104,199,大山,甲簡
2020-12-10,2120,110,129,239,大山,甲簡
2020-12-11,2120,105,129,234,大山,甲簡
2020-12-12,2120,100,95,195,大山,甲簡
2020-12-13,2120,85,82,167,大山,甲簡
2020-12-14,2120,99,102,201,大山,甲簡
2020-12-15,2120,100,117,217,大山,甲簡
2020-12-16,2120,100,110,210,大山,甲簡
2020-12-17,2120,94,104,198,大山,甲簡
2020-12-18,2120,89,107,196,大山,甲簡
2020-12-19,2120,98,102,200,大山,甲簡
2020-12-20,2120,78,83,161,大山,甲簡
2020-12-21,2120,82,99,181,大山,甲簡
2020-12-22,2120,106,120,226,大山,甲簡
2020-12-23,2120,85,99,184,大山,甲簡
2020-12-24,2120,91,112,203,大山,甲簡
2020-12-25,2120,83,109,192,大山,甲簡
2020-12-26,2120,91,95,186,大山,甲簡
2020-12-27,2120,77,65,142,大山,甲簡
2020-12-28,2120,102,115,217,大山,甲簡
2020-12-29,2120,96,109,205,大山,甲簡
2020-12-30,2120,85,90,175,大山,甲簡
2020-12-31,2120,80,105,185,大山,甲簡
2020-01-01,2130,1399,2000,3399,後龍,三等
2020-01-02,2130,1259,1308,2567,後龍,三等
2020-01-03,2130,2162,1358,3520,後龍,三等
2020-01-04,2130,762,1069,1831,後龍,三等
2020-01-05,2130,977,1386,2363,後龍,三等
2020-01-06,2130,1302,1326,2628,後龍,三等
2020-01-07,2130,1287,1253,2540,後龍,三等
2020-01-08,2130,1312,1290,2602,後龍,三等
2020-01-09,2130,1203,1200,2403,後龍,三等
2020-01-10,2130,1728,1573,3301,後龍,三等
2020-01-11,2130,961,958,1919,後龍,三等
2020-01-12,2130,1045,891,1936,後龍,三等
2020-01-13,2130,858,854,1712,後龍,三等
2020-01-14,2130,884,856,1740,後龍,三等
2020-01-15,2130,731,719,1450,後龍,三等
2020-01-16,2130,698,776,1474,後龍,三等
2020-01-17,2130,710,730,1440,後龍,三等
2020-01-18,2130,666,779,1445,後龍,三等
2020-01-19,2130,825,744,1569,後龍,三等
2020-01-20,2130,674,660,1334,後龍,三等
2020-01-21,2130,714,719,1433,後龍,三等
2020-01-22,2130,717,779,1496,後龍,三等
2020-01-23,2130,651,888,1539,後龍,三等
2020-01-24,2130,700,878,1578,後龍,三等
2020-01-25,2130,1051,877,1928,後龍,三等
2020-01-26,2130,1056,990,2046,後龍,三等
2020-01-27,2130,1146,949,2095,後龍,三等
2020-01-28,2130,886,833,1719,後龍,三等
2020-01-29,2130,726,604,1330,後龍,三等
2020-01-30,2130,626,617,1243,後龍,三等
2020-01-31,2130,602,608,1210,後龍,三等
2020-02-01,2130,561,573,1134,後龍,三等
2020-02-02,2130,710,627,1337,後龍,三等
2020-02-03,2130,645,596,1241,後龍,三等
2020-02-04,2130,565,530,1095,後龍,三等
2020-02-05,2130,551,539,1090,後龍,三等
2020-02-06,2130,609,572,1181,後龍,三等
2020-02-07,2130,549,716,1265,後龍,三等
2020-02-08,2130,598,742,1340,後龍,三等
2020-02-09,2130,851,724,1575,後龍,三等
2020-02-10,2130,705,661,1366,後龍,三等
2020-02-11,2130,600,588,1188,後龍,三等
2020-02-12,2130,669,658,1327,後龍,三等
2020-02-13,2130,583,597,1180,後龍,三等
2020-02-14,2130,705,656,1361,後龍,三等
2020-02-15,2130,573,593,1166,後龍,三等
2020-02-16,2130,573,555,1128,後龍,三等
2020-02-17,2130,626,603,1229,後龍,三等
2020-02-18,2130,550,518,1068,後龍,三等
2020-02-19,2130,566,589,1155,後龍,三等
2020-02-20,2130,653,639,1292,後龍,三等
2020-02-21,2130,614,719,1333,後龍,三等
2020-02-22,2130,524,554,1078,後龍,三等
2020-02-23,2130,720,602,1322,後龍,三等
2020-02-24,2130,645,558,1203,後龍,三等
2020-02-25,2130,648,653,1301,後龍,三等
2020-02-26,2130,628,674,1302,後龍,三等
2020-02-27,2130,683,809,1492,後龍,三等
2020-02-28,2130,603,721,1324,後龍,三等
2020-02-29,2130,599,623,1222,後龍,三等
2020-03-01,2130,951,957,1908,後龍,三等
2020-03-02,2130,1283,1239,2522,後龍,三等
2020-03-03,2130,1205,1188,2393,後龍,三等
2020-03-04,2130,1320,1289,2609,後龍,三等
2020-03-05,2130,1175,1145,2320,後龍,三等
2020-03-06,2130,2859,1395,4254,後龍,三等
2020-03-07,2130,640,668,1308,後龍,三等
2020-03-08,2130,811,1813,2624,後龍,三等
2020-03-09,2130,1322,1346,2668,後龍,三等
2020-03-10,2130,1184,1125,2309,後龍,三等
2020-03-11,2130,1408,1350,2758,後龍,三等
2020-03-12,2130,1237,1195,2432,後龍,三等
2020-03-13,2130,2777,1404,4181,後龍,三等
2020-03-14,2130,577,718,1295,後龍,三等
2020-03-15,2130,989,1895,2884,後龍,三等
2020-03-16,2130,1278,1285,2563,後龍,三等
2020-03-17,2130,1202,1186,2388,後龍,三等
2020-03-18,2130,1327,1222,2549,後龍,三等
2020-03-19,2130,1120,1147,2267,後龍,三等
2020-03-20,2130,2635,1372,4007,後龍,三等
2020-03-21,2130,609,662,1271,後龍,三等
2020-03-22,2130,758,1674,2432,後龍,三等
2020-03-23,2130,1250,1264,2514,後龍,三等
2020-03-24,2130,1180,1152,2332,後龍,三等
2020-03-25,2130,1248,1171,2419,後龍,三等
2020-03-26,2130,1173,1176,2349,後龍,三等
2020-03-27,2130,2627,1303,3930,後龍,三等
2020-03-28,2130,552,558,1110,後龍,三等
2020-03-29,2130,680,527,1207,後龍,三等
2020-03-30,2130,731,721,1452,後龍,三等
2020-03-31,2130,685,683,1368,後龍,三等
2020-04-01,2130,668,897,1565,後龍,三等
2020-04-02,2130,527,682,1209,後龍,三等
2020-04-03,2130,673,768,1441,後龍,三等
2020-04-04,2130,559,492,1051,後龍,三等
2020-04-05,2130,690,1437,2127,後龍,三等
2020-04-06,2130,1186,1185,2371,後龍,三等
2020-04-07,2130,1117,1101,2218,後龍,三等
2020-04-08,2130,1205,1155,2360,後龍,三等
2020-04-09,2130,1136,1126,2262,後龍,三等
2020-04-10,2130,2452,1216,3668,後龍,三等
2020-04-11,2130,571,581,1152,後龍,三等
2020-04-12,2130,691,1528,2219,後龍,三等
2020-04-13,2130,1168,1203,2371,後龍,三等
2020-04-14,2130,1154,1119,2273,後龍,三等
2020-04-15,2130,1221,1206,2427,後龍,三等
2020-04-16,2130,1112,1092,2204,後龍,三等
2020-04-17,2130,2556,1334,3890,後龍,三等
2020-04-18,2130,693,694,1387,後龍,三等
2020-04-19,2130,802,1616,2418,後龍,三等
2020-04-20,2130,1149,1209,2358,後龍,三等
2020-04-21,2130,1078,1093,2171,後龍,三等
2020-04-22,2130,1181,1099,2280,後龍,三等
2020-04-23,2130,1070,1057,2127,後龍,三等
2020-04-24,2130,1791,1261,3052,後龍,三等
2020-04-25,2130,574,623,1197,後龍,三等
2020-04-26,2130,617,953,1570,後龍,三等
2020-04-27,2130,1161,1109,2270,後龍,三等
2020-04-28,2130,1244,1108,2352,後龍,三等
2020-04-29,2130,1429,1084,2513,後龍,三等
2020-04-30,2130,2337,1017,3354,後龍,三等
2020-05-01,2130,890,888,1778,後龍,三等
2020-05-02,2130,531,567,1098,後龍,三等
2020-05-03,2130,777,1693,2470,後龍,三等
2020-05-04,2130,1188,1178,2366,後龍,三等
2020-05-05,2130,1097,1056,2153,後龍,三等
2020-05-06,2130,1223,1200,2423,後龍,三等
2020-05-07,2130,1091,1100,2191,後龍,三等
2020-05-08,2130,2745,1327,4072,後龍,三等
2020-05-09,2130,650,694,1344,後龍,三等
2020-05-10,2130,867,1757,2624,後龍,三等
2020-05-11,2130,1231,1258,2489,後龍,三等
2020-05-12,2130,1099,1074,2173,後龍,三等
2020-05-13,2130,1320,1214,2534,後龍,三等
2020-05-14,2130,1177,1139,2316,後龍,三等
2020-05-15,2130,2504,1308,3812,後龍,三等
2020-05-16,2130,653,679,1332,後龍,三等
2020-05-17,2130,953,1773,2726,後龍,三等
2020-05-18,2130,1136,1163,2299,後龍,三等
2020-05-19,2130,1075,1035,2110,後龍,三等
2020-05-20,2130,1279,1208,2487,後龍,三等
2020-05-21,2130,1096,1087,2183,後龍,三等
2020-05-22,2130,2473,1214,3687,後龍,三等
2020-05-23,2130,611,597,1208,後龍,三等
2020-05-24,2130,972,1839,2811,後龍,三等
2020-05-25,2130,1216,1229,2445,後龍,三等
2020-05-26,2130,1160,1097,2257,後龍,三等
2020-05-27,2130,1156,1070,2226,後龍,三等
2020-05-28,2130,1089,1064,2153,後龍,三等
2020-05-29,2130,2604,1265,3869,後龍,三等
2020-05-30,2130,689,725,1414,後龍,三等
2020-05-31,2130,833,1736,2569,後龍,三等
2020-06-01,2130,1253,1233,2486,後龍,三等
2020-06-02,2130,1164,1164,2328,後龍,三等
2020-06-03,2130,1291,1199,2490,後龍,三等
2020-06-04,2130,1130,1097,2227,後龍,三等
2020-06-05,2130,2659,1321,3980,後龍,三等
2020-06-06,2130,726,732,1458,後龍,三等
2020-06-07,2130,862,1740,2602,後龍,三等
2020-06-08,2130,1126,1185,2311,後龍,三等
2020-06-09,2130,1151,1116,2267,後龍,三等
2020-06-10,2130,1363,1299,2662,後龍,三等
2020-06-11,2130,1280,1180,2460,後龍,三等
2020-06-12,2130,2575,1397,3972,後龍,三等
2020-06-13,2130,889,904,1793,後龍,三等
2020-06-14,2130,1047,1880,2927,後龍,三等
2020-06-15,2130,1305,1334,2639,後龍,三等
2020-06-16,2130,1244,1203,2447,後龍,三等
2020-06-17,2130,1437,1300,2737,後龍,三等
2020-06-18,2130,1220,1127,2347,後龍,三等
2020-06-19,2130,2300,1165,3465,後龍,三等
2020-06-20,2130,908,888,1796,後龍,三等
2020-06-21,2130,830,1639,2469,後龍,三等
2020-06-22,2130,1192,1317,2509,後龍,三等
2020-06-23,2130,1180,1165,2345,後龍,三等
2020-06-24,2130,2606,1425,4031,後龍,三等
2020-06-25,2130,938,1137,2075,後龍,三等
2020-06-26,2130,1039,992,2031,後龍,三等
2020-06-27,2130,881,811,1692,後龍,三等
2020-06-28,2130,905,1622,2527,後龍,三等
2020-06-29,2130,1229,1242,2471,後龍,三等
2020-06-30,2130,1133,1131,2264,後龍,三等
2020-07-01,2130,1157,1081,2238,後龍,三等
2020-07-02,2130,1067,1031,2098,後龍,三等
2020-07-03,2130,1689,1225,2914,後龍,三等
2020-07-04,2130,1099,1042,2141,後龍,三等
2020-07-05,2130,948,1380,2328,後龍,三等
2020-07-06,2130,1319,1169,2488,後龍,三等
2020-07-07,2130,1036,822,1858,後龍,三等
2020-07-08,2130,720,687,1407,後龍,三等
2020-07-09,2130,859,840,1699,後龍,三等
2020-07-10,2130,857,883,1740,後龍,三等
2020-07-11,2130,887,873,1760,後龍,三等
2020-07-12,2130,1156,1130,2286,後龍,三等
2020-07-13,2130,1286,1255,2541,後龍,三等
2020-07-14,2130,686,668,1354,後龍,三等
2020-07-15,2130,660,613,1273,後龍,三等
2020-07-16,2130,615,610,1225,後龍,三等
2020-07-17,2130,729,743,1472,後龍,三等
2020-07-18,2130,635,668,1303,後龍,三等
2020-07-19,2130,855,808,1663,後龍,三等
2020-07-20,2130,660,663,1323,後龍,三等
2020-07-21,2130,662,613,1275,後龍,三等
2020-07-22,2130,648,617,1265,後龍,三等
2020-07-23,2130,709,680,1389,後龍,三等
2020-07-24,2130,748,788,1536,後龍,三等
2020-07-25,2130,649,712,1361,後龍,三等
2020-07-26,2130,863,839,1702,後龍,三等
2020-07-27,2130,912,909,1821,後龍,三等
2020-07-28,2130,859,869,1728,後龍,三等
2020-07-29,2130,907,907,1814,後龍,三等
2020-07-30,2130,931,889,1820,後龍,三等
2020-07-31,2130,1085,980,2065,後龍,三等
2020-08-01,2130,719,786,1505,後龍,三等
2020-08-02,2130,822,789,1611,後龍,三等
2020-08-03,2130,829,786,1615,後龍,三等
2020-08-04,2130,807,778,1585,後龍,三等
2020-08-05,2130,893,891,1784,後龍,三等
2020-08-06,2130,847,866,1713,後龍,三等
2020-08-07,2130,1002,985,1987,後龍,三等
2020-08-08,2130,692,764,1456,後龍,三等
2020-08-09,2130,879,817,1696,後龍,三等
2020-08-10,2130,862,837,1699,後龍,三等
2020-08-11,2130,769,789,1558,後龍,三等
2020-08-12,2130,800,781,1581,後龍,三等
2020-08-13,2130,790,735,1525,後龍,三等
2020-08-14,2130,844,812,1656,後龍,三等
2020-08-15,2130,688,710,1398,後龍,三等
2020-08-16,2130,801,835,1636,後龍,三等
2020-08-17,2130,730,725,1455,後龍,三等
2020-08-18,2130,748,685,1433,後龍,三等
2020-08-19,2130,684,668,1352,後龍,三等
2020-08-20,2130,640,631,1271,後龍,三等
2020-08-21,2130,781,771,1552,後龍,三等
2020-08-22,2130,646,714,1360,後龍,三等
2020-08-23,2130,903,899,1802,後龍,三等
2020-08-24,2130,774,734,1508,後龍,三等
2020-08-25,2130,677,673,1350,後龍,三等
2020-08-26,2130,652,687,1339,後龍,三等
2020-08-27,2130,679,650,1329,後龍,三等
2020-08-28,2130,750,733,1483,後龍,三等
2020-08-29,2130,617,686,1303,後龍,三等
2020-08-30,2130,781,690,1471,後龍,三等
2020-08-31,2130,688,783,1471,後龍,三等
2020-09-01,2130,670,721,1391,後龍,三等
2020-09-02,2130,733,776,1509,後龍,三等
2020-09-03,2130,708,696,1404,後龍,三等
2020-09-04,2130,829,880,1709,後龍,三等
2020-09-05,2130,723,762,1485,後龍,三等
2020-09-06,2130,825,725,1550,後龍,三等
2020-09-07,2130,792,759,1551,後龍,三等
2020-09-08,2130,731,721,1452,後龍,三等
2020-09-09,2130,711,718,1429,後龍,三等
2020-09-10,2130,750,741,1491,後龍,三等
2020-09-11,2130,778,825,1603,後龍,三等
2020-09-12,2130,678,725,1403,後龍,三等
2020-09-13,2130,982,840,1822,後龍,三等
2020-09-14,2130,722,716,1438,後龍,三等
2020-09-15,2130,676,648,1324,後龍,三等
2020-09-16,2130,762,760,1522,後龍,三等
2020-09-17,2130,708,693,1401,後龍,三等
2020-09-18,2130,770,924,1694,後龍,三等
2020-09-19,2130,748,808,1556,後龍,三等
2020-09-20,2130,915,737,1652,後龍,三等
2020-09-21,2130,722,666,1388,後龍,三等
2020-09-22,2130,636,609,1245,後龍,三等
2020-09-23,2130,576,601,1177,後龍,三等
2020-09-24,2130,666,651,1317,後龍,三等
2020-09-25,2130,745,799,1544,後龍,三等
2020-09-26,2130,704,820,1524,後龍,三等
2020-09-27,2130,948,1011,1959,後龍,三等
2020-09-28,2130,1220,1188,2408,後龍,三等
2020-09-29,2130,1152,1143,2295,後龍,三等
2020-09-30,2130,3014,1455,4469,後龍,三等
2020-10-01,2130,790,1017,1807,後龍,三等
2020-10-02,2130,960,917,1877,後龍,三等
2020-10-03,2130,845,736,1581,後龍,三等
2020-10-04,2130,1084,1963,3047,後龍,三等
2020-10-05,2130,1287,1296,2583,後龍,三等
2020-10-06,2130,1250,1188,2438,後龍,三等
2020-10-07,2130,1288,1237,2525,後龍,三等
2020-10-08,2130,2998,1448,4446,後龍,三等
2020-10-09,2130,962,940,1902,後龍,三等
2020-10-10,2130,693,727,1420,後龍,三等
2020-10-11,2130,1175,2153,3328,後龍,三等
2020-10-12,2130,1232,1214,2446,後龍,三等
2020-10-13,2130,1288,1207,2495,後龍,三等
2020-10-14,2130,1344,1299,2643,後龍,三等
2020-10-15,2130,1259,1215,2474,後龍,三等
2020-10-16,2130,3047,1373,4420,後龍,三等
2020-10-17,2130,800,828,1628,後龍,三等
2020-10-18,2130,981,2004,2985,後龍,三等
2020-10-19,2130,1290,1315,2605,後龍,三等
2020-10-20,2130,1232,1238,2470,後龍,三等
2020-10-21,2130,1343,1284,2627,後龍,三等
2020-10-22,2130,1280,1229,2509,後龍,三等
2020-10-23,2130,1672,1385,3057,後龍,三等
2020-10-24,2130,2271,1445,3716,後龍,三等
2020-10-25,2130,1206,1050,2256,後龍,三等
2020-10-26,2130,1002,2047,3049,後龍,三等
2020-10-27,2130,1222,1271,2493,後龍,三等
2020-10-28,2130,1345,1288,2633,後龍,三等
2020-10-29,2130,1261,1198,2459,後龍,三等
2020-10-30,2130,2936,1355,4291,後龍,三等
2020-10-31,2130,790,774,1564,後龍,三等
2020-11-01,2130,995,2009,3004,後龍,三等
2020-11-02,2130,1239,1280,2519,後龍,三等
2020-11-03,2130,1193,1163,2356,後龍,三等
2020-11-04,2130,1347,1288,2635,後龍,三等
2020-11-05,2130,1232,1221,2453,後龍,三等
2020-11-06,2130,2921,1405,4326,後龍,三等
2020-11-07,2130,779,768,1547,後龍,三等
2020-11-08,2130,957,1950,2907,後龍,三等
2020-11-09,2130,1256,1289,2545,後龍,三等
2020-11-10,2130,1211,1199,2410,後龍,三等
2020-11-11,2130,1335,1274,2609,後龍,三等
2020-11-12,2130,1310,1270,2580,後龍,三等
2020-11-13,2130,2698,1405,4103,後龍,三等
2020-11-14,2130,1018,1008,2026,後龍,三等
2020-11-15,2130,1079,1981,3060,後龍,三等
2020-11-16,2130,1286,1304,2590,後龍,三等
2020-11-17,2130,1223,1205,2428,後龍,三等
2020-11-18,2130,1351,1253,2604,後龍,三等
2020-11-19,2130,1240,1208,2448,後龍,三等
2020-11-20,2130,2109,1415,3524,後龍,三等
2020-11-21,2130,874,937,1811,後龍,三等
2020-11-22,2130,977,1386,2363,後龍,三等
2020-11-23,2130,1279,1201,2480,後龍,三等
2020-11-24,2130,1275,1175,2450,後龍,三等
2020-11-25,2130,1534,1291,2825,後龍,三等
2020-11-26,2130,1776,1498,3274,後龍,三等
2020-11-27,2130,2872,1330,4202,後龍,三等
2020-11-28,2130,764,780,1544,後龍,三等
2020-11-29,2130,1011,2056,3067,後龍,三等
2020-11-30,2130,1209,1241,2450,後龍,三等
2020-12-01,2130,1166,1152,2318,後龍,三等
2020-12-02,2130,1376,1312,2688,後龍,三等
2020-12-03,2130,1209,1159,2368,後龍,三等
2020-12-04,2130,2955,1367,4322,後龍,三等
2020-12-05,2130,814,862,1676,後龍,三等
2020-12-06,2130,939,1964,2903,後龍,三等
2020-12-07,2130,1260,1298,2558,後龍,三等
2020-12-08,2130,1194,1156,2350,後龍,三等
2020-12-09,2130,1281,1165,2446,後龍,三等
2020-12-10,2130,1182,1132,2314,後龍,三等
2020-12-11,2130,2759,1343,4102,後龍,三等
2020-12-12,2130,899,897,1796,後龍,三等
2020-12-13,2130,1093,2068,3161,後龍,三等
2020-12-14,2130,1240,1246,2486,後龍,三等
2020-12-15,2130,1179,1169,2348,後龍,三等
2020-12-16,2130,1308,1257,2565,後龍,三等
2020-12-17,2130,1222,1207,2429,後龍,三等
2020-12-18,2130,2923,1314,4237,後龍,三等
2020-12-19,2130,811,862,1673,後龍,三等
2020-12-20,2130,944,1987,2931,後龍,三等
2020-12-21,2130,1238,1245,2483,後龍,三等
2020-12-22,2130,1312,1224,2536,後龍,三等
2020-12-23,2130,1267,1147,2414,後龍,三等
2020-12-24,2130,1259,1197,2456,後龍,三等
2020-12-25,2130,2984,1371,4355,後龍,三等
2020-12-26,2130,730,799,1529,後龍,三等
2020-12-27,2130,884,1941,2825,後龍,三等
2020-12-28,2130,1289,1270,2559,後龍,三等
2020-12-29,2130,1217,1186,2403,後龍,三等
2020-12-30,2130,1406,1231,2637,後龍,三等
2020-12-31,2130,2782,1379,4161,後龍,三等
2020-01-01,2140,18,21,39,龍港,招呼
2020-01-02,2140,16,20,36,龍港,招呼
2020-01-03,2140,19,23,42,龍港,招呼
2020-01-04,2140,8,13,21,龍港,招呼
2020-01-05,2140,14,28,42,龍港,招呼
2020-01-06,2140,12,19,31,龍港,招呼
2020-01-07,2140,19,18,37,龍港,招呼
2020-01-08,2140,8,21,29,龍港,招呼
2020-01-09,2140,13,18,31,龍港,招呼
2020-01-10,2140,11,26,37,龍港,招呼
2020-01-11,2140,15,19,34,龍港,招呼
2020-01-12,2140,24,18,42,龍港,招呼
2020-01-13,2140,15,21,36,龍港,招呼
2020-01-14,2140,48,50,98,龍港,招呼
2020-01-15,2140,7,14,21,龍港,招呼
2020-01-16,2140,10,20,30,龍港,招呼
2020-01-17,2140,11,19,30,龍港,招呼
2020-01-18,2140,12,13,25,龍港,招呼
2020-01-19,2140,11,7,18,龍港,招呼
2020-01-20,2140,11,14,25,龍港,招呼
2020-01-21,2140,25,20,45,龍港,招呼
2020-01-22,2140,10,14,24,龍港,招呼
2020-01-23,2140,11,19,30,龍港,招呼
2020-01-24,2140,11,23,34,龍港,招呼
2020-01-25,2140,17,7,24,龍港,招呼
2020-01-26,2140,27,20,47,龍港,招呼
2020-01-27,2140,9,40,49,龍港,招呼
2020-01-28,2140,17,11,28,龍港,招呼
2020-01-29,2140,4,9,13,龍港,招呼
2020-01-30,2140,7,13,20,龍港,招呼
2020-01-31,2140,9,17,26,龍港,招呼
2020-02-01,2140,7,8,15,龍港,招呼
2020-02-02,2140,16,14,30,龍港,招呼
2020-02-03,2140,9,15,24,龍港,招呼
2020-02-04,2140,12,9,21,龍港,招呼
2020-02-05,2140,6,15,21,龍港,招呼
2020-02-06,2140,9,8,17,龍港,招呼
2020-02-07,2140,5,14,19,龍港,招呼
2020-02-08,2140,12,23,35,龍港,招呼
2020-02-09,2140,12,14,26,龍港,招呼
2020-02-10,2140,9,12,21,龍港,招呼
2020-02-11,2140,10,17,27,龍港,招呼
2020-02-12,2140,7,14,21,龍港,招呼
2020-02-13,2140,10,11,21,龍港,招呼
2020-02-14,2140,7,14,21,龍港,招呼
2020-02-15,2140,14,9,23,龍港,招呼
2020-02-16,2140,4,2,6,龍港,招呼
2020-02-17,2140,8,15,23,龍港,招呼
2020-02-18,2140,9,10,19,龍港,招呼
2020-02-19,2140,9,27,36,龍港,招呼
2020-02-20,2140,16,17,33,龍港,招呼
2020-02-21,2140,8,16,24,龍港,招呼
2020-02-22,2140,15,21,36,龍港,招呼
2020-02-23,2140,12,10,22,龍港,招呼
2020-02-24,2140,11,14,25,龍港,招呼
2020-02-25,2140,17,24,41,龍港,招呼
2020-02-26,2140,13,18,31,龍港,招呼
2020-02-27,2140,12,17,29,龍港,招呼
2020-02-28,2140,10,16,26,龍港,招呼
2020-02-29,2140,16,13,29,龍港,招呼
2020-03-01,2140,17,57,74,龍港,招呼
2020-03-02,2140,8,13,21,龍港,招呼
2020-03-03,2140,10,16,26,龍港,招呼
2020-03-04,2140,16,18,34,龍港,招呼
2020-03-05,2140,9,15,24,龍港,招呼
2020-03-06,2140,14,18,32,龍港,招呼
2020-03-07,2140,12,14,26,龍港,招呼
2020-03-08,2140,19,14,33,龍港,招呼
2020-03-09,2140,11,22,33,龍港,招呼
2020-03-10,2140,20,19,39,龍港,招呼
2020-03-11,2140,11,21,32,龍港,招呼
2020-03-12,2140,13,23,36,龍港,招呼
2020-03-13,2140,15,22,37,龍港,招呼
2020-03-14,2140,8,10,18,龍港,招呼
2020-03-15,2140,18,8,26,龍港,招呼
2020-03-16,2140,14,22,36,龍港,招呼
2020-03-17,2140,11,20,31,龍港,招呼
2020-03-18,2140,12,23,35,龍港,招呼
2020-03-19,2140,14,19,33,龍港,招呼
2020-03-20,2140,16,22,38,龍港,招呼
2020-03-21,2140,12,52,64,龍港,招呼
2020-03-22,2140,15,17,32,龍港,招呼
2020-03-23,2140,15,20,35,龍港,招呼
2020-03-24,2140,19,21,40,龍港,招呼
2020-03-25,2140,18,20,38,龍港,招呼
2020-03-26,2140,20,21,41,龍港,招呼
2020-03-27,2140,12,20,32,龍港,招呼
2020-03-28,2140,11,8,19,龍港,招呼
2020-03-29,2140,18,14,32,龍港,招呼
2020-03-30,2140,12,17,29,龍港,招呼
2020-03-31,2140,15,21,36,龍港,招呼
2020-04-01,2140,12,17,29,龍港,招呼
2020-04-02,2140,10,24,34,龍港,招呼
2020-04-03,2140,12,17,29,龍港,招呼
2020-04-04,2140,14,11,25,龍港,招呼
2020-04-05,2140,9,7,16,龍港,招呼
2020-04-06,2140,15,12,27,龍港,招呼
2020-04-07,2140,19,20,39,龍港,招呼
2020-04-08,2140,15,20,35,龍港,招呼
2020-04-09,2140,12,20,32,龍港,招呼
2020-04-10,2140,12,14,26,龍港,招呼
2020-04-11,2140,10,16,26,龍港,招呼
2020-04-12,2140,13,4,17,龍港,招呼
2020-04-13,2140,8,19,27,龍港,招呼
2020-04-14,2140,13,18,31,龍港,招呼
2020-04-15,2140,18,26,44,龍港,招呼
2020-04-16,2140,10,17,27,龍港,招呼
2020-04-17,2140,15,19,34,龍港,招呼
2020-04-18,2140,9,11,20,龍港,招呼
2020-04-19,2140,16,16,32,龍港,招呼
2020-04-20,2140,14,16,30,龍港,招呼
2020-04-21,2140,8,25,33,龍港,招呼
2020-04-22,2140,11,26,37,龍港,招呼
2020-04-23,2140,13,21,34,龍港,招呼
2020-04-24,2140,8,19,27,龍港,招呼
2020-04-25,2140,13,20,33,龍港,招呼
2020-04-26,2140,13,9,22,龍港,招呼
2020-04-27,2140,9,19,28,龍港,招呼
2020-04-28,2140,13,20,33,龍港,招呼
2020-04-29,2140,11,21,32,龍港,招呼
2020-04-30,2140,13,23,36,龍港,招呼
2020-05-01,2140,20,35,55,龍港,招呼
2020-05-02,2140,18,27,45,龍港,招呼
2020-05-03,2140,21,19,40,龍港,招呼
2020-05-04,2140,10,22,32,龍港,招呼
2020-05-05,2140,10,24,34,龍港,招呼
2020-05-06,2140,14,19,33,龍港,招呼
2020-05-07,2140,15,21,36,龍港,招呼
2020-05-08,2140,14,31,45,龍港,招呼
2020-05-09,2140,16,16,32,龍港,招呼
2020-05-10,2140,9,9,18,龍港,招呼
2020-05-11,2140,10,16,26,龍港,招呼
2020-05-12,2140,16,21,37,龍港,招呼
2020-05-13,2140,20,28,48,龍港,招呼
2020-05-14,2140,12,20,32,龍港,招呼
2020-05-15,2140,11,22,33,龍港,招呼
2020-05-16,2140,24,34,58,龍港,招呼
2020-05-17,2140,22,15,37,龍港,招呼
2020-05-18,2140,8,13,21,龍港,招呼
2020-05-19,2140,12,17,29,龍港,招呼
2020-05-20,2140,16,21,37,龍港,招呼
2020-05-21,2140,19,20,39,龍港,招呼
2020-05-22,2140,8,14,22,龍港,招呼
2020-05-23,2140,13,13,26,龍港,招呼
2020-05-24,2140,20,17,37,龍港,招呼
2020-05-25,2140,14,23,37,龍港,招呼
2020-05-26,2140,19,27,46,龍港,招呼
2020-05-27,2140,18,19,37,龍港,招呼
2020-05-28,2140,13,19,32,龍港,招呼
2020-05-29,2140,15,17,32,龍港,招呼
2020-05-30,2140,13,10,23,龍港,招呼
2020-05-31,2140,22,14,36,龍港,招呼
2020-06-01,2140,13,11,24,龍港,招呼
2020-06-02,2140,24,30,54,龍港,招呼
2020-06-03,2140,22,26,48,龍港,招呼
2020-06-04,2140,13,22,35,龍港,招呼
2020-06-05,2140,24,35,59,龍港,招呼
2020-06-06,2140,32,37,69,龍港,招呼
2020-06-07,2140,12,10,22,龍港,招呼
2020-06-08,2140,10,15,25,龍港,招呼
2020-06-09,2140,11,15,26,龍港,招呼
2020-06-10,2140,9,13,22,龍港,招呼
2020-06-11,2140,16,21,37,龍港,招呼
2020-06-12,2140,14,22,36,龍港,招呼
2020-06-13,2140,21,19,40,龍港,招呼
2020-06-14,2140,23,15,38,龍港,招呼
2020-06-15,2140,22,24,46,龍港,招呼
2020-06-16,2140,15,14,29,龍港,招呼
2020-06-17,2140,14,16,30,龍港,招呼
2020-06-18,2140,9,16,25,龍港,招呼
2020-06-19,2140,16,21,37,龍港,招呼
2020-06-20,2140,11,21,32,龍港,招呼
2020-06-21,2140,17,15,32,龍港,招呼
2020-06-22,2140,14,23,37,龍港,招呼
2020-06-23,2140,17,30,47,龍港,招呼
2020-06-24,2140,14,20,34,龍港,招呼
2020-06-25,2140,17,25,42,龍港,招呼
2020-06-26,2140,14,16,30,龍港,招呼
2020-06-27,2140,19,25,44,龍港,招呼
2020-06-28,2140,13,11,24,龍港,招呼
2020-06-29,2140,8,13,21,龍港,招呼
2020-06-30,2140,11,22,33,龍港,招呼
2020-07-01,2140,12,10,22,龍港,招呼
2020-07-02,2140,24,17,41,龍港,招呼
2020-07-03,2140,12,22,34,龍港,招呼
2020-07-04,2140,24,23,47,龍港,招呼
2020-07-05,2140,9,14,23,龍港,招呼
2020-07-06,2140,15,23,38,龍港,招呼
2020-07-07,2140,15,26,41,龍港,招呼
2020-07-08,2140,16,20,36,龍港,招呼
2020-07-09,2140,8,14,22,龍港,招呼
2020-07-10,2140,19,20,39,龍港,招呼
2020-07-11,2140,16,23,39,龍港,招呼
2020-07-12,2140,26,29,55,龍港,招呼
2020-07-13,2140,88,74,162,龍港,招呼
2020-07-14,2140,15,22,37,龍港,招呼
2020-07-15,2140,7,12,19,龍港,招呼
2020-07-16,2140,11,23,34,龍港,招呼
2020-07-17,2140,12,10,22,龍港,招呼
2020-07-18,2140,9,13,22,龍港,招呼
2020-07-19,2140,16,25,41,龍港,招呼
2020-07-20,2140,5,17,22,龍港,招呼
2020-07-21,2140,18,23,41,龍港,招呼
2020-07-22,2140,17,24,41,龍港,招呼
2020-07-23,2140,14,23,37,龍港,招呼
2020-07-24,2140,13,22,35,龍港,招呼
2020-07-25,2140,18,23,41,龍港,招呼
2020-07-26,2140,14,16,30,龍港,招呼
2020-07-27,2140,14,22,36,龍港,招呼
2020-07-28,2140,10,18,28,龍港,招呼
2020-07-29,2140,25,28,53,龍港,招呼
2020-07-30,2140,11,17,28,龍港,招呼
2020-07-31,2140,16,22,38,龍港,招呼
2020-08-01,2140,27,27,54,龍港,招呼
2020-08-02,2140,27,26,53,龍港,招呼
2020-08-03,2140,5,18,23,龍港,招呼
2020-08-04,2140,10,15,25,龍港,招呼
2020-08-05,2140,24,26,50,龍港,招呼
2020-08-06,2140,17,21,38,龍港,招呼
2020-08-07,2140,8,16,24,龍港,招呼
2020-08-08,2140,14,17,31,龍港,招呼
2020-08-09,2140,15,11,26,龍港,招呼
2020-08-10,2140,15,13,28,龍港,招呼
2020-08-11,2140,9,7,16,龍港,招呼
2020-08-12,2140,8,13,21,龍港,招呼
2020-08-13,2140,10,7,17,龍港,招呼
2020-08-14,2140,13,11,24,龍港,招呼
2020-08-15,2140,20,15,35,龍港,招呼
2020-08-16,2140,16,16,32,龍港,招呼
2020-08-17,2140,5,17,22,龍港,招呼
2020-08-18,2140,20,13,33,龍港,招呼
2020-08-19,2140,8,13,21,龍港,招呼
2020-08-20,2140,19,17,36,龍港,招呼
2020-08-21,2140,9,11,20,龍港,招呼
2020-08-22,2140,14,11,25,龍港,招呼
2020-08-23,2140,11,24,35,龍港,招呼
2020-08-24,2140,16,15,31,龍港,招呼
2020-08-25,2140,12,21,33,龍港,招呼
2020-08-26,2140,14,12,26,龍港,招呼
2020-08-27,2140,7,11,18,龍港,招呼
2020-08-28,2140,17,22,39,龍港,招呼
2020-08-29,2140,19,20,39,龍港,招呼
2020-08-30,2140,17,21,38,龍港,招呼
2020-08-31,2140,16,21,37,龍港,招呼
2020-09-01,2140,13,20,33,龍港,招呼
2020-09-02,2140,10,19,29,龍港,招呼
2020-09-03,2140,11,22,33,龍港,招呼
2020-09-04,2140,12,23,35,龍港,招呼
2020-09-05,2140,13,16,29,龍港,招呼
2020-09-06,2140,23,20,43,龍港,招呼
2020-09-07,2140,10,20,30,龍港,招呼
2020-09-08,2140,12,18,30,龍港,招呼
2020-09-09,2140,13,18,31,龍港,招呼
2020-09-10,2140,16,22,38,龍港,招呼
2020-09-11,2140,15,18,33,龍港,招呼
2020-09-12,2140,18,19,37,龍港,招呼
2020-09-13,2140,20,17,37,龍港,招呼
2020-09-14,2140,22,30,52,龍港,招呼
2020-09-15,2140,15,27,42,龍港,招呼
2020-09-16,2140,16,29,45,龍港,招呼
2020-09-17,2140,13,25,38,龍港,招呼
2020-09-18,2140,14,28,42,龍港,招呼
2020-09-19,2140,11,13,24,龍港,招呼
2020-09-20,2140,28,25,53,龍港,招呼
2020-09-21,2140,22,25,47,龍港,招呼
2020-09-22,2140,21,31,52,龍港,招呼
2020-09-23,2140,17,20,37,龍港,招呼
2020-09-24,2140,11,20,31,龍港,招呼
2020-09-25,2140,7,21,28,龍港,招呼
2020-09-26,2140,20,22,42,龍港,招呼
2020-09-27,2140,20,11,31,龍港,招呼
2020-09-28,2140,13,16,29,龍港,招呼
2020-09-29,2140,19,25,44,龍港,招呼
2020-09-30,2140,14,28,42,龍港,招呼
2020-10-01,2140,18,28,46,龍港,招呼
2020-10-02,2140,24,31,55,龍港,招呼
2020-10-03,2140,44,43,87,龍港,招呼
2020-10-04,2140,16,12,28,龍港,招呼
2020-10-05,2140,12,19,31,龍港,招呼
2020-10-06,2140,10,28,38,龍港,招呼
2020-10-07,2140,12,18,30,龍港,招呼
2020-10-08,2140,16,29,45,龍港,招呼
2020-10-09,2140,28,32,60,龍港,招呼
2020-10-10,2140,28,28,56,龍港,招呼
2020-10-11,2140,20,14,34,龍港,招呼
2020-10-12,2140,16,17,33,龍港,招呼
2020-10-13,2140,20,21,41,龍港,招呼
2020-10-14,2140,12,18,30,龍港,招呼
2020-10-15,2140,17,27,44,龍港,招呼
2020-10-16,2140,15,23,38,龍港,招呼
2020-10-17,2140,20,22,42,龍港,招呼
2020-10-18,2140,19,15,34,龍港,招呼
2020-10-19,2140,15,18,33,龍港,招呼
2020-10-20,2140,16,22,38,龍港,招呼
2020-10-21,2140,13,22,35,龍港,招呼
2020-10-22,2140,12,18,30,龍港,招呼
2020-10-23,2140,10,17,27,龍港,招呼
2020-10-24,2140,23,25,48,龍港,招呼
2020-10-25,2140,26,20,46,龍港,招呼
2020-10-26,2140,13,29,42,龍港,招呼
2020-10-27,2140,14,19,33,龍港,招呼
2020-10-28,2140,9,19,28,龍港,招呼
2020-10-29,2140,15,27,42,龍港,招呼
2020-10-30,2140,14,25,39,龍港,招呼
2020-10-31,2140,22,18,40,龍港,招呼
2020-11-01,2140,18,19,37,龍港,招呼
2020-11-02,2140,14,27,41,龍港,招呼
2020-11-03,2140,20,21,41,龍港,招呼
2020-11-04,2140,18,22,40,龍港,招呼
2020-11-05,2140,10,26,36,龍港,招呼
2020-11-06,2140,16,24,40,龍港,招呼
2020-11-07,2140,22,25,47,龍港,招呼
2020-11-08,2140,11,10,21,龍港,招呼
2020-11-09,2140,9,15,24,龍港,招呼
2020-11-10,2140,15,19,34,龍港,招呼
2020-11-11,2140,13,18,31,龍港,招呼
2020-11-12,2140,14,22,36,龍港,招呼
2020-11-13,2140,11,33,44,龍港,招呼
2020-11-14,2140,11,11,22,龍港,招呼
2020-11-15,2140,17,18,35,龍港,招呼
2020-11-16,2140,19,23,42,龍港,招呼
2020-11-17,2140,16,23,39,龍港,招呼
2020-11-18,2140,13,18,31,龍港,招呼
2020-11-19,2140,16,22,38,龍港,招呼
2020-11-20,2140,20,22,42,龍港,招呼
2020-11-21,2140,73,90,163,龍港,招呼
2020-11-22,2140,24,96,120,龍港,招呼
2020-11-23,2140,20,32,52,龍港,招呼
2020-11-24,2140,22,20,42,龍港,招呼
2020-11-25,2140,20,18,38,龍港,招呼
2020-11-26,2140,19,33,52,龍港,招呼
2020-11-27,2140,18,29,47,龍港,招呼
2020-11-28,2140,21,20,41,龍港,招呼
2020-11-29,2140,16,30,46,龍港,招呼
2020-11-30,2140,22,26,48,龍港,招呼
2020-12-01,2140,19,23,42,龍港,招呼
2020-12-02,2140,14,21,35,龍港,招呼
2020-12-03,2140,15,31,46,龍港,招呼
2020-12-04,2140,15,30,45,龍港,招呼
2020-12-05,2140,18,51,69,龍港,招呼
2020-12-06,2140,33,33,66,龍港,招呼
2020-12-07,2140,17,28,45,龍港,招呼
2020-12-08,2140,26,24,50,龍港,招呼
2020-12-09,2140,12,20,32,龍港,招呼
2020-12-10,2140,9,11,20,龍港,招呼
2020-12-11,2140,8,14,22,龍港,招呼
2020-12-12,2140,18,31,49,龍港,招呼
2020-12-13,2140,23,26,49,龍港,招呼
2020-12-14,2140,14,20,34,龍港,招呼
2020-12-15,2140,18,26,44,龍港,招呼
2020-12-16,2140,17,24,41,龍港,招呼
2020-12-17,2140,24,29,53,龍港,招呼
2020-12-18,2140,17,27,44,龍港,招呼
2020-12-19,2140,20,21,41,龍港,招呼
2020-12-20,2140,17,19,36,龍港,招呼
2020-12-21,2140,12,23,35,龍港,招呼
2020-12-22,2140,14,13,27,龍港,招呼
2020-12-23,2140,10,15,25,龍港,招呼
2020-12-24,2140,13,23,36,龍港,招呼
2020-12-25,2140,19,26,45,龍港,招呼
2020-12-26,2140,19,27,46,龍港,招呼
2020-12-27,2140,21,18,39,龍港,招呼
2020-12-28,2140,21,31,52,龍港,招呼
2020-12-29,2140,18,26,44,龍港,招呼
2020-12-30,2140,16,14,30,龍港,招呼
2020-12-31,2140,13,26,39,龍港,招呼
2020-01-01,2150,633,654,1287,白沙屯,三等
2020-01-02,2150,264,256,520,白沙屯,三等
2020-01-03,2150,258,309,567,白沙屯,三等
2020-01-04,2150,422,452,874,白沙屯,三等
2020-01-05,2150,495,418,913,白沙屯,三等
2020-01-06,2150,274,266,540,白沙屯,三等
2020-01-07,2150,281,251,532,白沙屯,三等
2020-01-08,2150,214,231,445,白沙屯,三等
2020-01-09,2150,488,549,1037,白沙屯,三等
2020-01-10,2150,241,295,536,白沙屯,三等
2020-01-11,2150,379,398,777,白沙屯,三等
2020-01-12,2150,502,461,963,白沙屯,三等
2020-01-13,2150,258,255,513,白沙屯,三等
2020-01-14,2150,256,238,494,白沙屯,三等
2020-01-15,2150,242,256,498,白沙屯,三等
2020-01-16,2150,255,266,521,白沙屯,三等
2020-01-17,2150,230,245,475,白沙屯,三等
2020-01-18,2150,288,283,571,白沙屯,三等
2020-01-19,2150,373,337,710,白沙屯,三等
2020-01-20,2150,210,216,426,白沙屯,三等
2020-01-21,2150,246,246,492,白沙屯,三等
2020-01-22,2150,167,213,380,白沙屯,三等
2020-01-23,2150,197,246,443,白沙屯,三等
2020-01-24,2150,156,250,406,白沙屯,三等
2020-01-25,2150,1563,1554,3117,白沙屯,三等
2020-01-26,2150,491,515,1006,白沙屯,三等
2020-01-27,2150,1245,1211,2456,白沙屯,三等
2020-01-28,2150,1088,1011,2099,白沙屯,三等
2020-01-29,2150,662,582,1244,白沙屯,三等
2020-01-30,2150,390,350,740,白沙屯,三等
2020-01-31,2150,307,300,607,白沙屯,三等
2020-02-01,2150,383,400,783,白沙屯,三等
2020-02-02,2150,562,536,1098,白沙屯,三等
2020-02-03,2150,334,336,670,白沙屯,三等
2020-02-04,2150,233,223,456,白沙屯,三等
2020-02-05,2150,217,219,436,白沙屯,三等
2020-02-06,2150,277,274,551,白沙屯,三等
2020-02-07,2150,217,260,477,白沙屯,三等
2020-02-08,2150,383,400,783,白沙屯,三等
2020-02-09,2150,441,327,768,白沙屯,三等
2020-02-10,2150,275,258,533,白沙屯,三等
2020-02-11,2150,276,273,549,白沙屯,三等
2020-02-12,2150,314,307,621,白沙屯,三等
2020-02-13,2150,251,238,489,白沙屯,三等
2020-02-14,2150,244,246,490,白沙屯,三等
2020-02-15,2150,401,419,820,白沙屯,三等
2020-02-16,2150,342,346,688,白沙屯,三等
2020-02-17,2150,228,223,451,白沙屯,三等
2020-02-18,2150,226,261,487,白沙屯,三等
2020-02-19,2150,506,472,978,白沙屯,三等
2020-02-20,2150,372,351,723,白沙屯,三等
2020-02-21,2150,334,376,710,白沙屯,三等
2020-02-22,2150,644,650,1294,白沙屯,三等
2020-02-23,2150,623,524,1147,白沙屯,三等
2020-02-24,2150,311,309,620,白沙屯,三等
2020-02-25,2150,357,367,724,白沙屯,三等
2020-02-26,2150,360,347,707,白沙屯,三等
2020-02-27,2150,326,330,656,白沙屯,三等
2020-02-28,2150,544,603,1147,白沙屯,三等
2020-02-29,2150,551,514,1065,白沙屯,三等
2020-03-01,2150,460,316,776,白沙屯,三等
2020-03-02,2150,218,213,431,白沙屯,三等
2020-03-03,2150,216,212,428,白沙屯,三等
2020-03-04,2150,179,199,378,白沙屯,三等
2020-03-05,2150,139,152,291,白沙屯,三等
2020-03-06,2150,232,277,509,白沙屯,三等
2020-03-07,2150,367,381,748,白沙屯,三等
2020-03-08,2150,429,349,778,白沙屯,三等
2020-03-09,2150,246,235,481,白沙屯,三等
2020-03-10,2150,153,143,296,白沙屯,三等
2020-03-11,2150,226,213,439,白沙屯,三等
2020-03-12,2150,212,204,416,白沙屯,三等
2020-03-13,2150,184,247,431,白沙屯,三等
2020-03-14,2150,264,279,543,白沙屯,三等
2020-03-15,2150,386,331,717,白沙屯,三等
2020-03-16,2150,233,217,450,白沙屯,三等
2020-03-17,2150,216,229,445,白沙屯,三等
2020-03-18,2150,180,162,342,白沙屯,三等
2020-03-19,2150,148,145,293,白沙屯,三等
2020-03-20,2150,173,235,408,白沙屯,三等
2020-03-21,2150,319,282,601,白沙屯,三等
2020-03-22,2150,401,263,664,白沙屯,三等
2020-03-23,2150,253,243,496,白沙屯,三等
2020-03-24,2150,214,208,422,白沙屯,三等
2020-03-25,2150,163,157,320,白沙屯,三等
2020-03-26,2150,183,175,358,白沙屯,三等
2020-03-27,2150,201,250,451,白沙屯,三等
2020-03-28,2150,199,238,437,白沙屯,三等
2020-03-29,2150,351,306,657,白沙屯,三等
2020-03-30,2150,190,177,367,白沙屯,三等
2020-03-31,2150,164,173,337,白沙屯,三等
2020-04-01,2150,170,211,381,白沙屯,三等
2020-04-02,2150,160,235,395,白沙屯,三等
2020-04-03,2150,253,256,509,白沙屯,三等
2020-04-04,2150,196,162,358,白沙屯,三等
2020-04-05,2150,278,201,479,白沙屯,三等
2020-04-06,2150,172,153,325,白沙屯,三等
2020-04-07,2150,166,159,325,白沙屯,三等
2020-04-08,2150,154,164,318,白沙屯,三等
2020-04-09,2150,152,139,291,白沙屯,三等
2020-04-10,2150,171,197,368,白沙屯,三等
2020-04-11,2150,278,301,579,白沙屯,三等
2020-04-12,2150,259,208,467,白沙屯,三等
2020-04-13,2150,194,183,377,白沙屯,三等
2020-04-14,2150,217,212,429,白沙屯,三等
2020-04-15,2150,362,372,734,白沙屯,三等
2020-04-16,2150,185,175,360,白沙屯,三等
2020-04-17,2150,183,232,415,白沙屯,三等
2020-04-18,2150,267,266,533,白沙屯,三等
2020-04-19,2150,317,249,566,白沙屯,三等
2020-04-20,2150,197,173,370,白沙屯,三等
2020-04-21,2150,158,154,312,白沙屯,三等
2020-04-22,2150,115,123,238,白沙屯,三等
2020-04-23,2150,124,126,250,白沙屯,三等
2020-04-24,2150,136,154,290,白沙屯,三等
2020-04-25,2150,213,239,452,白沙屯,三等
2020-04-26,2150,193,152,345,白沙屯,三等
2020-04-27,2150,154,140,294,白沙屯,三等
2020-04-28,2150,145,158,303,白沙屯,三等
2020-04-29,2150,165,171,336,白沙屯,三等
2020-04-30,2150,169,181,350,白沙屯,三等
2020-05-01,2150,251,307,558,白沙屯,三等
2020-05-02,2150,283,261,544,白沙屯,三等
2020-05-03,2150,312,247,559,白沙屯,三等
2020-05-04,2150,209,193,402,白沙屯,三等
2020-05-05,2150,177,171,348,白沙屯,三等
2020-05-06,2150,166,164,330,白沙屯,三等
2020-05-07,2150,166,176,342,白沙屯,三等
2020-05-08,2150,203,246,449,白沙屯,三等
2020-05-09,2150,249,324,573,白沙屯,三等
2020-05-10,2150,365,258,623,白沙屯,三等
2020-05-11,2150,178,153,331,白沙屯,三等
2020-05-12,2150,211,206,417,白沙屯,三等
2020-05-13,2150,216,206,422,白沙屯,三等
2020-05-14,2150,183,187,370,白沙屯,三等
2020-05-15,2150,189,231,420,白沙屯,三等
2020-05-16,2150,345,310,655,白沙屯,三等
2020-05-17,2150,366,302,668,白沙屯,三等
2020-05-18,2150,136,147,283,白沙屯,三等
2020-05-19,2150,136,127,263,白沙屯,三等
2020-05-20,2150,148,162,310,白沙屯,三等
2020-05-21,2150,170,173,343,白沙屯,三等
2020-05-22,2150,105,158,263,白沙屯,三等
2020-05-23,2150,234,258,492,白沙屯,三等
2020-05-24,2150,380,346,726,白沙屯,三等
2020-05-25,2150,243,229,472,白沙屯,三等
2020-05-26,2150,180,173,353,白沙屯,三等
2020-05-27,2150,153,144,297,白沙屯,三等
2020-05-28,2150,132,157,289,白沙屯,三等
2020-05-29,2150,195,240,435,白沙屯,三等
2020-05-30,2150,402,425,827,白沙屯,三等
2020-05-31,2150,556,472,1028,白沙屯,三等
2020-06-01,2150,220,186,406,白沙屯,三等
2020-06-02,2150,221,210,431,白沙屯,三等
2020-06-03,2150,215,224,439,白沙屯,三等
2020-06-04,2150,236,217,453,白沙屯,三等
2020-06-05,2150,244,262,506,白沙屯,三等
2020-06-06,2150,387,414,801,白沙屯,三等
2020-06-07,2150,459,360,819,白沙屯,三等
2020-06-08,2150,195,184,379,白沙屯,三等
2020-06-09,2150,219,216,435,白沙屯,三等
2020-06-10,2150,253,241,494,白沙屯,三等
2020-06-11,2150,255,268,523,白沙屯,三等
2020-06-12,2150,235,270,505,白沙屯,三等
2020-06-13,2150,451,418,869,白沙屯,三等
2020-06-14,2150,500,465,965,白沙屯,三等
2020-06-15,2150,257,231,488,白沙屯,三等
2020-06-16,2150,299,310,609,白沙屯,三等
2020-06-17,2150,280,287,567,白沙屯,三等
2020-06-18,2150,265,277,542,白沙屯,三等
2020-06-19,2150,225,242,467,白沙屯,三等
2020-06-20,2150,436,450,886,白沙屯,三等
2020-06-21,2150,584,556,1140,白沙屯,三等
2020-06-22,2150,300,287,587,白沙屯,三等
2020-06-23,2150,277,270,547,白沙屯,三等
2020-06-24,2150,244,316,560,白沙屯,三等
2020-06-25,2150,653,656,1309,白沙屯,三等
2020-06-26,2150,978,974,1952,白沙屯,三等
2020-06-27,2150,904,888,1792,白沙屯,三等
2020-06-28,2150,734,663,1397,白沙屯,三等
2020-06-29,2150,512,456,968,白沙屯,三等
2020-06-30,2150,464,459,923,白沙屯,三等
2020-07-01,2150,414,438,852,白沙屯,三等
2020-07-02,2150,369,404,773,白沙屯,三等
2020-07-03,2150,385,487,872,白沙屯,三等
2020-07-04,2150,1724,13562,15286,白沙屯,三等
2020-07-05,2150,759,1949,2708,白沙屯,三等
2020-07-06,2150,191,187,378,白沙屯,三等
2020-07-07,2150,179,206,385,白沙屯,三等
2020-07-08,2150,151,150,301,白沙屯,三等
2020-07-09,2150,170,173,343,白沙屯,三等
2020-07-10,2150,206,222,428,白沙屯,三等
2020-07-11,2150,447,496,943,白沙屯,三等
2020-07-12,2150,1848,1019,2867,白沙屯,三等
2020-07-13,2150,11037,6832,17869,白沙屯,三等
2020-07-14,2150,686,445,1131,白沙屯,三等
2020-07-15,2150,389,360,749,白沙屯,三等
2020-07-16,2150,387,402,789,白沙屯,三等
2020-07-17,2150,351,368,719,白沙屯,三等
2020-07-18,2150,772,743,1515,白沙屯,三等
2020-07-19,2150,849,763,1612,白沙屯,三等
2020-07-20,2150,373,363,736,白沙屯,三等
2020-07-21,2150,341,331,672,白沙屯,三等
2020-07-22,2150,345,361,706,白沙屯,三等
2020-07-23,2150,503,850,1353,白沙屯,三等
2020-07-24,2150,996,774,1770,白沙屯,三等
2020-07-25,2150,1128,1137,2265,白沙屯,三等
2020-07-26,2150,1197,1159,2356,白沙屯,三等
2020-07-27,2150,580,546,1126,白沙屯,三等
2020-07-28,2150,489,486,975,白沙屯,三等
2020-07-29,2150,483,489,972,白沙屯,三等
2020-07-30,2150,427,389,816,白沙屯,三等
2020-07-31,2150,494,501,995,白沙屯,三等
2020-08-01,2150,737,667,1404,白沙屯,三等
2020-08-02,2150,725,574,1299,白沙屯,三等
2020-08-03,2150,285,260,545,白沙屯,三等
2020-08-04,2150,287,277,564,白沙屯,三等
2020-08-05,2150,368,363,731,白沙屯,三等
2020-08-06,2150,351,326,677,白沙屯,三等
2020-08-07,2150,366,350,716,白沙屯,三等
2020-08-08,2150,542,457,999,白沙屯,三等
2020-08-09,2150,704,598,1302,白沙屯,三等
2020-08-10,2150,346,325,671,白沙屯,三等
2020-08-11,2150,313,300,613,白沙屯,三等
2020-08-12,2150,286,302,588,白沙屯,三等
2020-08-13,2150,410,380,790,白沙屯,三等
2020-08-14,2150,408,376,784,白沙屯,三等
2020-08-15,2150,657,636,1293,白沙屯,三等
2020-08-16,2150,802,680,1482,白沙屯,三等
2020-08-17,2150,403,353,756,白沙屯,三等
2020-08-18,2150,387,348,735,白沙屯,三等
2020-08-19,2150,221,233,454,白沙屯,三等
2020-08-20,2150,243,223,466,白沙屯,三等
2020-08-21,2150,268,276,544,白沙屯,三等
2020-08-22,2150,382,371,753,白沙屯,三等
2020-08-23,2150,433,348,781,白沙屯,三等
2020-08-24,2150,254,214,468,白沙屯,三等
2020-08-25,2150,199,188,387,白沙屯,三等
2020-08-26,2150,248,225,473,白沙屯,三等
2020-08-27,2150,182,198,380,白沙屯,三等
2020-08-28,2150,193,202,395,白沙屯,三等
2020-08-29,2150,436,436,872,白沙屯,三等
2020-08-30,2150,396,300,696,白沙屯,三等
2020-08-31,2150,182,155,337,白沙屯,三等
2020-09-01,2150,192,211,403,白沙屯,三等
2020-09-02,2150,162,184,346,白沙屯,三等
2020-09-03,2150,226,209,435,白沙屯,三等
2020-09-04,2150,221,231,452,白沙屯,三等
2020-09-05,2150,330,356,686,白沙屯,三等
2020-09-06,2150,355,280,635,白沙屯,三等
2020-09-07,2150,218,189,407,白沙屯,三等
2020-09-08,2150,191,161,352,白沙屯,三等
2020-09-09,2150,191,184,375,白沙屯,三等
2020-09-10,2150,212,217,429,白沙屯,三等
2020-09-11,2150,204,240,444,白沙屯,三等
2020-09-12,2150,371,491,862,白沙屯,三等
2020-09-13,2150,481,395,876,白沙屯,三等
2020-09-14,2150,217,196,413,白沙屯,三等
2020-09-15,2150,184,164,348,白沙屯,三等
2020-09-16,2150,235,237,472,白沙屯,三等
2020-09-17,2150,321,317,638,白沙屯,三等
2020-09-18,2150,308,342,650,白沙屯,三等
2020-09-19,2150,555,548,1103,白沙屯,三等
2020-09-20,2150,594,565,1159,白沙屯,三等
2020-09-21,2150,288,265,553,白沙屯,三等
2020-09-22,2150,284,273,557,白沙屯,三等
2020-09-23,2150,332,323,655,白沙屯,三等
2020-09-24,2150,265,261,526,白沙屯,三等
2020-09-25,2150,257,285,542,白沙屯,三等
2020-09-26,2150,483,467,950,白沙屯,三等
2020-09-27,2150,496,483,979,白沙屯,三等
2020-09-28,2150,223,243,466,白沙屯,三等
2020-09-29,2150,345,324,669,白沙屯,三等
2020-09-30,2150,232,301,533,白沙屯,三等
2020-10-01,2150,432,498,930,白沙屯,三等
2020-10-02,2150,835,796,1631,白沙屯,三等
2020-10-03,2150,707,681,1388,白沙屯,三等
2020-10-04,2150,543,405,948,白沙屯,三等
2020-10-05,2150,299,304,603,白沙屯,三等
2020-10-06,2150,285,287,572,白沙屯,三等
2020-10-07,2150,289,264,553,白沙屯,三等
2020-10-08,2150,288,289,577,白沙屯,三等
2020-10-09,2150,570,571,1141,白沙屯,三等
2020-10-10,2150,757,689,1446,白沙屯,三等
2020-10-11,2150,643,550,1193,白沙屯,三等
2020-10-12,2150,283,266,549,白沙屯,三等
2020-10-13,2150,272,251,523,白沙屯,三等
2020-10-14,2150,298,291,589,白沙屯,三等
2020-10-15,2150,344,311,655,白沙屯,三等
2020-10-16,2150,308,296,604,白沙屯,三等
2020-10-17,2150,522,549,1071,白沙屯,三等
2020-10-18,2150,766,660,1426,白沙屯,三等
2020-10-19,2150,355,321,676,白沙屯,三等
2020-10-20,2150,294,270,564,白沙屯,三等
2020-10-21,2150,314,290,604,白沙屯,三等
2020-10-22,2150,269,264,533,白沙屯,三等
2020-10-23,2150,211,229,440,白沙屯,三等
2020-10-24,2150,471,567,1038,白沙屯,三等
2020-10-25,2150,586,437,1023,白沙屯,三等
2020-10-26,2150,286,267,553,白沙屯,三等
2020-10-27,2150,335,317,652,白沙屯,三等
2020-10-28,2150,279,289,568,白沙屯,三等
2020-10-29,2150,268,277,545,白沙屯,三等
2020-10-30,2150,322,350,672,白沙屯,三等
2020-10-31,2150,509,542,1051,白沙屯,三等
2020-11-01,2150,627,575,1202,白沙屯,三等
2020-11-02,2150,302,282,584,白沙屯,三等
2020-11-03,2150,275,266,541,白沙屯,三等
2020-11-04,2150,260,252,512,白沙屯,三等
2020-11-05,2150,263,244,507,白沙屯,三等
2020-11-06,2150,281,344,625,白沙屯,三等
2020-11-07,2150,505,496,1001,白沙屯,三等
2020-11-08,2150,475,423,898,白沙屯,三等
2020-11-09,2150,283,249,532,白沙屯,三等
2020-11-10,2150,230,218,448,白沙屯,三等
2020-11-11,2150,244,248,492,白沙屯,三等
2020-11-12,2150,261,283,544,白沙屯,三等
2020-11-13,2150,270,307,577,白沙屯,三等
2020-11-14,2150,477,515,992,白沙屯,三等
2020-11-15,2150,624,566,1190,白沙屯,三等
2020-11-16,2150,313,295,608,白沙屯,三等
2020-11-17,2150,314,278,592,白沙屯,三等
2020-11-18,2150,285,292,577,白沙屯,三等
2020-11-19,2150,260,238,498,白沙屯,三等
2020-11-20,2150,295,330,625,白沙屯,三等
2020-11-21,2150,489,498,987,白沙屯,三等
2020-11-22,2150,651,566,1217,白沙屯,三等
2020-11-23,2150,278,282,560,白沙屯,三等
2020-11-24,2150,314,309,623,白沙屯,三等
2020-11-25,2150,318,321,639,白沙屯,三等
2020-11-26,2150,293,285,578,白沙屯,三等
2020-11-27,2150,285,328,613,白沙屯,三等
2020-11-28,2150,435,461,896,白沙屯,三等
2020-11-29,2150,819,735,1554,白沙屯,三等
2020-11-30,2150,276,261,537,白沙屯,三等
2020-12-01,2150,227,233,460,白沙屯,三等
2020-12-02,2150,247,251,498,白沙屯,三等
2020-12-03,2150,181,189,370,白沙屯,三等
2020-12-04,2150,232,248,480,白沙屯,三等
2020-12-05,2150,612,620,1232,白沙屯,三等
2020-12-06,2150,629,580,1209,白沙屯,三等
2020-12-07,2150,319,293,612,白沙屯,三等
2020-12-08,2150,233,241,474,白沙屯,三等
2020-12-09,2150,193,196,389,白沙屯,三等
2020-12-10,2150,232,217,449,白沙屯,三等
2020-12-11,2150,261,286,547,白沙屯,三等
2020-12-12,2150,465,480,945,白沙屯,三等
2020-12-13,2150,674,539,1213,白沙屯,三等
2020-12-14,2150,270,256,526,白沙屯,三等
2020-12-15,2150,251,239,490,白沙屯,三等
2020-12-16,2150,246,246,492,白沙屯,三等
2020-12-17,2150,226,232,458,白沙屯,三等
2020-12-18,2150,292,298,590,白沙屯,三等
2020-12-19,2150,403,440,843,白沙屯,三等
2020-12-20,2150,454,386,840,白沙屯,三等
2020-12-21,2150,226,200,426,白沙屯,三等
2020-12-22,2150,236,232,468,白沙屯,三等
2020-12-23,2150,180,182,362,白沙屯,三等
2020-12-24,2150,208,210,418,白沙屯,三等
2020-12-25,2150,220,234,454,白沙屯,三等
2020-12-26,2150,399,426,825,白沙屯,三等
2020-12-27,2150,522,476,998,白沙屯,三等
2020-12-28,2150,281,324,605,白沙屯,三等
2020-12-29,2150,344,284,628,白沙屯,三等
2020-12-30,2150,206,206,412,白沙屯,三等
2020-12-31,2150,188,217,405,白沙屯,三等
2020-01-01,2160,94,91,185,新埔,乙簡
2020-01-02,2160,62,60,122,新埔,乙簡
2020-01-03,2160,48,40,88,新埔,乙簡
2020-01-04,2160,71,62,133,新埔,乙簡
2020-01-05,2160,59,58,117,新埔,乙簡
2020-01-06,2160,38,39,77,新埔,乙簡
2020-01-07,2160,38,26,64,新埔,乙簡
2020-01-08,2160,49,48,97,新埔,乙簡
2020-01-09,2160,40,45,85,新埔,乙簡
2020-01-10,2160,58,62,120,新埔,乙簡
2020-01-11,2160,59,72,131,新埔,乙簡
2020-01-12,2160,74,63,137,新埔,乙簡
2020-01-13,2160,48,33,81,新埔,乙簡
2020-01-14,2160,51,42,93,新埔,乙簡
2020-01-15,2160,43,34,77,新埔,乙簡
2020-01-16,2160,59,63,122,新埔,乙簡
2020-01-17,2160,68,70,138,新埔,乙簡
2020-01-18,2160,69,59,128,新埔,乙簡
2020-01-19,2160,54,55,109,新埔,乙簡
2020-01-20,2160,44,43,87,新埔,乙簡
2020-01-21,2160,61,52,113,新埔,乙簡
2020-01-22,2160,64,65,129,新埔,乙簡
2020-01-23,2160,57,95,152,新埔,乙簡
2020-01-24,2160,56,65,121,新埔,乙簡
2020-01-25,2160,85,82,167,新埔,乙簡
2020-01-26,2160,34,39,73,新埔,乙簡
2020-01-27,2160,115,90,205,新埔,乙簡
2020-01-28,2160,64,43,107,新埔,乙簡
2020-01-29,2160,84,58,142,新埔,乙簡
2020-01-30,2160,35,31,66,新埔,乙簡
2020-01-31,2160,48,45,93,新埔,乙簡
2020-02-01,2160,50,58,108,新埔,乙簡
2020-02-02,2160,49,33,82,新埔,乙簡
2020-02-03,2160,36,42,78,新埔,乙簡
2020-02-04,2160,39,27,66,新埔,乙簡
2020-02-05,2160,39,35,74,新埔,乙簡
2020-02-06,2160,47,44,91,新埔,乙簡
2020-02-07,2160,33,31,64,新埔,乙簡
2020-02-08,2160,42,61,103,新埔,乙簡
2020-02-09,2160,49,43,92,新埔,乙簡
2020-02-10,2160,40,40,80,新埔,乙簡
2020-02-11,2160,53,50,103,新埔,乙簡
2020-02-12,2160,52,49,101,新埔,乙簡
2020-02-13,2160,35,35,70,新埔,乙簡
2020-02-14,2160,45,38,83,新埔,乙簡
2020-02-15,2160,58,48,106,新埔,乙簡
2020-02-16,2160,30,42,72,新埔,乙簡
2020-02-17,2160,44,50,94,新埔,乙簡
2020-02-18,2160,52,47,99,新埔,乙簡
2020-02-19,2160,45,33,78,新埔,乙簡
2020-02-20,2160,53,45,98,新埔,乙簡
2020-02-21,2160,57,43,100,新埔,乙簡
2020-02-22,2160,66,68,134,新埔,乙簡
2020-02-23,2160,90,69,159,新埔,乙簡
2020-02-24,2160,47,37,84,新埔,乙簡
2020-02-25,2160,55,44,99,新埔,乙簡
2020-02-26,2160,42,45,87,新埔,乙簡
2020-02-27,2160,42,47,89,新埔,乙簡
2020-02-28,2160,85,100,185,新埔,乙簡
2020-02-29,2160,69,68,137,新埔,乙簡
2020-03-01,2160,94,61,155,新埔,乙簡
2020-03-02,2160,39,33,72,新埔,乙簡
2020-03-03,2160,39,31,70,新埔,乙簡
2020-03-04,2160,30,28,58,新埔,乙簡
2020-03-05,2160,35,35,70,新埔,乙簡
2020-03-06,2160,35,47,82,新埔,乙簡
2020-03-07,2160,58,45,103,新埔,乙簡
2020-03-08,2160,46,28,74,新埔,乙簡
2020-03-09,2160,41,28,69,新埔,乙簡
2020-03-10,2160,19,22,41,新埔,乙簡
2020-03-11,2160,36,31,67,新埔,乙簡
2020-03-12,2160,33,32,65,新埔,乙簡
2020-03-13,2160,36,33,69,新埔,乙簡
2020-03-14,2160,36,38,74,新埔,乙簡
2020-03-15,2160,68,54,122,新埔,乙簡
2020-03-16,2160,41,24,65,新埔,乙簡
2020-03-17,2160,38,26,64,新埔,乙簡
2020-03-18,2160,32,49,81,新埔,乙簡
2020-03-19,2160,42,39,81,新埔,乙簡
2020-03-20,2160,51,52,103,新埔,乙簡
2020-03-21,2160,43,47,90,新埔,乙簡
2020-03-22,2160,67,51,118,新埔,乙簡
2020-03-23,2160,39,29,68,新埔,乙簡
2020-03-24,2160,43,43,86,新埔,乙簡
2020-03-25,2160,34,25,59,新埔,乙簡
2020-03-26,2160,38,36,74,新埔,乙簡
2020-03-27,2160,42,48,90,新埔,乙簡
2020-03-28,2160,36,39,75,新埔,乙簡
2020-03-29,2160,64,43,107,新埔,乙簡
2020-03-30,2160,39,25,64,新埔,乙簡
2020-03-31,2160,38,35,73,新埔,乙簡
2020-04-01,2160,42,35,77,新埔,乙簡
2020-04-02,2160,39,39,78,新埔,乙簡
2020-04-03,2160,58,50,108,新埔,乙簡
2020-04-04,2160,58,50,108,新埔,乙簡
2020-04-05,2160,57,25,82,新埔,乙簡
2020-04-06,2160,38,26,64,新埔,乙簡
2020-04-07,2160,31,31,62,新埔,乙簡
2020-04-08,2160,30,21,51,新埔,乙簡
2020-04-09,2160,40,31,71,新埔,乙簡
2020-04-10,2160,42,49,91,新埔,乙簡
2020-04-11,2160,27,33,60,新埔,乙簡
2020-04-12,2160,58,48,106,新埔,乙簡
2020-04-13,2160,35,30,65,新埔,乙簡
2020-04-14,2160,32,27,59,新埔,乙簡
2020-04-15,2160,35,34,69,新埔,乙簡
2020-04-16,2160,36,36,72,新埔,乙簡
2020-04-17,2160,43,43,86,新埔,乙簡
2020-04-18,2160,74,58,132,新埔,乙簡
2020-04-19,2160,62,36,98,新埔,乙簡
2020-04-20,2160,46,44,90,新埔,乙簡
2020-04-21,2160,34,28,62,新埔,乙簡
2020-04-22,2160,37,30,67,新埔,乙簡
2020-04-23,2160,24,28,52,新埔,乙簡
2020-04-24,2160,30,26,56,新埔,乙簡
2020-04-25,2160,59,51,110,新埔,乙簡
2020-04-26,2160,53,43,96,新埔,乙簡
2020-04-27,2160,45,35,80,新埔,乙簡
2020-04-28,2160,54,30,84,新埔,乙簡
2020-04-29,2160,32,31,63,新埔,乙簡
2020-04-30,2160,37,35,72,新埔,乙簡
2020-05-01,2160,61,66,127,新埔,乙簡
2020-05-02,2160,54,55,109,新埔,乙簡
2020-05-03,2160,78,64,142,新埔,乙簡
2020-05-04,2160,60,40,100,新埔,乙簡
2020-05-05,2160,38,27,65,新埔,乙簡
2020-05-06,2160,44,38,82,新埔,乙簡
2020-05-07,2160,58,41,99,新埔,乙簡
2020-05-08,2160,43,37,80,新埔,乙簡
2020-05-09,2160,55,75,130,新埔,乙簡
2020-05-10,2160,73,60,133,新埔,乙簡
2020-05-11,2160,36,28,64,新埔,乙簡
2020-05-12,2160,34,33,67,新埔,乙簡
2020-05-13,2160,44,46,90,新埔,乙簡
2020-05-14,2160,39,35,74,新埔,乙簡
2020-05-15,2160,61,67,128,新埔,乙簡
2020-05-16,2160,64,68,132,新埔,乙簡
2020-05-17,2160,62,55,117,新埔,乙簡
2020-05-18,2160,39,29,68,新埔,乙簡
2020-05-19,2160,29,23,52,新埔,乙簡
2020-05-20,2160,34,31,65,新埔,乙簡
2020-05-21,2160,29,31,60,新埔,乙簡
2020-05-22,2160,42,38,80,新埔,乙簡
2020-05-23,2160,37,41,78,新埔,乙簡
2020-05-24,2160,80,77,157,新埔,乙簡
2020-05-25,2160,64,56,120,新埔,乙簡
2020-05-26,2160,35,32,67,新埔,乙簡
2020-05-27,2160,29,29,58,新埔,乙簡
2020-05-28,2160,35,38,73,新埔,乙簡
2020-05-29,2160,46,49,95,新埔,乙簡
2020-05-30,2160,74,88,162,新埔,乙簡
2020-05-31,2160,103,86,189,新埔,乙簡
2020-06-01,2160,49,39,88,新埔,乙簡
2020-06-02,2160,48,39,87,新埔,乙簡
2020-06-03,2160,59,53,112,新埔,乙簡
2020-06-04,2160,59,46,105,新埔,乙簡
2020-06-05,2160,92,92,184,新埔,乙簡
2020-06-06,2160,63,67,130,新埔,乙簡
2020-06-07,2160,67,53,120,新埔,乙簡
2020-06-08,2160,34,27,61,新埔,乙簡
2020-06-09,2160,34,27,61,新埔,乙簡
2020-06-10,2160,55,50,105,新埔,乙簡
2020-06-11,2160,54,48,102,新埔,乙簡
2020-06-12,2160,55,57,112,新埔,乙簡
2020-06-13,2160,63,69,132,新埔,乙簡
2020-06-14,2160,114,92,206,新埔,乙簡
2020-06-15,2160,54,48,102,新埔,乙簡
2020-06-16,2160,46,39,85,新埔,乙簡
2020-06-17,2160,38,36,74,新埔,乙簡
2020-06-18,2160,33,32,65,新埔,乙簡
2020-06-19,2160,48,47,95,新埔,乙簡
2020-06-20,2160,59,59,118,新埔,乙簡
2020-06-21,2160,74,78,152,新埔,乙簡
2020-06-22,2160,37,33,70,新埔,乙簡
2020-06-23,2160,41,34,75,新埔,乙簡
2020-06-24,2160,56,62,118,新埔,乙簡
2020-06-25,2160,62,106,168,新埔,乙簡
2020-06-26,2160,116,100,216,新埔,乙簡
2020-06-27,2160,120,114,234,新埔,乙簡
2020-06-28,2160,85,55,140,新埔,乙簡
2020-06-29,2160,45,36,81,新埔,乙簡
2020-06-30,2160,81,76,157,新埔,乙簡
2020-07-01,2160,43,35,78,新埔,乙簡
2020-07-02,2160,43,64,107,新埔,乙簡
2020-07-03,2160,47,44,91,新埔,乙簡
2020-07-04,2160,150,93,243,新埔,乙簡
2020-07-05,2160,131,207,338,新埔,乙簡
2020-07-06,2160,58,51,109,新埔,乙簡
2020-07-07,2160,47,36,83,新埔,乙簡
2020-07-08,2160,55,71,126,新埔,乙簡
2020-07-09,2160,47,41,88,新埔,乙簡
2020-07-10,2160,64,57,121,新埔,乙簡
2020-07-11,2160,78,89,167,新埔,乙簡
2020-07-12,2160,493,162,655,新埔,乙簡
2020-07-13,2160,385,1885,2270,新埔,乙簡
2020-07-14,2160,97,90,187,新埔,乙簡
2020-07-15,2160,63,49,112,新埔,乙簡
2020-07-16,2160,57,70,127,新埔,乙簡
2020-07-17,2160,53,45,98,新埔,乙簡
2020-07-18,2160,93,82,175,新埔,乙簡
2020-07-19,2160,95,179,274,新埔,乙簡
2020-07-20,2160,49,46,95,新埔,乙簡
2020-07-21,2160,103,100,203,新埔,乙簡
2020-07-22,2160,79,72,151,新埔,乙簡
2020-07-23,2160,64,52,116,新埔,乙簡
2020-07-24,2160,63,64,127,新埔,乙簡
2020-07-25,2160,87,84,171,新埔,乙簡
2020-07-26,2160,109,104,213,新埔,乙簡
2020-07-27,2160,62,47,109,新埔,乙簡
2020-07-28,2160,100,88,188,新埔,乙簡
2020-07-29,2160,71,69,140,新埔,乙簡
2020-07-30,2160,55,49,104,新埔,乙簡
2020-07-31,2160,95,91,186,新埔,乙簡
2020-08-01,2160,70,82,152,新埔,乙簡
2020-08-02,2160,67,51,118,新埔,乙簡
2020-08-03,2160,47,33,80,新埔,乙簡
2020-08-04,2160,54,44,98,新埔,乙簡
2020-08-05,2160,50,41,91,新埔,乙簡
2020-08-06,2160,54,34,88,新埔,乙簡
2020-08-07,2160,63,54,117,新埔,乙簡
2020-08-08,2160,44,54,98,新埔,乙簡
2020-08-09,2160,83,68,151,新埔,乙簡
2020-08-10,2160,60,48,108,新埔,乙簡
2020-08-11,2160,64,58,122,新埔,乙簡
2020-08-12,2160,50,48,98,新埔,乙簡
2020-08-13,2160,69,45,114,新埔,乙簡
2020-08-14,2160,83,75,158,新埔,乙簡
2020-08-15,2160,56,52,108,新埔,乙簡
2020-08-16,2160,78,67,145,新埔,乙簡
2020-08-17,2160,48,47,95,新埔,乙簡
2020-08-18,2160,59,54,113,新埔,乙簡
2020-08-19,2160,64,59,123,新埔,乙簡
2020-08-20,2160,81,69,150,新埔,乙簡
2020-08-21,2160,61,55,116,新埔,乙簡
2020-08-22,2160,104,104,208,新埔,乙簡
2020-08-23,2160,86,57,143,新埔,乙簡
2020-08-24,2160,54,56,110,新埔,乙簡
2020-08-25,2160,54,46,100,新埔,乙簡
2020-08-26,2160,53,39,92,新埔,乙簡
2020-08-27,2160,41,35,76,新埔,乙簡
2020-08-28,2160,63,50,113,新埔,乙簡
2020-08-29,2160,58,98,156,新埔,乙簡
2020-08-30,2160,57,49,106,新埔,乙簡
2020-08-31,2160,50,39,89,新埔,乙簡
2020-09-01,2160,62,59,121,新埔,乙簡
2020-09-02,2160,47,39,86,新埔,乙簡
2020-09-03,2160,48,44,92,新埔,乙簡
2020-09-04,2160,59,81,140,新埔,乙簡
2020-09-05,2160,51,47,98,新埔,乙簡
2020-09-06,2160,40,36,76,新埔,乙簡
2020-09-07,2160,49,35,84,新埔,乙簡
2020-09-08,2160,54,43,97,新埔,乙簡
2020-09-09,2160,41,44,85,新埔,乙簡
2020-09-10,2160,48,47,95,新埔,乙簡
2020-09-11,2160,44,41,85,新埔,乙簡
2020-09-12,2160,145,115,260,新埔,乙簡
2020-09-13,2160,58,93,151,新埔,乙簡
2020-09-14,2160,47,43,90,新埔,乙簡
2020-09-15,2160,38,34,72,新埔,乙簡
2020-09-16,2160,50,53,103,新埔,乙簡
2020-09-17,2160,45,27,72,新埔,乙簡
2020-09-18,2160,44,41,85,新埔,乙簡
2020-09-19,2160,68,78,146,新埔,乙簡
2020-09-20,2160,66,61,127,新埔,乙簡
2020-09-21,2160,63,53,116,新埔,乙簡
2020-09-22,2160,37,34,71,新埔,乙簡
2020-09-23,2160,48,36,84,新埔,乙簡
2020-09-24,2160,41,37,78,新埔,乙簡
2020-09-25,2160,47,42,89,新埔,乙簡
2020-09-26,2160,136,133,269,新埔,乙簡
2020-09-27,2160,60,55,115,新埔,乙簡
2020-09-28,2160,42,33,75,新埔,乙簡
2020-09-29,2160,75,35,110,新埔,乙簡
2020-09-30,2160,36,40,76,新埔,乙簡
2020-10-01,2160,69,91,160,新埔,乙簡
2020-10-02,2160,143,134,277,新埔,乙簡
2020-10-03,2160,109,86,195,新埔,乙簡
2020-10-04,2160,70,55,125,新埔,乙簡
2020-10-05,2160,54,35,89,新埔,乙簡
2020-10-06,2160,48,38,86,新埔,乙簡
2020-10-07,2160,51,37,88,新埔,乙簡
2020-10-08,2160,56,60,116,新埔,乙簡
2020-10-09,2160,88,80,168,新埔,乙簡
2020-10-10,2160,103,127,230,新埔,乙簡
2020-10-11,2160,83,70,153,新埔,乙簡
2020-10-12,2160,49,41,90,新埔,乙簡
2020-10-13,2160,56,58,114,新埔,乙簡
2020-10-14,2160,71,59,130,新埔,乙簡
2020-10-15,2160,60,59,119,新埔,乙簡
2020-10-16,2160,59,67,126,新埔,乙簡
2020-10-17,2160,91,93,184,新埔,乙簡
2020-10-18,2160,81,76,157,新埔,乙簡
2020-10-19,2160,37,41,78,新埔,乙簡
2020-10-20,2160,47,50,97,新埔,乙簡
2020-10-21,2160,47,38,85,新埔,乙簡
2020-10-22,2160,45,39,84,新埔,乙簡
2020-10-23,2160,38,41,79,新埔,乙簡
2020-10-24,2160,45,49,94,新埔,乙簡
2020-10-25,2160,76,62,138,新埔,乙簡
2020-10-26,2160,53,47,100,新埔,乙簡
2020-10-27,2160,46,39,85,新埔,乙簡
2020-10-28,2160,47,42,89,新埔,乙簡
2020-10-29,2160,34,27,61,新埔,乙簡
2020-10-30,2160,45,43,88,新埔,乙簡
2020-10-31,2160,53,54,107,新埔,乙簡
2020-11-01,2160,70,58,128,新埔,乙簡
2020-11-02,2160,42,40,82,新埔,乙簡
2020-11-03,2160,33,28,61,新埔,乙簡
2020-11-04,2160,27,26,53,新埔,乙簡
2020-11-05,2160,38,36,74,新埔,乙簡
2020-11-06,2160,47,50,97,新埔,乙簡
2020-11-07,2160,52,62,114,新埔,乙簡
2020-11-08,2160,59,70,129,新埔,乙簡
2020-11-09,2160,39,47,86,新埔,乙簡
2020-11-10,2160,33,24,57,新埔,乙簡
2020-11-11,2160,42,37,79,新埔,乙簡
2020-11-12,2160,55,93,148,新埔,乙簡
2020-11-13,2160,29,35,64,新埔,乙簡
2020-11-14,2160,67,62,129,新埔,乙簡
2020-11-15,2160,94,86,180,新埔,乙簡
2020-11-16,2160,48,41,89,新埔,乙簡
2020-11-17,2160,43,40,83,新埔,乙簡
2020-11-18,2160,55,39,94,新埔,乙簡
2020-11-19,2160,40,34,74,新埔,乙簡
2020-11-20,2160,39,48,87,新埔,乙簡
2020-11-21,2160,55,85,140,新埔,乙簡
2020-11-22,2160,133,59,192,新埔,乙簡
2020-11-23,2160,50,43,93,新埔,乙簡
2020-11-24,2160,46,38,84,新埔,乙簡
2020-11-25,2160,46,35,81,新埔,乙簡
2020-11-26,2160,36,41,77,新埔,乙簡
2020-11-27,2160,48,47,95,新埔,乙簡
2020-11-28,2160,44,56,100,新埔,乙簡
2020-11-29,2160,47,48,95,新埔,乙簡
2020-11-30,2160,40,29,69,新埔,乙簡
2020-12-01,2160,40,48,88,新埔,乙簡
2020-12-02,2160,45,46,91,新埔,乙簡
2020-12-03,2160,50,46,96,新埔,乙簡
2020-12-04,2160,34,37,71,新埔,乙簡
2020-12-05,2160,37,39,76,新埔,乙簡
2020-12-06,2160,53,46,99,新埔,乙簡
2020-12-07,2160,49,39,88,新埔,乙簡
2020-12-08,2160,38,70,108,新埔,乙簡
2020-12-09,2160,38,22,60,新埔,乙簡
2020-12-10,2160,36,31,67,新埔,乙簡
2020-12-11,2160,47,51,98,新埔,乙簡
2020-12-12,2160,112,124,236,新埔,乙簡
2020-12-13,2160,94,60,154,新埔,乙簡
2020-12-14,2160,35,32,67,新埔,乙簡
2020-12-15,2160,44,82,126,新埔,乙簡
2020-12-16,2160,39,28,67,新埔,乙簡
2020-12-17,2160,45,40,85,新埔,乙簡
2020-12-18,2160,35,50,85,新埔,乙簡
2020-12-19,2160,47,54,101,新埔,乙簡
2020-12-20,2160,90,111,201,新埔,乙簡
2020-12-21,2160,34,30,64,新埔,乙簡
2020-12-22,2160,34,19,53,新埔,乙簡
2020-12-23,2160,29,18,47,新埔,乙簡
2020-12-24,2160,43,43,86,新埔,乙簡
2020-12-25,2160,42,52,94,新埔,乙簡
2020-12-26,2160,136,77,213,新埔,乙簡
2020-12-27,2160,55,39,94,新埔,乙簡
2020-12-28,2160,35,27,62,新埔,乙簡
2020-12-29,2160,51,41,92,新埔,乙簡
2020-12-30,2160,33,26,59,新埔,乙簡
2020-12-31,2160,35,35,70,新埔,乙簡
2020-01-01,2170,802,841,1643,通霄,三等
2020-01-02,2170,696,733,1429,通霄,三等
2020-01-03,2170,790,979,1769,通霄,三等
2020-01-04,2170,793,956,1749,通霄,三等
2020-01-05,2170,983,761,1744,通霄,三等
2020-01-06,2170,741,721,1462,通霄,三等
2020-01-07,2170,699,763,1462,通霄,三等
2020-01-08,2170,683,761,1444,通霄,三等
2020-01-09,2170,666,793,1459,通霄,三等
2020-01-10,2170,904,1332,2236,通霄,三等
2020-01-11,2170,1085,1230,2315,通霄,三等
2020-01-12,2170,1172,760,1932,通霄,三等
2020-01-13,2170,839,802,1641,通霄,三等
2020-01-14,2170,717,766,1483,通霄,三等
2020-01-15,2170,701,803,1504,通霄,三等
2020-01-16,2170,713,834,1547,通霄,三等
2020-01-17,2170,772,906,1678,通霄,三等
2020-01-18,2170,721,791,1512,通霄,三等
2020-01-19,2170,878,753,1631,通霄,三等
2020-01-20,2170,734,780,1514,通霄,三等
2020-01-21,2170,784,898,1682,通霄,三等
2020-01-22,2170,729,1058,1787,通霄,三等
2020-01-23,2170,647,1261,1908,通霄,三等
2020-01-24,2170,521,1046,1567,通霄,三等
2020-01-25,2170,1206,1075,2281,通霄,三等
2020-01-26,2170,1013,992,2005,通霄,三等
2020-01-27,2170,1416,1106,2522,通霄,三等
2020-01-28,2170,1199,851,2050,通霄,三等
2020-01-29,2170,1015,709,1724,通霄,三等
2020-01-30,2170,738,620,1358,通霄,三等
2020-01-31,2170,712,745,1457,通霄,三等
2020-02-01,2170,676,732,1408,通霄,三等
2020-02-02,2170,777,634,1411,通霄,三等
2020-02-03,2170,733,691,1424,通霄,三等
2020-02-04,2170,635,604,1239,通霄,三等
2020-02-05,2170,566,561,1127,通霄,三等
2020-02-06,2170,646,639,1285,通霄,三等
2020-02-07,2170,653,821,1474,通霄,三等
2020-02-08,2170,611,901,1512,通霄,三等
2020-02-09,2170,1081,688,1769,通霄,三等
2020-02-10,2170,681,639,1320,通霄,三等
2020-02-11,2170,635,639,1274,通霄,三等
2020-02-12,2170,623,638,1261,通霄,三等
2020-02-13,2170,555,573,1128,通霄,三等
2020-02-14,2170,637,688,1325,通霄,三等
2020-02-15,2170,594,774,1368,通霄,三等
2020-02-16,2170,724,615,1339,通霄,三等
2020-02-17,2170,614,616,1230,通霄,三等
2020-02-18,2170,625,609,1234,通霄,三等
2020-02-19,2170,604,627,1231,通霄,三等
2020-02-20,2170,637,650,1287,通霄,三等
2020-02-21,2170,659,825,1484,通霄,三等
2020-02-22,2170,652,742,1394,通霄,三等
2020-02-23,2170,828,611,1439,通霄,三等
2020-02-24,2170,704,662,1366,通霄,三等
2020-02-25,2170,626,651,1277,通霄,三等
2020-02-26,2170,598,646,1244,通霄,三等
2020-02-27,2170,753,1027,1780,通霄,三等
2020-02-28,2170,737,991,1728,通霄,三等
2020-02-29,2170,712,720,1432,通霄,三等
2020-03-01,2170,1025,621,1646,通霄,三等
2020-03-02,2170,692,631,1323,通霄,三等
2020-03-03,2170,597,571,1168,通霄,三等
2020-03-04,2170,577,584,1161,通霄,三等
2020-03-05,2170,559,617,1176,通霄,三等
2020-03-06,2170,717,1041,1758,通霄,三等
2020-03-07,2170,614,785,1399,通霄,三等
2020-03-08,2170,890,631,1521,通霄,三等
2020-03-09,2170,701,632,1333,通霄,三等
2020-03-10,2170,541,554,1095,通霄,三等
2020-03-11,2170,592,625,1217,通霄,三等
2020-03-12,2170,578,611,1189,通霄,三等
2020-03-13,2170,705,1027,1732,通霄,三等
2020-03-14,2170,526,746,1272,通霄,三等
2020-03-15,2170,1036,680,1716,通霄,三等
2020-03-16,2170,721,668,1389,通霄,三等
2020-03-17,2170,611,649,1260,通霄,三等
2020-03-18,2170,613,582,1195,通霄,三等
2020-03-19,2170,534,600,1134,通霄,三等
2020-03-20,2170,649,1000,1649,通霄,三等
2020-03-21,2170,531,650,1181,通霄,三等
2020-03-22,2170,839,523,1362,通霄,三等
2020-03-23,2170,643,570,1213,通霄,三等
2020-03-24,2170,587,599,1186,通霄,三等
2020-03-25,2170,557,580,1137,通霄,三等
2020-03-26,2170,573,611,1184,通霄,三等
2020-03-27,2170,684,932,1616,通霄,三等
2020-03-28,2170,422,575,997,通霄,三等
2020-03-29,2170,763,510,1273,通霄,三等
2020-03-30,2170,603,578,1181,通霄,三等
2020-03-31,2170,536,646,1182,通霄,三等
2020-04-01,2170,627,889,1516,通霄,三等
2020-04-02,2170,376,753,1129,通霄,三等
2020-04-03,2170,560,726,1286,通霄,三等
2020-04-04,2170,597,474,1071,通霄,三等
2020-04-05,2170,903,416,1319,通霄,三等
2020-04-06,2170,698,541,1239,通霄,三等
2020-04-07,2170,546,526,1072,通霄,三等
2020-04-08,2170,541,563,1104,通霄,三等
2020-04-09,2170,500,578,1078,通霄,三等
2020-04-10,2170,645,820,1465,通霄,三等
2020-04-11,2170,443,515,958,通霄,三等
2020-04-12,2170,652,468,1120,通霄,三等
2020-04-13,2170,604,575,1179,通霄,三等
2020-04-14,2170,543,575,1118,通霄,三等
2020-04-15,2170,544,581,1125,通霄,三等
2020-04-16,2170,539,544,1083,通霄,三等
2020-04-17,2170,633,944,1577,通霄,三等
2020-04-18,2170,507,645,1152,通霄,三等
2020-04-19,2170,853,570,1423,通霄,三等
2020-04-20,2170,633,590,1223,通霄,三等
2020-04-21,2170,528,537,1065,通霄,三等
2020-04-22,2170,511,563,1074,通霄,三等
2020-04-23,2170,495,535,1030,通霄,三等
2020-04-24,2170,595,813,1408,通霄,三等
2020-04-25,2170,430,543,973,通霄,三等
2020-04-26,2170,686,387,1073,通霄,三等
2020-04-27,2170,629,563,1192,通霄,三等
2020-04-28,2170,554,623,1177,通霄,三等
2020-04-29,2170,528,532,1060,通霄,三等
2020-04-30,2170,539,706,1245,通霄,三等
2020-05-01,2170,661,1021,1682,通霄,三等
2020-05-02,2170,576,723,1299,通霄,三等
2020-05-03,2170,1022,627,1649,通霄,三等
2020-05-04,2170,646,564,1210,通霄,三等
2020-05-05,2170,545,541,1086,通霄,三等
2020-05-06,2170,557,551,1108,通霄,三等
2020-05-07,2170,494,582,1076,通霄,三等
2020-05-08,2170,656,992,1648,通霄,三等
2020-05-09,2170,623,926,1549,通霄,三等
2020-05-10,2170,1148,623,1771,通霄,三等
2020-05-11,2170,704,610,1314,通霄,三等
2020-05-12,2170,571,596,1167,通霄,三等
2020-05-13,2170,605,606,1211,通霄,三等
2020-05-14,2170,584,665,1249,通霄,三等
2020-05-15,2170,730,991,1721,通霄,三等
2020-05-16,2170,555,701,1256,通霄,三等
2020-05-17,2170,860,581,1441,通霄,三等
2020-05-18,2170,623,567,1190,通霄,三等
2020-05-19,2170,519,539,1058,通霄,三等
2020-05-20,2170,587,585,1172,通霄,三等
2020-05-21,2170,535,562,1097,通霄,三等
2020-05-22,2170,568,789,1357,通霄,三等
2020-05-23,2170,463,624,1087,通霄,三等
2020-05-24,2170,951,645,1596,通霄,三等
2020-05-25,2170,748,692,1440,通霄,三等
2020-05-26,2170,572,598,1170,通霄,三等
2020-05-27,2170,556,555,1111,通霄,三等
2020-05-28,2170,517,598,1115,通霄,三等
2020-05-29,2170,714,977,1691,通霄,三等
2020-05-30,2170,668,824,1492,通霄,三等
2020-05-31,2170,1017,664,1681,通霄,三等
2020-06-01,2170,706,651,1357,通霄,三等
2020-06-02,2170,594,662,1256,通霄,三等
2020-06-03,2170,643,645,1288,通霄,三等
2020-06-04,2170,573,645,1218,通霄,三等
2020-06-05,2170,778,1037,1815,通霄,三等
2020-06-06,2170,716,869,1585,通霄,三等
2020-06-07,2170,965,617,1582,通霄,三等
2020-06-08,2170,614,608,1222,通霄,三等
2020-06-09,2170,613,608,1221,通霄,三等
2020-06-10,2170,632,617,1249,通霄,三等
2020-06-11,2170,701,707,1408,通霄,三等
2020-06-12,2170,760,977,1737,通霄,三等
2020-06-13,2170,709,871,1580,通霄,三等
2020-06-14,2170,1005,771,1776,通霄,三等
2020-06-15,2170,698,713,1411,通霄,三等
2020-06-16,2170,639,643,1282,通霄,三等
2020-06-17,2170,593,613,1206,通霄,三等
2020-06-18,2170,645,660,1305,通霄,三等
2020-06-19,2170,652,797,1449,通霄,三等
2020-06-20,2170,820,945,1765,通霄,三等
2020-06-21,2170,830,674,1504,通霄,三等
2020-06-22,2170,747,765,1512,通霄,三等
2020-06-23,2170,761,728,1489,通霄,三等
2020-06-24,2170,801,1117,1918,通霄,三等
2020-06-25,2170,709,1199,1908,通霄,三等
2020-06-26,2170,942,1053,1995,通霄,三等
2020-06-27,2170,1057,806,1863,通霄,三等
2020-06-28,2170,1137,703,1840,通霄,三等
2020-06-29,2170,765,707,1472,通霄,三等
2020-06-30,2170,692,681,1373,通霄,三等
2020-07-01,2170,720,689,1409,通霄,三等
2020-07-02,2170,660,680,1340,通霄,三等
2020-07-03,2170,701,869,1570,通霄,三等
2020-07-04,2170,1007,1675,2682,通霄,三等
2020-07-05,2170,4091,1016,5107,通霄,三等
2020-07-06,2170,724,732,1456,通霄,三等
2020-07-07,2170,622,695,1317,通霄,三等
2020-07-08,2170,628,678,1306,通霄,三等
2020-07-09,2170,631,663,1294,通霄,三等
2020-07-10,2170,767,989,1756,通霄,三等
2020-07-11,2170,1003,1170,2173,通霄,三等
2020-07-12,2170,7239,3168,10407,通霄,三等
2020-07-13,2170,1614,2629,4243,通霄,三等
2020-07-14,2170,723,782,1505,通霄,三等
2020-07-15,2170,662,705,1367,通霄,三等
2020-07-16,2170,751,757,1508,通霄,三等
2020-07-17,2170,818,922,1740,通霄,三等
2020-07-18,2170,825,962,1787,通霄,三等
2020-07-19,2170,977,785,1762,通霄,三等
2020-07-20,2170,728,688,1416,通霄,三等
2020-07-21,2170,700,723,1423,通霄,三等
2020-07-22,2170,732,751,1483,通霄,三等
2020-07-23,2170,749,769,1518,通霄,三等
2020-07-24,2170,774,923,1697,通霄,三等
2020-07-25,2170,799,928,1727,通霄,三等
2020-07-26,2170,1053,773,1826,通霄,三等
2020-07-27,2170,735,739,1474,通霄,三等
2020-07-28,2170,672,710,1382,通霄,三等
2020-07-29,2170,710,742,1452,通霄,三等
2020-07-30,2170,762,790,1552,通霄,三等
2020-07-31,2170,862,985,1847,通霄,三等
2020-08-01,2170,747,973,1720,通霄,三等
2020-08-02,2170,919,730,1649,通霄,三等
2020-08-03,2170,682,598,1280,通霄,三等
2020-08-04,2170,728,689,1417,通霄,三等
2020-08-05,2170,720,750,1470,通霄,三等
2020-08-06,2170,734,807,1541,通霄,三等
2020-08-07,2170,759,1054,1813,通霄,三等
2020-08-08,2170,727,1021,1748,通霄,三等
2020-08-09,2170,1108,741,1849,通霄,三等
2020-08-10,2170,830,784,1614,通霄,三等
2020-08-11,2170,685,657,1342,通霄,三等
2020-08-12,2170,704,722,1426,通霄,三等
2020-08-13,2170,687,753,1440,通霄,三等
2020-08-14,2170,833,920,1753,通霄,三等
2020-08-15,2170,782,876,1658,通霄,三等
2020-08-16,2170,1005,817,1822,通霄,三等
2020-08-17,2170,834,834,1668,通霄,三等
2020-08-18,2170,702,779,1481,通霄,三等
2020-08-19,2170,680,683,1363,通霄,三等
2020-08-20,2170,677,750,1427,通霄,三等
2020-08-21,2170,764,911,1675,通霄,三等
2020-08-22,2170,746,876,1622,通霄,三等
2020-08-23,2170,953,757,1710,通霄,三等
2020-08-24,2170,760,714,1474,通霄,三等
2020-08-25,2170,737,767,1504,通霄,三等
2020-08-26,2170,683,668,1351,通霄,三等
2020-08-27,2170,611,640,1251,通霄,三等
2020-08-28,2170,799,893,1692,通霄,三等
2020-08-29,2170,624,839,1463,通霄,三等
2020-08-30,2170,969,694,1663,通霄,三等
2020-08-31,2170,669,717,1386,通霄,三等
2020-09-01,2170,643,762,1405,通霄,三等
2020-09-02,2170,651,685,1336,通霄,三等
2020-09-03,2170,714,744,1458,通霄,三等
2020-09-04,2170,850,984,1834,通霄,三等
2020-09-05,2170,690,890,1580,通霄,三等
2020-09-06,2170,928,693,1621,通霄,三等
2020-09-07,2170,744,672,1416,通霄,三等
2020-09-08,2170,660,648,1308,通霄,三等
2020-09-09,2170,635,664,1299,通霄,三等
2020-09-10,2170,685,721,1406,通霄,三等
2020-09-11,2170,781,953,1734,通霄,三等
2020-09-12,2170,725,876,1601,通霄,三等
2020-09-13,2170,1036,680,1716,通霄,三等
2020-09-14,2170,678,709,1387,通霄,三等
2020-09-15,2170,654,675,1329,通霄,三等
2020-09-16,2170,769,748,1517,通霄,三等
2020-09-17,2170,646,660,1306,通霄,三等
2020-09-18,2170,777,1000,1777,通霄,三等
2020-09-19,2170,761,967,1728,通霄,三等
2020-09-20,2170,1098,783,1881,通霄,三等
2020-09-21,2170,690,717,1407,通霄,三等
2020-09-22,2170,629,649,1278,通霄,三等
2020-09-23,2170,668,660,1328,通霄,三等
2020-09-24,2170,616,668,1284,通霄,三等
2020-09-25,2170,646,827,1473,通霄,三等
2020-09-26,2170,677,846,1523,通霄,三等
2020-09-27,2170,822,668,1490,通霄,三等
2020-09-28,2170,740,721,1461,通霄,三等
2020-09-29,2170,655,702,1357,通霄,三等
2020-09-30,2170,806,1285,2091,通霄,三等
2020-10-01,2170,826,1507,2333,通霄,三等
2020-10-02,2170,1228,1169,2397,通霄,三等
2020-10-03,2170,1137,926,2063,通霄,三等
2020-10-04,2170,1347,791,2138,通霄,三等
2020-10-05,2170,878,751,1629,通霄,三等
2020-10-06,2170,739,720,1459,通霄,三等
2020-10-07,2170,729,740,1469,通霄,三等
2020-10-08,2170,835,1086,1921,通霄,三等
2020-10-09,2170,839,1207,2046,通霄,三等
2020-10-10,2170,933,854,1787,通霄,三等
2020-10-11,2170,1152,727,1879,通霄,三等
2020-10-12,2170,784,779,1563,通霄,三等
2020-10-13,2170,722,759,1481,通霄,三等
2020-10-14,2170,689,770,1459,通霄,三等
2020-10-15,2170,725,760,1485,通霄,三等
2020-10-16,2170,880,1098,1978,通霄,三等
2020-10-17,2170,772,1021,1793,通霄,三等
2020-10-18,2170,1174,867,2041,通霄,三等
2020-10-19,2170,785,740,1525,通霄,三等
2020-10-20,2170,735,724,1459,通霄,三等
2020-10-21,2170,727,745,1472,通霄,三等
2020-10-22,2170,670,731,1401,通霄,三等
2020-10-23,2170,748,1007,1755,通霄,三等
2020-10-24,2170,937,1093,2030,通霄,三等
2020-10-25,2170,1097,768,1865,通霄,三等
2020-10-26,2170,729,684,1413,通霄,三等
2020-10-27,2170,702,723,1425,通霄,三等
2020-10-28,2170,704,751,1455,通霄,三等
2020-10-29,2170,657,731,1388,通霄,三等
2020-10-30,2170,772,1015,1787,通霄,三等
2020-10-31,2170,808,963,1771,通霄,三等
2020-11-01,2170,1025,761,1786,通霄,三等
2020-11-02,2170,766,751,1517,通霄,三等
2020-11-03,2170,644,671,1315,通霄,三等
2020-11-04,2170,698,710,1408,通霄,三等
2020-11-05,2170,696,697,1393,通霄,三等
2020-11-06,2170,772,1006,1778,通霄,三等
2020-11-07,2170,816,921,1737,通霄,三等
2020-11-08,2170,1085,718,1803,通霄,三等
2020-11-09,2170,766,726,1492,通霄,三等
2020-11-10,2170,675,658,1333,通霄,三等
2020-11-11,2170,710,747,1457,通霄,三等
2020-11-12,2170,719,753,1472,通霄,三等
2020-11-13,2170,783,1078,1861,通霄,三等
2020-11-14,2170,741,909,1650,通霄,三等
2020-11-15,2170,1192,834,2026,通霄,三等
2020-11-16,2170,772,738,1510,通霄,三等
2020-11-17,2170,725,753,1478,通霄,三等
2020-11-18,2170,747,727,1474,通霄,三等
2020-11-19,2170,620,686,1306,通霄,三等
2020-11-20,2170,839,1129,1968,通霄,三等
2020-11-21,2170,779,1051,1830,通霄,三等
2020-11-22,2170,1313,781,2094,通霄,三等
2020-11-23,2170,799,716,1515,通霄,三等
2020-11-24,2170,712,740,1452,通霄,三等
2020-11-25,2170,687,719,1406,通霄,三等
2020-11-26,2170,695,747,1442,通霄,三等
2020-11-27,2170,845,1076,1921,通霄,三等
2020-11-28,2170,718,1010,1728,通霄,三等
2020-11-29,2170,1119,748,1867,通霄,三等
2020-11-30,2170,762,746,1508,通霄,三等
2020-12-01,2170,678,748,1426,通霄,三等
2020-12-02,2170,734,692,1426,通霄,三等
2020-12-03,2170,683,712,1395,通霄,三等
2020-12-04,2170,802,1077,1879,通霄,三等
2020-12-05,2170,685,874,1559,通霄,三等
2020-12-06,2170,1119,744,1863,通霄,三等
2020-12-07,2170,779,706,1485,通霄,三等
2020-12-08,2170,702,702,1404,通霄,三等
2020-12-09,2170,589,605,1194,通霄,三等
2020-12-10,2170,626,693,1319,通霄,三等
2020-12-11,2170,789,1065,1854,通霄,三等
2020-12-12,2170,802,1003,1805,通霄,三等
2020-12-13,2170,1284,905,2189,通霄,三等
2020-12-14,2170,773,717,1490,通霄,三等
2020-12-15,2170,706,663,1369,通霄,三等
2020-12-16,2170,672,622,1294,通霄,三等
2020-12-17,2170,630,703,1333,通霄,三等
2020-12-18,2170,784,1030,1814,通霄,三等
2020-12-19,2170,724,944,1668,通霄,三等
2020-12-20,2170,1033,683,1716,通霄,三等
2020-12-21,2170,734,683,1417,通霄,三等
2020-12-22,2170,681,726,1407,通霄,三等
2020-12-23,2170,588,618,1206,通霄,三等
2020-12-24,2170,664,700,1364,通霄,三等
2020-12-25,2170,806,1008,1814,通霄,三等
2020-12-26,2170,654,943,1597,通霄,三等
2020-12-27,2170,1023,708,1731,通霄,三等
2020-12-28,2170,714,723,1437,通霄,三等
2020-12-29,2170,712,722,1434,通霄,三等
2020-12-30,2170,630,697,1327,通霄,三等
2020-12-31,2170,773,1020,1793,通霄,三等
2020-01-01,2180,1349,1549,2898,苑裡,三等
2020-01-02,2180,1449,1428,2877,苑裡,三等
2020-01-03,2180,1509,1848,3357,苑裡,三等
2020-01-04,2180,1823,1825,3648,苑裡,三等
2020-01-05,2180,1688,1292,2980,苑裡,三等
2020-01-06,2180,1563,1443,3006,苑裡,三等
2020-01-07,2180,1466,1409,2875,苑裡,三等
2020-01-08,2180,1497,1397,2894,苑裡,三等
2020-01-09,2180,1431,1536,2967,苑裡,三等
2020-01-10,2180,1744,2508,4252,苑裡,三等
2020-01-11,2180,1917,2288,4205,苑裡,三等
2020-01-12,2180,2496,1674,4170,苑裡,三等
2020-01-13,2180,1738,1397,3135,苑裡,三等
2020-01-14,2180,1547,1469,3016,苑裡,三等
2020-01-15,2180,1576,1428,3004,苑裡,三等
2020-01-16,2180,1815,1728,3543,苑裡,三等
2020-01-17,2180,1282,1621,2903,苑裡,三等
2020-01-18,2180,1443,1673,3116,苑裡,三等
2020-01-19,2180,1575,1282,2857,苑裡,三等
2020-01-20,2180,1211,1292,2503,苑裡,三等
2020-01-21,2180,1211,1501,2712,苑裡,三等
2020-01-22,2180,1224,1791,3015,苑裡,三等
2020-01-23,2180,1125,2099,3224,苑裡,三等
2020-01-24,2180,1102,1681,2783,苑裡,三等
2020-01-25,2180,2203,2079,4282,苑裡,三等
2020-01-26,2180,1743,1719,3462,苑裡,三等
2020-01-27,2180,2385,1939,4324,苑裡,三等
2020-01-28,2180,2090,1618,3708,苑裡,三等
2020-01-29,2180,1877,1298,3175,苑裡,三等
2020-01-30,2180,1248,1003,2251,苑裡,三等
2020-01-31,2180,1167,1194,2361,苑裡,三等
2020-02-01,2180,1146,1248,2394,苑裡,三等
2020-02-02,2180,1323,1051,2374,苑裡,三等
2020-02-03,2180,1077,1016,2093,苑裡,三等
2020-02-04,2180,863,876,1739,苑裡,三等
2020-02-05,2180,952,932,1884,苑裡,三等
2020-02-06,2180,1021,1024,2045,苑裡,三等
2020-02-07,2180,1044,1300,2344,苑裡,三等
2020-02-08,2180,1091,1427,2518,苑裡,三等
2020-02-09,2180,1606,1157,2763,苑裡,三等
2020-02-10,2180,1084,960,2044,苑裡,三等
2020-02-11,2180,929,921,1850,苑裡,三等
2020-02-12,2180,988,976,1964,苑裡,三等
2020-02-13,2180,938,908,1846,苑裡,三等
2020-02-14,2180,1062,1190,2252,苑裡,三等
2020-02-15,2180,1063,1337,2400,苑裡,三等
2020-02-16,2180,1327,1076,2403,苑裡,三等
2020-02-17,2180,961,883,1844,苑裡,三等
2020-02-18,2180,1093,1064,2157,苑裡,三等
2020-02-19,2180,1049,1019,2068,苑裡,三等
2020-02-20,2180,903,927,1830,苑裡,三等
2020-02-21,2180,985,1239,2224,苑裡,三等
2020-02-22,2180,1113,1334,2447,苑裡,三等
2020-02-23,2180,1502,1108,2610,苑裡,三等
2020-02-24,2180,1156,1027,2183,苑裡,三等
2020-02-25,2180,1453,1317,2770,苑裡,三等
2020-02-26,2180,1409,1315,2724,苑裡,三等
2020-02-27,2180,1650,1844,3494,苑裡,三等
2020-02-28,2180,1126,1609,2735,苑裡,三等
2020-02-29,2180,1187,1202,2389,苑裡,三等
2020-03-01,2180,1912,1146,3058,苑裡,三等
2020-03-02,2180,1519,1281,2800,苑裡,三等
2020-03-03,2180,1310,1237,2547,苑裡,三等
2020-03-04,2180,1291,1290,2581,苑裡,三等
2020-03-05,2180,1210,1209,2419,苑裡,三等
2020-03-06,2180,1560,1943,3503,苑裡,三等
2020-03-07,2180,1067,1263,2330,苑裡,三等
2020-03-08,2180,1533,1052,2585,苑裡,三等
2020-03-09,2180,1447,1306,2753,苑裡,三等
2020-03-10,2180,1248,1197,2445,苑裡,三等
2020-03-11,2180,1344,1267,2611,苑裡,三等
2020-03-12,2180,1283,1270,2553,苑裡,三等
2020-03-13,2180,1510,1941,3451,苑裡,三等
2020-03-14,2180,1043,1319,2362,苑裡,三等
2020-03-15,2180,1789,1200,2989,苑裡,三等
2020-03-16,2180,1432,1297,2729,苑裡,三等
2020-03-17,2180,1307,1253,2560,苑裡,三等
2020-03-18,2180,1236,1231,2467,苑裡,三等
2020-03-19,2180,1200,1213,2413,苑裡,三等
2020-03-20,2180,1477,1858,3335,苑裡,三等
2020-03-21,2180,969,1202,2171,苑裡,三等
2020-03-22,2180,1326,846,2172,苑裡,三等
2020-03-23,2180,1370,1209,2579,苑裡,三等
2020-03-24,2180,1251,1163,2414,苑裡,三等
2020-03-25,2180,1197,1179,2376,苑裡,三等
2020-03-26,2180,1235,1213,2448,苑裡,三等
2020-03-27,2180,1440,1696,3136,苑裡,三等
2020-03-28,2180,775,1035,1810,苑裡,三等
2020-03-29,2180,1193,825,2018,苑裡,三等
2020-03-30,2180,1328,1244,2572,苑裡,三等
2020-03-31,2180,1142,1260,2402,苑裡,三等
2020-04-01,2180,1370,1744,3114,苑裡,三等
2020-04-02,2180,727,1391,2118,苑裡,三等
2020-04-03,2180,910,1262,2172,苑裡,三等
2020-04-04,2180,1047,776,1823,苑裡,三等
2020-04-05,2180,1732,751,2483,苑裡,三等
2020-04-06,2180,1455,1155,2610,苑裡,三等
2020-04-07,2180,1169,1099,2268,苑裡,三等
2020-04-08,2180,1199,1157,2356,苑裡,三等
2020-04-09,2180,1195,1167,2362,苑裡,三等
2020-04-10,2180,1367,1656,3023,苑裡,三等
2020-04-11,2180,779,932,1711,苑裡,三等
2020-04-12,2180,1142,858,2000,苑裡,三等
2020-04-13,2180,1317,1144,2461,苑裡,三等
2020-04-14,2180,1288,1186,2474,苑裡,三等
2020-04-15,2180,1237,1192,2429,苑裡,三等
2020-04-16,2180,1223,1207,2430,苑裡,三等
2020-04-17,2180,1397,1790,3187,苑裡,三等
2020-04-18,2180,961,1163,2124,苑裡,三等
2020-04-19,2180,1376,909,2285,苑裡,三等
2020-04-20,2180,1296,1194,2490,苑裡,三等
2020-04-21,2180,1179,1144,2323,苑裡,三等
2020-04-22,2180,1133,1098,2231,苑裡,三等
2020-04-23,2180,1144,1128,2272,苑裡,三等
2020-04-24,2180,1299,1596,2895,苑裡,三等
2020-04-25,2180,762,958,1720,苑裡,三等
2020-04-26,2180,1158,790,1948,苑裡,三等
2020-04-27,2180,1315,1165,2480,苑裡,三等
2020-04-28,2180,1209,1171,2380,苑裡,三等
2020-04-29,2180,1156,1147,2303,苑裡,三等
2020-04-30,2180,1268,1429,2697,苑裡,三等
2020-05-01,2180,1413,1960,3373,苑裡,三等
2020-05-02,2180,1031,1245,2276,苑裡,三等
2020-05-03,2180,1634,916,2550,苑裡,三等
2020-05-04,2180,1378,1208,2586,苑裡,三等
2020-05-05,2180,1262,1191,2453,苑裡,三等
2020-05-06,2180,1267,1285,2552,苑裡,三等
2020-05-07,2180,1237,1262,2499,苑裡,三等
2020-05-08,2180,1406,2094,3500,苑裡,三等
2020-05-09,2180,1074,1646,2720,苑裡,三等
2020-05-10,2180,1904,1026,2930,苑裡,三等
2020-05-11,2180,1527,1234,2761,苑裡,三等
2020-05-12,2180,1294,1204,2498,苑裡,三等
2020-05-13,2180,1285,1282,2567,苑裡,三等
2020-05-14,2180,1136,1244,2380,苑裡,三等
2020-05-15,2180,1661,1879,3540,苑裡,三等
2020-05-16,2180,1104,1317,2421,苑裡,三等
2020-05-17,2180,1547,1161,2708,苑裡,三等
2020-05-18,2180,1357,1204,2561,苑裡,三等
2020-05-19,2180,1150,1083,2233,苑裡,三等
2020-05-20,2180,1219,1157,2376,苑裡,三等
2020-05-21,2180,1150,1194,2344,苑裡,三等
2020-05-22,2180,1271,1657,2928,苑裡,三等
2020-05-23,2180,971,1192,2163,苑裡,三等
2020-05-24,2180,1564,1135,2699,苑裡,三等
2020-05-25,2180,1428,1300,2728,苑裡,三等
2020-05-26,2180,1293,1178,2471,苑裡,三等
2020-05-27,2180,1167,1185,2352,苑裡,三等
2020-05-28,2180,1166,1163,2329,苑裡,三等
2020-05-29,2180,1452,1872,3324,苑裡,三等
2020-05-30,2180,1167,1446,2613,苑裡,三等
2020-05-31,2180,1619,1127,2746,苑裡,三等
2020-06-01,2180,1471,1278,2749,苑裡,三等
2020-06-02,2180,1147,1187,2334,苑裡,三等
2020-06-03,2180,1296,1309,2605,苑裡,三等
2020-06-04,2180,1229,1244,2473,苑裡,三等
2020-06-05,2180,1444,1868,3312,苑裡,三等
2020-06-06,2180,1253,1493,2746,苑裡,三等
2020-06-07,2180,1663,1142,2805,苑裡,三等
2020-06-08,2180,1329,1204,2533,苑裡,三等
2020-06-09,2180,1244,1227,2471,苑裡,三等
2020-06-10,2180,1361,1330,2691,苑裡,三等
2020-06-11,2180,1406,1468,2874,苑裡,三等
2020-06-12,2180,1590,1878,3468,苑裡,三等
2020-06-13,2180,1381,1549,2930,苑裡,三等
2020-06-14,2180,1715,1336,3051,苑裡,三等
2020-06-15,2180,1804,1558,3362,苑裡,三等
2020-06-16,2180,1366,1336,2702,苑裡,三等
2020-06-17,2180,1185,1202,2387,苑裡,三等
2020-06-18,2180,1157,1207,2364,苑裡,三等
2020-06-19,2180,1260,1512,2772,苑裡,三等
2020-06-20,2180,1621,1838,3459,苑裡,三等
2020-06-21,2180,1415,1201,2616,苑裡,三等
2020-06-22,2180,1365,1246,2611,苑裡,三等
2020-06-23,2180,1196,1303,2499,苑裡,三等
2020-06-24,2180,1433,2010,3443,苑裡,三等
2020-06-25,2180,1300,2111,3411,苑裡,三等
2020-06-26,2180,1527,1568,3095,苑裡,三等
2020-06-27,2180,1730,1434,3164,苑裡,三等
2020-06-28,2180,1995,1239,3234,苑裡,三等
2020-06-29,2180,1483,1259,2742,苑裡,三等
2020-06-30,2180,1236,1207,2443,苑裡,三等
2020-07-01,2180,1143,1189,2332,苑裡,三等
2020-07-02,2180,1208,1236,2444,苑裡,三等
2020-07-03,2180,1322,1569,2891,苑裡,三等
2020-07-04,2180,1849,1470,3319,苑裡,三等
2020-07-05,2180,4428,1678,6106,苑裡,三等
2020-07-06,2180,1349,1240,2589,苑裡,三等
2020-07-07,2180,1261,1165,2426,苑裡,三等
2020-07-08,2180,1174,1169,2343,苑裡,三等
2020-07-09,2180,1225,1158,2383,苑裡,三等
2020-07-10,2180,1663,1836,3499,苑裡,三等
2020-07-11,2180,1528,1778,3306,苑裡,三等
2020-07-12,2180,3494,5052,8546,苑裡,三等
2020-07-13,2180,1703,1584,3287,苑裡,三等
2020-07-14,2180,1492,1345,2837,苑裡,三等
2020-07-15,2180,1023,1102,2125,苑裡,三等
2020-07-16,2180,1125,1132,2257,苑裡,三等
2020-07-17,2180,1314,1542,2856,苑裡,三等
2020-07-18,2180,1373,1532,2905,苑裡,三等
2020-07-19,2180,1790,1475,3265,苑裡,三等
2020-07-20,2180,1183,1028,2211,苑裡,三等
2020-07-21,2180,1228,1182,2410,苑裡,三等
2020-07-22,2180,1082,1080,2162,苑裡,三等
2020-07-23,2180,1241,1305,2546,苑裡,三等
2020-07-24,2180,1234,1495,2729,苑裡,三等
2020-07-25,2180,1322,1508,2830,苑裡,三等
2020-07-26,2180,1674,1343,3017,苑裡,三等
2020-07-27,2180,1329,1228,2557,苑裡,三等
2020-07-28,2180,1283,1252,2535,苑裡,三等
2020-07-29,2180,1292,1252,2544,苑裡,三等
2020-07-30,2180,1271,1302,2573,苑裡,三等
2020-07-31,2180,1510,1711,3221,苑裡,三等
2020-08-01,2180,1299,1698,2997,苑裡,三等
2020-08-02,2180,1662,1258,2920,苑裡,三等
2020-08-03,2180,1230,1116,2346,苑裡,三等
2020-08-04,2180,1231,1125,2356,苑裡,三等
2020-08-05,2180,1325,1285,2610,苑裡,三等
2020-08-06,2180,1353,1373,2726,苑裡,三等
2020-08-07,2180,1488,1995,3483,苑裡,三等
2020-08-08,2180,1217,1642,2859,苑裡,三等
2020-08-09,2180,2026,1353,3379,苑裡,三等
2020-08-10,2180,1494,1270,2764,苑裡,三等
2020-08-11,2180,1305,1230,2535,苑裡,三等
2020-08-12,2180,1250,1229,2479,苑裡,三等
2020-08-13,2180,1276,1239,2515,苑裡,三等
2020-08-14,2180,1319,1529,2848,苑裡,三等
2020-08-15,2180,1482,1656,3138,苑裡,三等
2020-08-16,2180,1852,1510,3362,苑裡,三等
2020-08-17,2180,1363,1267,2630,苑裡,三等
2020-08-18,2180,1291,1239,2530,苑裡,三等
2020-08-19,2180,1262,1213,2475,苑裡,三等
2020-08-20,2180,1245,1178,2423,苑裡,三等
2020-08-21,2180,1355,1600,2955,苑裡,三等
2020-08-22,2180,1249,1536,2785,苑裡,三等
2020-08-23,2180,1650,1298,2948,苑裡,三等
2020-08-24,2180,1112,1099,2211,苑裡,三等
2020-08-25,2180,1050,1011,2061,苑裡,三等
2020-08-26,2180,1041,1005,2046,苑裡,三等
2020-08-27,2180,967,1004,1971,苑裡,三等
2020-08-28,2180,1246,1490,2736,苑裡,三等
2020-08-29,2180,1275,1502,2777,苑裡,三等
2020-08-30,2180,1588,1242,2830,苑裡,三等
2020-08-31,2180,1462,1364,2826,苑裡,三等
2020-09-01,2180,1374,1410,2784,苑裡,三等
2020-09-02,2180,1335,1320,2655,苑裡,三等
2020-09-03,2180,1473,1346,2819,苑裡,三等
2020-09-04,2180,1647,1849,3496,苑裡,三等
2020-09-05,2180,1255,1445,2700,苑裡,三等
2020-09-06,2180,1676,1306,2982,苑裡,三等
2020-09-07,2180,1415,1368,2783,苑裡,三等
2020-09-08,2180,1287,1314,2601,苑裡,三等
2020-09-09,2180,1357,1327,2684,苑裡,三等
2020-09-10,2180,1357,1403,2760,苑裡,三等
2020-09-11,2180,1622,1893,3515,苑裡,三等
2020-09-12,2180,1256,1519,2775,苑裡,三等
2020-09-13,2180,1901,1413,3314,苑裡,三等
2020-09-14,2180,1384,1324,2708,苑裡,三等
2020-09-15,2180,1233,1239,2472,苑裡,三等
2020-09-16,2180,2092,2230,4322,苑裡,三等
2020-09-17,2180,1323,1312,2635,苑裡,三等
2020-09-18,2180,1554,2023,3577,苑裡,三等
2020-09-19,2180,1391,1596,2987,苑裡,三等
2020-09-20,2180,2008,1454,3462,苑裡,三等
2020-09-21,2180,1433,1265,2698,苑裡,三等
2020-09-22,2180,1280,1316,2596,苑裡,三等
2020-09-23,2180,1256,1264,2520,苑裡,三等
2020-09-24,2180,1287,1345,2632,苑裡,三等
2020-09-25,2180,1346,1609,2955,苑裡,三等
2020-09-26,2180,1571,1565,3136,苑裡,三等
2020-09-27,2180,1466,1168,2634,苑裡,三等
2020-09-28,2180,1374,1290,2664,苑裡,三等
2020-09-29,2180,1311,1359,2670,苑裡,三等
2020-09-30,2180,1656,2477,4133,苑裡,三等
2020-10-01,2180,1316,2366,3682,苑裡,三等
2020-10-02,2180,1835,1834,3669,苑裡,三等
2020-10-03,2180,1984,1472,3456,苑裡,三等
2020-10-04,2180,2384,1307,3691,苑裡,三等
2020-10-05,2180,1682,1321,3003,苑裡,三等
2020-10-06,2180,1331,1339,2670,苑裡,三等
2020-10-07,2180,1470,1459,2929,苑裡,三等
2020-10-08,2180,1682,1997,3679,苑裡,三等
2020-10-09,2180,1331,1808,3139,苑裡,三等
2020-10-10,2180,1534,1498,3032,苑裡,三等
2020-10-11,2180,2081,1389,3470,苑裡,三等
2020-10-12,2180,1578,1408,2986,苑裡,三等
2020-10-13,2180,1408,1433,2841,苑裡,三等
2020-10-14,2180,1420,1352,2772,苑裡,三等
2020-10-15,2180,1438,1362,2800,苑裡,三等
2020-10-16,2180,1643,1912,3555,苑裡,三等
2020-10-17,2180,1382,1625,3007,苑裡,三等
2020-10-18,2180,1933,1536,3469,苑裡,三等
2020-10-19,2180,1526,1389,2915,苑裡,三等
2020-10-20,2180,1440,1338,2778,苑裡,三等
2020-10-21,2180,1361,1299,2660,苑裡,三等
2020-10-22,2180,1362,1384,2746,苑裡,三等
2020-10-23,2180,1529,1945,3474,苑裡,三等
2020-10-24,2180,1470,1873,3343,苑裡,三等
2020-10-25,2180,1900,1356,3256,苑裡,三等
2020-10-26,2180,1544,1400,2944,苑裡,三等
2020-10-27,2180,1365,1320,2685,苑裡,三等
2020-10-28,2180,1350,1282,2632,苑裡,三等
2020-10-29,2180,1359,1346,2705,苑裡,三等
2020-10-30,2180,1548,2016,3564,苑裡,三等
2020-10-31,2180,1229,1505,2734,苑裡,三等
2020-11-01,2180,1865,1329,3194,苑裡,三等
2020-11-02,2180,1570,1386,2956,苑裡,三等
2020-11-03,2180,1330,1302,2632,苑裡,三等
2020-11-04,2180,1319,1298,2617,苑裡,三等
2020-11-05,2180,1281,1312,2593,苑裡,三等
2020-11-06,2180,1568,1989,3557,苑裡,三等
2020-11-07,2180,1289,1568,2857,苑裡,三等
2020-11-08,2180,2019,1469,3488,苑裡,三等
2020-11-09,2180,1550,1387,2937,苑裡,三等
2020-11-10,2180,1374,1359,2733,苑裡,三等
2020-11-11,2180,1399,1370,2769,苑裡,三等
2020-11-12,2180,1383,1425,2808,苑裡,三等
2020-11-13,2180,1613,2110,3723,苑裡,三等
2020-11-14,2180,1482,1726,3208,苑裡,三等
2020-11-15,2180,2138,1554,3692,苑裡,三等
2020-11-16,2180,1572,1382,2954,苑裡,三等
2020-11-17,2180,1352,1323,2675,苑裡,三等
2020-11-18,2180,1351,1357,2708,苑裡,三等
2020-11-19,2180,1459,1457,2916,苑裡,三等
2020-11-20,2180,1651,2061,3712,苑裡,三等
2020-11-21,2180,1492,1710,3202,苑裡,三等
2020-11-22,2180,2061,1511,3572,苑裡,三等
2020-11-23,2180,1569,1395,2964,苑裡,三等
2020-11-24,2180,1393,1350,2743,苑裡,三等
2020-11-25,2180,1381,1411,2792,苑裡,三等
2020-11-26,2180,1365,1431,2796,苑裡,三等
2020-11-27,2180,1627,2087,3714,苑裡,三等
2020-11-28,2180,1283,1579,2862,苑裡,三等
2020-11-29,2180,1937,1257,3194,苑裡,三等
2020-11-30,2180,1610,1401,3011,苑裡,三等
2020-12-01,2180,1407,1313,2720,苑裡,三等
2020-12-02,2180,1377,1334,2711,苑裡,三等
2020-12-03,2180,1335,1392,2727,苑裡,三等
2020-12-04,2180,1691,2078,3769,苑裡,三等
2020-12-05,2180,1437,1710,3147,苑裡,三等
2020-12-06,2180,1959,1422,3381,苑裡,三等
2020-12-07,2180,1519,1363,2882,苑裡,三等
2020-12-08,2180,1295,1260,2555,苑裡,三等
2020-12-09,2180,1263,1215,2478,苑裡,三等
2020-12-10,2180,1325,1283,2608,苑裡,三等
2020-12-11,2180,1685,2069,3754,苑裡,三等
2020-12-12,2180,1566,1720,3286,苑裡,三等
2020-12-13,2180,2042,1583,3625,苑裡,三等
2020-12-14,2180,1554,1392,2946,苑裡,三等
2020-12-15,2180,1326,1315,2641,苑裡,三等
2020-12-16,2180,1333,1296,2629,苑裡,三等
2020-12-17,2180,1408,1432,2840,苑裡,三等
2020-12-18,2180,1700,2136,3836,苑裡,三等
2020-12-19,2180,1295,1580,2875,苑裡,三等
2020-12-20,2180,1974,1481,3455,苑裡,三等
2020-12-21,2180,1506,1379,2885,苑裡,三等
2020-12-22,2180,1376,1337,2713,苑裡,三等
2020-12-23,2180,1237,1216,2453,苑裡,三等
2020-12-24,2180,1323,1293,2616,苑裡,三等
2020-12-25,2180,1725,2041,3766,苑裡,三等
2020-12-26,2180,1417,1647,3064,苑裡,三等
2020-12-27,2180,1760,1285,3045,苑裡,三等
2020-12-28,2180,1520,1369,2889,苑裡,三等
2020-12-29,2180,1387,1369,2756,苑裡,三等
2020-12-30,2180,1349,1340,2689,苑裡,三等
2020-12-31,2180,1707,2016,3723,苑裡,三等
2020-01-01,2190,302,308,610,日南,乙簡
2020-01-02,2190,249,213,462,日南,乙簡
2020-01-03,2190,262,283,545,日南,乙簡
2020-01-04,2190,235,258,493,日南,乙簡
2020-01-05,2190,344,320,664,日南,乙簡
2020-01-06,2190,261,230,491,日南,乙簡
2020-01-07,2190,240,212,452,日南,乙簡
2020-01-08,2190,245,235,480,日南,乙簡
2020-01-09,2190,272,248,520,日南,乙簡
2020-01-10,2190,286,381,667,日南,乙簡
2020-01-11,2190,356,349,705,日南,乙簡
2020-01-12,2190,498,410,908,日南,乙簡
2020-01-13,2190,277,245,522,日南,乙簡
2020-01-14,2190,236,219,455,日南,乙簡
2020-01-15,2190,253,248,501,日南,乙簡
2020-01-16,2190,258,252,510,日南,乙簡
2020-01-17,2190,231,250,481,日南,乙簡
2020-01-18,2190,285,255,540,日南,乙簡
2020-01-19,2190,305,314,619,日南,乙簡
2020-01-20,2190,212,201,413,日南,乙簡
2020-01-21,2190,234,190,424,日南,乙簡
2020-01-22,2190,251,280,531,日南,乙簡
2020-01-23,2190,300,383,683,日南,乙簡
2020-01-24,2190,394,400,794,日南,乙簡
2020-01-25,2190,714,640,1354,日南,乙簡
2020-01-26,2190,317,305,622,日南,乙簡
2020-01-27,2190,492,471,963,日南,乙簡
2020-01-28,2190,398,414,812,日南,乙簡
2020-01-29,2190,354,303,657,日南,乙簡
2020-01-30,2190,187,176,363,日南,乙簡
2020-01-31,2190,216,212,428,日南,乙簡
2020-02-01,2190,209,209,418,日南,乙簡
2020-02-02,2190,271,249,520,日南,乙簡
2020-02-03,2190,199,156,355,日南,乙簡
2020-02-04,2190,143,148,291,日南,乙簡
2020-02-05,2190,176,161,337,日南,乙簡
2020-02-06,2190,190,173,363,日南,乙簡
2020-02-07,2190,191,209,400,日南,乙簡
2020-02-08,2190,222,228,450,日南,乙簡
2020-02-09,2190,307,276,583,日南,乙簡
2020-02-10,2190,194,192,386,日南,乙簡
2020-02-11,2190,186,184,370,日南,乙簡
2020-02-12,2190,177,167,344,日南,乙簡
2020-02-13,2190,152,151,303,日南,乙簡
2020-02-14,2190,197,214,411,日南,乙簡
2020-02-15,2190,303,259,562,日南,乙簡
2020-02-16,2190,337,354,691,日南,乙簡
2020-02-17,2190,190,156,346,日南,乙簡
2020-02-18,2190,162,156,318,日南,乙簡
2020-02-19,2190,159,171,330,日南,乙簡
2020-02-20,2190,153,171,324,日南,乙簡
2020-02-21,2190,210,195,405,日南,乙簡
2020-02-22,2190,240,233,473,日南,乙簡
2020-02-23,2190,319,292,611,日南,乙簡
2020-02-24,2190,181,158,339,日南,乙簡
2020-02-25,2190,191,182,373,日南,乙簡
2020-02-26,2190,197,213,410,日南,乙簡
2020-02-27,2190,238,265,503,日南,乙簡
2020-02-28,2190,237,236,473,日南,乙簡
2020-02-29,2190,253,248,501,日南,乙簡
2020-03-01,2190,324,263,587,日南,乙簡
2020-03-02,2190,230,220,450,日南,乙簡
2020-03-03,2190,209,189,398,日南,乙簡
2020-03-04,2190,217,214,431,日南,乙簡
2020-03-05,2190,206,217,423,日南,乙簡
2020-03-06,2190,232,275,507,日南,乙簡
2020-03-07,2190,183,212,395,日南,乙簡
2020-03-08,2190,316,221,537,日南,乙簡
2020-03-09,2190,251,224,475,日南,乙簡
2020-03-10,2190,207,177,384,日南,乙簡
2020-03-11,2190,204,197,401,日南,乙簡
2020-03-12,2190,201,212,413,日南,乙簡
2020-03-13,2190,238,276,514,日南,乙簡
2020-03-14,2190,282,241,523,日南,乙簡
2020-03-15,2190,404,356,760,日南,乙簡
2020-03-16,2190,244,212,456,日南,乙簡
2020-03-17,2190,218,202,420,日南,乙簡
2020-03-18,2190,202,183,385,日南,乙簡
2020-03-19,2190,191,189,380,日南,乙簡
2020-03-20,2190,236,292,528,日南,乙簡
2020-03-21,2190,200,237,437,日南,乙簡
2020-03-22,2190,266,202,468,日南,乙簡
2020-03-23,2190,234,188,422,日南,乙簡
2020-03-24,2190,196,184,380,日南,乙簡
2020-03-25,2190,191,181,372,日南,乙簡
2020-03-26,2190,190,196,386,日南,乙簡
2020-03-27,2190,208,240,448,日南,乙簡
2020-03-28,2190,143,169,312,日南,乙簡
2020-03-29,2190,222,192,414,日南,乙簡
2020-03-30,2190,207,210,417,日南,乙簡
2020-03-31,2190,176,175,351,日南,乙簡
2020-04-01,2190,191,242,433,日南,乙簡
2020-04-02,2190,127,169,296,日南,乙簡
2020-04-03,2190,177,175,352,日南,乙簡
2020-04-04,2190,180,161,341,日南,乙簡
2020-04-05,2190,255,148,403,日南,乙簡
2020-04-06,2190,211,169,380,日南,乙簡
2020-04-07,2190,187,170,357,日南,乙簡
2020-04-08,2190,185,169,354,日南,乙簡
2020-04-09,2190,189,172,361,日南,乙簡
2020-04-10,2190,202,261,463,日南,乙簡
2020-04-11,2190,193,204,397,日南,乙簡
2020-04-12,2190,326,245,571,日南,乙簡
2020-04-13,2190,222,190,412,日南,乙簡
2020-04-14,2190,182,176,358,日南,乙簡
2020-04-15,2190,196,195,391,日南,乙簡
2020-04-16,2190,203,193,396,日南,乙簡
2020-04-17,2190,231,259,490,日南,乙簡
2020-04-18,2190,198,213,411,日南,乙簡
2020-04-19,2190,310,251,561,日南,乙簡
2020-04-20,2190,229,179,408,日南,乙簡
2020-04-21,2190,191,168,359,日南,乙簡
2020-04-22,2190,170,168,338,日南,乙簡
2020-04-23,2190,164,162,326,日南,乙簡
2020-04-24,2190,205,227,432,日南,乙簡
2020-04-25,2190,158,174,332,日南,乙簡
2020-04-26,2190,208,155,363,日南,乙簡
2020-04-27,2190,187,168,355,日南,乙簡
2020-04-28,2190,192,163,355,日南,乙簡
2020-04-29,2190,199,163,362,日南,乙簡
2020-04-30,2190,191,207,398,日南,乙簡
2020-05-01,2190,222,283,505,日南,乙簡
2020-05-02,2190,188,188,376,日南,乙簡
2020-05-03,2190,287,247,534,日南,乙簡
2020-05-04,2190,215,175,390,日南,乙簡
2020-05-05,2190,189,173,362,日南,乙簡
2020-05-06,2190,193,201,394,日南,乙簡
2020-05-07,2190,201,183,384,日南,乙簡
2020-05-08,2190,213,278,491,日南,乙簡
2020-05-09,2190,253,269,522,日南,乙簡
2020-05-10,2190,337,244,581,日南,乙簡
2020-05-11,2190,231,186,417,日南,乙簡
2020-05-12,2190,205,173,378,日南,乙簡
2020-05-13,2190,205,206,411,日南,乙簡
2020-05-14,2190,175,174,349,日南,乙簡
2020-05-15,2190,242,272,514,日南,乙簡
2020-05-16,2190,260,264,524,日南,乙簡
2020-05-17,2190,351,292,643,日南,乙簡
2020-05-18,2190,210,183,393,日南,乙簡
2020-05-19,2190,193,176,369,日南,乙簡
2020-05-20,2190,190,195,385,日南,乙簡
2020-05-21,2190,173,159,332,日南,乙簡
2020-05-22,2190,202,224,426,日南,乙簡
2020-05-23,2190,238,214,452,日南,乙簡
2020-05-24,2190,367,314,681,日南,乙簡
2020-05-25,2190,244,194,438,日南,乙簡
2020-05-26,2190,186,170,356,日南,乙簡
2020-05-27,2190,169,164,333,日南,乙簡
2020-05-28,2190,183,173,356,日南,乙簡
2020-05-29,2190,232,276,508,日南,乙簡
2020-05-30,2190,232,255,487,日南,乙簡
2020-05-31,2190,333,239,572,日南,乙簡
2020-06-01,2190,240,182,422,日南,乙簡
2020-06-02,2190,180,169,349,日南,乙簡
2020-06-03,2190,202,194,396,日南,乙簡
2020-06-04,2190,200,176,376,日南,乙簡
2020-06-05,2190,225,260,485,日南,乙簡
2020-06-06,2190,236,228,464,日南,乙簡
2020-06-07,2190,309,276,585,日南,乙簡
2020-06-08,2190,214,170,384,日南,乙簡
2020-06-09,2190,192,176,368,日南,乙簡
2020-06-10,2190,227,216,443,日南,乙簡
2020-06-11,2190,250,304,554,日南,乙簡
2020-06-12,2190,261,304,565,日南,乙簡
2020-06-13,2190,287,279,566,日南,乙簡
2020-06-14,2190,424,372,796,日南,乙簡
2020-06-15,2190,251,224,475,日南,乙簡
2020-06-16,2190,204,181,385,日南,乙簡
2020-06-17,2190,197,180,377,日南,乙簡
2020-06-18,2190,193,189,382,日南,乙簡
2020-06-19,2190,207,247,454,日南,乙簡
2020-06-20,2190,570,618,1188,日南,乙簡
2020-06-21,2190,284,233,517,日南,乙簡
2020-06-22,2190,201,223,424,日南,乙簡
2020-06-23,2190,193,172,365,日南,乙簡
2020-06-24,2190,221,270,491,日南,乙簡
2020-06-25,2190,261,315,576,日南,乙簡
2020-06-26,2190,357,302,659,日南,乙簡
2020-06-27,2190,320,299,619,日南,乙簡
2020-06-28,2190,363,307,670,日南,乙簡
2020-06-29,2190,240,212,452,日南,乙簡
2020-06-30,2190,203,181,384,日南,乙簡
2020-07-01,2190,198,177,375,日南,乙簡
2020-07-02,2190,190,170,360,日南,乙簡
2020-07-03,2190,215,252,467,日南,乙簡
2020-07-04,2190,323,244,567,日南,乙簡
2020-07-05,2190,914,600,1514,日南,乙簡
2020-07-06,2190,232,216,448,日南,乙簡
2020-07-07,2190,186,180,366,日南,乙簡
2020-07-08,2190,216,189,405,日南,乙簡
2020-07-09,2190,180,188,368,日南,乙簡
2020-07-10,2190,252,239,491,日南,乙簡
2020-07-11,2190,453,401,854,日南,乙簡
2020-07-12,2190,735,1201,1936,日南,乙簡
2020-07-13,2190,286,268,554,日南,乙簡
2020-07-14,2190,182,203,385,日南,乙簡
2020-07-15,2190,175,158,333,日南,乙簡
2020-07-16,2190,166,157,323,日南,乙簡
2020-07-17,2190,229,231,460,日南,乙簡
2020-07-18,2190,273,237,510,日南,乙簡
2020-07-19,2190,416,319,735,日南,乙簡
2020-07-20,2190,171,180,351,日南,乙簡
2020-07-21,2190,226,228,454,日南,乙簡
2020-07-22,2190,187,182,369,日南,乙簡
2020-07-23,2190,170,171,341,日南,乙簡
2020-07-24,2190,201,215,416,日南,乙簡
2020-07-25,2190,246,243,489,日南,乙簡
2020-07-26,2190,269,260,529,日南,乙簡
2020-07-27,2190,206,187,393,日南,乙簡
2020-07-28,2190,193,185,378,日南,乙簡
2020-07-29,2190,180,168,348,日南,乙簡
2020-07-30,2190,190,196,386,日南,乙簡
2020-07-31,2190,235,233,468,日南,乙簡
2020-08-01,2190,243,247,490,日南,乙簡
2020-08-02,2190,287,259,546,日南,乙簡
2020-08-03,2190,173,172,345,日南,乙簡
2020-08-04,2190,198,174,372,日南,乙簡
2020-08-05,2190,198,194,392,日南,乙簡
2020-08-06,2190,181,187,368,日南,乙簡
2020-08-07,2190,243,261,504,日南,乙簡
2020-08-08,2190,212,233,445,日南,乙簡
2020-08-09,2190,332,256,588,日南,乙簡
2020-08-10,2190,213,190,403,日南,乙簡
2020-08-11,2190,188,182,370,日南,乙簡
2020-08-12,2190,196,174,370,日南,乙簡
2020-08-13,2190,165,173,338,日南,乙簡
2020-08-14,2190,228,241,469,日南,乙簡
2020-08-15,2190,293,255,548,日南,乙簡
2020-08-16,2190,387,371,758,日南,乙簡
2020-08-17,2190,191,191,382,日南,乙簡
2020-08-18,2190,165,160,325,日南,乙簡
2020-08-19,2190,162,165,327,日南,乙簡
2020-08-20,2190,193,208,401,日南,乙簡
2020-08-21,2190,171,186,357,日南,乙簡
2020-08-22,2190,299,244,543,日南,乙簡
2020-08-23,2190,282,309,591,日南,乙簡
2020-08-24,2190,141,160,301,日南,乙簡
2020-08-25,2190,151,140,291,日南,乙簡
2020-08-26,2190,187,187,374,日南,乙簡
2020-08-27,2190,160,155,315,日南,乙簡
2020-08-28,2190,211,239,450,日南,乙簡
2020-08-29,2190,265,216,481,日南,乙簡
2020-08-30,2190,304,264,568,日南,乙簡
2020-08-31,2190,195,193,388,日南,乙簡
2020-09-01,2190,199,199,398,日南,乙簡
2020-09-02,2190,210,191,401,日南,乙簡
2020-09-03,2190,200,193,393,日南,乙簡
2020-09-04,2190,220,246,466,日南,乙簡
2020-09-05,2190,235,225,460,日南,乙簡
2020-09-06,2190,243,249,492,日南,乙簡
2020-09-07,2190,226,193,419,日南,乙簡
2020-09-08,2190,184,185,369,日南,乙簡
2020-09-09,2190,196,185,381,日南,乙簡
2020-09-10,2190,197,184,381,日南,乙簡
2020-09-11,2190,204,225,429,日南,乙簡
2020-09-12,2190,325,300,625,日南,乙簡
2020-09-13,2190,470,395,865,日南,乙簡
2020-09-14,2190,214,201,415,日南,乙簡
2020-09-15,2190,179,153,332,日南,乙簡
2020-09-16,2190,242,248,490,日南,乙簡
2020-09-17,2190,196,200,396,日南,乙簡
2020-09-18,2190,209,245,454,日南,乙簡
2020-09-19,2190,245,263,508,日南,乙簡
2020-09-20,2190,345,339,684,日南,乙簡
2020-09-21,2190,230,195,425,日南,乙簡
2020-09-22,2190,178,182,360,日南,乙簡
2020-09-23,2190,199,166,365,日南,乙簡
2020-09-24,2190,206,199,405,日南,乙簡
2020-09-25,2190,218,220,438,日南,乙簡
2020-09-26,2190,227,268,495,日南,乙簡
2020-09-27,2190,288,290,578,日南,乙簡
2020-09-28,2190,220,204,424,日南,乙簡
2020-09-29,2190,197,196,393,日南,乙簡
2020-09-30,2190,236,349,585,日南,乙簡
2020-10-01,2190,264,359,623,日南,乙簡
2020-10-02,2190,345,338,683,日南,乙簡
2020-10-03,2190,350,277,627,日南,乙簡
2020-10-04,2190,404,341,745,日南,乙簡
2020-10-05,2190,252,216,468,日南,乙簡
2020-10-06,2190,199,225,424,日南,乙簡
2020-10-07,2190,207,218,425,日南,乙簡
2020-10-08,2190,232,326,558,日南,乙簡
2020-10-09,2190,251,295,546,日南,乙簡
2020-10-10,2190,311,293,604,日南,乙簡
2020-10-11,2190,444,390,834,日南,乙簡
2020-10-12,2190,226,213,439,日南,乙簡
2020-10-13,2190,195,208,403,日南,乙簡
2020-10-14,2190,213,194,407,日南,乙簡
2020-10-15,2190,194,231,425,日南,乙簡
2020-10-16,2190,240,310,550,日南,乙簡
2020-10-17,2190,308,300,608,日南,乙簡
2020-10-18,2190,411,396,807,日南,乙簡
2020-10-19,2190,190,208,398,日南,乙簡
2020-10-20,2190,176,201,377,日南,乙簡
2020-10-21,2190,228,228,456,日南,乙簡
2020-10-22,2190,215,213,428,日南,乙簡
2020-10-23,2190,194,261,455,日南,乙簡
2020-10-24,2190,276,313,589,日南,乙簡
2020-10-25,2190,402,362,764,日南,乙簡
2020-10-26,2190,230,206,436,日南,乙簡
2020-10-27,2190,204,209,413,日南,乙簡
2020-10-28,2190,196,209,405,日南,乙簡
2020-10-29,2190,222,228,450,日南,乙簡
2020-10-30,2190,241,281,522,日南,乙簡
2020-10-31,2190,256,271,527,日南,乙簡
2020-11-01,2190,341,306,647,日南,乙簡
2020-11-02,2190,236,234,470,日南,乙簡
2020-11-03,2190,200,224,424,日南,乙簡
2020-11-04,2190,206,199,405,日南,乙簡
2020-11-05,2190,187,207,394,日南,乙簡
2020-11-06,2190,227,335,562,日南,乙簡
2020-11-07,2190,265,257,522,日南,乙簡
2020-11-08,2190,420,368,788,日南,乙簡
2020-11-09,2190,237,215,452,日南,乙簡
2020-11-10,2190,210,214,424,日南,乙簡
2020-11-11,2190,233,210,443,日南,乙簡
2020-11-12,2190,245,197,442,日南,乙簡
2020-11-13,2190,232,287,519,日南,乙簡
2020-11-14,2190,329,297,626,日南,乙簡
2020-11-15,2190,448,429,877,日南,乙簡
2020-11-16,2190,231,213,444,日南,乙簡
2020-11-17,2190,224,216,440,日南,乙簡
2020-11-18,2190,235,216,451,日南,乙簡
2020-11-19,2190,203,230,433,日南,乙簡
2020-11-20,2190,297,323,620,日南,乙簡
2020-11-21,2190,238,238,476,日南,乙簡
2020-11-22,2190,362,341,703,日南,乙簡
2020-11-23,2190,237,222,459,日南,乙簡
2020-11-24,2190,216,193,409,日南,乙簡
2020-11-25,2190,197,194,391,日南,乙簡
2020-11-26,2190,206,220,426,日南,乙簡
2020-11-27,2190,234,263,497,日南,乙簡
2020-11-28,2190,242,268,510,日南,乙簡
2020-11-29,2190,367,316,683,日南,乙簡
2020-11-30,2190,232,209,441,日南,乙簡
2020-12-01,2190,195,196,391,日南,乙簡
2020-12-02,2190,194,211,405,日南,乙簡
2020-12-03,2190,236,237,473,日南,乙簡
2020-12-04,2190,240,320,560,日南,乙簡
2020-12-05,2190,280,272,552,日南,乙簡
2020-12-06,2190,363,306,669,日南,乙簡
2020-12-07,2190,216,223,439,日南,乙簡
2020-12-08,2190,197,188,385,日南,乙簡
2020-12-09,2190,191,181,372,日南,乙簡
2020-12-10,2190,196,203,399,日南,乙簡
2020-12-11,2190,222,291,513,日南,乙簡
2020-12-12,2190,258,240,498,日南,乙簡
2020-12-13,2190,398,374,772,日南,乙簡
2020-12-14,2190,240,218,458,日南,乙簡
2020-12-15,2190,220,197,417,日南,乙簡
2020-12-16,2190,221,209,430,日南,乙簡
2020-12-17,2190,237,239,476,日南,乙簡
2020-12-18,2190,231,277,508,日南,乙簡
2020-12-19,2190,271,245,516,日南,乙簡
2020-12-20,2190,376,378,754,日南,乙簡
2020-12-21,2190,215,188,403,日南,乙簡
2020-12-22,2190,193,171,364,日南,乙簡
2020-12-23,2190,185,179,364,日南,乙簡
2020-12-24,2190,194,208,402,日南,乙簡
2020-12-25,2190,201,279,480,日南,乙簡
2020-12-26,2190,228,248,476,日南,乙簡
2020-12-27,2190,318,260,578,日南,乙簡
2020-12-28,2190,219,210,429,日南,乙簡
2020-12-29,2190,235,223,458,日南,乙簡
2020-12-30,2190,201,209,410,日南,乙簡
2020-12-31,2190,258,303,561,日南,乙簡
2020-01-01,2200,3516,3413,6929,大甲,二等
2020-01-02,2200,2123,2042,4165,大甲,二等
2020-01-03,2200,2382,2867,5249,大甲,二等
2020-01-04,2200,2911,3065,5976,大甲,二等
2020-01-05,2200,3670,3052,6722,大甲,二等
2020-01-06,2200,2317,2035,4352,大甲,二等
2020-01-07,2200,1978,1929,3907,大甲,二等
2020-01-08,2200,2061,2102,4163,大甲,二等
2020-01-09,2200,2123,2349,4472,大甲,二等
2020-01-10,2200,2649,4105,6754,大甲,二等
2020-01-11,2200,3542,3896,7438,大甲,二等
2020-01-12,2200,4651,3523,8174,大甲,二等
2020-01-13,2200,2537,2176,4713,大甲,二等
2020-01-14,2200,2258,2145,4403,大甲,二等
2020-01-15,2200,2162,2122,4284,大甲,二等
2020-01-16,2200,2492,2453,4945,大甲,二等
2020-01-17,2200,2189,2410,4599,大甲,二等
2020-01-18,2200,2639,2752,5391,大甲,二等
2020-01-19,2200,3094,2849,5943,大甲,二等
2020-01-20,2200,2034,1982,4016,大甲,二等
2020-01-21,2200,2076,2365,4441,大甲,二等
2020-01-22,2200,2082,2990,5072,大甲,二等
2020-01-23,2200,2560,3696,6256,大甲,二等
2020-01-24,2200,2732,3328,6060,大甲,二等
2020-01-25,2200,11352,11164,22516,大甲,二等
2020-01-26,2200,4638,4595,9233,大甲,二等
2020-01-27,2200,8197,7839,16036,大甲,二等
2020-01-28,2200,6436,5977,12413,大甲,二等
2020-01-29,2200,4941,4155,9096,大甲,二等
2020-01-30,2200,2560,2218,4778,大甲,二等
2020-01-31,2200,2476,2372,4848,大甲,二等
2020-02-01,2200,2668,2615,5283,大甲,二等
2020-02-02,2200,3217,2827,6044,大甲,二等
2020-02-03,2200,2040,1859,3899,大甲,二等
2020-02-04,2200,1623,1609,3232,大甲,二等
2020-02-05,2200,1852,1834,3686,大甲,二等
2020-02-06,2200,1712,1862,3574,大甲,二等
2020-02-07,2200,1947,2222,4169,大甲,二等
2020-02-08,2200,2424,2517,4941,大甲,二等
2020-02-09,2200,3200,2653,5853,大甲,二等
2020-02-10,2200,1990,1773,3763,大甲,二等
2020-02-11,2200,1741,1794,3535,大甲,二等
2020-02-12,2200,1850,1788,3638,大甲,二等
2020-02-13,2200,1730,1609,3339,大甲,二等
2020-02-14,2200,1891,2088,3979,大甲,二等
2020-02-15,2200,2318,2362,4680,大甲,二等
2020-02-16,2200,2802,2627,5429,大甲,二等
2020-02-17,2200,1657,1570,3227,大甲,二等
2020-02-18,2200,1629,1606,3235,大甲,二等
2020-02-19,2200,1576,1587,3163,大甲,二等
2020-02-20,2200,1644,1656,3300,大甲,二等
2020-02-21,2200,2010,2251,4261,大甲,二等
2020-02-22,2200,2269,2526,4795,大甲,二等
2020-02-23,2200,3030,2555,5585,大甲,二等
2020-02-24,2200,1904,1659,3563,大甲,二等
2020-02-25,2200,1848,1835,3683,大甲,二等
2020-02-26,2200,1864,1791,3655,大甲,二等
2020-02-27,2200,2336,2711,5047,大甲,二等
2020-02-28,2200,2452,2925,5377,大甲,二等
2020-02-29,2200,2412,2221,4633,大甲,二等
2020-03-01,2200,3458,2279,5737,大甲,二等
2020-03-02,2200,2040,1764,3804,大甲,二等
2020-03-03,2200,1695,1666,3361,大甲,二等
2020-03-04,2200,1732,1656,3388,大甲,二等
2020-03-05,2200,1604,1805,3409,大甲,二等
2020-03-06,2200,2168,2907,5075,大甲,二等
2020-03-07,2200,2081,2146,4227,大甲,二等
2020-03-08,2200,3057,2315,5372,大甲,二等
2020-03-09,2200,2023,1756,3779,大甲,二等
2020-03-10,2200,1562,1554,3116,大甲,二等
2020-03-11,2200,1804,1777,3581,大甲,二等
2020-03-12,2200,1806,1831,3637,大甲,二等
2020-03-13,2200,2290,3031,5321,大甲,二等
2020-03-14,2200,2034,2224,4258,大甲,二等
2020-03-15,2200,3345,2566,5911,大甲,二等
2020-03-16,2200,2114,1831,3945,大甲,二等
2020-03-17,2200,1736,1680,3416,大甲,二等
2020-03-18,2200,1690,1691,3381,大甲,二等
2020-03-19,2200,1608,1733,3341,大甲,二等
2020-03-20,2200,2107,2748,4855,大甲,二等
2020-03-21,2200,1704,1921,3625,大甲,二等
2020-03-22,2200,2705,1950,4655,大甲,二等
2020-03-23,2200,1892,1683,3575,大甲,二等
2020-03-24,2200,1667,1570,3237,大甲,二等
2020-03-25,2200,1583,1580,3163,大甲,二等
2020-03-26,2200,1604,1652,3256,大甲,二等
2020-03-27,2200,1960,2472,4432,大甲,二等
2020-03-28,2200,1393,1631,3024,大甲,二等
2020-03-29,2200,2261,1678,3939,大甲,二等
2020-03-30,2200,1765,1571,3336,大甲,二等
2020-03-31,2200,1616,1736,3352,大甲,二等
2020-04-01,2200,1882,2632,4514,大甲,二等
2020-04-02,2200,1396,2275,3671,大甲,二等
2020-04-03,2200,1678,2024,3702,大甲,二等
2020-04-04,2200,1752,1291,3043,大甲,二等
2020-04-05,2200,2900,1635,4535,大甲,二等
2020-04-06,2200,1982,1432,3414,大甲,二等
2020-04-07,2200,1557,1449,3006,大甲,二等
2020-04-08,2200,1475,1416,2891,大甲,二等
2020-04-09,2200,1498,1559,3057,大甲,二等
2020-04-10,2200,1915,2385,4300,大甲,二等
2020-04-11,2200,1471,1613,3084,大甲,二等
2020-04-12,2200,2479,1904,4383,大甲,二等
2020-04-13,2200,1719,1559,3278,大甲,二等
2020-04-14,2200,1586,1577,3163,大甲,二等
2020-04-15,2200,1805,1771,3576,大甲,二等
2020-04-16,2200,1573,1640,3213,大甲,二等
2020-04-17,2200,1988,2602,4590,大甲,二等
2020-04-18,2200,1717,1810,3527,大甲,二等
2020-04-19,2200,2523,1813,4336,大甲,二等
2020-04-20,2200,1742,1559,3301,大甲,二等
2020-04-21,2200,1523,1469,2992,大甲,二等
2020-04-22,2200,1375,1424,2799,大甲,二等
2020-04-23,2200,1335,1427,2762,大甲,二等
2020-04-24,2200,1762,2169,3931,大甲,二等
2020-04-25,2200,1328,1501,2829,大甲,二等
2020-04-26,2200,1994,1478,3472,大甲,二等
2020-04-27,2200,1681,1538,3219,大甲,二等
2020-04-28,2200,1492,1496,2988,大甲,二等
2020-04-29,2200,1452,1510,2962,大甲,二等
2020-04-30,2200,1704,2087,3791,大甲,二等
2020-05-01,2200,2205,2845,5050,大甲,二等
2020-05-02,2200,1939,1993,3932,大甲,二等
2020-05-03,2200,2895,1844,4739,大甲,二等
2020-05-04,2200,1859,1580,3439,大甲,二等
2020-05-05,2200,1594,1571,3165,大甲,二等
2020-05-06,2200,1589,1609,3198,大甲,二等
2020-05-07,2200,1598,1708,3306,大甲,二等
2020-05-08,2200,2052,3093,5145,大甲,二等
2020-05-09,2200,1978,2581,4559,大甲,二等
2020-05-10,2200,3421,2304,5725,大甲,二等
2020-05-11,2200,2107,1636,3743,大甲,二等
2020-05-12,2200,1678,1572,3250,大甲,二等
2020-05-13,2200,1698,1642,3340,大甲,二等
2020-05-14,2200,1635,1573,3208,大甲,二等
2020-05-15,2200,2294,2845,5139,大甲,二等
2020-05-16,2200,2107,2222,4329,大甲,二等
2020-05-17,2200,2902,2356,5258,大甲,二等
2020-05-18,2200,1837,1632,3469,大甲,二等
2020-05-19,2200,1471,1403,2874,大甲,二等
2020-05-20,2200,1625,1617,3242,大甲,二等
2020-05-21,2200,1568,1629,3197,大甲,二等
2020-05-22,2200,1788,2361,4149,大甲,二等
2020-05-23,2200,1872,2005,3877,大甲,二等
2020-05-24,2200,3126,2598,5724,大甲,二等
2020-05-25,2200,1947,1735,3682,大甲,二等
2020-05-26,2200,1583,1560,3143,大甲,二等
2020-05-27,2200,1412,1434,2846,大甲,二等
2020-05-28,2200,1421,1552,2973,大甲,二等
2020-05-29,2200,2060,2759,4819,大甲,二等
2020-05-30,2200,2360,2545,4905,大甲,二等
2020-05-31,2200,3231,2458,5689,大甲,二等
2020-06-01,2200,1955,1679,3634,大甲,二等
2020-06-02,2200,1642,1526,3168,大甲,二等
2020-06-03,2200,1662,1657,3319,大甲,二等
2020-06-04,2200,1646,1716,3362,大甲,二等
2020-06-05,2200,2150,2789,4939,大甲,二等
2020-06-06,2200,2246,2451,4697,大甲,二等
2020-06-07,2200,3106,2416,5522,大甲,二等
2020-06-08,2200,1906,1679,3585,大甲,二等
2020-06-09,2200,1839,1806,3645,大甲,二等
2020-06-10,2200,2145,2170,4315,大甲,二等
2020-06-11,2200,3519,8252,11771,大甲,二等
2020-06-12,2200,2776,3205,5981,大甲,二等
2020-06-13,2200,2672,2777,5449,大甲,二等
2020-06-14,2200,3534,3089,6623,大甲,二等
2020-06-15,2200,2201,2106,4307,大甲,二等
2020-06-16,2200,1887,1835,3722,大甲,二等
2020-06-17,2200,1737,1735,3472,大甲,二等
2020-06-18,2200,1862,1765,3627,大甲,二等
2020-06-19,2200,2796,2632,5428,大甲,二等
2020-06-20,2200,11395,7748,19143,大甲,二等
2020-06-21,2200,3688,2714,6402,大甲,二等
2020-06-22,2200,2128,1861,3989,大甲,二等
2020-06-23,2200,1797,1828,3625,大甲,二等
2020-06-24,2200,2258,3102,5360,大甲,二等
2020-06-25,2200,2430,3489,5919,大甲,二等
2020-06-26,2200,3437,3418,6855,大甲,二等
2020-06-27,2200,3899,3315,7214,大甲,二等
2020-06-28,2200,3987,3080,7067,大甲,二等
2020-06-29,2200,2343,1945,4288,大甲,二等
2020-06-30,2200,1977,1914,3891,大甲,二等
2020-07-01,2200,1864,1729,3593,大甲,二等
2020-07-02,2200,1800,1794,3594,大甲,二等
2020-07-03,2200,2186,2407,4593,大甲,二等
2020-07-04,2200,2990,2713,5703,大甲,二等
2020-07-05,2200,6716,4040,10756,大甲,二等
2020-07-06,2200,2090,2000,4090,大甲,二等
2020-07-07,2200,1828,1829,3657,大甲,二等
2020-07-08,2200,1802,1795,3597,大甲,二等
2020-07-09,2200,1776,1846,3622,大甲,二等
2020-07-10,2200,2457,2646,5103,大甲,二等
2020-07-11,2200,3775,3679,7454,大甲,二等
2020-07-12,2200,4525,4164,8689,大甲,二等
2020-07-13,2200,2901,2866,5767,大甲,二等
2020-07-14,2200,2122,2134,4256,大甲,二等
2020-07-15,2200,1859,1820,3679,大甲,二等
2020-07-16,2200,1876,1915,3791,大甲,二等
2020-07-17,2200,2319,2641,4960,大甲,二等
2020-07-18,2200,2804,2851,5655,大甲,二等
2020-07-19,2200,3612,3187,6799,大甲,二等
2020-07-20,2200,1993,1972,3965,大甲,二等
2020-07-21,2200,1879,1834,3713,大甲,二等
2020-07-22,2200,1788,1820,3608,大甲,二等
2020-07-23,2200,1911,1961,3872,大甲,二等
2020-07-24,2200,2305,2647,4952,大甲,二等
2020-07-25,2200,2786,2928,5714,大甲,二等
2020-07-26,2200,3527,3125,6652,大甲,二等
2020-07-27,2200,2029,1961,3990,大甲,二等
2020-07-28,2200,1966,1915,3881,大甲,二等
2020-07-29,2200,2033,1984,4017,大甲,二等
2020-07-30,2200,1806,1864,3670,大甲,二等
2020-07-31,2200,2421,2740,5161,大甲,二等
2020-08-01,2200,2808,2955,5763,大甲,二等
2020-08-02,2200,3088,2759,5847,大甲,二等
2020-08-03,2200,1824,1690,3514,大甲,二等
2020-08-04,2200,1776,1699,3475,大甲,二等
2020-08-05,2200,1876,1882,3758,大甲,二等
2020-08-06,2200,1913,1936,3849,大甲,二等
2020-08-07,2200,2280,2901,5181,大甲,二等
2020-08-08,2200,2482,2822,5304,大甲,二等
2020-08-09,2200,3702,2981,6683,大甲,二等
2020-08-10,2200,2190,1969,4159,大甲,二等
2020-08-11,2200,1865,1736,3601,大甲,二等
2020-08-12,2200,1871,1879,3750,大甲,二等
2020-08-13,2200,1865,1989,3854,大甲,二等
2020-08-14,2200,2472,2670,5142,大甲,二等
2020-08-15,2200,2841,3031,5872,大甲,二等
2020-08-16,2200,3760,3485,7245,大甲,二等
2020-08-17,2200,2238,2120,4358,大甲,二等
2020-08-18,2200,1939,2014,3953,大甲,二等
2020-08-19,2200,1840,1815,3655,大甲,二等
2020-08-20,2200,1814,1906,3720,大甲,二等
2020-08-21,2200,2354,2526,4880,大甲,二等
2020-08-22,2200,2659,2643,5302,大甲,二等
2020-08-23,2200,3342,2925,6267,大甲,二等
2020-08-24,2200,1837,1705,3542,大甲,二等
2020-08-25,2200,1783,1735,3518,大甲,二等
2020-08-26,2200,1730,1684,3414,大甲,二等
2020-08-27,2200,1571,1567,3138,大甲,二等
2020-08-28,2200,1980,2309,4289,大甲,二等
2020-08-29,2200,2195,2482,4677,大甲,二等
2020-08-30,2200,2862,2376,5238,大甲,二等
2020-08-31,2200,1881,1785,3666,大甲,二等
2020-09-01,2200,1698,1694,3392,大甲,二等
2020-09-02,2200,1706,1643,3349,大甲,二等
2020-09-03,2200,1878,1771,3649,大甲,二等
2020-09-04,2200,2199,2465,4664,大甲,二等
2020-09-05,2200,2356,2343,4699,大甲,二等
2020-09-06,2200,3023,2556,5579,大甲,二等
2020-09-07,2200,1951,1748,3699,大甲,二等
2020-09-08,2200,1779,1702,3481,大甲,二等
2020-09-09,2200,1822,1768,3590,大甲,二等
2020-09-10,2200,1796,1737,3533,大甲,二等
2020-09-11,2200,2363,2769,5132,大甲,二等
2020-09-12,2200,2735,2581,5316,大甲,二等
2020-09-13,2200,3660,3152,6812,大甲,二等
2020-09-14,2200,1942,1761,3703,大甲,二等
2020-09-15,2200,1663,1557,3220,大甲,二等
2020-09-16,2200,1948,1915,3863,大甲,二等
2020-09-17,2200,1823,1797,3620,大甲,二等
2020-09-18,2200,2320,3206,5526,大甲,二等
2020-09-19,2200,2905,3365,6270,大甲,二等
2020-09-20,2200,4244,3434,7678,大甲,二等
2020-09-21,2200,2492,2036,4528,大甲,二等
2020-09-22,2200,1949,1801,3750,大甲,二等
2020-09-23,2200,1799,1765,3564,大甲,二等
2020-09-24,2200,1766,1757,3523,大甲,二等
2020-09-25,2200,2071,2287,4358,大甲,二等
2020-09-26,2200,2491,2531,5022,大甲,二等
2020-09-27,2200,3068,2774,5842,大甲,二等
2020-09-28,2200,1996,1848,3844,大甲,二等
2020-09-29,2200,1800,1936,3736,大甲,二等
2020-09-30,2200,2413,3611,6024,大甲,二等
2020-10-01,2200,2693,3997,6690,大甲,二等
2020-10-02,2200,3636,3745,7381,大甲,二等
2020-10-03,2200,3975,3237,7212,大甲,二等
2020-10-04,2200,4553,3099,7652,大甲,二等
2020-10-05,2200,2455,1903,4358,大甲,二等
2020-10-06,2200,1895,1808,3703,大甲,二等
2020-10-07,2200,1899,1964,3863,大甲,二等
2020-10-08,2200,2405,2988,5393,大甲,二等
2020-10-09,2200,3000,3531,6531,大甲,二等
2020-10-10,2200,3555,3416,6971,大甲,二等
2020-10-11,2200,4213,3514,7727,大甲,二等
2020-10-12,2200,2326,1958,4284,大甲,二等
2020-10-13,2200,1935,1840,3775,大甲,二等
2020-10-14,2200,1832,1822,3654,大甲,二等
2020-10-15,2200,1939,1995,3934,大甲,二等
2020-10-16,2200,2367,3013,5380,大甲,二等
2020-10-17,2200,2939,3004,5943,大甲,二等
2020-10-18,2200,3913,3250,7163,大甲,二等
2020-10-19,2200,2225,2000,4225,大甲,二等
2020-10-20,2200,1953,1896,3849,大甲,二等
2020-10-21,2200,1953,1950,3903,大甲,二等
2020-10-22,2200,1848,1856,3704,大甲,二等
2020-10-23,2200,2188,2976,5164,大甲,二等
2020-10-24,2200,2871,3020,5891,大甲,二等
2020-10-25,2200,3594,2814,6408,大甲,二等
2020-10-26,2200,2334,1980,4314,大甲,二等
2020-10-27,2200,1850,1811,3661,大甲,二等
2020-10-28,2200,1847,1912,3759,大甲,二等
2020-10-29,2200,1787,1876,3663,大甲,二等
2020-10-30,2200,2461,3048,5509,大甲,二等
2020-10-31,2200,2775,3420,6195,大甲,二等
2020-11-01,2200,4172,2997,7169,大甲,二等
2020-11-02,2200,2155,1910,4065,大甲,二等
2020-11-03,2200,1837,1775,3612,大甲,二等
2020-11-04,2200,1772,1745,3517,大甲,二等
2020-11-05,2200,1822,1791,3613,大甲,二等
2020-11-06,2200,2293,2969,5262,大甲,二等
2020-11-07,2200,2566,2797,5363,大甲,二等
2020-11-08,2200,4752,4013,8765,大甲,二等
2020-11-09,2200,2114,1858,3972,大甲,二等
2020-11-10,2200,1862,1797,3659,大甲,二等
2020-11-11,2200,1986,1909,3895,大甲,二等
2020-11-12,2200,1933,1951,3884,大甲,二等
2020-11-13,2200,2423,3332,5755,大甲,二等
2020-11-14,2200,2973,3200,6173,大甲,二等
2020-11-15,2200,4291,3445,7736,大甲,二等
2020-11-16,2200,2224,1996,4220,大甲,二等
2020-11-17,2200,2021,1998,4019,大甲,二等
2020-11-18,2200,1945,1926,3871,大甲,二等
2020-11-19,2200,1881,1884,3765,大甲,二等
2020-11-20,2200,2551,3185,5736,大甲,二等
2020-11-21,2200,2786,2846,5632,大甲,二等
2020-11-22,2200,3929,3244,7173,大甲,二等
2020-11-23,2200,2213,2056,4269,大甲,二等
2020-11-24,2200,1936,1804,3740,大甲,二等
2020-11-25,2200,1934,1904,3838,大甲,二等
2020-11-26,2200,1891,1969,3860,大甲,二等
2020-11-27,2200,2368,3272,5640,大甲,二等
2020-11-28,2200,2655,2885,5540,大甲,二等
2020-11-29,2200,3581,2766,6347,大甲,二等
2020-11-30,2200,2194,1998,4192,大甲,二等
2020-12-01,2200,1883,1819,3702,大甲,二等
2020-12-02,2200,1943,1925,3868,大甲,二等
2020-12-03,2200,1840,1864,3704,大甲,二等
2020-12-04,2200,2435,3149,5584,大甲,二等
2020-12-05,2200,2675,2906,5581,大甲,二等
2020-12-06,2200,3848,3096,6944,大甲,二等
2020-12-07,2200,2217,1953,4170,大甲,二等
2020-12-08,2200,1819,1746,3565,大甲,二等
2020-12-09,2200,1703,1689,3392,大甲,二等
2020-12-10,2200,1803,1832,3635,大甲,二等
2020-12-11,2200,2484,3092,5576,大甲,二等
2020-12-12,2200,2963,3037,6000,大甲,二等
2020-12-13,2200,4291,3643,7934,大甲,二等
2020-12-14,2200,2227,2007,4234,大甲,二等
2020-12-15,2200,1884,1814,3698,大甲,二等
2020-12-16,2200,1911,1848,3759,大甲,二等
2020-12-17,2200,1878,1952,3830,大甲,二等
2020-12-18,2200,2444,3225,5669,大甲,二等
2020-12-19,2200,2696,2874,5570,大甲,二等
2020-12-20,2200,3788,3120,6908,大甲,二等
2020-12-21,2200,2172,1870,4042,大甲,二等
2020-12-22,2200,1906,1748,3654,大甲,二等
2020-12-23,2200,1650,1665,3315,大甲,二等
2020-12-24,2200,1764,1899,3663,大甲,二等
2020-12-25,2200,2369,2950,5319,大甲,二等
2020-12-26,2200,2545,2784,5329,大甲,二等
2020-12-27,2200,3328,2723,6051,大甲,二等
2020-12-28,2200,2160,1933,4093,大甲,二等
2020-12-29,2200,1905,1920,3825,大甲,二等
2020-12-30,2200,1798,1937,3735,大甲,二等
2020-12-31,2200,2483,3194,5677,大甲,二等
2020-01-01,2210,74,74,148,臺中港,二等
2020-01-02,2210,92,85,177,臺中港,二等
2020-01-03,2210,86,95,181,臺中港,二等
2020-01-04,2210,83,87,170,臺中港,二等
2020-01-05,2210,97,59,156,臺中港,二等
2020-01-06,2210,98,84,182,臺中港,二等
2020-01-07,2210,94,94,188,臺中港,二等
2020-01-08,2210,77,76,153,臺中港,二等
2020-01-09,2210,100,102,202,臺中港,二等
2020-01-10,2210,94,165,259,臺中港,二等
2020-01-11,2210,70,82,152,臺中港,二等
2020-01-12,2210,93,72,165,臺中港,二等
2020-01-13,2210,69,70,139,臺中港,二等
2020-01-14,2210,79,72,151,臺中港,二等
2020-01-15,2210,88,83,171,臺中港,二等
2020-01-16,2210,88,93,181,臺中港,二等
2020-01-17,2210,52,54,106,臺中港,二等
2020-01-18,2210,49,59,108,臺中港,二等
2020-01-19,2210,73,66,139,臺中港,二等
2020-01-20,2210,52,55,107,臺中港,二等
2020-01-21,2210,49,58,107,臺中港,二等
2020-01-22,2210,61,67,128,臺中港,二等
2020-01-23,2210,61,92,153,臺中港,二等
2020-01-24,2210,85,90,175,臺中港,二等
2020-01-25,2210,371,346,717,臺中港,二等
2020-01-26,2210,108,134,242,臺中港,二等
2020-01-27,2210,177,152,329,臺中港,二等
2020-01-28,2210,114,123,237,臺中港,二等
2020-01-29,2210,103,92,195,臺中港,二等
2020-01-30,2210,42,39,81,臺中港,二等
2020-01-31,2210,58,52,110,臺中港,二等
2020-02-01,2210,72,86,158,臺中港,二等
2020-02-02,2210,71,91,162,臺中港,二等
2020-02-03,2210,44,56,100,臺中港,二等
2020-02-04,2210,28,48,76,臺中港,二等
2020-02-05,2210,31,36,67,臺中港,二等
2020-02-06,2210,45,39,84,臺中港,二等
2020-02-07,2210,44,51,95,臺中港,二等
2020-02-08,2210,57,54,111,臺中港,二等
2020-02-09,2210,65,81,146,臺中港,二等
2020-02-10,2210,59,40,99,臺中港,二等
2020-02-11,2210,48,49,97,臺中港,二等
2020-02-12,2210,47,48,95,臺中港,二等
2020-02-13,2210,42,65,107,臺中港,二等
2020-02-14,2210,47,72,119,臺中港,二等
2020-02-15,2210,65,65,130,臺中港,二等
2020-02-16,2210,75,71,146,臺中港,二等
2020-02-17,2210,47,40,87,臺中港,二等
2020-02-18,2210,60,54,114,臺中港,二等
2020-02-19,2210,60,50,110,臺中港,二等
2020-02-20,2210,42,49,91,臺中港,二等
2020-02-21,2210,42,66,108,臺中港,二等
2020-02-22,2210,53,49,102,臺中港,二等
2020-02-23,2210,85,92,177,臺中港,二等
2020-02-24,2210,81,69,150,臺中港,二等
2020-02-25,2210,80,84,164,臺中港,二等
2020-02-26,2210,71,89,160,臺中港,二等
2020-02-27,2210,89,100,189,臺中港,二等
2020-02-28,2210,45,67,112,臺中港,二等
2020-02-29,2210,50,57,107,臺中港,二等
2020-03-01,2210,95,63,158,臺中港,二等
2020-03-02,2210,90,82,172,臺中港,二等
2020-03-03,2210,86,81,167,臺中港,二等
2020-03-04,2210,82,84,166,臺中港,二等
2020-03-05,2210,81,87,168,臺中港,二等
2020-03-06,2210,95,103,198,臺中港,二等
2020-03-07,2210,47,53,100,臺中港,二等
2020-03-08,2210,93,53,146,臺中港,二等
2020-03-09,2210,90,96,186,臺中港,二等
2020-03-10,2210,85,82,167,臺中港,二等
2020-03-11,2210,82,75,157,臺中港,二等
2020-03-12,2210,80,87,167,臺中港,二等
2020-03-13,2210,92,125,217,臺中港,二等
2020-03-14,2210,60,74,134,臺中港,二等
2020-03-15,2210,88,75,163,臺中港,二等
2020-03-16,2210,91,88,179,臺中港,二等
2020-03-17,2210,90,91,181,臺中港,二等
2020-03-18,2210,83,89,172,臺中港,二等
2020-03-19,2210,84,79,163,臺中港,二等
2020-03-20,2210,96,104,200,臺中港,二等
2020-03-21,2210,58,60,118,臺中港,二等
2020-03-22,2210,69,59,128,臺中港,二等
2020-03-23,2210,81,83,164,臺中港,二等
2020-03-24,2210,91,89,180,臺中港,二等
2020-03-25,2210,80,71,151,臺中港,二等
2020-03-26,2210,76,84,160,臺中港,二等
2020-03-27,2210,80,106,186,臺中港,二等
2020-03-28,2210,41,42,83,臺中港,二等
2020-03-29,2210,61,51,112,臺中港,二等
2020-03-30,2210,74,76,150,臺中港,二等
2020-03-31,2210,74,76,150,臺中港,二等
2020-04-01,2210,72,93,165,臺中港,二等
2020-04-02,2210,38,56,94,臺中港,二等
2020-04-03,2210,56,60,116,臺中港,二等
2020-04-04,2210,33,36,69,臺中港,二等
2020-04-05,2210,91,64,155,臺中港,二等
2020-04-06,2210,95,84,179,臺中港,二等
2020-04-07,2210,81,82,163,臺中港,二等
2020-04-08,2210,81,83,164,臺中港,二等
2020-04-09,2210,85,84,169,臺中港,二等
2020-04-10,2210,90,110,200,臺中港,二等
2020-04-11,2210,54,52,106,臺中港,二等
2020-04-12,2210,76,63,139,臺中港,二等
2020-04-13,2210,83,84,167,臺中港,二等
2020-04-14,2210,80,80,160,臺中港,二等
2020-04-15,2210,75,75,150,臺中港,二等
2020-04-16,2210,79,88,167,臺中港,二等
2020-04-17,2210,84,100,184,臺中港,二等
2020-04-18,2210,69,80,149,臺中港,二等
2020-04-19,2210,87,63,150,臺中港,二等
2020-04-20,2210,91,84,175,臺中港,二等
2020-04-21,2210,80,80,160,臺中港,二等
2020-04-22,2210,75,69,144,臺中港,二等
2020-04-23,2210,78,77,155,臺中港,二等
2020-04-24,2210,83,92,175,臺中港,二等
2020-04-25,2210,42,54,96,臺中港,二等
2020-04-26,2210,69,55,124,臺中港,二等
2020-04-27,2210,86,84,170,臺中港,二等
2020-04-28,2210,81,76,157,臺中港,二等
2020-04-29,2210,75,71,146,臺中港,二等
2020-04-30,2210,75,89,164,臺中港,二等
2020-05-01,2210,80,117,197,臺中港,二等
2020-05-02,2210,46,53,99,臺中港,二等
2020-05-03,2210,84,64,148,臺中港,二等
2020-05-04,2210,94,77,171,臺中港,二等
2020-05-05,2210,80,84,164,臺中港,二等
2020-05-06,2210,83,75,158,臺中港,二等
2020-05-07,2210,89,95,184,臺中港,二等
2020-05-08,2210,84,112,196,臺中港,二等
2020-05-09,2210,53,78,131,臺中港,二等
2020-05-10,2210,103,67,170,臺中港,二等
2020-05-11,2210,88,78,166,臺中港,二等
2020-05-12,2210,81,84,165,臺中港,二等
2020-05-13,2210,82,81,163,臺中港,二等
2020-05-14,2210,86,87,173,臺中港,二等
2020-05-15,2210,87,95,182,臺中港,二等
2020-05-16,2210,57,74,131,臺中港,二等
2020-05-17,2210,79,66,145,臺中港,二等
2020-05-18,2210,96,85,181,臺中港,二等
2020-05-19,2210,86,94,180,臺中港,二等
2020-05-20,2210,81,85,166,臺中港,二等
2020-05-21,2210,82,95,177,臺中港,二等
2020-05-22,2210,89,130,219,臺中港,二等
2020-05-23,2210,49,54,103,臺中港,二等
2020-05-24,2210,105,89,194,臺中港,二等
2020-05-25,2210,91,82,173,臺中港,二等
2020-05-26,2210,80,79,159,臺中港,二等
2020-05-27,2210,89,95,184,臺中港,二等
2020-05-28,2210,73,79,152,臺中港,二等
2020-05-29,2210,83,113,196,臺中港,二等
2020-05-30,2210,71,82,153,臺中港,二等
2020-05-31,2210,111,75,186,臺中港,二等
2020-06-01,2210,87,83,170,臺中港,二等
2020-06-02,2210,84,75,159,臺中港,二等
2020-06-03,2210,87,85,172,臺中港,二等
2020-06-04,2210,78,83,161,臺中港,二等
2020-06-05,2210,88,100,188,臺中港,二等
2020-06-06,2210,54,58,112,臺中港,二等
2020-06-07,2210,61,86,147,臺中港,二等
2020-06-08,2210,91,86,177,臺中港,二等
2020-06-09,2210,79,87,166,臺中港,二等
2020-06-10,2210,92,85,177,臺中港,二等
2020-06-11,2210,673,171,844,臺中港,二等
2020-06-12,2210,98,121,219,臺中港,二等
2020-06-13,2210,82,104,186,臺中港,二等
2020-06-14,2210,116,86,202,臺中港,二等
2020-06-15,2210,82,76,158,臺中港,二等
2020-06-16,2210,83,80,163,臺中港,二等
2020-06-17,2210,67,72,139,臺中港,二等
2020-06-18,2210,80,74,154,臺中港,二等
2020-06-19,2210,157,122,279,臺中港,二等
2020-06-20,2210,481,2382,2863,臺中港,二等
2020-06-21,2210,84,79,163,臺中港,二等
2020-06-22,2210,78,78,156,臺中港,二等
2020-06-23,2210,73,89,162,臺中港,二等
2020-06-24,2210,92,109,201,臺中港,二等
2020-06-25,2210,54,77,131,臺中港,二等
2020-06-26,2210,88,93,181,臺中港,二等
2020-06-27,2210,77,79,156,臺中港,二等
2020-06-28,2210,105,75,180,臺中港,二等
2020-06-29,2210,88,83,171,臺中港,二等
2020-06-30,2210,77,80,157,臺中港,二等
2020-07-01,2210,74,69,143,臺中港,二等
2020-07-02,2210,66,76,142,臺中港,二等
2020-07-03,2210,78,103,181,臺中港,二等
2020-07-04,2210,155,84,239,臺中港,二等
2020-07-05,2210,579,261,840,臺中港,二等
2020-07-06,2210,94,96,190,臺中港,二等
2020-07-07,2210,72,72,144,臺中港,二等
2020-07-08,2210,74,77,151,臺中港,二等
2020-07-09,2210,75,83,158,臺中港,二等
2020-07-10,2210,76,90,166,臺中港,二等
2020-07-11,2210,913,194,1107,臺中港,二等
2020-07-12,2210,96,332,428,臺中港,二等
2020-07-13,2210,132,125,257,臺中港,二等
2020-07-14,2210,69,75,144,臺中港,二等
2020-07-15,2210,63,75,138,臺中港,二等
2020-07-16,2210,47,55,102,臺中港,二等
2020-07-17,2210,57,71,128,臺中港,二等
2020-07-18,2210,60,80,140,臺中港,二等
2020-07-19,2210,84,74,158,臺中港,二等
2020-07-20,2210,59,57,116,臺中港,二等
2020-07-21,2210,69,60,129,臺中港,二等
2020-07-22,2210,66,60,126,臺中港,二等
2020-07-23,2210,76,70,146,臺中港,二等
2020-07-24,2210,67,73,140,臺中港,二等
2020-07-25,2210,44,66,110,臺中港,二等
2020-07-26,2210,76,80,156,臺中港,二等
2020-07-27,2210,69,66,135,臺中港,二等
2020-07-28,2210,69,72,141,臺中港,二等
2020-07-29,2210,69,77,146,臺中港,二等
2020-07-30,2210,59,65,124,臺中港,二等
2020-07-31,2210,80,85,165,臺中港,二等
2020-08-01,2210,60,73,133,臺中港,二等
2020-08-02,2210,62,46,108,臺中港,二等
2020-08-03,2210,71,59,130,臺中港,二等
2020-08-04,2210,74,65,139,臺中港,二等
2020-08-05,2210,69,59,128,臺中港,二等
2020-08-06,2210,67,70,137,臺中港,二等
2020-08-07,2210,90,83,173,臺中港,二等
2020-08-08,2210,52,73,125,臺中港,二等
2020-08-09,2210,64,53,117,臺中港,二等
2020-08-10,2210,67,61,128,臺中港,二等
2020-08-11,2210,61,70,131,臺中港,二等
2020-08-12,2210,76,73,149,臺中港,二等
2020-08-13,2210,63,71,134,臺中港,二等
2020-08-14,2210,70,67,137,臺中港,二等
2020-08-15,2210,80,82,162,臺中港,二等
2020-08-16,2210,79,74,153,臺中港,二等
2020-08-17,2210,66,65,131,臺中港,二等
2020-08-18,2210,56,49,105,臺中港,二等
2020-08-19,2210,63,68,131,臺中港,二等
2020-08-20,2210,60,54,114,臺中港,二等
2020-08-21,2210,69,73,142,臺中港,二等
2020-08-22,2210,65,70,135,臺中港,二等
2020-08-23,2210,88,66,154,臺中港,二等
2020-08-24,2210,64,62,126,臺中港,二等
2020-08-25,2210,43,52,95,臺中港,二等
2020-08-26,2210,51,45,96,臺中港,二等
2020-08-27,2210,45,54,99,臺中港,二等
2020-08-28,2210,76,92,168,臺中港,二等
2020-08-29,2210,49,65,114,臺中港,二等
2020-08-30,2210,82,61,143,臺中港,二等
2020-08-31,2210,76,54,130,臺中港,二等
2020-09-01,2210,74,71,145,臺中港,二等
2020-09-02,2210,64,66,130,臺中港,二等
2020-09-03,2210,70,62,132,臺中港,二等
2020-09-04,2210,73,92,165,臺中港,二等
2020-09-05,2210,60,69,129,臺中港,二等
2020-09-06,2210,67,47,114,臺中港,二等
2020-09-07,2210,74,66,140,臺中港,二等
2020-09-08,2210,66,61,127,臺中港,二等
2020-09-09,2210,70,65,135,臺中港,二等
2020-09-10,2210,62,61,123,臺中港,二等
2020-09-11,2210,80,88,168,臺中港,二等
2020-09-12,2210,55,62,117,臺中港,二等
2020-09-13,2210,108,91,199,臺中港,二等
2020-09-14,2210,76,66,142,臺中港,二等
2020-09-15,2210,60,59,119,臺中港,二等
2020-09-16,2210,76,71,147,臺中港,二等
2020-09-17,2210,70,68,138,臺中港,二等
2020-09-18,2210,76,101,177,臺中港,二等
2020-09-19,2210,75,113,188,臺中港,二等
2020-09-20,2210,109,81,190,臺中港,二等
2020-09-21,2210,78,65,143,臺中港,二等
2020-09-22,2210,67,55,122,臺中港,二等
2020-09-23,2210,58,53,111,臺中港,二等
2020-09-24,2210,62,64,126,臺中港,二等
2020-09-25,2210,70,71,141,臺中港,二等
2020-09-26,2210,61,75,136,臺中港,二等
2020-09-27,2210,60,67,127,臺中港,二等
2020-09-28,2210,81,75,156,臺中港,二等
2020-09-29,2210,69,75,144,臺中港,二等
2020-09-30,2210,86,124,210,臺中港,二等
2020-10-01,2210,66,120,186,臺中港,二等
2020-10-02,2210,107,101,208,臺中港,二等
2020-10-03,2210,76,100,176,臺中港,二等
2020-10-04,2210,126,70,196,臺中港,二等
2020-10-05,2210,84,76,160,臺中港,二等
2020-10-06,2210,83,74,157,臺中港,二等
2020-10-07,2210,69,77,146,臺中港,二等
2020-10-08,2210,87,102,189,臺中港,二等
2020-10-09,2210,67,96,163,臺中港,二等
2020-10-10,2210,78,71,149,臺中港,二等
2020-10-11,2210,110,96,206,臺中港,二等
2020-10-12,2210,83,70,153,臺中港,二等
2020-10-13,2210,71,66,137,臺中港,二等
2020-10-14,2210,80,70,150,臺中港,二等
2020-10-15,2210,69,79,148,臺中港,二等
2020-10-16,2210,81,99,180,臺中港,二等
2020-10-17,2210,57,76,133,臺中港,二等
2020-10-18,2210,101,79,180,臺中港,二等
2020-10-19,2210,97,83,180,臺中港,二等
2020-10-20,2210,73,83,156,臺中港,二等
2020-10-21,2210,85,78,163,臺中港,二等
2020-10-22,2210,71,81,152,臺中港,二等
2020-10-23,2210,89,106,195,臺中港,二等
2020-10-24,2210,62,80,142,臺中港,二等
2020-10-25,2210,88,59,147,臺中港,二等
2020-10-26,2210,91,82,173,臺中港,二等
2020-10-27,2210,73,74,147,臺中港,二等
2020-10-28,2210,69,69,138,臺中港,二等
2020-10-29,2210,55,57,112,臺中港,二等
2020-10-30,2210,87,107,194,臺中港,二等
2020-10-31,2210,43,52,95,臺中港,二等
2020-11-01,2210,80,63,143,臺中港,二等
2020-11-02,2210,89,82,171,臺中港,二等
2020-11-03,2210,80,84,164,臺中港,二等
2020-11-04,2210,76,69,145,臺中港,二等
2020-11-05,2210,66,68,134,臺中港,二等
2020-11-06,2210,100,107,207,臺中港,二等
2020-11-07,2210,55,78,133,臺中港,二等
2020-11-08,2210,153,127,280,臺中港,二等
2020-11-09,2210,86,70,156,臺中港,二等
2020-11-10,2210,75,72,147,臺中港,二等
2020-11-11,2210,76,79,155,臺中港,二等
2020-11-12,2210,69,70,139,臺中港,二等
2020-11-13,2210,76,120,196,臺中港,二等
2020-11-14,2210,73,84,157,臺中港,二等
2020-11-15,2210,131,92,223,臺中港,二等
2020-11-16,2210,88,89,177,臺中港,二等
2020-11-17,2210,75,72,147,臺中港,二等
2020-11-18,2210,82,80,162,臺中港,二等
2020-11-19,2210,73,78,151,臺中港,二等
2020-11-20,2210,86,117,203,臺中港,二等
2020-11-21,2210,59,76,135,臺中港,二等
2020-11-22,2210,89,81,170,臺中港,二等
2020-11-23,2210,107,82,189,臺中港,二等
2020-11-24,2210,74,73,147,臺中港,二等
2020-11-25,2210,79,80,159,臺中港,二等
2020-11-26,2210,77,86,163,臺中港,二等
2020-11-27,2210,88,105,193,臺中港,二等
2020-11-28,2210,47,56,103,臺中港,二等
2020-11-29,2210,102,76,178,臺中港,二等
2020-11-30,2210,88,81,169,臺中港,二等
2020-12-01,2210,85,80,165,臺中港,二等
2020-12-02,2210,99,80,179,臺中港,二等
2020-12-03,2210,73,75,148,臺中港,二等
2020-12-04,2210,88,123,211,臺中港,二等
2020-12-05,2210,75,64,139,臺中港,二等
2020-12-06,2210,99,78,177,臺中港,二等
2020-12-07,2210,83,74,157,臺中港,二等
2020-12-08,2210,81,76,157,臺中港,二等
2020-12-09,2210,83,74,157,臺中港,二等
2020-12-10,2210,77,83,160,臺中港,二等
2020-12-11,2210,85,120,205,臺中港,二等
2020-12-12,2210,70,75,145,臺中港,二等
2020-12-13,2210,113,97,210,臺中港,二等
2020-12-14,2210,94,88,182,臺中港,二等
2020-12-15,2210,87,79,166,臺中港,二等
2020-12-16,2210,76,81,157,臺中港,二等
2020-12-17,2210,79,77,156,臺中港,二等
2020-12-18,2210,87,120,207,臺中港,二等
2020-12-19,2210,75,72,147,臺中港,二等
2020-12-20,2210,100,70,170,臺中港,二等
2020-12-21,2210,91,82,173,臺中港,二等
2020-12-22,2210,76,86,162,臺中港,二等
2020-12-23,2210,74,72,146,臺中港,二等
2020-12-24,2210,84,81,165,臺中港,二等
2020-12-25,2210,100,113,213,臺中港,二等
2020-12-26,2210,43,57,100,臺中港,二等
2020-12-27,2210,93,69,162,臺中港,二等
2020-12-28,2210,83,80,163,臺中港,二等
2020-12-29,2210,68,71,139,臺中港,二等
2020-12-30,2210,75,77,152,臺中港,二等
2020-12-31,2210,89,104,193,臺中港,二等
2020-01-01,2220,1121,1060,2181,清水,三等
2020-01-02,2220,945,989,1934,清水,三等
2020-01-03,2220,1005,1356,2361,清水,三等
2020-01-04,2220,1212,1383,2595,清水,三等
2020-01-05,2220,1506,1129,2635,清水,三等
2020-01-06,2220,1061,928,1989,清水,三等
2020-01-07,2220,917,882,1799,清水,三等
2020-01-08,2220,940,980,1920,清水,三等
2020-01-09,2220,934,1093,2027,清水,三等
2020-01-10,2220,1297,2074,3371,清水,三等
2020-01-11,2220,1403,1583,2986,清水,三等
2020-01-12,2220,2050,1348,3398,清水,三等
2020-01-13,2220,1167,977,2144,清水,三等
2020-01-14,2220,929,907,1836,清水,三等
2020-01-15,2220,891,931,1822,清水,三等
2020-01-16,2220,1135,1147,2282,清水,三等
2020-01-17,2220,1190,1292,2482,清水,三等
2020-01-18,2220,1282,1368,2650,清水,三等
2020-01-19,2220,1354,1071,2425,清水,三等
2020-01-20,2220,918,948,1866,清水,三等
2020-01-21,2220,883,1093,1976,清水,三等
2020-01-22,2220,911,1403,2314,清水,三等
2020-01-23,2220,964,1436,2400,清水,三等
2020-01-24,2220,743,1096,1839,清水,三等
2020-01-25,2220,2246,2014,4260,清水,三等
2020-01-26,2220,1380,1466,2846,清水,三等
2020-01-27,2220,1987,1774,3761,清水,三等
2020-01-28,2220,1782,1444,3226,清水,三等
2020-01-29,2220,1738,1218,2956,清水,三等
2020-01-30,2220,1097,805,1902,清水,三等
2020-01-31,2220,942,993,1935,清水,三等
2020-02-01,2220,941,888,1829,清水,三等
2020-02-02,2220,1162,1006,2168,清水,三等
2020-02-03,2220,792,682,1474,清水,三等
2020-02-04,2220,689,677,1366,清水,三等
2020-02-05,2220,686,705,1391,清水,三等
2020-02-06,2220,700,713,1413,清水,三等
2020-02-07,2220,836,1174,2010,清水,三等
2020-02-08,2220,910,965,1875,清水,三等
2020-02-09,2220,1336,1068,2404,清水,三等
2020-02-10,2220,887,766,1653,清水,三等
2020-02-11,2220,707,683,1390,清水,三等
2020-02-12,2220,682,642,1324,清水,三等
2020-02-13,2220,640,690,1330,清水,三等
2020-02-14,2220,761,921,1682,清水,三等
2020-02-15,2220,898,901,1799,清水,三等
2020-02-16,2220,1154,956,2110,清水,三等
2020-02-17,2220,830,692,1522,清水,三等
2020-02-18,2220,680,674,1354,清水,三等
2020-02-19,2220,734,682,1416,清水,三等
2020-02-20,2220,710,697,1407,清水,三等
2020-02-21,2220,852,1028,1880,清水,三等
2020-02-22,2220,849,960,1809,清水,三等
2020-02-23,2220,1172,871,2043,清水,三等
2020-02-24,2220,862,711,1573,清水,三等
2020-02-25,2220,841,808,1649,清水,三等
2020-02-26,2220,762,782,1544,清水,三等
2020-02-27,2220,1018,1475,2493,清水,三等
2020-02-28,2220,961,1179,2140,清水,三等
2020-02-29,2220,993,865,1858,清水,三等
2020-03-01,2220,1731,1044,2775,清水,三等
2020-03-02,2220,1006,846,1852,清水,三等
2020-03-03,2220,755,765,1520,清水,三等
2020-03-04,2220,731,743,1474,清水,三等
2020-03-05,2220,706,803,1509,清水,三等
2020-03-06,2220,945,1481,2426,清水,三等
2020-03-07,2220,781,848,1629,清水,三等
2020-03-08,2220,1250,851,2101,清水,三等
2020-03-09,2220,921,830,1751,清水,三等
2020-03-10,2220,716,684,1400,清水,三等
2020-03-11,2220,761,819,1580,清水,三等
2020-03-12,2220,785,835,1620,清水,三等
2020-03-13,2220,996,1588,2584,清水,三等
2020-03-14,2220,797,896,1693,清水,三等
2020-03-15,2220,1456,932,2388,清水,三等
2020-03-16,2220,970,838,1808,清水,三等
2020-03-17,2220,733,772,1505,清水,三等
2020-03-18,2220,709,763,1472,清水,三等
2020-03-19,2220,720,746,1466,清水,三等
2020-03-20,2220,915,1466,2381,清水,三等
2020-03-21,2220,745,771,1516,清水,三等
2020-03-22,2220,1220,720,1940,清水,三等
2020-03-23,2220,915,794,1709,清水,三等
2020-03-24,2220,715,745,1460,清水,三等
2020-03-25,2220,669,692,1361,清水,三等
2020-03-26,2220,717,752,1469,清水,三等
2020-03-27,2220,885,1311,2196,清水,三等
2020-03-28,2220,636,748,1384,清水,三等
2020-03-29,2220,886,626,1512,清水,三等
2020-03-30,2220,787,746,1533,清水,三等
2020-03-31,2220,661,764,1425,清水,三等
2020-04-01,2220,840,1515,2355,清水,三等
2020-04-02,2220,676,1159,1835,清水,三等
2020-04-03,2220,668,907,1575,清水,三等
2020-04-04,2220,732,516,1248,清水,三等
2020-04-05,2220,1578,655,2233,清水,三等
2020-04-06,2220,1047,755,1802,清水,三等
2020-04-07,2220,777,709,1486,清水,三等
2020-04-08,2220,705,665,1370,清水,三等
2020-04-09,2220,653,683,1336,清水,三等
2020-04-10,2220,859,1206,2065,清水,三等
2020-04-11,2220,584,662,1246,清水,三等
2020-04-12,2220,961,712,1673,清水,三等
2020-04-13,2220,846,744,1590,清水,三等
2020-04-14,2220,699,715,1414,清水,三等
2020-04-15,2220,718,707,1425,清水,三等
2020-04-16,2220,721,745,1466,清水,三等
2020-04-17,2220,881,1326,2207,清水,三等
2020-04-18,2220,713,847,1560,清水,三等
2020-04-19,2220,1107,692,1799,清水,三等
2020-04-20,2220,844,718,1562,清水,三等
2020-04-21,2220,687,691,1378,清水,三等
2020-04-22,2220,646,655,1301,清水,三等
2020-04-23,2220,627,690,1317,清水,三等
2020-04-24,2220,803,1087,1890,清水,三等
2020-04-25,2220,523,589,1112,清水,三等
2020-04-26,2220,842,515,1357,清水,三等
2020-04-27,2220,783,719,1502,清水,三等
2020-04-28,2220,681,674,1355,清水,三等
2020-04-29,2220,624,704,1328,清水,三等
2020-04-30,2220,724,1015,1739,清水,三等
2020-05-01,2220,873,1405,2278,清水,三等
2020-05-02,2220,689,723,1412,清水,三等
2020-05-03,2220,1380,738,2118,清水,三等
2020-05-04,2220,915,740,1655,清水,三等
2020-05-05,2220,707,702,1409,清水,三等
2020-05-06,2220,741,737,1478,清水,三等
2020-05-07,2220,680,796,1476,清水,三等
2020-05-08,2220,938,1706,2644,清水,三等
2020-05-09,2220,720,1043,1763,清水,三等
2020-05-10,2220,1598,774,2372,清水,三等
2020-05-11,2220,1060,769,1829,清水,三等
2020-05-12,2220,785,720,1505,清水,三等
2020-05-13,2220,744,746,1490,清水,三等
2020-05-14,2220,698,744,1442,清水,三等
2020-05-15,2220,1032,1445,2477,清水,三等
2020-05-16,2220,755,871,1626,清水,三等
2020-05-17,2220,1261,861,2122,清水,三等
2020-05-18,2220,877,776,1653,清水,三等
2020-05-19,2220,719,661,1380,清水,三等
2020-05-20,2220,703,710,1413,清水,三等
2020-05-21,2220,715,746,1461,清水,三等
2020-05-22,2220,909,1411,2320,清水,三等
2020-05-23,2220,675,775,1450,清水,三等
2020-05-24,2220,1365,898,2263,清水,三等
2020-05-25,2220,923,827,1750,清水,三等
2020-05-26,2220,713,737,1450,清水,三等
2020-05-27,2220,682,668,1350,清水,三等
2020-05-28,2220,696,745,1441,清水,三等
2020-05-29,2220,986,1538,2524,清水,三等
2020-05-30,2220,816,963,1779,清水,三等
2020-05-31,2220,1507,1020,2527,清水,三等
2020-06-01,2220,976,834,1810,清水,三等
2020-06-02,2220,735,737,1472,清水,三等
2020-06-03,2220,750,717,1467,清水,三等
2020-06-04,2220,717,755,1472,清水,三等
2020-06-05,2220,993,1476,2469,清水,三等
2020-06-06,2220,933,1042,1975,清水,三等
2020-06-07,2220,1467,974,2441,清水,三等
2020-06-08,2220,927,753,1680,清水,三等
2020-06-09,2220,758,740,1498,清水,三等
2020-06-10,2220,787,793,1580,清水,三等
2020-06-11,2220,1617,1093,2710,清水,三等
2020-06-12,2220,1270,1565,2835,清水,三等
2020-06-13,2220,1123,1106,2229,清水,三等
2020-06-14,2220,1510,1199,2709,清水,三等
2020-06-15,2220,1025,920,1945,清水,三等
2020-06-16,2220,849,846,1695,清水,三等
2020-06-17,2220,799,816,1615,清水,三等
2020-06-18,2220,833,863,1696,清水,三等
2020-06-19,2220,1857,2039,3896,清水,三等
2020-06-20,2220,1440,2488,3928,清水,三等
2020-06-21,2220,1142,1029,2171,清水,三等
2020-06-22,2220,962,862,1824,清水,三等
2020-06-23,2220,788,881,1669,清水,三等
2020-06-24,2220,1005,1550,2555,清水,三等
2020-06-25,2220,1208,1568,2776,清水,三等
2020-06-26,2220,1323,1344,2667,清水,三等
2020-06-27,2220,1438,1243,2681,清水,三等
2020-06-28,2220,1888,1225,3113,清水,三等
2020-06-29,2220,1154,875,2029,清水,三等
2020-06-30,2220,896,843,1739,清水,三等
2020-07-01,2220,784,770,1554,清水,三等
2020-07-02,2220,757,832,1589,清水,三等
2020-07-03,2220,1030,1232,2262,清水,三等
2020-07-04,2220,1467,1095,2562,清水,三等
2020-07-05,2220,3210,1572,4782,清水,三等
2020-07-06,2220,1083,1050,2133,清水,三等
2020-07-07,2220,847,815,1662,清水,三等
2020-07-08,2220,840,829,1669,清水,三等
2020-07-09,2220,868,838,1706,清水,三等
2020-07-10,2220,1173,1384,2557,清水,三等
2020-07-11,2220,4320,2413,6733,清水,三等
2020-07-12,2220,1594,2290,3884,清水,三等
2020-07-13,2220,1286,1168,2454,清水,三等
2020-07-14,2220,912,905,1817,清水,三等
2020-07-15,2220,880,845,1725,清水,三等
2020-07-16,2220,828,847,1675,清水,三等
2020-07-17,2220,1029,1264,2293,清水,三等
2020-07-18,2220,1083,1195,2278,清水,三等
2020-07-19,2220,1503,1190,2693,清水,三等
2020-07-20,2220,882,818,1700,清水,三等
2020-07-21,2220,810,775,1585,清水,三等
2020-07-22,2220,841,839,1680,清水,三等
2020-07-23,2220,853,864,1717,清水,三等
2020-07-24,2220,1014,1258,2272,清水,三等
2020-07-25,2220,1266,1315,2581,清水,三等
2020-07-26,2220,1452,1199,2651,清水,三等
2020-07-27,2220,996,842,1838,清水,三等
2020-07-28,2220,950,863,1813,清水,三等
2020-07-29,2220,877,842,1719,清水,三等
2020-07-30,2220,909,970,1879,清水,三等
2020-07-31,2220,1125,1302,2427,清水,三等
2020-08-01,2220,1119,1220,2339,清水,三等
2020-08-02,2220,1366,1146,2512,清水,三等
2020-08-03,2220,927,884,1811,清水,三等
2020-08-04,2220,839,827,1666,清水,三等
2020-08-05,2220,896,865,1761,清水,三等
2020-08-06,2220,871,895,1766,清水,三等
2020-08-07,2220,1164,1649,2813,清水,三等
2020-08-08,2220,1005,1152,2157,清水,三等
2020-08-09,2220,1689,1198,2887,清水,三等
2020-08-10,2220,1042,804,1846,清水,三等
2020-08-11,2220,842,796,1638,清水,三等
2020-08-12,2220,854,857,1711,清水,三等
2020-08-13,2220,862,824,1686,清水,三等
2020-08-14,2220,1164,1298,2462,清水,三等
2020-08-15,2220,1167,1261,2428,清水,三等
2020-08-16,2220,1514,1277,2791,清水,三等
2020-08-17,2220,1031,947,1978,清水,三等
2020-08-18,2220,890,932,1822,清水,三等
2020-08-19,2220,839,845,1684,清水,三等
2020-08-20,2220,852,804,1656,清水,三等
2020-08-21,2220,1118,1286,2404,清水,三等
2020-08-22,2220,1208,1192,2400,清水,三等
2020-08-23,2220,1354,1272,2626,清水,三等
2020-08-24,2220,981,905,1886,清水,三等
2020-08-25,2220,836,807,1643,清水,三等
2020-08-26,2220,819,772,1591,清水,三等
2020-08-27,2220,784,774,1558,清水,三等
2020-08-28,2220,895,1172,2067,清水,三等
2020-08-29,2220,1032,1052,2084,清水,三等
2020-08-30,2220,1330,1045,2375,清水,三等
2020-08-31,2220,944,862,1806,清水,三等
2020-09-01,2220,823,858,1681,清水,三等
2020-09-02,2220,747,787,1534,清水,三等
2020-09-03,2220,926,852,1778,清水,三等
2020-09-04,2220,1072,1372,2444,清水,三等
2020-09-05,2220,1074,1125,2199,清水,三等
2020-09-06,2220,1366,1026,2392,清水,三等
2020-09-07,2220,944,902,1846,清水,三等
2020-09-08,2220,871,841,1712,清水,三等
2020-09-09,2220,832,902,1734,清水,三等
2020-09-10,2220,836,923,1759,清水,三等
2020-09-11,2220,1118,1453,2571,清水,三等
2020-09-12,2220,1072,1141,2213,清水,三等
2020-09-13,2220,1634,1165,2799,清水,三等
2020-09-14,2220,942,830,1772,清水,三等
2020-09-15,2220,758,772,1530,清水,三等
2020-09-16,2220,804,814,1618,清水,三等
2020-09-17,2220,825,873,1698,清水,三等
2020-09-18,2220,1094,1649,2743,清水,三等
2020-09-19,2220,1167,1317,2484,清水,三等
2020-09-20,2220,1770,1314,3084,清水,三等
2020-09-21,2220,990,863,1853,清水,三等
2020-09-22,2220,828,853,1681,清水,三等
2020-09-23,2220,791,845,1636,清水,三等
2020-09-24,2220,821,836,1657,清水,三等
2020-09-25,2220,888,1039,1927,清水,三等
2020-09-26,2220,1112,1221,2333,清水,三等
2020-09-27,2220,1224,1096,2320,清水,三等
2020-09-28,2220,956,829,1785,清水,三等
2020-09-29,2220,839,932,1771,清水,三等
2020-09-30,2220,1205,2034,3239,清水,三等
2020-10-01,2220,1239,1916,3155,清水,三等
2020-10-02,2220,1418,1474,2892,清水,三等
2020-10-03,2220,1649,1298,2947,清水,三等
2020-10-04,2220,2222,1233,3455,清水,三等
2020-10-05,2220,1256,933,2189,清水,三等
2020-10-06,2220,863,854,1717,清水,三等
2020-10-07,2220,804,876,1680,清水,三等
2020-10-08,2220,1074,1627,2701,清水,三等
2020-10-09,2220,1257,1512,2769,清水,三等
2020-10-10,2220,1313,1232,2545,清水,三等
2020-10-11,2220,1894,1368,3262,清水,三等
2020-10-12,2220,1129,978,2107,清水,三等
2020-10-13,2220,832,847,1679,清水,三等
2020-10-14,2220,818,829,1647,清水,三等
2020-10-15,2220,837,902,1739,清水,三等
2020-10-16,2220,1110,1622,2732,清水,三等
2020-10-17,2220,1229,1286,2515,清水,三等
2020-10-18,2220,1762,1264,3026,清水,三等
2020-10-19,2220,1037,992,2029,清水,三等
2020-10-20,2220,927,928,1855,清水,三等
2020-10-21,2220,864,866,1730,清水,三等
2020-10-22,2220,880,867,1747,清水,三等
2020-10-23,2220,1089,1587,2676,清水,三等
2020-10-24,2220,1216,1541,2757,清水,三等
2020-10-25,2220,1577,1060,2637,清水,三等
2020-10-26,2220,1088,913,2001,清水,三等
2020-10-27,2220,890,837,1727,清水,三等
2020-10-28,2220,823,814,1637,清水,三等
2020-10-29,2220,790,858,1648,清水,三等
2020-10-30,2220,1130,1633,2763,清水,三等
2020-10-31,2220,1026,1113,2139,清水,三等
2020-11-01,2220,1577,1071,2648,清水,三等
2020-11-02,2220,1050,907,1957,清水,三等
2020-11-03,2220,853,841,1694,清水,三等
2020-11-04,2220,823,849,1672,清水,三等
2020-11-05,2220,834,892,1726,清水,三等
2020-11-06,2220,1088,1680,2768,清水,三等
2020-11-07,2220,1154,1220,2374,清水,三等
2020-11-08,2220,1677,1159,2836,清水,三等
2020-11-09,2220,1068,933,2001,清水,三等
2020-11-10,2220,806,800,1606,清水,三等
2020-11-11,2220,870,874,1744,清水,三等
2020-11-12,2220,893,912,1805,清水,三等
2020-11-13,2220,1184,1761,2945,清水,三等
2020-11-14,2220,1125,1240,2365,清水,三等
2020-11-15,2220,1827,1268,3095,清水,三等
2020-11-16,2220,1135,959,2094,清水,三等
2020-11-17,2220,897,834,1731,清水,三等
2020-11-18,2220,882,853,1735,清水,三等
2020-11-19,2220,902,951,1853,清水,三等
2020-11-20,2220,1223,1742,2965,清水,三等
2020-11-21,2220,1156,1148,2304,清水,三等
2020-11-22,2220,1727,1262,2989,清水,三等
2020-11-23,2220,1093,966,2059,清水,三等
2020-11-24,2220,892,903,1795,清水,三等
2020-11-25,2220,862,903,1765,清水,三等
2020-11-26,2220,905,974,1879,清水,三等
2020-11-27,2220,1154,1811,2965,清水,三等
2020-11-28,2220,1163,1218,2381,清水,三等
2020-11-29,2220,1720,1212,2932,清水,三等
2020-11-30,2220,1066,898,1964,清水,三等
2020-12-01,2220,841,829,1670,清水,三等
2020-12-02,2220,792,831,1623,清水,三等
2020-12-03,2220,860,901,1761,清水,三等
2020-12-04,2220,1084,1754,2838,清水,三等
2020-12-05,2220,1200,1214,2414,清水,三等
2020-12-06,2220,1685,1205,2890,清水,三等
2020-12-07,2220,1052,900,1952,清水,三等
2020-12-08,2220,874,830,1704,清水,三等
2020-12-09,2220,755,762,1517,清水,三等
2020-12-10,2220,788,844,1632,清水,三等
2020-12-11,2220,1131,1738,2869,清水,三等
2020-12-12,2220,1300,1302,2602,清水,三等
2020-12-13,2220,1790,1369,3159,清水,三等
2020-12-14,2220,1037,963,2000,清水,三等
2020-12-15,2220,862,871,1733,清水,三等
2020-12-16,2220,832,849,1681,清水,三等
2020-12-17,2220,858,871,1729,清水,三等
2020-12-18,2220,1111,1714,2825,清水,三等
2020-12-19,2220,1180,1261,2441,清水,三等
2020-12-20,2220,1703,1265,2968,清水,三等
2020-12-21,2220,1036,870,1906,清水,三等
2020-12-22,2220,848,866,1714,清水,三等
2020-12-23,2220,761,824,1585,清水,三等
2020-12-24,2220,876,872,1748,清水,三等
2020-12-25,2220,1152,1659,2811,清水,三等
2020-12-26,2220,1178,1241,2419,清水,三等
2020-12-27,2220,1549,1122,2671,清水,三等
2020-12-28,2220,1040,932,1972,清水,三等
2020-12-29,2220,819,794,1613,清水,三等
2020-12-30,2220,805,905,1710,清水,三等
2020-12-31,2220,1252,1740,2992,清水,三等
2020-01-01,2230,2923,3151,6074,沙鹿,二等
2020-01-02,2230,2037,2085,4122,沙鹿,二等
2020-01-03,2230,2818,2741,5559,沙鹿,二等
2020-01-04,2230,2691,2633,5324,沙鹿,二等
2020-01-05,2230,3303,3378,6681,沙鹿,二等
2020-01-06,2230,2066,2163,4229,沙鹿,二等
2020-01-07,2230,1829,1882,3711,沙鹿,二等
2020-01-08,2230,1892,1976,3868,沙鹿,二等
2020-01-09,2230,2122,2041,4163,沙鹿,二等
2020-01-10,2230,4478,3520,7998,沙鹿,二等
2020-01-11,2230,3718,3549,7267,沙鹿,二等
2020-01-12,2230,4248,4276,8524,沙鹿,二等
2020-01-13,2230,2272,2348,4620,沙鹿,二等
2020-01-14,2230,1988,2008,3996,沙鹿,二等
2020-01-15,2230,1965,2011,3976,沙鹿,二等
2020-01-16,2230,2074,2189,4263,沙鹿,二等
2020-01-17,2230,2436,2373,4809,沙鹿,二等
2020-01-18,2230,3031,2860,5891,沙鹿,二等
2020-01-19,2230,3255,3151,6406,沙鹿,二等
2020-01-20,2230,2195,2216,4411,沙鹿,二等
2020-01-21,2230,2288,2349,4637,沙鹿,二等
2020-01-22,2230,2766,2847,5613,沙鹿,二等
2020-01-23,2230,3370,3194,6564,沙鹿,二等
2020-01-24,2230,3207,2843,6050,沙鹿,二等
2020-01-25,2230,4620,4532,9152,沙鹿,二等
2020-01-26,2230,3333,3441,6774,沙鹿,二等
2020-01-27,2230,4245,4467,8712,沙鹿,二等
2020-01-28,2230,3604,3609,7213,沙鹿,二等
2020-01-29,2230,3266,3176,6442,沙鹿,二等
2020-01-30,2230,2076,1937,4013,沙鹿,二等
2020-01-31,2230,2172,2206,4378,沙鹿,二等
2020-02-01,2230,2208,1998,4206,沙鹿,二等
2020-02-02,2230,2593,2499,5092,沙鹿,二等
2020-02-03,2230,1853,1872,3725,沙鹿,二等
2020-02-04,2230,1494,1556,3050,沙鹿,二等
2020-02-05,2230,1576,1641,3217,沙鹿,二等
2020-02-06,2230,1617,1620,3237,沙鹿,二等
2020-02-07,2230,2208,2225,4433,沙鹿,二等
2020-02-08,2230,2374,2189,4563,沙鹿,二等
2020-02-09,2230,2855,2800,5655,沙鹿,二等
2020-02-10,2230,1886,1889,3775,沙鹿,二等
2020-02-11,2230,1675,1728,3403,沙鹿,二等
2020-02-12,2230,1691,1762,3453,沙鹿,二等
2020-02-13,2230,1624,1617,3241,沙鹿,二等
2020-02-14,2230,2128,2197,4325,沙鹿,二等
2020-02-15,2230,2358,2274,4632,沙鹿,二等
2020-02-16,2230,2885,2675,5560,沙鹿,二等
2020-02-17,2230,1695,1704,3399,沙鹿,二等
2020-02-18,2230,1568,1565,3133,沙鹿,二等
2020-02-19,2230,1586,1556,3142,沙鹿,二等
2020-02-20,2230,1596,1571,3167,沙鹿,二等
2020-02-21,2230,2249,2155,4404,沙鹿,二等
2020-02-22,2230,2291,2174,4465,沙鹿,二等
2020-02-23,2230,2701,2630,5331,沙鹿,二等
2020-02-24,2230,1797,1751,3548,沙鹿,二等
2020-02-25,2230,1606,1647,3253,沙鹿,二等
2020-02-26,2230,1647,1687,3334,沙鹿,二等
2020-02-27,2230,2340,2583,4923,沙鹿,二等
2020-02-28,2230,2491,2442,4933,沙鹿,二等
2020-02-29,2230,2071,2201,4272,沙鹿,二等
2020-03-01,2230,3273,3213,6486,沙鹿,二等
2020-03-02,2230,1813,1793,3606,沙鹿,二等
2020-03-03,2230,1574,1555,3129,沙鹿,二等
2020-03-04,2230,1551,1525,3076,沙鹿,二等
2020-03-05,2230,1539,1515,3054,沙鹿,二等
2020-03-06,2230,3043,2594,5637,沙鹿,二等
2020-03-07,2230,2093,1969,4062,沙鹿,二等
2020-03-08,2230,2880,3144,6024,沙鹿,二等
2020-03-09,2230,1840,1911,3751,沙鹿,二等
2020-03-10,2230,1451,1437,2888,沙鹿,二等
2020-03-11,2230,1655,1651,3306,沙鹿,二等
2020-03-12,2230,1732,1639,3371,沙鹿,二等
2020-03-13,2230,3081,2814,5895,沙鹿,二等
2020-03-14,2230,2376,2051,4427,沙鹿,二等
2020-03-15,2230,3341,3495,6836,沙鹿,二等
2020-03-16,2230,1862,1992,3854,沙鹿,二等
2020-03-17,2230,1555,1562,3117,沙鹿,二等
2020-03-18,2230,1572,1538,3110,沙鹿,二等
2020-03-19,2230,1565,1519,3084,沙鹿,二等
2020-03-20,2230,3026,2609,5635,沙鹿,二等
2020-03-21,2230,1988,1763,3751,沙鹿,二等
2020-03-22,2230,2512,2794,5306,沙鹿,二等
2020-03-23,2230,1648,1802,3450,沙鹿,二等
2020-03-24,2230,1446,1413,2859,沙鹿,二等
2020-03-25,2230,1439,1407,2846,沙鹿,二等
2020-03-26,2230,1458,1404,2862,沙鹿,二等
2020-03-27,2230,2470,2319,4789,沙鹿,二等
2020-03-28,2230,1549,1494,3043,沙鹿,二等
2020-03-29,2230,2102,2302,4404,沙鹿,二等
2020-03-30,2230,1636,1742,3378,沙鹿,二等
2020-03-31,2230,1381,1521,2902,沙鹿,二等
2020-04-01,2230,3035,2415,5450,沙鹿,二等
2020-04-02,2230,2291,1933,4224,沙鹿,二等
2020-04-03,2230,1807,1679,3486,沙鹿,二等
2020-04-04,2230,1553,1413,2966,沙鹿,二等
2020-04-05,2230,2723,2512,5235,沙鹿,二等
2020-04-06,2230,1780,2566,4346,沙鹿,二等
2020-04-07,2230,1347,1501,2848,沙鹿,二等
2020-04-08,2230,1371,1362,2733,沙鹿,二等
2020-04-09,2230,1429,1377,2806,沙鹿,二等
2020-04-10,2230,2480,2206,4686,沙鹿,二等
2020-04-11,2230,1809,1655,3464,沙鹿,二等
2020-04-12,2230,2350,2516,4866,沙鹿,二等
2020-04-13,2230,1569,1661,3230,沙鹿,二等
2020-04-14,2230,1318,1358,2676,沙鹿,二等
2020-04-15,2230,1459,1488,2947,沙鹿,二等
2020-04-16,2230,1478,1437,2915,沙鹿,二等
2020-04-17,2230,2685,2444,5129,沙鹿,二等
2020-04-18,2230,1819,1786,3605,沙鹿,二等
2020-04-19,2230,2536,2544,5080,沙鹿,二等
2020-04-20,2230,1588,1627,3215,沙鹿,二等
2020-04-21,2230,1287,1293,2580,沙鹿,二等
2020-04-22,2230,1299,1292,2591,沙鹿,二等
2020-04-23,2230,1299,1283,2582,沙鹿,二等
2020-04-24,2230,2354,2115,4469,沙鹿,二等
2020-04-25,2230,1501,1469,2970,沙鹿,二等
2020-04-26,2230,2031,2127,4158,沙鹿,二等
2020-04-27,2230,1550,1637,3187,沙鹿,二等
2020-04-28,2230,1326,1300,2626,沙鹿,二等
2020-04-29,2230,1355,1414,2769,沙鹿,二等
2020-04-30,2230,1838,1985,3823,沙鹿,二等
2020-05-01,2230,2793,2456,5249,沙鹿,二等
2020-05-02,2230,1815,1739,3554,沙鹿,二等
2020-05-03,2230,2744,2870,5614,沙鹿,二等
2020-05-04,2230,1710,1822,3532,沙鹿,二等
2020-05-05,2230,1391,1386,2777,沙鹿,二等
2020-05-06,2230,1451,1453,2904,沙鹿,二等
2020-05-07,2230,1547,1424,2971,沙鹿,二等
2020-05-08,2230,3342,2798,6140,沙鹿,二等
2020-05-09,2230,2387,2150,4537,沙鹿,二等
2020-05-10,2230,3086,3401,6487,沙鹿,二等
2020-05-11,2230,1919,2018,3937,沙鹿,二等
2020-05-12,2230,1471,1489,2960,沙鹿,二等
2020-05-13,2230,1444,1469,2913,沙鹿,二等
2020-05-14,2230,1529,1517,3046,沙鹿,二等
2020-05-15,2230,2936,2608,5544,沙鹿,二等
2020-05-16,2230,2209,1932,4141,沙鹿,二等
2020-05-17,2230,2808,2933,5741,沙鹿,二等
2020-05-18,2230,1650,1761,3411,沙鹿,二等
2020-05-19,2230,1302,1330,2632,沙鹿,二等
2020-05-20,2230,1483,1465,2948,沙鹿,二等
2020-05-21,2230,1497,1407,2904,沙鹿,二等
2020-05-22,2230,2622,2413,5035,沙鹿,二等
2020-05-23,2230,2048,1931,3979,沙鹿,二等
2020-05-24,2230,3165,3396,6561,沙鹿,二等
2020-05-25,2230,1870,1901,3771,沙鹿,二等
2020-05-26,2230,1419,1488,2907,沙鹿,二等
2020-05-27,2230,1461,1430,2891,沙鹿,二等
2020-05-28,2230,1575,1501,3076,沙鹿,二等
2020-05-29,2230,2977,2685,5662,沙鹿,二等
2020-05-30,2230,2362,2203,4565,沙鹿,二等
2020-05-31,2230,3174,3277,6451,沙鹿,二等
2020-06-01,2230,1794,1873,3667,沙鹿,二等
2020-06-02,2230,1436,1507,2943,沙鹿,二等
2020-06-03,2230,1523,1560,3083,沙鹿,二等
2020-06-04,2230,1691,1677,3368,沙鹿,二等
2020-06-05,2230,3018,2612,5630,沙鹿,二等
2020-06-06,2230,2446,2196,4642,沙鹿,二等
2020-06-07,2230,2994,3282,6276,沙鹿,二等
2020-06-08,2230,1810,1986,3796,沙鹿,二等
2020-06-09,2230,1490,1567,3057,沙鹿,二等
2020-06-10,2230,1761,1708,3469,沙鹿,二等
2020-06-11,2230,2476,1869,4345,沙鹿,二等
2020-06-12,2230,3413,2772,6185,沙鹿,二等
2020-06-13,2230,2931,2613,5544,沙鹿,二等
2020-06-14,2230,3482,3604,7086,沙鹿,二等
2020-06-15,2230,1977,2161,4138,沙鹿,二等
2020-06-16,2230,1710,1787,3497,沙鹿,二等
2020-06-17,2230,1765,1749,3514,沙鹿,二等
2020-06-18,2230,1788,1806,3594,沙鹿,二等
2020-06-19,2230,2780,3000,5780,沙鹿,二等
2020-06-20,2230,2837,2947,5784,沙鹿,二等
2020-06-21,2230,2869,3008,5877,沙鹿,二等
2020-06-22,2230,1874,1962,3836,沙鹿,二等
2020-06-23,2230,1718,1763,3481,沙鹿,二等
2020-06-24,2230,3215,2978,6193,沙鹿,二等
2020-06-25,2230,3246,2887,6133,沙鹿,二等
2020-06-26,2230,2918,2972,5890,沙鹿,二等
2020-06-27,2230,3162,3154,6316,沙鹿,二等
2020-06-28,2230,3747,3759,7506,沙鹿,二等
2020-06-29,2230,2221,2190,4411,沙鹿,二等
2020-06-30,2230,1799,1802,3601,沙鹿,二等
2020-07-01,2230,1726,1746,3472,沙鹿,二等
2020-07-02,2230,1683,1605,3288,沙鹿,二等
2020-07-03,2230,2336,2282,4618,沙鹿,二等
2020-07-04,2230,3037,2257,5294,沙鹿,二等
2020-07-05,2230,3035,3277,6312,沙鹿,二等
2020-07-06,2230,2047,2115,4162,沙鹿,二等
2020-07-07,2230,1740,1716,3456,沙鹿,二等
2020-07-08,2230,1656,1602,3258,沙鹿,二等
2020-07-09,2230,1758,1713,3471,沙鹿,二等
2020-07-10,2230,2526,2424,4950,沙鹿,二等
2020-07-11,2230,4303,4707,9010,沙鹿,二等
2020-07-12,2230,3414,3637,7051,沙鹿,二等
2020-07-13,2230,2341,2321,4662,沙鹿,二等
2020-07-14,2230,1819,2036,3855,沙鹿,二等
2020-07-15,2230,2010,1927,3937,沙鹿,二等
2020-07-16,2230,1936,1835,3771,沙鹿,二等
2020-07-17,2230,2579,2500,5079,沙鹿,二等
2020-07-18,2230,2751,2640,5391,沙鹿,二等
2020-07-19,2230,3286,3266,6552,沙鹿,二等
2020-07-20,2230,2049,1969,4018,沙鹿,二等
2020-07-21,2230,1743,1720,3463,沙鹿,二等
2020-07-22,2230,1809,1775,3584,沙鹿,二等
2020-07-23,2230,1913,1768,3681,沙鹿,二等
2020-07-24,2230,2464,2484,4948,沙鹿,二等
2020-07-25,2230,2658,2596,5254,沙鹿,二等
2020-07-26,2230,3152,3109,6261,沙鹿,二等
2020-07-27,2230,1998,2035,4033,沙鹿,二等
2020-07-28,2230,1754,1726,3480,沙鹿,二等
2020-07-29,2230,1832,1760,3592,沙鹿,二等
2020-07-30,2230,1870,1788,3658,沙鹿,二等
2020-07-31,2230,2591,2546,5137,沙鹿,二等
2020-08-01,2230,2712,2699,5411,沙鹿,二等
2020-08-02,2230,2938,2942,5880,沙鹿,二等
2020-08-03,2230,1878,1808,3686,沙鹿,二等
2020-08-04,2230,1642,1577,3219,沙鹿,二等
2020-08-05,2230,1759,1747,3506,沙鹿,二等
2020-08-06,2230,1807,1713,3520,沙鹿,二等
2020-08-07,2230,2678,2582,5260,沙鹿,二等
2020-08-08,2230,2588,2551,5139,沙鹿,二等
2020-08-09,2230,3332,3333,6665,沙鹿,二等
2020-08-10,2230,2128,1993,4121,沙鹿,二等
2020-08-11,2230,1802,1731,3533,沙鹿,二等
2020-08-12,2230,1794,1812,3606,沙鹿,二等
2020-08-13,2230,1889,1777,3666,沙鹿,二等
2020-08-14,2230,2734,2656,5390,沙鹿,二等
2020-08-15,2230,2949,2885,5834,沙鹿,二等
2020-08-16,2230,3625,3674,7299,沙鹿,二等
2020-08-17,2230,2103,2078,4181,沙鹿,二等
2020-08-18,2230,1806,1824,3630,沙鹿,二等
2020-08-19,2230,1806,1829,3635,沙鹿,二等
2020-08-20,2230,1843,1766,3609,沙鹿,二等
2020-08-21,2230,2527,2514,5041,沙鹿,二等
2020-08-22,2230,2704,2653,5357,沙鹿,二等
2020-08-23,2230,3213,3189,6402,沙鹿,二等
2020-08-24,2230,2029,2007,4036,沙鹿,二等
2020-08-25,2230,1810,1817,3627,沙鹿,二等
2020-08-26,2230,1827,1804,3631,沙鹿,二等
2020-08-27,2230,1678,1710,3388,沙鹿,二等
2020-08-28,2230,2428,2360,4788,沙鹿,二等
2020-08-29,2230,2452,2319,4771,沙鹿,二等
2020-08-30,2230,2858,2764,5622,沙鹿,二等
2020-08-31,2230,1749,1817,3566,沙鹿,二等
2020-09-01,2230,1688,1691,3379,沙鹿,二等
2020-09-02,2230,1612,1624,3236,沙鹿,二等
2020-09-03,2230,1822,1763,3585,沙鹿,二等
2020-09-04,2230,2349,2566,4915,沙鹿,二等
2020-09-05,2230,2568,2562,5130,沙鹿,二等
2020-09-06,2230,3243,3057,6300,沙鹿,二等
2020-09-07,2230,1986,1947,3933,沙鹿,二等
2020-09-08,2230,1992,1680,3672,沙鹿,二等
2020-09-09,2230,1853,1748,3601,沙鹿,二等
2020-09-10,2230,1868,1740,3608,沙鹿,二等
2020-09-11,2230,2760,2637,5397,沙鹿,二等
2020-09-12,2230,2861,2708,5569,沙鹿,二等
2020-09-13,2230,3800,4189,7989,沙鹿,二等
2020-09-14,2230,1898,1972,3870,沙鹿,二等
2020-09-15,2230,1564,1533,3097,沙鹿,二等
2020-09-16,2230,1663,1643,3306,沙鹿,二等
2020-09-17,2230,1779,1678,3457,沙鹿,二等
2020-09-18,2230,3462,2812,6274,沙鹿,二等
2020-09-19,2230,2945,2779,5724,沙鹿,二等
2020-09-20,2230,3726,4101,7827,沙鹿,二等
2020-09-21,2230,1938,2079,4017,沙鹿,二等
2020-09-22,2230,1644,1576,3220,沙鹿,二等
2020-09-23,2230,1618,1676,3294,沙鹿,二等
2020-09-24,2230,1681,1613,3294,沙鹿,二等
2020-09-25,2230,2583,2019,4602,沙鹿,二等
2020-09-26,2230,2367,2271,4638,沙鹿,二等
2020-09-27,2230,2939,3140,6079,沙鹿,二等
2020-09-28,2230,1868,1939,3807,沙鹿,二等
2020-09-29,2230,1754,1760,3514,沙鹿,二等
2020-09-30,2230,4208,3519,7727,沙鹿,二等
2020-10-01,2230,3878,3301,7179,沙鹿,二等
2020-10-02,2230,3189,3196,6385,沙鹿,二等
2020-10-03,2230,3293,3162,6455,沙鹿,二等
2020-10-04,2230,4101,5057,9158,沙鹿,二等
2020-10-05,2230,2160,2210,4370,沙鹿,二等
2020-10-06,2230,1660,1658,3318,沙鹿,二等
2020-10-07,2230,1756,1735,3491,沙鹿,二等
2020-10-08,2230,3570,2934,6504,沙鹿,二等
2020-10-09,2230,3663,3126,6789,沙鹿,二等
2020-10-10,2230,3147,2974,6121,沙鹿,二等
2020-10-11,2230,4011,4780,8791,沙鹿,二等
2020-10-12,2230,2144,2207,4351,沙鹿,二等
2020-10-13,2230,1762,1709,3471,沙鹿,二等
2020-10-14,2230,1732,1712,3444,沙鹿,二等
2020-10-15,2230,1810,1703,3513,沙鹿,二等
2020-10-16,2230,3175,2847,6022,沙鹿,二等
2020-10-17,2230,2916,2701,5617,沙鹿,二等
2020-10-18,2230,3710,3949,7659,沙鹿,二等
2020-10-19,2230,2064,2167,4231,沙鹿,二等
2020-10-20,2230,1758,1687,3445,沙鹿,二等
2020-10-21,2230,1779,1716,3495,沙鹿,二等
2020-10-22,2230,1971,1783,3754,沙鹿,二等
2020-10-23,2230,3366,2759,6125,沙鹿,二等
2020-10-24,2230,2824,2626,5450,沙鹿,二等
2020-10-25,2230,3309,3667,6976,沙鹿,二等
2020-10-26,2230,2134,2097,4231,沙鹿,二等
2020-10-27,2230,1735,1644,3379,沙鹿,二等
2020-10-28,2230,1789,1717,3506,沙鹿,二等
2020-10-29,2230,1843,1827,3670,沙鹿,二等
2020-10-30,2230,3270,2938,6208,沙鹿,二等
2020-10-31,2230,2748,2624,5372,沙鹿,二等
2020-11-01,2230,3486,3921,7407,沙鹿,二等
2020-11-02,2230,1946,2031,3977,沙鹿,二等
2020-11-03,2230,1554,1582,3136,沙鹿,二等
2020-11-04,2230,1604,1569,3173,沙鹿,二等
2020-11-05,2230,1775,1713,3488,沙鹿,二等
2020-11-06,2230,2965,2922,5887,沙鹿,二等
2020-11-07,2230,2766,2658,5424,沙鹿,二等
2020-11-08,2230,3409,3275,6684,沙鹿,二等
2020-11-09,2230,1913,2010,3923,沙鹿,二等
2020-11-10,2230,1640,1634,3274,沙鹿,二等
2020-11-11,2230,1718,1762,3480,沙鹿,二等
2020-11-12,2230,1917,1835,3752,沙鹿,二等
2020-11-13,2230,3683,3049,6732,沙鹿,二等
2020-11-14,2230,3223,2905,6128,沙鹿,二等
2020-11-15,2230,4167,4606,8773,沙鹿,二等
2020-11-16,2230,2147,2272,4419,沙鹿,二等
2020-11-17,2230,1777,1731,3508,沙鹿,二等
2020-11-18,2230,1726,1751,3477,沙鹿,二等
2020-11-19,2230,1921,1882,3803,沙鹿,二等
2020-11-20,2230,3620,3116,6736,沙鹿,二等
2020-11-21,2230,3211,2888,6099,沙鹿,二等
2020-11-22,2230,3691,4184,7875,沙鹿,二等
2020-11-23,2230,2167,2236,4403,沙鹿,二等
2020-11-24,2230,1742,1685,3427,沙鹿,二等
2020-11-25,2230,1776,1766,3542,沙鹿,二等
2020-11-26,2230,1899,1786,3685,沙鹿,二等
2020-11-27,2230,3440,3072,6512,沙鹿,二等
2020-11-28,2230,3007,2707,5714,沙鹿,二等
2020-11-29,2230,3569,3836,7405,沙鹿,二等
2020-11-30,2230,2030,2152,4182,沙鹿,二等
2020-12-01,2230,1657,1643,3300,沙鹿,二等
2020-12-02,2230,1673,1749,3422,沙鹿,二等
2020-12-03,2230,1878,1717,3595,沙鹿,二等
2020-12-04,2230,3583,2999,6582,沙鹿,二等
2020-12-05,2230,3138,2804,5942,沙鹿,二等
2020-12-06,2230,3642,4150,7792,沙鹿,二等
2020-12-07,2230,2107,2197,4304,沙鹿,二等
2020-12-08,2230,1647,1595,3242,沙鹿,二等
2020-12-09,2230,1596,1639,3235,沙鹿,二等
2020-12-10,2230,1814,1759,3573,沙鹿,二等
2020-12-11,2230,3620,3042,6662,沙鹿,二等
2020-12-12,2230,3346,2884,6230,沙鹿,二等
2020-12-13,2230,3973,4544,8517,沙鹿,二等
2020-12-14,2230,2069,2206,4275,沙鹿,二等
2020-12-15,2230,1728,1712,3440,沙鹿,二等
2020-12-16,2230,1804,1694,3498,沙鹿,二等
2020-12-17,2230,1861,1770,3631,沙鹿,二等
2020-12-18,2230,3419,3083,6502,沙鹿,二等
2020-12-19,2230,3162,2753,5915,沙鹿,二等
2020-12-20,2230,3856,3976,7832,沙鹿,二等
2020-12-21,2230,2012,2373,4385,沙鹿,二等
2020-12-22,2230,1738,1791,3529,沙鹿,二等
2020-12-23,2230,1606,1608,3214,沙鹿,二等
2020-12-24,2230,2403,1834,4237,沙鹿,二等
2020-12-25,2230,3224,3009,6233,沙鹿,二等
2020-12-26,2230,2836,2672,5508,沙鹿,二等
2020-12-27,2230,3374,3888,7262,沙鹿,二等
2020-12-28,2230,2023,2150,4173,沙鹿,二等
2020-12-29,2230,1765,1709,3474,沙鹿,二等
2020-12-30,2230,1979,1873,3852,沙鹿,二等
2020-12-31,2230,4154,3308,7462,沙鹿,二等
2020-01-01,2240,431,406,837,龍井,三等
2020-01-02,2240,356,338,694,龍井,三等
2020-01-03,2240,371,395,766,龍井,三等
2020-01-04,2240,490,476,966,龍井,三等
2020-01-05,2240,499,446,945,龍井,三等
2020-01-06,2240,370,344,714,龍井,三等
2020-01-07,2240,338,321,659,龍井,三等
2020-01-08,2240,358,304,662,龍井,三等
2020-01-09,2240,329,323,652,龍井,三等
2020-01-10,2240,419,585,1004,龍井,三等
2020-01-11,2240,500,455,955,龍井,三等
2020-01-12,2240,607,548,1155,龍井,三等
2020-01-13,2240,415,344,759,龍井,三等
2020-01-14,2240,342,303,645,龍井,三等
2020-01-15,2240,316,314,630,龍井,三等
2020-01-16,2240,348,361,709,龍井,三等
2020-01-17,2240,370,359,729,龍井,三等
2020-01-18,2240,381,371,752,龍井,三等
2020-01-19,2240,482,427,909,龍井,三等
2020-01-20,2240,330,282,612,龍井,三等
2020-01-21,2240,284,275,559,龍井,三等
2020-01-22,2240,369,381,750,龍井,三等
2020-01-23,2240,371,423,794,龍井,三等
2020-01-24,2240,375,351,726,龍井,三等
2020-01-25,2240,968,887,1855,龍井,三等
2020-01-26,2240,426,408,834,龍井,三等
2020-01-27,2240,767,677,1444,龍井,三等
2020-01-28,2240,594,553,1147,龍井,三等
2020-01-29,2240,490,416,906,龍井,三等
2020-01-30,2240,321,264,585,龍井,三等
2020-01-31,2240,305,291,596,龍井,三等
2020-02-01,2240,307,280,587,龍井,三等
2020-02-02,2240,391,354,745,龍井,三等
2020-02-03,2240,291,245,536,龍井,三等
2020-02-04,2240,230,231,461,龍井,三等
2020-02-05,2240,273,275,548,龍井,三等
2020-02-06,2240,259,241,500,龍井,三等
2020-02-07,2240,305,313,618,龍井,三等
2020-02-08,2240,315,298,613,龍井,三等
2020-02-09,2240,378,394,772,龍井,三等
2020-02-10,2240,287,287,574,龍井,三等
2020-02-11,2240,271,254,525,龍井,三等
2020-02-12,2240,281,256,537,龍井,三等
2020-02-13,2240,238,241,479,龍井,三等
2020-02-14,2240,295,298,593,龍井,三等
2020-02-15,2240,354,343,697,龍井,三等
2020-02-16,2240,356,352,708,龍井,三等
2020-02-17,2240,282,264,546,龍井,三等
2020-02-18,2240,289,272,561,龍井,三等
2020-02-19,2240,255,230,485,龍井,三等
2020-02-20,2240,242,246,488,龍井,三等
2020-02-21,2240,309,328,637,龍井,三等
2020-02-22,2240,327,328,655,龍井,三等
2020-02-23,2240,387,361,748,龍井,三等
2020-02-24,2240,283,235,518,龍井,三等
2020-02-25,2240,305,279,584,龍井,三等
2020-02-26,2240,296,298,594,龍井,三等
2020-02-27,2240,368,449,817,龍井,三等
2020-02-28,2240,319,359,678,龍井,三等
2020-02-29,2240,317,277,594,龍井,三等
2020-03-01,2240,436,310,746,龍井,三等
2020-03-02,2240,361,328,689,龍井,三等
2020-03-03,2240,338,319,657,龍井,三等
2020-03-04,2240,323,307,630,龍井,三等
2020-03-05,2240,311,299,610,龍井,三等
2020-03-06,2240,357,481,838,龍井,三等
2020-03-07,2240,321,346,667,龍井,三等
2020-03-08,2240,456,351,807,龍井,三等
2020-03-09,2240,361,309,670,龍井,三等
2020-03-10,2240,299,290,589,龍井,三等
2020-03-11,2240,316,317,633,龍井,三等
2020-03-12,2240,349,309,658,龍井,三等
2020-03-13,2240,394,514,908,龍井,三等
2020-03-14,2240,305,300,605,龍井,三等
2020-03-15,2240,478,387,865,龍井,三等
2020-03-16,2240,355,316,671,龍井,三等
2020-03-17,2240,332,309,641,龍井,三等
2020-03-18,2240,314,307,621,龍井,三等
2020-03-19,2240,329,309,638,龍井,三等
2020-03-20,2240,337,460,797,龍井,三等
2020-03-21,2240,273,248,521,龍井,三等
2020-03-22,2240,381,286,667,龍井,三等
2020-03-23,2240,319,279,598,龍井,三等
2020-03-24,2240,322,315,637,龍井,三等
2020-03-25,2240,310,269,579,龍井,三等
2020-03-26,2240,298,278,576,龍井,三等
2020-03-27,2240,320,434,754,龍井,三等
2020-03-28,2240,230,243,473,龍井,三等
2020-03-29,2240,295,257,552,龍井,三等
2020-03-30,2240,328,309,637,龍井,三等
2020-03-31,2240,274,269,543,龍井,三等
2020-04-01,2240,289,412,701,龍井,三等
2020-04-02,2240,232,282,514,龍井,三等
2020-04-03,2240,245,256,501,龍井,三等
2020-04-04,2240,219,161,380,龍井,三等
2020-04-05,2240,371,257,628,龍井,三等
2020-04-06,2240,368,293,661,龍井,三等
2020-04-07,2240,301,266,567,龍井,三等
2020-04-08,2240,276,255,531,龍井,三等
2020-04-09,2240,315,283,598,龍井,三等
2020-04-10,2240,322,448,770,龍井,三等
2020-04-11,2240,275,244,519,龍井,三等
2020-04-12,2240,366,301,667,龍井,三等
2020-04-13,2240,331,286,617,龍井,三等
2020-04-14,2240,288,266,554,龍井,三等
2020-04-15,2240,280,262,542,龍井,三等
2020-04-16,2240,298,317,615,龍井,三等
2020-04-17,2240,320,439,759,龍井,三等
2020-04-18,2240,266,256,522,龍井,三等
2020-04-19,2240,369,294,663,龍井,三等
2020-04-20,2240,318,269,587,龍井,三等
2020-04-21,2240,279,243,522,龍井,三等
2020-04-22,2240,259,261,520,龍井,三等
2020-04-23,2240,264,246,510,龍井,三等
2020-04-24,2240,278,407,685,龍井,三等
2020-04-25,2240,201,191,392,龍井,三等
2020-04-26,2240,270,255,525,龍井,三等
2020-04-27,2240,331,262,593,龍井,三等
2020-04-28,2240,288,255,543,龍井,三等
2020-04-29,2240,251,246,497,龍井,三等
2020-04-30,2240,331,343,674,龍井,三等
2020-05-01,2240,343,443,786,龍井,三等
2020-05-02,2240,274,277,551,龍井,三等
2020-05-03,2240,397,304,701,龍井,三等
2020-05-04,2240,319,254,573,龍井,三等
2020-05-05,2240,280,266,546,龍井,三等
2020-05-06,2240,277,291,568,龍井,三等
2020-05-07,2240,289,281,570,龍井,三等
2020-05-08,2240,341,483,824,龍井,三等
2020-05-09,2240,307,323,630,龍井,三等
2020-05-10,2240,426,312,738,龍井,三等
2020-05-11,2240,346,272,618,龍井,三等
2020-05-12,2240,279,273,552,龍井,三等
2020-05-13,2240,279,290,569,龍井,三等
2020-05-14,2240,280,285,565,龍井,三等
2020-05-15,2240,345,435,780,龍井,三等
2020-05-16,2240,288,303,591,龍井,三等
2020-05-17,2240,405,325,730,龍井,三等
2020-05-18,2240,353,298,651,龍井,三等
2020-05-19,2240,282,254,536,龍井,三等
2020-05-20,2240,304,287,591,龍井,三等
2020-05-21,2240,305,295,600,龍井,三等
2020-05-22,2240,299,415,714,龍井,三等
2020-05-23,2240,290,272,562,龍井,三等
2020-05-24,2240,488,426,914,龍井,三等
2020-05-25,2240,333,282,615,龍井,三等
2020-05-26,2240,288,271,559,龍井,三等
2020-05-27,2240,275,255,530,龍井,三等
2020-05-28,2240,309,292,601,龍井,三等
2020-05-29,2240,339,488,827,龍井,三等
2020-05-30,2240,343,311,654,龍井,三等
2020-05-31,2240,464,372,836,龍井,三等
2020-06-01,2240,341,294,635,龍井,三等
2020-06-02,2240,291,263,554,龍井,三等
2020-06-03,2240,296,268,564,龍井,三等
2020-06-04,2240,311,288,599,龍井,三等
2020-06-05,2240,344,465,809,龍井,三等
2020-06-06,2240,338,363,701,龍井,三等
2020-06-07,2240,464,333,797,龍井,三等
2020-06-08,2240,343,297,640,龍井,三等
2020-06-09,2240,297,279,576,龍井,三等
2020-06-10,2240,299,315,614,龍井,三等
2020-06-11,2240,440,324,764,龍井,三等
2020-06-12,2240,629,517,1146,龍井,三等
2020-06-13,2240,409,392,801,龍井,三等
2020-06-14,2240,457,421,878,龍井,三等
2020-06-15,2240,355,320,675,龍井,三等
2020-06-16,2240,314,280,594,龍井,三等
2020-06-17,2240,287,273,560,龍井,三等
2020-06-18,2240,318,295,613,龍井,三等
2020-06-19,2240,430,748,1178,龍井,三等
2020-06-20,2240,437,447,884,龍井,三等
2020-06-21,2240,343,356,699,龍井,三等
2020-06-22,2240,298,274,572,龍井,三等
2020-06-23,2240,280,259,539,龍井,三等
2020-06-24,2240,344,429,773,龍井,三等
2020-06-25,2240,381,422,803,龍井,三等
2020-06-26,2240,437,385,822,龍井,三等
2020-06-27,2240,380,399,779,龍井,三等
2020-06-28,2240,537,423,960,龍井,三等
2020-06-29,2240,318,296,614,龍井,三等
2020-06-30,2240,279,271,550,龍井,三等
2020-07-01,2240,268,242,510,龍井,三等
2020-07-02,2240,282,256,538,龍井,三等
2020-07-03,2240,385,394,779,龍井,三等
2020-07-04,2240,525,297,822,龍井,三等
2020-07-05,2240,397,537,934,龍井,三等
2020-07-06,2240,377,380,757,龍井,三等
2020-07-07,2240,283,266,549,龍井,三等
2020-07-08,2240,285,275,560,龍井,三等
2020-07-09,2240,305,272,577,龍井,三等
2020-07-10,2240,371,367,738,龍井,三等
2020-07-11,2240,1284,2234,3518,龍井,三等
2020-07-12,2240,562,573,1135,龍井,三等
2020-07-13,2240,398,371,769,龍井,三等
2020-07-14,2240,275,274,549,龍井,三等
2020-07-15,2240,313,259,572,龍井,三等
2020-07-16,2240,287,283,570,龍井,三等
2020-07-17,2240,358,324,682,龍井,三等
2020-07-18,2240,379,372,751,龍井,三等
2020-07-19,2240,463,455,918,龍井,三等
2020-07-20,2240,306,267,573,龍井,三等
2020-07-21,2240,301,282,583,龍井,三等
2020-07-22,2240,276,253,529,龍井,三等
2020-07-23,2240,295,270,565,龍井,三等
2020-07-24,2240,338,335,673,龍井,三等
2020-07-25,2240,405,364,769,龍井,三等
2020-07-26,2240,431,416,847,龍井,三等
2020-07-27,2240,296,283,579,龍井,三等
2020-07-28,2240,295,250,545,龍井,三等
2020-07-29,2240,304,261,565,龍井,三等
2020-07-30,2240,321,312,633,龍井,三等
2020-07-31,2240,371,372,743,龍井,三等
2020-08-01,2240,415,360,775,龍井,三等
2020-08-02,2240,411,354,765,龍井,三等
2020-08-03,2240,267,238,505,龍井,三等
2020-08-04,2240,276,267,543,龍井,三等
2020-08-05,2240,305,315,620,龍井,三等
2020-08-06,2240,274,292,566,龍井,三等
2020-08-07,2240,323,360,683,龍井,三等
2020-08-08,2240,350,337,687,龍井,三等
2020-08-09,2240,481,388,869,龍井,三等
2020-08-10,2240,329,280,609,龍井,三等
2020-08-11,2240,270,252,522,龍井,三等
2020-08-12,2240,258,255,513,龍井,三等
2020-08-13,2240,331,319,650,龍井,三等
2020-08-14,2240,340,376,716,龍井,三等
2020-08-15,2240,465,418,883,龍井,三等
2020-08-16,2240,507,464,971,龍井,三等
2020-08-17,2240,293,257,550,龍井,三等
2020-08-18,2240,281,263,544,龍井,三等
2020-08-19,2240,289,277,566,龍井,三等
2020-08-20,2240,268,225,493,龍井,三等
2020-08-21,2240,328,368,696,龍井,三等
2020-08-22,2240,417,332,749,龍井,三等
2020-08-23,2240,436,462,898,龍井,三等
2020-08-24,2240,295,244,539,龍井,三等
2020-08-25,2240,300,258,558,龍井,三等
2020-08-26,2240,290,260,550,龍井,三等
2020-08-27,2240,259,237,496,龍井,三等
2020-08-28,2240,297,322,619,龍井,三等
2020-08-29,2240,333,326,659,龍井,三等
2020-08-30,2240,383,353,736,龍井,三等
2020-08-31,2240,284,264,548,龍井,三等
2020-09-01,2240,304,272,576,龍井,三等
2020-09-02,2240,285,276,561,龍井,三等
2020-09-03,2240,302,262,564,龍井,三等
2020-09-04,2240,352,424,776,龍井,三等
2020-09-05,2240,306,345,651,龍井,三等
2020-09-06,2240,385,378,763,龍井,三等
2020-09-07,2240,336,282,618,龍井,三等
2020-09-08,2240,308,285,593,龍井,三等
2020-09-09,2240,284,287,571,龍井,三等
2020-09-10,2240,299,291,590,龍井,三等
2020-09-11,2240,337,406,743,龍井,三等
2020-09-12,2240,413,418,831,龍井,三等
2020-09-13,2240,498,479,977,龍井,三等
2020-09-14,2240,358,339,697,龍井,三等
2020-09-15,2240,287,283,570,龍井,三等
2020-09-16,2240,309,295,604,龍井,三等
2020-09-17,2240,290,280,570,龍井,三等
2020-09-18,2240,374,418,792,龍井,三等
2020-09-19,2240,389,392,781,龍井,三等
2020-09-20,2240,535,431,966,龍井,三等
2020-09-21,2240,332,296,628,龍井,三等
2020-09-22,2240,302,298,600,龍井,三等
2020-09-23,2240,280,279,559,龍井,三等
2020-09-24,2240,322,295,617,龍井,三等
2020-09-25,2240,320,370,690,龍井,三等
2020-09-26,2240,324,340,664,龍井,三等
2020-09-27,2240,421,388,809,龍井,三等
2020-09-28,2240,340,291,631,龍井,三等
2020-09-29,2240,309,309,618,龍井,三等
2020-09-30,2240,358,557,915,龍井,三等
2020-10-01,2240,421,500,921,龍井,三等
2020-10-02,2240,513,452,965,龍井,三等
2020-10-03,2240,452,418,870,龍井,三等
2020-10-04,2240,587,458,1045,龍井,三等
2020-10-05,2240,355,299,654,龍井,三等
2020-10-06,2240,312,296,608,龍井,三等
2020-10-07,2240,318,320,638,龍井,三等
2020-10-08,2240,362,468,830,龍井,三等
2020-10-09,2240,427,419,846,龍井,三等
2020-10-10,2240,389,329,718,龍井,三等
2020-10-11,2240,520,436,956,龍井,三等
2020-10-12,2240,359,306,665,龍井,三等
2020-10-13,2240,333,301,634,龍井,三等
2020-10-14,2240,308,287,595,龍井,三等
2020-10-15,2240,316,299,615,龍井,三等
2020-10-16,2240,342,473,815,龍井,三等
2020-10-17,2240,394,380,774,龍井,三等
2020-10-18,2240,548,442,990,龍井,三等
2020-10-19,2240,370,317,687,龍井,三等
2020-10-20,2240,309,278,587,龍井,三等
2020-10-21,2240,302,315,617,龍井,三等
2020-10-22,2240,346,328,674,龍井,三等
2020-10-23,2240,342,416,758,龍井,三等
2020-10-24,2240,432,449,881,龍井,三等
2020-10-25,2240,464,397,861,龍井,三等
2020-10-26,2240,374,310,684,龍井,三等
2020-10-27,2240,288,285,573,龍井,三等
2020-10-28,2240,271,267,538,龍井,三等
2020-10-29,2240,305,299,604,龍井,三等
2020-10-30,2240,343,476,819,龍井,三等
2020-10-31,2240,400,353,753,龍井,三等
2020-11-01,2240,497,417,914,龍井,三等
2020-11-02,2240,354,305,659,龍井,三等
2020-11-03,2240,319,294,613,龍井,三等
2020-11-04,2240,303,305,608,龍井,三等
2020-11-05,2240,332,309,641,龍井,三等
2020-11-06,2240,396,495,891,龍井,三等
2020-11-07,2240,392,380,772,龍井,三等
2020-11-08,2240,482,398,880,龍井,三等
2020-11-09,2240,335,292,627,龍井,三等
2020-11-10,2240,308,293,601,龍井,三等
2020-11-11,2240,306,284,590,龍井,三等
2020-11-12,2240,298,303,601,龍井,三等
2020-11-13,2240,366,490,856,龍井,三等
2020-11-14,2240,446,406,852,龍井,三等
2020-11-15,2240,576,489,1065,龍井,三等
2020-11-16,2240,355,309,664,龍井,三等
2020-11-17,2240,337,318,655,龍井,三等
2020-11-18,2240,337,301,638,龍井,三等
2020-11-19,2240,351,349,700,龍井,三等
2020-11-20,2240,373,492,865,龍井,三等
2020-11-21,2240,437,437,874,龍井,三等
2020-11-22,2240,577,467,1044,龍井,三等
2020-11-23,2240,356,319,675,龍井,三等
2020-11-24,2240,354,337,691,龍井,三等
2020-11-25,2240,303,288,591,龍井,三等
2020-11-26,2240,355,347,702,龍井,三等
2020-11-27,2240,375,488,863,龍井,三等
2020-11-28,2240,366,359,725,龍井,三等
2020-11-29,2240,588,458,1046,龍井,三等
2020-11-30,2240,354,313,667,龍井,三等
2020-12-01,2240,319,288,607,龍井,三等
2020-12-02,2240,308,276,584,龍井,三等
2020-12-03,2240,292,291,583,龍井,三等
2020-12-04,2240,396,495,891,龍井,三等
2020-12-05,2240,409,380,789,龍井,三等
2020-12-06,2240,597,418,1015,龍井,三等
2020-12-07,2240,367,315,682,龍井,三等
2020-12-08,2240,313,307,620,龍井,三等
2020-12-09,2240,290,288,578,龍井,三等
2020-12-10,2240,321,331,652,龍井,三等
2020-12-11,2240,379,484,863,龍井,三等
2020-12-12,2240,433,453,886,龍井,三等
2020-12-13,2240,580,532,1112,龍井,三等
2020-12-14,2240,359,304,663,龍井,三等
2020-12-15,2240,312,301,613,龍井,三等
2020-12-16,2240,321,290,611,龍井,三等
2020-12-17,2240,307,307,614,龍井,三等
2020-12-18,2240,374,488,862,龍井,三等
2020-12-19,2240,422,425,847,龍井,三等
2020-12-20,2240,522,447,969,龍井,三等
2020-12-21,2240,329,285,614,龍井,三等
2020-12-22,2240,317,288,605,龍井,三等
2020-12-23,2240,251,269,520,龍井,三等
2020-12-24,2240,344,347,691,龍井,三等
2020-12-25,2240,388,486,874,龍井,三等
2020-12-26,2240,345,336,681,龍井,三等
2020-12-27,2240,466,381,847,龍井,三等
2020-12-28,2240,333,313,646,龍井,三等
2020-12-29,2240,322,304,626,龍井,三等
2020-12-30,2240,292,307,599,龍井,三等
2020-12-31,2240,396,535,931,龍井,三等
2020-01-01,2250,755,693,1448,大肚,三等
2020-01-02,2250,634,602,1236,大肚,三等
2020-01-03,2250,718,661,1379,大肚,三等
2020-01-04,2250,757,742,1499,大肚,三等
2020-01-05,2250,729,672,1401,大肚,三等
2020-01-06,2250,692,620,1312,大肚,三等
2020-01-07,2250,649,612,1261,大肚,三等
2020-01-08,2250,618,622,1240,大肚,三等
2020-01-09,2250,604,613,1217,大肚,三等
2020-01-10,2250,664,863,1527,大肚,三等
2020-01-11,2250,832,816,1648,大肚,三等
2020-01-12,2250,932,821,1753,大肚,三等
2020-01-13,2250,697,1084,1781,大肚,三等
2020-01-14,2250,623,571,1194,大肚,三等
2020-01-15,2250,642,591,1233,大肚,三等
2020-01-16,2250,658,601,1259,大肚,三等
2020-01-17,2250,662,642,1304,大肚,三等
2020-01-18,2250,677,640,1317,大肚,三等
2020-01-19,2250,718,734,1452,大肚,三等
2020-01-20,2250,595,537,1132,大肚,三等
2020-01-21,2250,617,628,1245,大肚,三等
2020-01-22,2250,676,748,1424,大肚,三等
2020-01-23,2250,737,762,1499,大肚,三等
2020-01-24,2250,625,702,1327,大肚,三等
2020-01-25,2250,1476,1321,2797,大肚,三等
2020-01-26,2250,753,728,1481,大肚,三等
2020-01-27,2250,1193,1123,2316,大肚,三等
2020-01-28,2250,841,776,1617,大肚,三等
2020-01-29,2250,759,734,1493,大肚,三等
2020-01-30,2250,523,439,962,大肚,三等
2020-01-31,2250,547,546,1093,大肚,三等
2020-02-01,2250,490,479,969,大肚,三等
2020-02-02,2250,652,589,1241,大肚,三等
2020-02-03,2250,518,431,949,大肚,三等
2020-02-04,2250,435,401,836,大肚,三等
2020-02-05,2250,457,417,874,大肚,三等
2020-02-06,2250,473,458,931,大肚,三等
2020-02-07,2250,533,506,1039,大肚,三等
2020-02-08,2250,528,518,1046,大肚,三等
2020-02-09,2250,593,573,1166,大肚,三等
2020-02-10,2250,578,511,1089,大肚,三等
2020-02-11,2250,537,484,1021,大肚,三等
2020-02-12,2250,519,511,1030,大肚,三等
2020-02-13,2250,474,424,898,大肚,三等
2020-02-14,2250,539,522,1061,大肚,三等
2020-02-15,2250,637,551,1188,大肚,三等
2020-02-16,2250,613,672,1285,大肚,三等
2020-02-17,2250,484,435,919,大肚,三等
2020-02-18,2250,435,457,892,大肚,三等
2020-02-19,2250,468,955,1423,大肚,三等
2020-02-20,2250,467,441,908,大肚,三等
2020-02-21,2250,514,514,1028,大肚,三等
2020-02-22,2250,529,531,1060,大肚,三等
2020-02-23,2250,598,560,1158,大肚,三等
2020-02-24,2250,474,397,871,大肚,三等
2020-02-25,2250,599,565,1164,大肚,三等
2020-02-26,2250,551,532,1083,大肚,三等
2020-02-27,2250,645,720,1365,大肚,三等
2020-02-28,2250,554,540,1094,大肚,三等
2020-02-29,2250,609,471,1080,大肚,三等
2020-03-01,2250,582,495,1077,大肚,三等
2020-03-02,2250,604,546,1150,大肚,三等
2020-03-03,2250,545,531,1076,大肚,三等
2020-03-04,2250,579,549,1128,大肚,三等
2020-03-05,2250,525,551,1076,大肚,三等
2020-03-06,2250,620,731,1351,大肚,三等
2020-03-07,2250,467,510,977,大肚,三等
2020-03-08,2250,605,477,1082,大肚,三等
2020-03-09,2250,629,929,1558,大肚,三等
2020-03-10,2250,533,533,1066,大肚,三等
2020-03-11,2250,559,548,1107,大肚,三等
2020-03-12,2250,554,565,1119,大肚,三等
2020-03-13,2250,618,732,1350,大肚,三等
2020-03-14,2250,531,523,1054,大肚,三等
2020-03-15,2250,749,558,1307,大肚,三等
2020-03-16,2250,629,591,1220,大肚,三等
2020-03-17,2250,564,569,1133,大肚,三等
2020-03-18,2250,545,532,1077,大肚,三等
2020-03-19,2250,551,549,1100,大肚,三等
2020-03-20,2250,595,706,1301,大肚,三等
2020-03-21,2250,436,431,867,大肚,三等
2020-03-22,2250,527,405,932,大肚,三等
2020-03-23,2250,619,554,1173,大肚,三等
2020-03-24,2250,555,563,1118,大肚,三等
2020-03-25,2250,528,525,1053,大肚,三等
2020-03-26,2250,548,571,1119,大肚,三等
2020-03-27,2250,556,663,1219,大肚,三等
2020-03-28,2250,346,379,725,大肚,三等
2020-03-29,2250,433,322,755,大肚,三等
2020-03-30,2250,581,520,1101,大肚,三等
2020-03-31,2250,494,536,1030,大肚,三等
2020-04-01,2250,523,674,1197,大肚,三等
2020-04-02,2250,400,455,855,大肚,三等
2020-04-03,2250,471,471,942,大肚,三等
2020-04-04,2250,316,279,595,大肚,三等
2020-04-05,2250,492,310,802,大肚,三等
2020-04-06,2250,594,679,1273,大肚,三等
2020-04-07,2250,501,485,986,大肚,三等
2020-04-08,2250,492,483,975,大肚,三等
2020-04-09,2250,496,501,997,大肚,三等
2020-04-10,2250,557,648,1205,大肚,三等
2020-04-11,2250,427,433,860,大肚,三等
2020-04-12,2250,537,447,984,大肚,三等
2020-04-13,2250,577,501,1078,大肚,三等
2020-04-14,2250,491,519,1010,大肚,三等
2020-04-15,2250,524,523,1047,大肚,三等
2020-04-16,2250,513,542,1055,大肚,三等
2020-04-17,2250,573,705,1278,大肚,三等
2020-04-18,2250,444,413,857,大肚,三等
2020-04-19,2250,559,460,1019,大肚,三等
2020-04-20,2250,584,528,1112,大肚,三等
2020-04-21,2250,493,491,984,大肚,三等
2020-04-22,2250,493,474,967,大肚,三等
2020-04-23,2250,472,471,943,大肚,三等
2020-04-24,2250,507,560,1067,大肚,三等
2020-04-25,2250,385,351,736,大肚,三等
2020-04-26,2250,442,365,807,大肚,三等
2020-04-27,2250,563,527,1090,大肚,三等
2020-04-28,2250,509,494,1003,大肚,三等
2020-04-29,2250,484,455,939,大肚,三等
2020-04-30,2250,537,580,1117,大肚,三等
2020-05-01,2250,555,599,1154,大肚,三等
2020-05-02,2250,490,459,949,大肚,三等
2020-05-03,2250,542,443,985,大肚,三等
2020-05-04,2250,565,488,1053,大肚,三等
2020-05-05,2250,517,476,993,大肚,三等
2020-05-06,2250,532,515,1047,大肚,三等
2020-05-07,2250,514,477,991,大肚,三等
2020-05-08,2250,577,726,1303,大肚,三等
2020-05-09,2250,466,491,957,大肚,三等
2020-05-10,2250,552,415,967,大肚,三等
2020-05-11,2250,665,531,1196,大肚,三等
2020-05-12,2250,536,528,1064,大肚,三等
2020-05-13,2250,534,523,1057,大肚,三等
2020-05-14,2250,546,532,1078,大肚,三等
2020-05-15,2250,620,702,1322,大肚,三等
2020-05-16,2250,483,469,952,大肚,三等
2020-05-17,2250,610,537,1147,大肚,三等
2020-05-18,2250,602,536,1138,大肚,三等
2020-05-19,2250,492,472,964,大肚,三等
2020-05-20,2250,545,554,1099,大肚,三等
2020-05-21,2250,808,518,1326,大肚,三等
2020-05-22,2250,549,617,1166,大肚,三等
2020-05-23,2250,430,428,858,大肚,三等
2020-05-24,2250,649,554,1203,大肚,三等
2020-05-25,2250,618,555,1173,大肚,三等
2020-05-26,2250,518,487,1005,大肚,三等
2020-05-27,2250,518,504,1022,大肚,三等
2020-05-28,2250,546,526,1072,大肚,三等
2020-05-29,2250,592,687,1279,大肚,三等
2020-05-30,2250,589,504,1093,大肚,三等
2020-05-31,2250,658,488,1146,大肚,三等
2020-06-01,2250,600,518,1118,大肚,三等
2020-06-02,2250,524,506,1030,大肚,三等
2020-06-03,2250,562,531,1093,大肚,三等
2020-06-04,2250,527,493,1020,大肚,三等
2020-06-05,2250,647,694,1341,大肚,三等
2020-06-06,2250,548,570,1118,大肚,三等
2020-06-07,2250,616,498,1114,大肚,三等
2020-06-08,2250,614,499,1113,大肚,三等
2020-06-09,2250,539,489,1028,大肚,三等
2020-06-10,2250,592,531,1123,大肚,三等
2020-06-11,2250,731,613,1344,大肚,三等
2020-06-12,2250,941,914,1855,大肚,三等
2020-06-13,2250,681,623,1304,大肚,三等
2020-06-14,2250,711,622,1333,大肚,三等
2020-06-15,2250,622,578,1200,大肚,三等
2020-06-16,2250,550,555,1105,大肚,三等
2020-06-17,2250,565,539,1104,大肚,三等
2020-06-18,2250,576,528,1104,大肚,三等
2020-06-19,2250,1075,896,1971,大肚,三等
2020-06-20,2250,732,710,1442,大肚,三等
2020-06-21,2250,639,590,1229,大肚,三等
2020-06-22,2250,610,515,1125,大肚,三等
2020-06-23,2250,554,536,1090,大肚,三等
2020-06-24,2250,598,696,1294,大肚,三等
2020-06-25,2250,599,606,1205,大肚,三等
2020-06-26,2250,712,661,1373,大肚,三等
2020-06-27,2250,670,594,1264,大肚,三等
2020-06-28,2250,824,601,1425,大肚,三等
2020-06-29,2250,625,529,1154,大肚,三等
2020-06-30,2250,554,503,1057,大肚,三等
2020-07-01,2250,555,497,1052,大肚,三等
2020-07-02,2250,520,464,984,大肚,三等
2020-07-03,2250,631,622,1253,大肚,三等
2020-07-04,2250,670,555,1225,大肚,三等
2020-07-05,2250,603,641,1244,大肚,三等
2020-07-06,2250,695,1260,1955,大肚,三等
2020-07-07,2250,531,490,1021,大肚,三等
2020-07-08,2250,563,493,1056,大肚,三等
2020-07-09,2250,527,495,1022,大肚,三等
2020-07-10,2250,661,616,1277,大肚,三等
2020-07-11,2250,1056,1591,2647,大肚,三等
2020-07-12,2250,833,757,1590,大肚,三等
2020-07-13,2250,728,629,1357,大肚,三等
2020-07-14,2250,547,511,1058,大肚,三等
2020-07-15,2250,517,483,1000,大肚,三等
2020-07-16,2250,542,512,1054,大肚,三等
2020-07-17,2250,598,610,1208,大肚,三等
2020-07-18,2250,671,613,1284,大肚,三等
2020-07-19,2250,629,581,1210,大肚,三等
2020-07-20,2250,514,442,956,大肚,三等
2020-07-21,2250,474,452,926,大肚,三等
2020-07-22,2250,500,452,952,大肚,三等
2020-07-23,2250,492,457,949,大肚,三等
2020-07-24,2250,643,600,1243,大肚,三等
2020-07-25,2250,691,612,1303,大肚,三等
2020-07-26,2250,622,590,1212,大肚,三等
2020-07-27,2250,569,475,1044,大肚,三等
2020-07-28,2250,520,477,997,大肚,三等
2020-07-29,2250,574,471,1045,大肚,三等
2020-07-30,2250,563,510,1073,大肚,三等
2020-07-31,2250,672,622,1294,大肚,三等
2020-08-01,2250,605,566,1171,大肚,三等
2020-08-02,2250,572,560,1132,大肚,三等
2020-08-03,2250,533,433,966,大肚,三等
2020-08-04,2250,534,468,1002,大肚,三等
2020-08-05,2250,657,534,1191,大肚,三等
2020-08-06,2250,590,525,1115,大肚,三等
2020-08-07,2250,635,639,1274,大肚,三等
2020-08-08,2250,576,571,1147,大肚,三等
2020-08-09,2250,702,578,1280,大肚,三等
2020-08-10,2250,835,455,1290,大肚,三等
2020-08-11,2250,485,445,930,大肚,三等
2020-08-12,2250,549,479,1028,大肚,三等
2020-08-13,2250,574,508,1082,大肚,三等
2020-08-14,2250,627,573,1200,大肚,三等
2020-08-15,2250,703,598,1301,大肚,三等
2020-08-16,2250,755,717,1472,大肚,三等
2020-08-17,2250,547,851,1398,大肚,三等
2020-08-18,2250,542,446,988,大肚,三等
2020-08-19,2250,501,450,951,大肚,三等
2020-08-20,2250,564,747,1311,大肚,三等
2020-08-21,2250,603,644,1247,大肚,三等
2020-08-22,2250,609,540,1149,大肚,三等
2020-08-23,2250,622,604,1226,大肚,三等
2020-08-24,2250,507,718,1225,大肚,三等
2020-08-25,2250,500,469,969,大肚,三等
2020-08-26,2250,497,496,993,大肚,三等
2020-08-27,2250,542,449,991,大肚,三等
2020-08-28,2250,512,530,1042,大肚,三等
2020-08-29,2250,575,541,1116,大肚,三等
2020-08-30,2250,551,480,1031,大肚,三等
2020-08-31,2250,575,470,1045,大肚,三等
2020-09-01,2250,566,525,1091,大肚,三等
2020-09-02,2250,535,484,1019,大肚,三等
2020-09-03,2250,565,508,1073,大肚,三等
2020-09-04,2250,623,785,1408,大肚,三等
2020-09-05,2250,541,559,1100,大肚,三等
2020-09-06,2250,624,548,1172,大肚,三等
2020-09-07,2250,628,715,1343,大肚,三等
2020-09-08,2250,608,1245,1853,大肚,三等
2020-09-09,2250,562,531,1093,大肚,三等
2020-09-10,2250,582,534,1116,大肚,三等
2020-09-11,2250,658,658,1316,大肚,三等
2020-09-12,2250,708,610,1318,大肚,三等
2020-09-13,2250,785,682,1467,大肚,三等
2020-09-14,2250,613,544,1157,大肚,三等
2020-09-15,2250,564,520,1084,大肚,三等
2020-09-16,2250,543,475,1018,大肚,三等
2020-09-17,2250,609,541,1150,大肚,三等
2020-09-18,2250,629,689,1318,大肚,三等
2020-09-19,2250,615,566,1181,大肚,三等
2020-09-20,2250,691,589,1280,大肚,三等
2020-09-21,2250,596,531,1127,大肚,三等
2020-09-22,2250,532,493,1025,大肚,三等
2020-09-23,2250,583,536,1119,大肚,三等
2020-09-24,2250,562,533,1095,大肚,三等
2020-09-25,2250,592,533,1125,大肚,三等
2020-09-26,2250,597,532,1129,大肚,三等
2020-09-27,2250,625,579,1204,大肚,三等
2020-09-28,2250,566,530,1096,大肚,三等
2020-09-29,2250,584,516,1100,大肚,三等
2020-09-30,2250,674,822,1496,大肚,三等
2020-10-01,2250,635,679,1314,大肚,三等
2020-10-02,2250,755,715,1470,大肚,三等
2020-10-03,2250,698,662,1360,大肚,三等
2020-10-04,2250,813,574,1387,大肚,三等
2020-10-05,2250,643,533,1176,大肚,三等
2020-10-06,2250,571,1054,1625,大肚,三等
2020-10-07,2250,567,534,1101,大肚,三等
2020-10-08,2250,650,726,1376,大肚,三等
2020-10-09,2250,770,750,1520,大肚,三等
2020-10-10,2250,693,619,1312,大肚,三等
2020-10-11,2250,792,669,1461,大肚,三等
2020-10-12,2250,650,547,1197,大肚,三等
2020-10-13,2250,575,538,1113,大肚,三等
2020-10-14,2250,581,557,1138,大肚,三等
2020-10-15,2250,568,531,1099,大肚,三等
2020-10-16,2250,650,702,1352,大肚,三等
2020-10-17,2250,609,600,1209,大肚,三等
2020-10-18,2250,716,640,1356,大肚,三等
2020-10-19,2250,634,553,1187,大肚,三等
2020-10-20,2250,574,547,1121,大肚,三等
2020-10-21,2250,605,571,1176,大肚,三等
2020-10-22,2250,578,541,1119,大肚,三等
2020-10-23,2250,585,657,1242,大肚,三等
2020-10-24,2250,638,596,1234,大肚,三等
2020-10-25,2250,659,559,1218,大肚,三等
2020-10-26,2250,748,557,1305,大肚,三等
2020-10-27,2250,545,513,1058,大肚,三等
2020-10-28,2250,569,509,1078,大肚,三等
2020-10-29,2250,544,534,1078,大肚,三等
2020-10-30,2250,602,687,1289,大肚,三等
2020-10-31,2250,579,582,1161,大肚,三等
2020-11-01,2250,748,601,1349,大肚,三等
2020-11-02,2250,598,565,1163,大肚,三等
2020-11-03,2250,564,519,1083,大肚,三等
2020-11-04,2250,584,558,1142,大肚,三等
2020-11-05,2250,583,541,1124,大肚,三等
2020-11-06,2250,638,695,1333,大肚,三等
2020-11-07,2250,613,574,1187,大肚,三等
2020-11-08,2250,745,600,1345,大肚,三等
2020-11-09,2250,630,543,1173,大肚,三等
2020-11-10,2250,563,524,1087,大肚,三等
2020-11-11,2250,587,571,1158,大肚,三等
2020-11-12,2250,594,579,1173,大肚,三等
2020-11-13,2250,627,705,1332,大肚,三等
2020-11-14,2250,740,684,1424,大肚,三等
2020-11-15,2250,912,787,1699,大肚,三等
2020-11-16,2250,656,575,1231,大肚,三等
2020-11-17,2250,576,537,1113,大肚,三等
2020-11-18,2250,588,559,1147,大肚,三等
2020-11-19,2250,593,547,1140,大肚,三等
2020-11-20,2250,753,843,1596,大肚,三等
2020-11-21,2250,764,669,1433,大肚,三等
2020-11-22,2250,792,714,1506,大肚,三等
2020-11-23,2250,665,568,1233,大肚,三等
2020-11-24,2250,554,515,1069,大肚,三等
2020-11-25,2250,637,568,1205,大肚,三等
2020-11-26,2250,689,566,1255,大肚,三等
2020-11-27,2250,658,769,1427,大肚,三等
2020-11-28,2250,690,614,1304,大肚,三等
2020-11-29,2250,759,628,1387,大肚,三等
2020-11-30,2250,636,528,1164,大肚,三等
2020-12-01,2250,578,529,1107,大肚,三等
2020-12-02,2250,581,562,1143,大肚,三等
2020-12-03,2250,560,552,1112,大肚,三等
2020-12-04,2250,694,710,1404,大肚,三等
2020-12-05,2250,596,589,1185,大肚,三等
2020-12-06,2250,781,630,1411,大肚,三等
2020-12-07,2250,632,525,1157,大肚,三等
2020-12-08,2250,548,545,1093,大肚,三等
2020-12-09,2250,511,507,1018,大肚,三等
2020-12-10,2250,557,547,1104,大肚,三等
2020-12-11,2250,665,701,1366,大肚,三等
2020-12-12,2250,732,713,1445,大肚,三等
2020-12-13,2250,839,743,1582,大肚,三等
2020-12-14,2250,660,574,1234,大肚,三等
2020-12-15,2250,554,528,1082,大肚,三等
2020-12-16,2250,610,536,1146,大肚,三等
2020-12-17,2250,589,575,1164,大肚,三等
2020-12-18,2250,656,740,1396,大肚,三等
2020-12-19,2250,704,629,1333,大肚,三等
2020-12-20,2250,756,681,1437,大肚,三等
2020-12-21,2250,668,613,1281,大肚,三等
2020-12-22,2250,585,555,1140,大肚,三等
2020-12-23,2250,512,472,984,大肚,三等
2020-12-24,2250,563,560,1123,大肚,三等
2020-12-25,2250,688,736,1424,大肚,三等
2020-12-26,2250,671,660,1331,大肚,三等
2020-12-27,2250,847,671,1518,大肚,三等
2020-12-28,2250,650,570,1220,大肚,三等
2020-12-29,2250,542,553,1095,大肚,三等
2020-12-30,2250,539,523,1062,大肚,三等
2020-12-31,2250,607,685,1292,大肚,三等
2020-01-01,2260,3939,449,4388,追分,三等
2020-01-02,2260,411,206,617,追分,三等
2020-01-03,2260,1290,1969,3259,追分,三等
2020-01-04,2260,1081,264,1345,追分,三等
2020-01-05,2260,1759,269,2028,追分,三等
2020-01-06,2260,621,205,826,追分,三等
2020-01-07,2260,580,188,768,追分,三等
2020-01-08,2260,950,217,1167,追分,三等
2020-01-09,2260,461,217,678,追分,三等
2020-01-10,2260,1167,267,1434,追分,三等
2020-01-11,2260,782,369,1151,追分,三等
2020-01-12,2260,767,440,1207,追分,三等
2020-01-13,2260,534,199,733,追分,三等
2020-01-14,2260,493,196,689,追分,三等
2020-01-15,2260,639,219,858,追分,三等
2020-01-16,2260,773,242,1015,追分,三等
2020-01-17,2260,852,187,1039,追分,三等
2020-01-18,2260,994,268,1262,追分,三等
2020-01-19,2260,499,259,758,追分,三等
2020-01-20,2260,224,171,395,追分,三等
2020-01-21,2260,307,180,487,追分,三等
2020-01-22,2260,624,210,834,追分,三等
2020-01-23,2260,652,331,983,追分,三等
2020-01-24,2260,433,321,754,追分,三等
2020-01-25,2260,853,671,1524,追分,三等
2020-01-26,2260,505,325,830,追分,三等
2020-01-27,2260,953,474,1427,追分,三等
2020-01-28,2260,960,449,1409,追分,三等
2020-01-29,2260,453,273,726,追分,三等
2020-01-30,2260,657,181,838,追分,三等
2020-01-31,2260,831,138,969,追分,三等
2020-02-01,2260,294,188,482,追分,三等
2020-02-02,2260,856,248,1104,追分,三等
2020-02-03,2260,263,167,430,追分,三等
2020-02-04,2260,320,126,446,追分,三等
2020-02-05,2260,171,143,314,追分,三等
2020-02-06,2260,266,149,415,追分,三等
2020-02-07,2260,348,175,523,追分,三等
2020-02-08,2260,439,227,666,追分,三等
2020-02-09,2260,478,279,757,追分,三等
2020-02-10,2260,255,163,418,追分,三等
2020-02-11,2260,192,152,344,追分,三等
2020-02-12,2260,424,153,577,追分,三等
2020-02-13,2260,256,137,393,追分,三等
2020-02-14,2260,319,176,495,追分,三等
2020-02-15,2260,531,231,762,追分,三等
2020-02-16,2260,533,314,847,追分,三等
2020-02-17,2260,716,138,854,追分,三等
2020-02-18,2260,287,100,387,追分,三等
2020-02-19,2260,323,139,462,追分,三等
2020-02-20,2260,314,149,463,追分,三等
2020-02-21,2260,302,160,462,追分,三等
2020-02-22,2260,249,177,426,追分,三等
2020-02-23,2260,544,231,775,追分,三等
2020-02-24,2260,748,139,887,追分,三等
2020-02-25,2260,254,183,437,追分,三等
2020-02-26,2260,198,162,360,追分,三等
2020-02-27,2260,436,215,651,追分,三等
2020-02-28,2260,691,165,856,追分,三等
2020-02-29,2260,727,190,917,追分,三等
2020-03-01,2260,525,210,735,追分,三等
2020-03-02,2260,304,193,497,追分,三等
2020-03-03,2260,251,214,465,追分,三等
2020-03-04,2260,310,174,484,追分,三等
2020-03-05,2260,195,148,343,追分,三等
2020-03-06,2260,445,205,650,追分,三等
2020-03-07,2260,415,195,610,追分,三等
2020-03-08,2260,336,227,563,追分,三等
2020-03-09,2260,325,172,497,追分,三等
2020-03-10,2260,488,162,650,追分,三等
2020-03-11,2260,296,197,493,追分,三等
2020-03-12,2260,466,184,650,追分,三等
2020-03-13,2260,293,221,514,追分,三等
2020-03-14,2260,1503,212,1715,追分,三等
2020-03-15,2260,786,305,1091,追分,三等
2020-03-16,2260,273,166,439,追分,三等
2020-03-17,2260,507,183,690,追分,三等
2020-03-18,2260,387,150,537,追分,三等
2020-03-19,2260,182,161,343,追分,三等
2020-03-20,2260,690,214,904,追分,三等
2020-03-21,2260,1457,149,1606,追分,三等
2020-03-22,2260,442,207,649,追分,三等
2020-03-23,2260,549,173,722,追分,三等
2020-03-24,2260,830,172,1002,追分,三等
2020-03-25,2260,217,158,375,追分,三等
2020-03-26,2260,979,218,1197,追分,三等
2020-03-27,2260,225,194,419,追分,三等
2020-03-28,2260,644,126,770,追分,三等
2020-03-29,2260,720,165,885,追分,三等
2020-03-30,2260,420,176,596,追分,三等
2020-03-31,2260,304,164,468,追分,三等
2020-04-01,2260,565,181,746,追分,三等
2020-04-02,2260,866,136,1002,追分,三等
2020-04-03,2260,1194,144,1338,追分,三等
2020-04-04,2260,890,109,999,追分,三等
2020-04-05,2260,875,135,1010,追分,三等
2020-04-06,2260,630,158,788,追分,三等
2020-04-07,2260,360,136,496,追分,三等
2020-04-08,2260,975,136,1111,追分,三等
2020-04-09,2260,1648,141,1789,追分,三等
2020-04-10,2260,477,212,689,追分,三等
2020-04-11,2260,2538,193,2731,追分,三等
2020-04-12,2260,2572,211,2783,追分,三等
2020-04-13,2260,815,172,987,追分,三等
2020-04-14,2260,858,163,1021,追分,三等
2020-04-15,2260,605,164,769,追分,三等
2020-04-16,2260,1466,151,1617,追分,三等
2020-04-17,2260,799,215,1014,追分,三等
2020-04-18,2260,2402,159,2561,追分,三等
2020-04-19,2260,2265,223,2488,追分,三等
2020-04-20,2260,918,161,1079,追分,三等
2020-04-21,2260,1293,151,1444,追分,三等
2020-04-22,2260,1631,144,1775,追分,三等
2020-04-23,2260,765,140,905,追分,三等
2020-04-24,2260,2203,184,2387,追分,三等
2020-04-25,2260,1600,153,1753,追分,三等
2020-04-26,2260,2682,162,2844,追分,三等
2020-04-27,2260,228,168,396,追分,三等
2020-04-28,2260,254,219,473,追分,三等
2020-04-29,2260,2950,149,3099,追分,三等
2020-04-30,2260,1454,191,1645,追分,三等
2020-05-01,2260,1115,198,1313,追分,三等
2020-05-02,2260,2278,202,2480,追分,三等
2020-05-03,2260,2397,202,2599,追分,三等
2020-05-04,2260,1217,163,1380,追分,三等
2020-05-05,2260,923,166,1089,追分,三等
2020-05-06,2260,1653,186,1839,追分,三等
2020-05-07,2260,1041,148,1189,追分,三等
2020-05-08,2260,1699,299,1998,追分,三等
2020-05-09,2260,1878,227,2105,追分,三等
2020-05-10,2260,1263,252,1515,追分,三等
2020-05-11,2260,326,170,496,追分,三等
2020-05-12,2260,747,157,904,追分,三等
2020-05-13,2260,398,155,553,追分,三等
2020-05-14,2260,305,154,459,追分,三等
2020-05-15,2260,549,219,768,追分,三等
2020-05-16,2260,602,178,780,追分,三等
2020-05-17,2260,523,272,795,追分,三等
2020-05-18,2260,219,163,382,追分,三等
2020-05-19,2260,266,139,405,追分,三等
2020-05-20,2260,1137,207,1344,追分,三等
2020-05-21,2260,314,152,466,追分,三等
2020-05-22,2260,163,196,359,追分,三等
2020-05-23,2260,354,151,505,追分,三等
2020-05-24,2260,493,270,763,追分,三等
2020-05-25,2260,281,192,473,追分,三等
2020-05-26,2260,197,153,350,追分,三等
2020-05-27,2260,193,133,326,追分,三等
2020-05-28,2260,225,158,383,追分,三等
2020-05-29,2260,273,230,503,追分,三等
2020-05-30,2260,494,284,778,追分,三等
2020-05-31,2260,401,268,669,追分,三等
2020-06-01,2260,215,170,385,追分,三等
2020-06-02,2260,275,147,422,追分,三等
2020-06-03,2260,222,159,381,追分,三等
2020-06-04,2260,439,167,606,追分,三等
2020-06-05,2260,293,202,495,追分,三等
2020-06-06,2260,518,172,690,追分,三等
2020-06-07,2260,1182,233,1415,追分,三等
2020-06-08,2260,189,161,350,追分,三等
2020-06-09,2260,239,143,382,追分,三等
2020-06-10,2260,369,185,554,追分,三等
2020-06-11,2260,327,217,544,追分,三等
2020-06-12,2260,485,467,952,追分,三等
2020-06-13,2260,472,272,744,追分,三等
2020-06-14,2260,440,294,734,追分,三等
2020-06-15,2260,232,193,425,追分,三等
2020-06-16,2260,525,174,699,追分,三等
2020-06-17,2260,313,150,463,追分,三等
2020-06-18,2260,331,179,510,追分,三等
2020-06-19,2260,368,233,601,追分,三等
2020-06-20,2260,975,430,1405,追分,三等
2020-06-21,2260,390,274,664,追分,三等
2020-06-22,2260,200,169,369,追分,三等
2020-06-23,2260,301,176,477,追分,三等
2020-06-24,2260,215,237,452,追分,三等
2020-06-25,2260,718,241,959,追分,三等
2020-06-26,2260,427,257,684,追分,三等
2020-06-27,2260,408,269,677,追分,三等
2020-06-28,2260,483,308,791,追分,三等
2020-06-29,2260,273,194,467,追分,三等
2020-06-30,2260,195,155,350,追分,三等
2020-07-01,2260,688,197,885,追分,三等
2020-07-02,2260,146,145,291,追分,三等
2020-07-03,2260,250,229,479,追分,三等
2020-07-04,2260,469,193,662,追分,三等
2020-07-05,2260,313,345,658,追分,三等
2020-07-06,2260,866,326,1192,追分,三等
2020-07-07,2260,265,177,442,追分,三等
2020-07-08,2260,168,145,313,追分,三等
2020-07-09,2260,174,162,336,追分,三等
2020-07-10,2260,282,199,481,追分,三等
2020-07-11,2260,992,955,1947,追分,三等
2020-07-12,2260,507,406,913,追分,三等
2020-07-13,2260,300,270,570,追分,三等
2020-07-14,2260,260,194,454,追分,三等
2020-07-15,2260,160,120,280,追分,三等
2020-07-16,2260,231,153,384,追分,三等
2020-07-17,2260,279,349,628,追分,三等
2020-07-18,2260,393,211,604,追分,三等
2020-07-19,2260,620,316,936,追分,三等
2020-07-20,2260,245,163,408,追分,三等
2020-07-21,2260,240,165,405,追分,三等
2020-07-22,2260,174,164,338,追分,三等
2020-07-23,2260,337,184,521,追分,三等
2020-07-24,2260,802,216,1018,追分,三等
2020-07-25,2260,317,225,542,追分,三等
2020-07-26,2260,330,304,634,追分,三等
2020-07-27,2260,180,156,336,追分,三等
2020-07-28,2260,214,145,359,追分,三等
2020-07-29,2260,225,133,358,追分,三等
2020-07-30,2260,171,159,330,追分,三等
2020-07-31,2260,283,220,503,追分,三等
2020-08-01,2260,225,181,406,追分,三等
2020-08-02,2260,401,281,682,追分,三等
2020-08-03,2260,188,146,334,追分,三等
2020-08-04,2260,703,126,829,追分,三等
2020-08-05,2260,400,136,536,追分,三等
2020-08-06,2260,162,142,304,追分,三等
2020-08-07,2260,260,175,435,追分,三等
2020-08-08,2260,405,378,783,追分,三等
2020-08-09,2260,345,324,669,追分,三等
2020-08-10,2260,167,150,317,追分,三等
2020-08-11,2260,191,143,334,追分,三等
2020-08-12,2260,149,131,280,追分,三等
2020-08-13,2260,158,136,294,追分,三等
2020-08-14,2260,212,184,396,追分,三等
2020-08-15,2260,299,349,648,追分,三等
2020-08-16,2260,465,370,835,追分,三等
2020-08-17,2260,266,173,439,追分,三等
2020-08-18,2260,277,152,429,追分,三等
2020-08-19,2260,161,149,310,追分,三等
2020-08-20,2260,166,36,202,追分,三等
2020-08-21,2260,289,42,331,追分,三等
2020-08-22,2260,393,96,489,追分,三等
2020-08-23,2260,379,66,445,追分,三等
2020-08-24,2260,255,51,306,追分,三等
2020-08-25,2260,532,38,570,追分,三等
2020-08-26,2260,172,25,197,追分,三等
2020-08-27,2260,187,75,262,追分,三等
2020-08-28,2260,219,30,249,追分,三等
2020-08-29,2260,239,67,306,追分,三等
2020-08-30,2260,314,41,355,追分,三等
2020-08-31,2260,144,67,211,追分,三等
2020-09-01,2260,168,142,310,追分,三等
2020-09-02,2260,155,142,297,追分,三等
2020-09-03,2260,167,151,318,追分,三等
2020-09-04,2260,215,196,411,追分,三等
2020-09-05,2260,1608,162,1770,追分,三等
2020-09-06,2260,247,247,494,追分,三等
2020-09-07,2260,170,165,335,追分,三等
2020-09-08,2260,179,154,333,追分,三等
2020-09-09,2260,470,186,656,追分,三等
2020-09-10,2260,184,167,351,追分,三等
2020-09-11,2260,187,210,397,追分,三等
2020-09-12,2260,893,220,1113,追分,三等
2020-09-13,2260,387,313,700,追分,三等
2020-09-14,2260,178,189,367,追分,三等
2020-09-15,2260,372,139,511,追分,三等
2020-09-16,2260,169,149,318,追分,三等
2020-09-17,2260,172,157,329,追分,三等
2020-09-18,2260,181,195,376,追分,三等
2020-09-19,2260,371,204,575,追分,三等
2020-09-20,2260,286,258,544,追分,三等
2020-09-21,2260,186,157,343,追分,三等
2020-09-22,2260,182,159,341,追分,三等
2020-09-23,2260,202,162,364,追分,三等
2020-09-24,2260,420,190,610,追分,三等
2020-09-25,2260,209,184,393,追分,三等
2020-09-26,2260,196,181,377,追分,三等
2020-09-27,2260,318,280,598,追分,三等
2020-09-28,2260,185,177,362,追分,三等
2020-09-29,2260,241,142,383,追分,三等
2020-09-30,2260,191,257,448,追分,三等
2020-10-01,2260,438,232,670,追分,三等
2020-10-02,2260,732,311,1043,追分,三等
2020-10-03,2260,401,272,673,追分,三等
2020-10-04,2260,321,234,555,追分,三等
2020-10-05,2260,796,160,956,追分,三等
2020-10-06,2260,1290,164,1454,追分,三等
2020-10-07,2260,278,151,429,追分,三等
2020-10-08,2260,279,217,496,追分,三等
2020-10-09,2260,529,249,778,追分,三等
2020-10-10,2260,944,315,1259,追分,三等
2020-10-11,2260,348,281,629,追分,三等
2020-10-12,2260,199,163,362,追分,三等
2020-10-13,2260,275,149,424,追分,三等
2020-10-14,2260,624,161,785,追分,三等
2020-10-15,2260,198,167,365,追分,三等
2020-10-16,2260,192,216,408,追分,三等
2020-10-17,2260,896,318,1214,追分,三等
2020-10-18,2260,487,307,794,追分,三等
2020-10-19,2260,172,165,337,追分,三等
2020-10-20,2260,2039,158,2197,追分,三等
2020-10-21,2260,397,176,573,追分,三等
2020-10-22,2260,765,158,923,追分,三等
2020-10-23,2260,154,226,380,追分,三等
2020-10-24,2260,488,257,745,追分,三等
2020-10-25,2260,345,276,621,追分,三等
2020-10-26,2260,197,157,354,追分,三等
2020-10-27,2260,155,144,299,追分,三等
2020-10-28,2260,175,157,332,追分,三等
2020-10-29,2260,407,175,582,追分,三等
2020-10-30,2260,193,208,401,追分,三等
2020-10-31,2260,277,215,492,追分,三等
2020-11-01,2260,655,241,896,追分,三等
2020-11-02,2260,183,170,353,追分,三等
2020-11-03,2260,195,165,360,追分,三等
2020-11-04,2260,165,153,318,追分,三等
2020-11-05,2260,971,155,1126,追分,三等
2020-11-06,2260,207,268,475,追分,三等
2020-11-07,2260,628,210,838,追分,三等
2020-11-08,2260,409,264,673,追分,三等
2020-11-09,2260,326,146,472,追分,三等
2020-11-10,2260,181,206,387,追分,三等
2020-11-11,2260,321,192,513,追分,三等
2020-11-12,2260,332,146,478,追分,三等
2020-11-13,2260,705,249,954,追分,三等
2020-11-14,2260,486,277,763,追分,三等
2020-11-15,2260,445,414,859,追分,三等
2020-11-16,2260,196,166,362,追分,三等
2020-11-17,2260,282,170,452,追分,三等
2020-11-18,2260,265,169,434,追分,三等
2020-11-19,2260,438,183,621,追分,三等
2020-11-20,2260,343,208,551,追分,三等
2020-11-21,2260,860,229,1089,追分,三等
2020-11-22,2260,583,328,911,追分,三等
2020-11-23,2260,228,160,388,追分,三等
2020-11-24,2260,190,158,348,追分,三等
2020-11-25,2260,182,181,363,追分,三等
2020-11-26,2260,548,153,701,追分,三等
2020-11-27,2260,298,238,536,追分,三等
2020-11-28,2260,930,236,1166,追分,三等
2020-11-29,2260,608,226,834,追分,三等
2020-11-30,2260,653,169,822,追分,三等
2020-12-01,2260,1057,161,1218,追分,三等
2020-12-02,2260,329,167,496,追分,三等
2020-12-03,2260,459,159,618,追分,三等
2020-12-04,2260,236,205,441,追分,三等
2020-12-05,2260,758,270,1028,追分,三等
2020-12-06,2260,798,255,1053,追分,三等
2020-12-07,2260,556,208,764,追分,三等
2020-12-08,2260,793,208,1001,追分,三等
2020-12-09,2260,658,150,808,追分,三等
2020-12-10,2260,666,150,816,追分,三等
2020-12-11,2260,694,224,918,追分,三等
2020-12-12,2260,976,321,1297,追分,三等
2020-12-13,2260,696,359,1055,追分,三等
2020-12-14,2260,1167,198,1365,追分,三等
2020-12-15,2260,310,204,514,追分,三等
2020-12-16,2260,540,164,704,追分,三等
2020-12-17,2260,250,184,434,追分,三等
2020-12-18,2260,600,240,840,追分,三等
2020-12-19,2260,1078,251,1329,追分,三等
2020-12-20,2260,1719,306,2025,追分,三等
2020-12-21,2260,772,152,924,追分,三等
2020-12-22,2260,887,176,1063,追分,三等
2020-12-23,2260,579,142,721,追分,三等
2020-12-24,2260,617,149,766,追分,三等
2020-12-25,2260,987,347,1334,追分,三等
2020-12-26,2260,991,246,1237,追分,三等
2020-12-27,2260,856,256,1112,追分,三等
2020-12-28,2260,828,277,1105,追分,三等
2020-12-29,2260,957,195,1152,追分,三等
2020-12-30,2260,931,151,1082,追分,三等
2020-12-31,2260,1286,246,1532,追分,三等
2020-01-01,3140,278,294,572,造橋,招呼
2020-01-02,3140,309,356,665,造橋,招呼
2020-01-03,3140,390,439,829,造橋,招呼
2020-01-04,3140,306,384,690,造橋,招呼
2020-01-05,3140,331,322,653,造橋,招呼
2020-01-06,3140,358,368,726,造橋,招呼
2020-01-07,3140,350,407,757,造橋,招呼
2020-01-08,3140,349,381,730,造橋,招呼
2020-01-09,3140,320,372,692,造橋,招呼
2020-01-10,3140,391,532,923,造橋,招呼
2020-01-11,3140,368,412,780,造橋,招呼
2020-01-12,3140,386,336,722,造橋,招呼
2020-01-13,3140,328,354,682,造橋,招呼
2020-01-14,3140,351,399,750,造橋,招呼
2020-01-15,3140,320,342,662,造橋,招呼
2020-01-16,3140,350,403,753,造橋,招呼
2020-01-17,3140,329,368,697,造橋,招呼
2020-01-18,3140,324,309,633,造橋,招呼
2020-01-19,3140,265,300,565,造橋,招呼
2020-01-20,3140,298,334,632,造橋,招呼
2020-01-21,3140,331,350,681,造橋,招呼
2020-01-22,3140,335,436,771,造橋,招呼
2020-01-23,3140,232,336,568,造橋,招呼
2020-01-24,3140,237,300,537,造橋,招呼
2020-01-25,3140,282,301,583,造橋,招呼
2020-01-26,3140,287,342,629,造橋,招呼
2020-01-27,3140,285,321,606,造橋,招呼
2020-01-28,3140,248,280,528,造橋,招呼
2020-01-29,3140,318,267,585,造橋,招呼
2020-01-30,3140,227,268,495,造橋,招呼
2020-01-31,3140,273,293,566,造橋,招呼
2020-02-01,3140,239,267,506,造橋,招呼
2020-02-02,3140,277,282,559,造橋,招呼
2020-02-03,3140,262,273,535,造橋,招呼
2020-02-04,3140,258,267,525,造橋,招呼
2020-02-05,3140,263,277,540,造橋,招呼
2020-02-06,3140,286,293,579,造橋,招呼
2020-02-07,3140,284,330,614,造橋,招呼
2020-02-08,3140,232,276,508,造橋,招呼
2020-02-09,3140,306,259,565,造橋,招呼
2020-02-10,3140,294,307,601,造橋,招呼
2020-02-11,3140,309,312,621,造橋,招呼
2020-02-12,3140,304,314,618,造橋,招呼
2020-02-13,3140,263,267,530,造橋,招呼
2020-02-14,3140,292,338,630,造橋,招呼
2020-02-15,3140,256,341,597,造橋,招呼
2020-02-16,3140,225,195,420,造橋,招呼
2020-02-17,3140,279,271,550,造橋,招呼
2020-02-18,3140,319,306,625,造橋,招呼
2020-02-19,3140,289,302,591,造橋,招呼
2020-02-20,3140,261,275,536,造橋,招呼
2020-02-21,3140,294,324,618,造橋,招呼
2020-02-22,3140,259,271,530,造橋,招呼
2020-02-23,3140,253,240,493,造橋,招呼
2020-02-24,3140,260,294,554,造橋,招呼
2020-02-25,3140,334,347,681,造橋,招呼
2020-02-26,3140,326,350,676,造橋,招呼
2020-02-27,3140,341,397,738,造橋,招呼
2020-02-28,3140,258,295,553,造橋,招呼
2020-02-29,3140,206,249,455,造橋,招呼
2020-03-01,3140,258,221,479,造橋,招呼
2020-03-02,3140,322,333,655,造橋,招呼
2020-03-03,3140,300,335,635,造橋,招呼
2020-03-04,3140,312,344,656,造橋,招呼
2020-03-05,3140,312,348,660,造橋,招呼
2020-03-06,3140,347,446,793,造橋,招呼
2020-03-07,3140,256,287,543,造橋,招呼
2020-03-08,3140,296,259,555,造橋,招呼
2020-03-09,3140,340,359,699,造橋,招呼
2020-03-10,3140,288,322,610,造橋,招呼
2020-03-11,3140,318,377,695,造橋,招呼
2020-03-12,3140,309,342,651,造橋,招呼
2020-03-13,3140,324,426,750,造橋,招呼
2020-03-14,3140,198,233,431,造橋,招呼
2020-03-15,3140,313,252,565,造橋,招呼
2020-03-16,3140,310,322,632,造橋,招呼
2020-03-17,3140,302,332,634,造橋,招呼
2020-03-18,3140,319,336,655,造橋,招呼
2020-03-19,3140,284,311,595,造橋,招呼
2020-03-20,3140,317,400,717,造橋,招呼
2020-03-21,3140,175,217,392,造橋,招呼
2020-03-22,3140,228,185,413,造橋,招呼
2020-03-23,3140,307,335,642,造橋,招呼
2020-03-24,3140,315,337,652,造橋,招呼
2020-03-25,3140,291,328,619,造橋,招呼
2020-03-26,3140,278,347,625,造橋,招呼
2020-03-27,3140,281,382,663,造橋,招呼
2020-03-28,3140,178,222,400,造橋,招呼
2020-03-29,3140,209,195,404,造橋,招呼
2020-03-30,3140,294,317,611,造橋,招呼
2020-03-31,3140,273,327,600,造橋,招呼
2020-04-01,3140,313,416,729,造橋,招呼
2020-04-02,3140,178,221,399,造橋,招呼
2020-04-03,3140,178,211,389,造橋,招呼
2020-04-04,3140,197,210,407,造橋,招呼
2020-04-05,3140,234,171,405,造橋,招呼
2020-04-06,3140,302,297,599,造橋,招呼
2020-04-07,3140,219,317,536,造橋,招呼
2020-04-08,3140,304,349,653,造橋,招呼
2020-04-09,3140,275,331,606,造橋,招呼
2020-04-10,3140,329,383,712,造橋,招呼
2020-04-11,3140,174,203,377,造橋,招呼
2020-04-12,3140,199,186,385,造橋,招呼
2020-04-13,3140,285,309,594,造橋,招呼
2020-04-14,3140,195,329,524,造橋,招呼
2020-04-15,3140,309,355,664,造橋,招呼
2020-04-16,3140,313,341,654,造橋,招呼
2020-04-17,3140,290,393,683,造橋,招呼
2020-04-18,3140,216,250,466,造橋,招呼
2020-04-19,3140,229,195,424,造橋,招呼
2020-04-20,3140,292,320,612,造橋,招呼
2020-04-21,3140,283,318,601,造橋,招呼
2020-04-22,3140,291,333,624,造橋,招呼
2020-04-23,3140,274,309,583,造橋,招呼
2020-04-24,3140,286,358,644,造橋,招呼
2020-04-25,3140,167,211,378,造橋,招呼
2020-04-26,3140,196,175,371,造橋,招呼
2020-04-27,3140,292,312,604,造橋,招呼
2020-04-28,3140,288,325,613,造橋,招呼
2020-04-29,3140,297,334,631,造橋,招呼
2020-04-30,3140,275,347,622,造橋,招呼
2020-05-01,3140,259,377,636,造橋,招呼
2020-05-02,3140,237,253,490,造橋,招呼
2020-05-03,3140,233,188,421,造橋,招呼
2020-05-04,3140,293,317,610,造橋,招呼
2020-05-05,3140,309,336,645,造橋,招呼
2020-05-06,3140,303,340,643,造橋,招呼
2020-05-07,3140,302,363,665,造橋,招呼
2020-05-08,3140,336,460,796,造橋,招呼
2020-05-09,3140,225,304,529,造橋,招呼
2020-05-10,3140,300,215,515,造橋,招呼
2020-05-11,3140,311,341,652,造橋,招呼
2020-05-12,3140,282,333,615,造橋,招呼
2020-05-13,3140,309,345,654,造橋,招呼
2020-05-14,3140,303,343,646,造橋,招呼
2020-05-15,3140,315,402,717,造橋,招呼
2020-05-16,3140,202,244,446,造橋,招呼
2020-05-17,3140,250,216,466,造橋,招呼
2020-05-18,3140,300,300,600,造橋,招呼
2020-05-19,3140,257,304,561,造橋,招呼
2020-05-20,3140,291,337,628,造橋,招呼
2020-05-21,3140,262,290,552,造橋,招呼
2020-05-22,3140,263,317,580,造橋,招呼
2020-05-23,3140,181,224,405,造橋,招呼
2020-05-24,3140,307,253,560,造橋,招呼
2020-05-25,3140,322,353,675,造橋,招呼
2020-05-26,3140,311,345,656,造橋,招呼
2020-05-27,3140,274,331,605,造橋,招呼
2020-05-28,3140,270,319,589,造橋,招呼
2020-05-29,3140,315,407,722,造橋,招呼
2020-05-30,3140,284,305,589,造橋,招呼
2020-05-31,3140,313,277,590,造橋,招呼
2020-06-01,3140,322,328,650,造橋,招呼
2020-06-02,3140,318,347,665,造橋,招呼
2020-06-03,3140,317,347,664,造橋,招呼
2020-06-04,3140,320,358,678,造橋,招呼
2020-06-05,3140,324,415,739,造橋,招呼
2020-06-06,3140,258,314,572,造橋,招呼
2020-06-07,3140,326,276,602,造橋,招呼
2020-06-08,3140,292,304,596,造橋,招呼
2020-06-09,3140,312,330,642,造橋,招呼
2020-06-10,3140,316,343,659,造橋,招呼
2020-06-11,3140,295,346,641,造橋,招呼
2020-06-12,3140,328,413,741,造橋,招呼
2020-06-13,3140,281,307,588,造橋,招呼
2020-06-14,3140,261,250,511,造橋,招呼
2020-06-15,3140,310,361,671,造橋,招呼
2020-06-16,3140,360,373,733,造橋,招呼
2020-06-17,3140,312,340,652,造橋,招呼
2020-06-18,3140,291,339,630,造橋,招呼
2020-06-19,3140,283,347,630,造橋,招呼
2020-06-20,3140,283,332,615,造橋,招呼
2020-06-21,3140,276,263,539,造橋,招呼
2020-06-22,3140,304,336,640,造橋,招呼
2020-06-23,3140,315,330,645,造橋,招呼
2020-06-24,3140,312,383,695,造橋,招呼
2020-06-25,3140,255,316,571,造橋,招呼
2020-06-26,3140,272,309,581,造橋,招呼
2020-06-27,3140,249,281,530,造橋,招呼
2020-06-28,3140,312,248,560,造橋,招呼
2020-06-29,3140,298,313,611,造橋,招呼
2020-06-30,3140,291,311,602,造橋,招呼
2020-07-01,3140,301,318,619,造橋,招呼
2020-07-02,3140,251,317,568,造橋,招呼
2020-07-03,3140,324,360,684,造橋,招呼
2020-07-04,3140,270,257,527,造橋,招呼
2020-07-05,3140,227,246,473,造橋,招呼
2020-07-06,3140,276,317,593,造橋,招呼
2020-07-07,3140,306,320,626,造橋,招呼
2020-07-08,3140,282,325,607,造橋,招呼
2020-07-09,3140,277,315,592,造橋,招呼
2020-07-10,3140,336,368,704,造橋,招呼
2020-07-11,3140,276,289,565,造橋,招呼
2020-07-12,3140,246,233,479,造橋,招呼
2020-07-13,3140,281,305,586,造橋,招呼
2020-07-14,3140,302,331,633,造橋,招呼
2020-07-15,3140,273,293,566,造橋,招呼
2020-07-16,3140,274,301,575,造橋,招呼
2020-07-17,3140,276,300,576,造橋,招呼
2020-07-18,3140,229,260,489,造橋,招呼
2020-07-19,3140,261,249,510,造橋,招呼
2020-07-20,3140,274,289,563,造橋,招呼
2020-07-21,3140,272,279,551,造橋,招呼
2020-07-22,3140,273,288,561,造橋,招呼
2020-07-23,3140,257,273,530,造橋,招呼
2020-07-24,3140,290,321,611,造橋,招呼
2020-07-25,3140,229,239,468,造橋,招呼
2020-07-26,3140,260,254,514,造橋,招呼
2020-07-27,3140,307,336,643,造橋,招呼
2020-07-28,3140,290,315,605,造橋,招呼
2020-07-29,3140,263,269,532,造橋,招呼
2020-07-30,3140,264,294,558,造橋,招呼
2020-07-31,3140,310,318,628,造橋,招呼
2020-08-01,3140,241,291,532,造橋,招呼
2020-08-02,3140,242,195,437,造橋,招呼
2020-08-03,3140,279,289,568,造橋,招呼
2020-08-04,3140,296,309,605,造橋,招呼
2020-08-05,3140,302,321,623,造橋,招呼
2020-08-06,3140,304,343,647,造橋,招呼
2020-08-07,3140,336,406,742,造橋,招呼
2020-08-08,3140,242,270,512,造橋,招呼
2020-08-09,3140,288,238,526,造橋,招呼
2020-08-10,3140,299,297,596,造橋,招呼
2020-08-11,3140,312,322,634,造橋,招呼
2020-08-12,3140,310,330,640,造橋,招呼
2020-08-13,3140,298,332,630,造橋,招呼
2020-08-14,3140,311,327,638,造橋,招呼
2020-08-15,3140,245,267,512,造橋,招呼
2020-08-16,3140,271,268,539,造橋,招呼
2020-08-17,3140,298,317,615,造橋,招呼
2020-08-18,3140,255,293,548,造橋,招呼
2020-08-19,3140,259,267,526,造橋,招呼
2020-08-20,3140,267,290,557,造橋,招呼
2020-08-21,3140,290,357,647,造橋,招呼
2020-08-22,3140,298,326,624,造橋,招呼
2020-08-23,3140,263,251,514,造橋,招呼
2020-08-24,3140,271,277,548,造橋,招呼
2020-08-25,3140,279,308,587,造橋,招呼
2020-08-26,3140,272,259,531,造橋,招呼
2020-08-27,3140,242,264,506,造橋,招呼
2020-08-28,3140,274,318,592,造橋,招呼
2020-08-29,3140,217,284,501,造橋,招呼
2020-08-30,3140,244,215,459,造橋,招呼
2020-08-31,3140,291,306,597,造橋,招呼
2020-09-01,3140,267,298,565,造橋,招呼
2020-09-02,3140,284,323,607,造橋,招呼
2020-09-03,3140,267,272,539,造橋,招呼
2020-09-04,3140,297,345,642,造橋,招呼
2020-09-05,3140,252,271,523,造橋,招呼
2020-09-06,3140,282,279,561,造橋,招呼
2020-09-07,3140,325,336,661,造橋,招呼
2020-09-08,3140,286,324,610,造橋,招呼
2020-09-09,3140,300,346,646,造橋,招呼
2020-09-10,3140,278,314,592,造橋,招呼
2020-09-11,3140,336,396,732,造橋,招呼
2020-09-12,3140,274,318,592,造橋,招呼
2020-09-13,3140,310,270,580,造橋,招呼
2020-09-14,3140,312,298,610,造橋,招呼
2020-09-15,3140,302,324,626,造橋,招呼
2020-09-16,3140,277,281,558,造橋,招呼
2020-09-17,3140,285,315,600,造橋,招呼
2020-09-18,3140,320,429,749,造橋,招呼
2020-09-19,3140,249,290,539,造橋,招呼
2020-09-20,3140,287,257,544,造橋,招呼
2020-09-21,3140,306,355,661,造橋,招呼
2020-09-22,3140,307,328,635,造橋,招呼
2020-09-23,3140,296,321,617,造橋,招呼
2020-09-24,3140,287,332,619,造橋,招呼
2020-09-25,3140,312,358,670,造橋,招呼
2020-09-26,3140,256,324,580,造橋,招呼
2020-09-27,3140,219,194,413,造橋,招呼
2020-09-28,3140,281,294,575,造橋,招呼
2020-09-29,3140,240,331,571,造橋,招呼
2020-09-30,3140,319,457,776,造橋,招呼
2020-10-01,3140,314,436,750,造橋,招呼
2020-10-02,3140,334,333,667,造橋,招呼
2020-10-03,3140,299,300,599,造橋,招呼
2020-10-04,3140,368,259,627,造橋,招呼
2020-10-05,3140,319,337,656,造橋,招呼
2020-10-06,3140,310,344,654,造橋,招呼
2020-10-07,3140,289,327,616,造橋,招呼
2020-10-08,3140,287,405,692,造橋,招呼
2020-10-09,3140,305,368,673,造橋,招呼
2020-10-10,3140,239,277,516,造橋,招呼
2020-10-11,3140,337,250,587,造橋,招呼
2020-10-12,3140,304,302,606,造橋,招呼
2020-10-13,3140,298,330,628,造橋,招呼
2020-10-14,3140,282,325,607,造橋,招呼
2020-10-15,3140,297,314,611,造橋,招呼
2020-10-16,3140,311,400,711,造橋,招呼
2020-10-17,3140,301,340,641,造橋,招呼
2020-10-18,3140,300,277,577,造橋,招呼
2020-10-19,3140,322,335,657,造橋,招呼
2020-10-20,3140,292,319,611,造橋,招呼
2020-10-21,3140,304,326,630,造橋,招呼
2020-10-22,3140,303,326,629,造橋,招呼
2020-10-23,3140,274,347,621,造橋,招呼
2020-10-24,3140,264,327,591,造橋,招呼
2020-10-25,3140,250,229,479,造橋,招呼
2020-10-26,3140,324,343,667,造橋,招呼
2020-10-27,3140,304,332,636,造橋,招呼
2020-10-28,3140,311,352,663,造橋,招呼
2020-10-29,3140,285,312,597,造橋,招呼
2020-10-30,3140,294,404,698,造橋,招呼
2020-10-31,3140,254,306,560,造橋,招呼
2020-11-01,3140,310,244,554,造橋,招呼
2020-11-02,3140,308,316,624,造橋,招呼
2020-11-03,3140,224,321,545,造橋,招呼
2020-11-04,3140,306,328,634,造橋,招呼
2020-11-05,3140,315,344,659,造橋,招呼
2020-11-06,3140,322,441,763,造橋,招呼
2020-11-07,3140,279,347,626,造橋,招呼
2020-11-08,3140,304,272,576,造橋,招呼
2020-11-09,3140,321,328,649,造橋,招呼
2020-11-10,3140,299,320,619,造橋,招呼
2020-11-11,3140,304,323,627,造橋,招呼
2020-11-12,3140,302,308,610,造橋,招呼
2020-11-13,3140,312,395,707,造橋,招呼
2020-11-14,3140,266,341,607,造橋,招呼
2020-11-15,3140,340,284,624,造橋,招呼
2020-11-16,3140,300,328,628,造橋,招呼
2020-11-17,3140,305,332,637,造橋,招呼
2020-11-18,3140,322,358,680,造橋,招呼
2020-11-19,3140,293,371,664,造橋,招呼
2020-11-20,3140,313,407,720,造橋,招呼
2020-11-21,3140,284,332,616,造橋,招呼
2020-11-22,3140,348,322,670,造橋,招呼
2020-11-23,3140,305,325,630,造橋,招呼
2020-11-24,3140,301,332,633,造橋,招呼
2020-11-25,3140,312,343,655,造橋,招呼
2020-11-26,3140,320,323,643,造橋,招呼
2020-11-27,3140,252,442,694,造橋,招呼
2020-11-28,3140,295,335,630,造橋,招呼
2020-11-29,3140,286,253,539,造橋,招呼
2020-11-30,3140,318,349,667,造橋,招呼
2020-12-01,3140,295,344,639,造橋,招呼
2020-12-02,3140,307,322,629,造橋,招呼
2020-12-03,3140,265,322,587,造橋,招呼
2020-12-04,3140,301,417,718,造橋,招呼
2020-12-05,3140,298,345,643,造橋,招呼
2020-12-06,3140,319,291,610,造橋,招呼
2020-12-07,3140,311,316,627,造橋,招呼
2020-12-08,3140,289,316,605,造橋,招呼
2020-12-09,3140,281,317,598,造橋,招呼
2020-12-10,3140,283,321,604,造橋,招呼
2020-12-11,3140,307,412,719,造橋,招呼
2020-12-12,3140,294,372,666,造橋,招呼
2020-12-13,3140,305,310,615,造橋,招呼
2020-12-14,3140,320,316,636,造橋,招呼
2020-12-15,3140,276,289,565,造橋,招呼
2020-12-16,3140,323,347,670,造橋,招呼
2020-12-17,3140,294,339,633,造橋,招呼
2020-12-18,3140,314,401,715,造橋,招呼
2020-12-19,3140,249,334,583,造橋,招呼
2020-12-20,3140,292,275,567,造橋,招呼
2020-12-21,3140,287,302,589,造橋,招呼
2020-12-22,3140,326,351,677,造橋,招呼
2020-12-23,3140,261,308,569,造橋,招呼
2020-12-24,3140,274,326,600,造橋,招呼
2020-12-25,3140,321,418,739,造橋,招呼
2020-12-26,3140,295,337,632,造橋,招呼
2020-12-27,3140,279,256,535,造橋,招呼
2020-12-28,3140,301,322,623,造橋,招呼
2020-12-29,3140,301,340,641,造橋,招呼
2020-12-30,3140,256,304,560,造橋,招呼
2020-12-31,3140,301,378,679,造橋,招呼
2020-01-01,3150,882,804,1686,豐富,簡易
2020-01-02,3150,694,707,1401,豐富,簡易
2020-01-03,3150,937,957,1894,豐富,簡易
2020-01-04,3150,846,847,1693,豐富,簡易
2020-01-05,3150,841,863,1704,豐富,簡易
2020-01-06,3150,652,754,1406,豐富,簡易
2020-01-07,3150,681,742,1423,豐富,簡易
2020-01-08,3150,659,726,1385,豐富,簡易
2020-01-09,3150,714,802,1516,豐富,簡易
2020-01-10,3150,1406,1357,2763,豐富,簡易
2020-01-11,3150,1251,1216,2467,豐富,簡易
2020-01-12,3150,1187,1004,2191,豐富,簡易
2020-01-13,3150,796,804,1600,豐富,簡易
2020-01-14,3150,698,736,1434,豐富,簡易
2020-01-15,3150,614,700,1314,豐富,簡易
2020-01-16,3150,757,798,1555,豐富,簡易
2020-01-17,3150,806,849,1655,豐富,簡易
2020-01-18,3150,836,837,1673,豐富,簡易
2020-01-19,3150,779,724,1503,豐富,簡易
2020-01-20,3150,802,797,1599,豐富,簡易
2020-01-21,3150,768,770,1538,豐富,簡易
2020-01-22,3150,1089,1049,2138,豐富,簡易
2020-01-23,3150,972,859,1831,豐富,簡易
2020-01-24,3150,738,651,1389,豐富,簡易
2020-01-25,3150,804,766,1570,豐富,簡易
2020-01-26,3150,925,786,1711,豐富,簡易
2020-01-27,3150,1060,1022,2082,豐富,簡易
2020-01-28,3150,1019,962,1981,豐富,簡易
2020-01-29,3150,981,829,1810,豐富,簡易
2020-01-30,3150,684,719,1403,豐富,簡易
2020-01-31,3150,711,677,1388,豐富,簡易
2020-02-01,3150,646,646,1292,豐富,簡易
2020-02-02,3150,729,650,1379,豐富,簡易
2020-02-03,3150,674,642,1316,豐富,簡易
2020-02-04,3150,580,547,1127,豐富,簡易
2020-02-05,3150,595,561,1156,豐富,簡易
2020-02-06,3150,628,575,1203,豐富,簡易
2020-02-07,3150,907,871,1778,豐富,簡易
2020-02-08,3150,949,889,1838,豐富,簡易
2020-02-09,3150,985,1047,2032,豐富,簡易
2020-02-10,3150,695,707,1402,豐富,簡易
2020-02-11,3150,641,667,1308,豐富,簡易
2020-02-12,3150,669,704,1373,豐富,簡易
2020-02-13,3150,568,621,1189,豐富,簡易
2020-02-14,3150,802,771,1573,豐富,簡易
2020-02-15,3150,870,806,1676,豐富,簡易
2020-02-16,3150,709,702,1411,豐富,簡易
2020-02-17,3150,639,637,1276,豐富,簡易
2020-02-18,3150,582,643,1225,豐富,簡易
2020-02-19,3150,686,727,1413,豐富,簡易
2020-02-20,3150,648,670,1318,豐富,簡易
2020-02-21,3150,894,875,1769,豐富,簡易
2020-02-22,3150,937,895,1832,豐富,簡易
2020-02-23,3150,870,922,1792,豐富,簡易
2020-02-24,3150,640,657,1297,豐富,簡易
2020-02-25,3150,579,621,1200,豐富,簡易
2020-02-26,3150,555,629,1184,豐富,簡易
2020-02-27,3150,844,978,1822,豐富,簡易
2020-02-28,3150,827,807,1634,豐富,簡易
2020-02-29,3150,666,653,1319,豐富,簡易
2020-03-01,3150,1043,889,1932,豐富,簡易
2020-03-02,3150,634,685,1319,豐富,簡易
2020-03-03,3150,549,609,1158,豐富,簡易
2020-03-04,3150,541,592,1133,豐富,簡易
2020-03-05,3150,554,532,1086,豐富,簡易
2020-03-06,3150,1046,871,1917,豐富,簡易
2020-03-07,3150,589,625,1214,豐富,簡易
2020-03-08,3150,719,794,1513,豐富,簡易
2020-03-09,3150,644,680,1324,豐富,簡易
2020-03-10,3150,542,540,1082,豐富,簡易
2020-03-11,3150,565,613,1178,豐富,簡易
2020-03-12,3150,588,595,1183,豐富,簡易
2020-03-13,3150,1031,892,1923,豐富,簡易
2020-03-14,3150,562,596,1158,豐富,簡易
2020-03-15,3150,773,797,1570,豐富,簡易
2020-03-16,3150,645,637,1282,豐富,簡易
2020-03-17,3150,510,569,1079,豐富,簡易
2020-03-18,3150,527,571,1098,豐富,簡易
2020-03-19,3150,554,552,1106,豐富,簡易
2020-03-20,3150,972,844,1816,豐富,簡易
2020-03-21,3150,506,516,1022,豐富,簡易
2020-03-22,3150,644,716,1360,豐富,簡易
2020-03-23,3150,584,596,1180,豐富,簡易
2020-03-24,3150,489,533,1022,豐富,簡易
2020-03-25,3150,473,539,1012,豐富,簡易
2020-03-26,3150,486,511,997,豐富,簡易
2020-03-27,3150,849,743,1592,豐富,簡易
2020-03-28,3150,401,391,792,豐富,簡易
2020-03-29,3150,572,486,1058,豐富,簡易
2020-03-30,3150,579,547,1126,豐富,簡易
2020-03-31,3150,528,559,1087,豐富,簡易
2020-04-01,3150,863,897,1760,豐富,簡易
2020-04-02,3150,614,642,1256,豐富,簡易
2020-04-03,3150,503,499,1002,豐富,簡易
2020-04-04,3150,420,438,858,豐富,簡易
2020-04-05,3150,873,783,1656,豐富,簡易
2020-04-06,3150,701,687,1388,豐富,簡易
2020-04-07,3150,463,501,964,豐富,簡易
2020-04-08,3150,471,511,982,豐富,簡易
2020-04-09,3150,486,505,991,豐富,簡易
2020-04-10,3150,836,756,1592,豐富,簡易
2020-04-11,3150,397,422,819,豐富,簡易
2020-04-12,3150,494,550,1044,豐富,簡易
2020-04-13,3150,549,567,1116,豐富,簡易
2020-04-14,3150,454,506,960,豐富,簡易
2020-04-15,3150,477,518,995,豐富,簡易
2020-04-16,3150,526,536,1062,豐富,簡易
2020-04-17,3150,926,781,1707,豐富,簡易
2020-04-18,3150,520,508,1028,豐富,簡易
2020-04-19,3150,645,689,1334,豐富,簡易
2020-04-20,3150,583,619,1202,豐富,簡易
2020-04-21,3150,459,481,940,豐富,簡易
2020-04-22,3150,457,511,968,豐富,簡易
2020-04-23,3150,476,504,980,豐富,簡易
2020-04-24,3150,727,725,1452,豐富,簡易
2020-04-25,3150,426,458,884,豐富,簡易
2020-04-26,3150,530,520,1050,豐富,簡易
2020-04-27,3150,575,584,1159,豐富,簡易
2020-04-28,3150,481,561,1042,豐富,簡易
2020-04-29,3150,525,522,1047,豐富,簡易
2020-04-30,3150,804,694,1498,豐富,簡易
2020-05-01,3150,823,781,1604,豐富,簡易
2020-05-02,3150,499,527,1026,豐富,簡易
2020-05-03,3150,815,778,1593,豐富,簡易
2020-05-04,3150,595,621,1216,豐富,簡易
2020-05-05,3150,479,523,1002,豐富,簡易
2020-05-06,3150,473,537,1010,豐富,簡易
2020-05-07,3150,558,566,1124,豐富,簡易
2020-05-08,3150,1070,958,2028,豐富,簡易
2020-05-09,3150,703,604,1307,豐富,簡易
2020-05-10,3150,952,840,1792,豐富,簡易
2020-05-11,3150,640,648,1288,豐富,簡易
2020-05-12,3150,517,585,1102,豐富,簡易
2020-05-13,3150,542,536,1078,豐富,簡易
2020-05-14,3150,511,569,1080,豐富,簡易
2020-05-15,3150,933,865,1798,豐富,簡易
2020-05-16,3150,554,578,1132,豐富,簡易
2020-05-17,3150,706,660,1366,豐富,簡易
2020-05-18,3150,629,618,1247,豐富,簡易
2020-05-19,3150,472,479,951,豐富,簡易
2020-05-20,3150,521,571,1092,豐富,簡易
2020-05-21,3150,520,524,1044,豐富,簡易
2020-05-22,3150,856,695,1551,豐富,簡易
2020-05-23,3150,497,513,1010,豐富,簡易
2020-05-24,3150,740,741,1481,豐富,簡易
2020-05-25,3150,623,644,1267,豐富,簡易
2020-05-26,3150,505,537,1042,豐富,簡易
2020-05-27,3150,454,492,946,豐富,簡易
2020-05-28,3150,518,519,1037,豐富,簡易
2020-05-29,3150,926,905,1831,豐富,簡易
2020-05-30,3150,733,766,1499,豐富,簡易
2020-05-31,3150,893,806,1699,豐富,簡易
2020-06-01,3150,645,665,1310,豐富,簡易
2020-06-02,3150,499,528,1027,豐富,簡易
2020-06-03,3150,516,557,1073,豐富,簡易
2020-06-04,3150,504,562,1066,豐富,簡易
2020-06-05,3150,1029,945,1974,豐富,簡易
2020-06-06,3150,654,702,1356,豐富,簡易
2020-06-07,3150,858,716,1574,豐富,簡易
2020-06-08,3150,594,619,1213,豐富,簡易
2020-06-09,3150,557,575,1132,豐富,簡易
2020-06-10,3150,524,574,1098,豐富,簡易
2020-06-11,3150,592,601,1193,豐富,簡易
2020-06-12,3150,989,927,1916,豐富,簡易
2020-06-13,3150,742,774,1516,豐富,簡易
2020-06-14,3150,869,796,1665,豐富,簡易
2020-06-15,3150,660,699,1359,豐富,簡易
2020-06-16,3150,635,642,1277,豐富,簡易
2020-06-17,3150,618,611,1229,豐富,簡易
2020-06-18,3150,555,607,1162,豐富,簡易
2020-06-19,3150,845,688,1533,豐富,簡易
2020-06-20,3150,687,695,1382,豐富,簡易
2020-06-21,3150,806,755,1561,豐富,簡易
2020-06-22,3150,631,674,1305,豐富,簡易
2020-06-23,3150,561,630,1191,豐富,簡易
2020-06-24,3150,1164,1114,2278,豐富,簡易
2020-06-25,3150,844,1014,1858,豐富,簡易
2020-06-26,3150,898,795,1693,豐富,簡易
2020-06-27,3150,963,715,1678,豐富,簡易
2020-06-28,3150,1150,928,2078,豐富,簡易
2020-06-29,3150,691,790,1481,豐富,簡易
2020-06-30,3150,604,631,1235,豐富,簡易
2020-07-01,3150,520,579,1099,豐富,簡易
2020-07-02,3150,532,564,1096,豐富,簡易
2020-07-03,3150,806,826,1632,豐富,簡易
2020-07-04,3150,738,646,1384,豐富,簡易
2020-07-05,3150,705,669,1374,豐富,簡易
2020-07-06,3150,701,691,1392,豐富,簡易
2020-07-07,3150,661,686,1347,豐富,簡易
2020-07-08,3150,629,605,1234,豐富,簡易
2020-07-09,3150,623,654,1277,豐富,簡易
2020-07-10,3150,846,850,1696,豐富,簡易
2020-07-11,3150,786,744,1530,豐富,簡易
2020-07-12,3150,828,802,1630,豐富,簡易
2020-07-13,3150,658,686,1344,豐富,簡易
2020-07-14,3150,626,684,1310,豐富,簡易
2020-07-15,3150,646,675,1321,豐富,簡易
2020-07-16,3150,679,668,1347,豐富,簡易
2020-07-17,3150,956,961,1917,豐富,簡易
2020-07-18,3150,788,816,1604,豐富,簡易
2020-07-19,3150,940,815,1755,豐富,簡易
2020-07-20,3150,772,751,1523,豐富,簡易
2020-07-21,3150,663,749,1412,豐富,簡易
2020-07-22,3150,664,733,1397,豐富,簡易
2020-07-23,3150,670,632,1302,豐富,簡易
2020-07-24,3150,864,935,1799,豐富,簡易
2020-07-25,3150,760,807,1567,豐富,簡易
2020-07-26,3150,911,755,1666,豐富,簡易
2020-07-27,3150,775,697,1472,豐富,簡易
2020-07-28,3150,644,636,1280,豐富,簡易
2020-07-29,3150,730,767,1497,豐富,簡易
2020-07-30,3150,652,696,1348,豐富,簡易
2020-07-31,3150,916,922,1838,豐富,簡易
2020-08-01,3150,792,840,1632,豐富,簡易
2020-08-02,3150,906,763,1669,豐富,簡易
2020-08-03,3150,632,656,1288,豐富,簡易
2020-08-04,3150,607,652,1259,豐富,簡易
2020-08-05,3150,674,723,1397,豐富,簡易
2020-08-06,3150,738,741,1479,豐富,簡易
2020-08-07,3150,1010,1012,2022,豐富,簡易
2020-08-08,3150,771,722,1493,豐富,簡易
2020-08-09,3150,1040,841,1881,豐富,簡易
2020-08-10,3150,720,807,1527,豐富,簡易
2020-08-11,3150,620,651,1271,豐富,簡易
2020-08-12,3150,667,657,1324,豐富,簡易
2020-08-13,3150,696,737,1433,豐富,簡易
2020-08-14,3150,931,961,1892,豐富,簡易
2020-08-15,3150,796,794,1590,豐富,簡易
2020-08-16,3150,1052,864,1916,豐富,簡易
2020-08-17,3150,768,753,1521,豐富,簡易
2020-08-18,3150,705,700,1405,豐富,簡易
2020-08-19,3150,649,718,1367,豐富,簡易
2020-08-20,3150,705,753,1458,豐富,簡易
2020-08-21,3150,943,998,1941,豐富,簡易
2020-08-22,3150,809,807,1616,豐富,簡易
2020-08-23,3150,954,782,1736,豐富,簡易
2020-08-24,3150,759,759,1518,豐富,簡易
2020-08-25,3150,696,750,1446,豐富,簡易
2020-08-26,3150,680,677,1357,豐富,簡易
2020-08-27,3150,757,738,1495,豐富,簡易
2020-08-28,3150,899,889,1788,豐富,簡易
2020-08-29,3150,790,839,1629,豐富,簡易
2020-08-30,3150,840,762,1602,豐富,簡易
2020-08-31,3150,706,720,1426,豐富,簡易
2020-09-01,3150,622,657,1279,豐富,簡易
2020-09-02,3150,620,650,1270,豐富,簡易
2020-09-03,3150,631,676,1307,豐富,簡易
2020-09-04,3150,899,965,1864,豐富,簡易
2020-09-05,3150,828,829,1657,豐富,簡易
2020-09-06,3150,906,780,1686,豐富,簡易
2020-09-07,3150,695,717,1412,豐富,簡易
2020-09-08,3150,627,643,1270,豐富,簡易
2020-09-09,3150,679,722,1401,豐富,簡易
2020-09-10,3150,650,668,1318,豐富,簡易
2020-09-11,3150,948,949,1897,豐富,簡易
2020-09-12,3150,779,813,1592,豐富,簡易
2020-09-13,3150,976,828,1804,豐富,簡易
2020-09-14,3150,712,726,1438,豐富,簡易
2020-09-15,3150,596,632,1228,豐富,簡易
2020-09-16,3150,618,705,1323,豐富,簡易
2020-09-17,3150,650,702,1352,豐富,簡易
2020-09-18,3150,971,1093,2064,豐富,簡易
2020-09-19,3150,875,883,1758,豐富,簡易
2020-09-20,3150,1035,818,1853,豐富,簡易
2020-09-21,3150,733,718,1451,豐富,簡易
2020-09-22,3150,612,663,1275,豐富,簡易
2020-09-23,3150,629,675,1304,豐富,簡易
2020-09-24,3150,645,707,1352,豐富,簡易
2020-09-25,3150,763,845,1608,豐富,簡易
2020-09-26,3150,726,816,1542,豐富,簡易
2020-09-27,3150,772,621,1393,豐富,簡易
2020-09-28,3150,671,646,1317,豐富,簡易
2020-09-29,3150,669,717,1386,豐富,簡易
2020-09-30,3150,1353,1232,2585,豐富,簡易
2020-10-01,3150,1206,1192,2398,豐富,簡易
2020-10-02,3150,1048,951,1999,豐富,簡易
2020-10-03,3150,1073,954,2027,豐富,簡易
2020-10-04,3150,1397,1176,2573,豐富,簡易
2020-10-05,3150,727,810,1537,豐富,簡易
2020-10-06,3150,604,673,1277,豐富,簡易
2020-10-07,3150,606,668,1274,豐富,簡易
2020-10-08,3150,1124,1038,2162,豐富,簡易
2020-10-09,3150,893,947,1840,豐富,簡易
2020-10-10,3150,757,782,1539,豐富,簡易
2020-10-11,3150,1171,979,2150,豐富,簡易
2020-10-12,3150,752,776,1528,豐富,簡易
2020-10-13,3150,637,705,1342,豐富,簡易
2020-10-14,3150,629,647,1276,豐富,簡易
2020-10-15,3150,699,723,1422,豐富,簡易
2020-10-16,3150,1095,1066,2161,豐富,簡易
2020-10-17,3150,899,959,1858,豐富,簡易
2020-10-18,3150,1072,986,2058,豐富,簡易
2020-10-19,3150,706,750,1456,豐富,簡易
2020-10-20,3150,669,705,1374,豐富,簡易
2020-10-21,3150,620,703,1323,豐富,簡易
2020-10-22,3150,668,714,1382,豐富,簡易
2020-10-23,3150,991,997,1988,豐富,簡易
2020-10-24,3150,995,885,1880,豐富,簡易
2020-10-25,3150,1048,850,1898,豐富,簡易
2020-10-26,3150,685,874,1559,豐富,簡易
2020-10-27,3150,627,710,1337,豐富,簡易
2020-10-28,3150,632,687,1319,豐富,簡易
2020-10-29,3150,641,706,1347,豐富,簡易
2020-10-30,3150,1145,1063,2208,豐富,簡易
2020-10-31,3150,899,842,1741,豐富,簡易
2020-11-01,3150,1022,936,1958,豐富,簡易
2020-11-02,3150,701,770,1471,豐富,簡易
2020-11-03,3150,591,638,1229,豐富,簡易
2020-11-04,3150,641,681,1322,豐富,簡易
2020-11-05,3150,681,738,1419,豐富,簡易
2020-11-06,3150,1147,1075,2222,豐富,簡易
2020-11-07,3150,853,791,1644,豐富,簡易
2020-11-08,3150,1114,959,2073,豐富,簡易
2020-11-09,3150,722,747,1469,豐富,簡易
2020-11-10,3150,605,712,1317,豐富,簡易
2020-11-11,3150,644,695,1339,豐富,簡易
2020-11-12,3150,704,763,1467,豐富,簡易
2020-11-13,3150,1217,1133,2350,豐富,簡易
2020-11-14,3150,1042,1002,2044,豐富,簡易
2020-11-15,3150,1215,1105,2320,豐富,簡易
2020-11-16,3150,812,823,1635,豐富,簡易
2020-11-17,3150,682,709,1391,豐富,簡易
2020-11-18,3150,667,697,1364,豐富,簡易
2020-11-19,3150,738,780,1518,豐富,簡易
2020-11-20,3150,1110,1068,2178,豐富,簡易
2020-11-21,3150,928,927,1855,豐富,簡易
2020-11-22,3150,1105,930,2035,豐富,簡易
2020-11-23,3150,767,788,1555,豐富,簡易
2020-11-24,3150,685,727,1412,豐富,簡易
2020-11-25,3150,722,754,1476,豐富,簡易
2020-11-26,3150,775,753,1528,豐富,簡易
2020-11-27,3150,1228,1160,2388,豐富,簡易
2020-11-28,3150,988,1043,2031,豐富,簡易
2020-11-29,3150,1139,961,2100,豐富,簡易
2020-11-30,3150,810,780,1590,豐富,簡易
2020-12-01,3150,592,673,1265,豐富,簡易
2020-12-02,3150,659,683,1342,豐富,簡易
2020-12-03,3150,657,759,1416,豐富,簡易
2020-12-04,3150,1230,1039,2269,豐富,簡易
2020-12-05,3150,978,999,1977,豐富,簡易
2020-12-06,3150,1094,973,2067,豐富,簡易
2020-12-07,3150,734,759,1493,豐富,簡易
2020-12-08,3150,597,674,1271,豐富,簡易
2020-12-09,3150,548,575,1123,豐富,簡易
2020-12-10,3150,637,698,1335,豐富,簡易
2020-12-11,3150,1208,1088,2296,豐富,簡易
2020-12-12,3150,982,1027,2009,豐富,簡易
2020-12-13,3150,1261,1017,2278,豐富,簡易
2020-12-14,3150,711,743,1454,豐富,簡易
2020-12-15,3150,638,709,1347,豐富,簡易
2020-12-16,3150,617,655,1272,豐富,簡易
2020-12-17,3150,697,714,1411,豐富,簡易
2020-12-18,3150,1201,1112,2313,豐富,簡易
2020-12-19,3150,980,1079,2059,豐富,簡易
2020-12-20,3150,1252,1023,2275,豐富,簡易
2020-12-21,3150,731,777,1508,豐富,簡易
2020-12-22,3150,634,697,1331,豐富,簡易
2020-12-23,3150,622,616,1238,豐富,簡易
2020-12-24,3150,658,746,1404,豐富,簡易
2020-12-25,3150,1125,1075,2200,豐富,簡易
2020-12-26,3150,789,840,1629,豐富,簡易
2020-12-27,3150,1079,882,1961,豐富,簡易
2020-12-28,3150,712,769,1481,豐富,簡易
2020-12-29,3150,649,732,1381,豐富,簡易
2020-12-30,3150,656,696,1352,豐富,簡易
2020-12-31,3150,1175,1288,2463,豐富,簡易
2020-01-01,3160,5454,6106,11560,苗栗,一等
2020-01-02,3160,5617,5640,11257,苗栗,一等
2020-01-03,3160,6696,6822,13518,苗栗,一等
2020-01-04,3160,6021,6097,12118,苗栗,一等
2020-01-05,3160,5731,5115,10846,苗栗,一等
2020-01-06,3160,5768,5613,11381,苗栗,一等
2020-01-07,3160,5618,5408,11026,苗栗,一等
2020-01-08,3160,5598,5559,11157,苗栗,一等
2020-01-09,3160,5845,5729,11574,苗栗,一等
2020-01-10,3160,8018,8642,16660,苗栗,一等
2020-01-11,3160,6327,6700,13027,苗栗,一等
2020-01-12,3160,6806,5415,12221,苗栗,一等
2020-01-13,3160,6274,5983,12257,苗栗,一等
2020-01-14,3160,5847,5664,11511,苗栗,一等
2020-01-15,3160,5883,5815,11698,苗栗,一等
2020-01-16,3160,6706,6456,13162,苗栗,一等
2020-01-17,3160,6193,6409,12602,苗栗,一等
2020-01-18,3160,5403,5732,11135,苗栗,一等
2020-01-19,3160,5163,4615,9778,苗栗,一等
2020-01-20,3160,5690,5645,11335,苗栗,一等
2020-01-21,3160,5492,5605,11097,苗栗,一等
2020-01-22,3160,5965,6624,12589,苗栗,一等
2020-01-23,3160,4036,5802,9838,苗栗,一等
2020-01-24,3160,3329,4964,8293,苗栗,一等
2020-01-25,3160,4531,4375,8906,苗栗,一等
2020-01-26,3160,4781,4639,9420,苗栗,一等
2020-01-27,3160,6156,5368,11524,苗栗,一等
2020-01-28,3160,5782,4826,10608,苗栗,一等
2020-01-29,3160,5442,4269,9711,苗栗,一等
2020-01-30,3160,4928,4796,9724,苗栗,一等
2020-01-31,3160,5127,5402,10529,苗栗,一等
2020-02-01,3160,3977,4282,8259,苗栗,一等
2020-02-02,3160,4334,3782,8116,苗栗,一等
2020-02-03,3160,4857,4852,9709,苗栗,一等
2020-02-04,3160,4480,4441,8921,苗栗,一等
2020-02-05,3160,4685,4805,9490,苗栗,一等
2020-02-06,3160,5030,4888,9918,苗栗,一等
2020-02-07,3160,5407,6376,11783,苗栗,一等
2020-02-08,3160,4216,5722,9938,苗栗,一等
2020-02-09,3160,6024,4527,10551,苗栗,一等
2020-02-10,3160,5010,4854,9864,苗栗,一等
2020-02-11,3160,4728,4655,9383,苗栗,一等
2020-02-12,3160,4867,4817,9684,苗栗,一等
2020-02-13,3160,4364,4418,8782,苗栗,一等
2020-02-14,3160,5189,5686,10875,苗栗,一等
2020-02-15,3160,4670,5596,10266,苗栗,一等
2020-02-16,3160,4510,3813,8323,苗栗,一等
2020-02-17,3160,4667,4600,9267,苗栗,一等
2020-02-18,3160,4495,4366,8861,苗栗,一等
2020-02-19,3160,5074,5090,10164,苗栗,一等
2020-02-20,3160,4597,4724,9321,苗栗,一等
2020-02-21,3160,5392,6063,11455,苗栗,一等
2020-02-22,3160,4321,5042,9363,苗栗,一等
2020-02-23,3160,5346,4538,9884,苗栗,一等
2020-02-24,3160,4877,5125,10002,苗栗,一等
2020-02-25,3160,5187,5065,10252,苗栗,一等
2020-02-26,3160,5286,5150,10436,苗栗,一等
2020-02-27,3160,7467,6730,14197,苗栗,一等
2020-02-28,3160,5125,5710,10835,苗栗,一等
2020-02-29,3160,4372,4346,8718,苗栗,一等
2020-03-01,3160,5541,5002,10543,苗栗,一等
2020-03-02,3160,5194,5192,10386,苗栗,一等
2020-03-03,3160,4857,4670,9527,苗栗,一等
2020-03-04,3160,4781,4725,9506,苗栗,一等
2020-03-05,3160,4745,4589,9334,苗栗,一等
2020-03-06,3160,6918,6789,13707,苗栗,一等
2020-03-07,3160,3854,4404,8258,苗栗,一等
2020-03-08,3160,5075,4578,9653,苗栗,一等
2020-03-09,3160,5239,5059,10298,苗栗,一等
2020-03-10,3160,4436,4254,8690,苗栗,一等
2020-03-11,3160,4947,4841,9788,苗栗,一等
2020-03-12,3160,4976,4790,9766,苗栗,一等
2020-03-13,3160,7188,6901,14089,苗栗,一等
2020-03-14,3160,3792,4364,8156,苗栗,一等
2020-03-15,3160,5516,4991,10507,苗栗,一等
2020-03-16,3160,5276,5237,10513,苗栗,一等
2020-03-17,3160,4863,4716,9579,苗栗,一等
2020-03-18,3160,4695,4574,9269,苗栗,一等
2020-03-19,3160,4707,4492,9199,苗栗,一等
2020-03-20,3160,6878,6576,13454,苗栗,一等
2020-03-21,3160,3437,3868,7305,苗栗,一等
2020-03-22,3160,4419,4050,8469,苗栗,一等
2020-03-23,3160,4899,4775,9674,苗栗,一等
2020-03-24,3160,4541,4378,8919,苗栗,一等
2020-03-25,3160,4486,4284,8770,苗栗,一等
2020-03-26,3160,4564,4447,9011,苗栗,一等
2020-03-27,3160,6165,6096,12261,苗栗,一等
2020-03-28,3160,2746,3228,5974,苗栗,一等
2020-03-29,3160,3922,3335,7257,苗栗,一等
2020-03-30,3160,4715,4573,9288,苗栗,一等
2020-03-31,3160,4529,4548,9077,苗栗,一等
2020-04-01,3160,6670,6268,12938,苗栗,一等
2020-04-02,3160,3615,4041,7656,苗栗,一等
2020-04-03,3160,3203,3577,6780,苗栗,一等
2020-04-04,3160,2880,2597,5477,苗栗,一等
2020-04-05,3160,4539,3246,7785,苗栗,一等
2020-04-06,3160,4782,5573,10355,苗栗,一等
2020-04-07,3160,4208,4159,8367,苗栗,一等
2020-04-08,3160,4369,4185,8554,苗栗,一等
2020-04-09,3160,4211,4203,8414,苗栗,一等
2020-04-10,3160,5982,5859,11841,苗栗,一等
2020-04-11,3160,2747,3260,6007,苗栗,一等
2020-04-12,3160,4023,3420,7443,苗栗,一等
2020-04-13,3160,4653,4509,9162,苗栗,一等
2020-04-14,3160,4315,4169,8484,苗栗,一等
2020-04-15,3160,4400,4337,8737,苗栗,一等
2020-04-16,3160,4539,4507,9046,苗栗,一等
2020-04-17,3160,6120,6247,12367,苗栗,一等
2020-04-18,3160,3296,3929,7225,苗栗,一等
2020-04-19,3160,4586,3722,8308,苗栗,一等
2020-04-20,3160,4851,4657,9508,苗栗,一等
2020-04-21,3160,4289,4165,8454,苗栗,一等
2020-04-22,3160,4206,4132,8338,苗栗,一等
2020-04-23,3160,4327,4072,8399,苗栗,一等
2020-04-24,3160,5965,5866,11831,苗栗,一等
2020-04-25,3160,3029,3340,6369,苗栗,一等
2020-04-26,3160,3876,3489,7365,苗栗,一等
2020-04-27,3160,4812,4620,9432,苗栗,一等
2020-04-28,3160,4449,4295,8744,苗栗,一等
2020-04-29,3160,4384,4292,8676,苗栗,一等
2020-04-30,3160,5002,5054,10056,苗栗,一等
2020-05-01,3160,6034,6265,12299,苗栗,一等
2020-05-02,3160,3364,3573,6937,苗栗,一等
2020-05-03,3160,4929,4018,8947,苗栗,一等
2020-05-04,3160,4940,4735,9675,苗栗,一等
2020-05-05,3160,4527,4424,8951,苗栗,一等
2020-05-06,3160,4647,4500,9147,苗栗,一等
2020-05-07,3160,4705,4619,9324,苗栗,一等
2020-05-08,3160,7471,7123,14594,苗栗,一等
2020-05-09,3160,3725,4808,8533,苗栗,一等
2020-05-10,3160,5783,4912,10695,苗栗,一等
2020-05-11,3160,5227,5071,10298,苗栗,一等
2020-05-12,3160,4589,4394,8983,苗栗,一等
2020-05-13,3160,4689,4619,9308,苗栗,一等
2020-05-14,3160,4874,4733,9607,苗栗,一等
2020-05-15,3160,7002,6811,13813,苗栗,一等
2020-05-16,3160,3737,4046,7783,苗栗,一等
2020-05-17,3160,4718,4291,9009,苗栗,一等
2020-05-18,3160,4842,4787,9629,苗栗,一等
2020-05-19,3160,4236,4114,8350,苗栗,一等
2020-05-20,3160,4606,4402,9008,苗栗,一等
2020-05-21,3160,4476,4396,8872,苗栗,一等
2020-05-22,3160,5911,5749,11660,苗栗,一等
2020-05-23,3160,3426,3580,7006,苗栗,一等
2020-05-24,3160,5107,4747,9854,苗栗,一等
2020-05-25,3160,5170,4996,10166,苗栗,一等
2020-05-26,3160,4695,4551,9246,苗栗,一等
2020-05-27,3160,4389,4257,8646,苗栗,一等
2020-05-28,3160,4487,4427,8914,苗栗,一等
2020-05-29,3160,6970,6566,13536,苗栗,一等
2020-05-30,3160,4360,4816,9176,苗栗,一等
2020-05-31,3160,5471,5014,10485,苗栗,一等
2020-06-01,3160,5085,5095,10180,苗栗,一等
2020-06-02,3160,4732,4720,9452,苗栗,一等
2020-06-03,3160,4784,4628,9412,苗栗,一等
2020-06-04,3160,4826,4726,9552,苗栗,一等
2020-06-05,3160,7181,6648,13829,苗栗,一等
2020-06-06,3160,4507,4939,9446,苗栗,一等
2020-06-07,3160,5246,4898,10144,苗栗,一等
2020-06-08,3160,4903,4865,9768,苗栗,一等
2020-06-09,3160,4669,4559,9228,苗栗,一等
2020-06-10,3160,5034,4897,9931,苗栗,一等
2020-06-11,3160,5066,4969,10035,苗栗,一等
2020-06-12,3160,6911,6760,13671,苗栗,一等
2020-06-13,3160,5059,5280,10339,苗栗,一等
2020-06-14,3160,5436,5121,10557,苗栗,一等
2020-06-15,3160,5579,5398,10977,苗栗,一等
2020-06-16,3160,5113,5062,10175,苗栗,一等
2020-06-17,3160,4951,4798,9749,苗栗,一等
2020-06-18,3160,4807,4646,9453,苗栗,一等
2020-06-19,3160,5619,5546,11165,苗栗,一等
2020-06-20,3160,5272,5295,10567,苗栗,一等
2020-06-21,3160,4596,4414,9010,苗栗,一等
2020-06-22,3160,5073,5071,10144,苗栗,一等
2020-06-23,3160,4972,4976,9948,苗栗,一等
2020-06-24,3160,6645,7377,14022,苗栗,一等
2020-06-25,3160,5241,6150,11391,苗栗,一等
2020-06-26,3160,5636,5491,11127,苗栗,一等
2020-06-27,3160,5247,4740,9987,苗栗,一等
2020-06-28,3160,5946,4868,10814,苗栗,一等
2020-06-29,3160,5726,5387,11113,苗栗,一等
2020-06-30,3160,5175,4975,10150,苗栗,一等
2020-07-01,3160,4854,4617,9471,苗栗,一等
2020-07-02,3160,4671,4678,9349,苗栗,一等
2020-07-03,3160,5915,5921,11836,苗栗,一等
2020-07-04,3160,4377,4890,9267,苗栗,一等
2020-07-05,3160,4587,4249,8836,苗栗,一等
2020-07-06,3160,5191,5117,10308,苗栗,一等
2020-07-07,3160,5171,5130,10301,苗栗,一等
2020-07-08,3160,4999,4904,9903,苗栗,一等
2020-07-09,3160,5034,4902,9936,苗栗,一等
2020-07-10,3160,6347,6557,12904,苗栗,一等
2020-07-11,3160,4543,4998,9541,苗栗,一等
2020-07-12,3160,5441,4771,10212,苗栗,一等
2020-07-13,3160,5359,5221,10580,苗栗,一等
2020-07-14,3160,5587,5646,11233,苗栗,一等
2020-07-15,3160,5685,5496,11181,苗栗,一等
2020-07-16,3160,5134,5089,10223,苗栗,一等
2020-07-17,3160,5982,6399,12381,苗栗,一等
2020-07-18,3160,5112,5759,10871,苗栗,一等
2020-07-19,3160,5874,5211,11085,苗栗,一等
2020-07-20,3160,5707,5652,11359,苗栗,一等
2020-07-21,3160,5165,5373,10538,苗栗,一等
2020-07-22,3160,5755,5688,11443,苗栗,一等
2020-07-23,3160,5204,5281,10485,苗栗,一等
2020-07-24,3160,6370,6410,12780,苗栗,一等
2020-07-25,3160,4864,5337,10201,苗栗,一等
2020-07-26,3160,5431,4786,10217,苗栗,一等
2020-07-27,3160,5328,5340,10668,苗栗,一等
2020-07-28,3160,5039,4932,9971,苗栗,一等
2020-07-29,3160,5018,4920,9938,苗栗,一等
2020-07-30,3160,5162,5058,10220,苗栗,一等
2020-07-31,3160,6019,6193,12212,苗栗,一等
2020-08-01,3160,4588,5253,9841,苗栗,一等
2020-08-02,3160,5093,4549,9642,苗栗,一等
2020-08-03,3160,5099,5040,10139,苗栗,一等
2020-08-04,3160,4936,4788,9724,苗栗,一等
2020-08-05,3160,5299,5096,10395,苗栗,一等
2020-08-06,3160,5497,5390,10887,苗栗,一等
2020-08-07,3160,6439,7102,13541,苗栗,一等
2020-08-08,3160,4514,5267,9781,苗栗,一等
2020-08-09,3160,5903,4844,10747,苗栗,一等
2020-08-10,3160,5587,5444,11031,苗栗,一等
2020-08-11,3160,5023,4955,9978,苗栗,一等
2020-08-12,3160,5201,5135,10336,苗栗,一等
2020-08-13,3160,5546,5362,10908,苗栗,一等
2020-08-14,3160,6523,6456,12979,苗栗,一等
2020-08-15,3160,4866,5272,10138,苗栗,一等
2020-08-16,3160,5584,5085,10669,苗栗,一等
2020-08-17,3160,5397,5459,10856,苗栗,一等
2020-08-18,3160,5213,5035,10248,苗栗,一等
2020-08-19,3160,5187,5027,10214,苗栗,一等
2020-08-20,3160,5260,5215,10475,苗栗,一等
2020-08-21,3160,6573,6733,13306,苗栗,一等
2020-08-22,3160,4729,5225,9954,苗栗,一等
2020-08-23,3160,5077,4813,9890,苗栗,一等
2020-08-24,3160,5325,5287,10612,苗栗,一等
2020-08-25,3160,5263,5268,10531,苗栗,一等
2020-08-26,3160,5365,5334,10699,苗栗,一等
2020-08-27,3160,5190,5141,10331,苗栗,一等
2020-08-28,3160,5818,6112,11930,苗栗,一等
2020-08-29,3160,4781,5128,9909,苗栗,一等
2020-08-30,3160,5161,4494,9655,苗栗,一等
2020-08-31,3160,5402,5270,10672,苗栗,一等
2020-09-01,3160,5092,5056,10148,苗栗,一等
2020-09-02,3160,5217,5113,10330,苗栗,一等
2020-09-03,3160,5290,5156,10446,苗栗,一等
2020-09-04,3160,6491,6523,13014,苗栗,一等
2020-09-05,3160,4746,5175,9921,苗栗,一等
2020-09-06,3160,5366,4517,9883,苗栗,一等
2020-09-07,3160,5480,5312,10792,苗栗,一等
2020-09-08,3160,5244,5054,10298,苗栗,一等
2020-09-09,3160,5703,5221,10924,苗栗,一等
2020-09-10,3160,5664,5326,10990,苗栗,一等
2020-09-11,3160,6607,7075,13682,苗栗,一等
2020-09-12,3160,4822,5327,10149,苗栗,一等
2020-09-13,3160,5784,5523,11307,苗栗,一等
2020-09-14,3160,5333,5246,10579,苗栗,一等
2020-09-15,3160,5061,4896,9957,苗栗,一等
2020-09-16,3160,5036,4977,10013,苗栗,一等
2020-09-17,3160,5324,5132,10456,苗栗,一等
2020-09-18,3160,7707,7325,15032,苗栗,一等
2020-09-19,3160,5129,5577,10706,苗栗,一等
2020-09-20,3160,6104,5777,11881,苗栗,一等
2020-09-21,3160,5429,5309,10738,苗栗,一等
2020-09-22,3160,5165,5065,10230,苗栗,一等
2020-09-23,3160,5302,5206,10508,苗栗,一等
2020-09-24,3160,5269,5245,10514,苗栗,一等
2020-09-25,3160,5954,5953,11907,苗栗,一等
2020-09-26,3160,5560,5528,11088,苗栗,一等
2020-09-27,3160,4625,4443,9068,苗栗,一等
2020-09-28,3160,5102,5030,10132,苗栗,一等
2020-09-29,3160,5040,4977,10017,苗栗,一等
2020-09-30,3160,8450,7970,16420,苗栗,一等
2020-10-01,3160,5741,7098,12839,苗栗,一等
2020-10-02,3160,6175,6281,12456,苗栗,一等
2020-10-03,3160,5645,5186,10831,苗栗,一等
2020-10-04,3160,6913,5985,12898,苗栗,一等
2020-10-05,3160,5643,5472,11115,苗栗,一等
2020-10-06,3160,5116,5043,10159,苗栗,一等
2020-10-07,3160,5225,5067,10292,苗栗,一等
2020-10-08,3160,7890,7408,15298,苗栗,一等
2020-10-09,3160,6020,6700,12720,苗栗,一等
2020-10-10,3160,5338,5271,10609,苗栗,一等
2020-10-11,3160,6362,6078,12440,苗栗,一等
2020-10-12,3160,5704,5647,11351,苗栗,一等
2020-10-13,3160,5376,5301,10677,苗栗,一等
2020-10-14,3160,5505,5283,10788,苗栗,一等
2020-10-15,3160,5546,5452,10998,苗栗,一等
2020-10-16,3160,7513,7223,14736,苗栗,一等
2020-10-17,3160,5402,5835,11237,苗栗,一等
2020-10-18,3160,6306,5851,12157,苗栗,一等
2020-10-19,3160,5640,5431,11071,苗栗,一等
2020-10-20,3160,5295,5115,10410,苗栗,一等
2020-10-21,3160,5357,5144,10501,苗栗,一等
2020-10-22,3160,5135,4994,10129,苗栗,一等
2020-10-23,3160,7177,6817,13994,苗栗,一等
2020-10-24,3160,5278,5643,10921,苗栗,一等
2020-10-25,3160,6039,5812,11851,苗栗,一等
2020-10-26,3160,5645,5469,11114,苗栗,一等
2020-10-27,3160,5170,4973,10143,苗栗,一等
2020-10-28,3160,5376,5224,10600,苗栗,一等
2020-10-29,3160,5268,5090,10358,苗栗,一等
2020-10-30,3160,7705,7273,14978,苗栗,一等
2020-10-31,3160,5260,5807,11067,苗栗,一等
2020-11-01,3160,6374,5805,12179,苗栗,一等
2020-11-02,3160,5829,5603,11432,苗栗,一等
2020-11-03,3160,4903,4864,9767,苗栗,一等
2020-11-04,3160,5186,4963,10149,苗栗,一等
2020-11-05,3160,5174,4966,10140,苗栗,一等
2020-11-06,3160,7284,7224,14508,苗栗,一等
2020-11-07,3160,5048,5482,10530,苗栗,一等
2020-11-08,3160,5892,5302,11194,苗栗,一等
2020-11-09,3160,5384,5193,10577,苗栗,一等
2020-11-10,3160,5133,4937,10070,苗栗,一等
2020-11-11,3160,5382,5189,10571,苗栗,一等
2020-11-12,3160,5585,5468,11053,苗栗,一等
2020-11-13,3160,7817,7356,15173,苗栗,一等
2020-11-14,3160,5617,6001,11618,苗栗,一等
2020-11-15,3160,6855,6458,13313,苗栗,一等
2020-11-16,3160,5896,5846,11742,苗栗,一等
2020-11-17,3160,5350,5224,10574,苗栗,一等
2020-11-18,3160,5431,5337,10768,苗栗,一等
2020-11-19,3160,5652,5449,11101,苗栗,一等
2020-11-20,3160,7942,7459,15401,苗栗,一等
2020-11-21,3160,5433,5943,11376,苗栗,一等
2020-11-22,3160,6490,6315,12805,苗栗,一等
2020-11-23,3160,5675,5578,11253,苗栗,一等
2020-11-24,3160,5154,5192,10346,苗栗,一等
2020-11-25,3160,5560,5321,10881,苗栗,一等
2020-11-26,3160,5674,5374,11048,苗栗,一等
2020-11-27,3160,7280,7410,14690,苗栗,一等
2020-11-28,3160,5589,5820,11409,苗栗,一等
2020-11-29,3160,6116,5541,11657,苗栗,一等
2020-11-30,3160,5640,5531,11171,苗栗,一等
2020-12-01,3160,5057,4911,9968,苗栗,一等
2020-12-02,3160,5358,5125,10483,苗栗,一等
2020-12-03,3160,5265,5083,10348,苗栗,一等
2020-12-04,3160,7959,7051,15010,苗栗,一等
2020-12-05,3160,5391,5817,11208,苗栗,一等
2020-12-06,3160,6293,6256,12549,苗栗,一等
2020-12-07,3160,5669,5616,11285,苗栗,一等
2020-12-08,3160,5085,4969,10054,苗栗,一等
2020-12-09,3160,4742,4690,9432,苗栗,一等
2020-12-10,3160,5196,5029,10225,苗栗,一等
2020-12-11,3160,7701,7105,14806,苗栗,一等
2020-12-12,3160,5672,6033,11705,苗栗,一等
2020-12-13,3160,6590,6346,12936,苗栗,一等
2020-12-14,3160,5662,5212,10874,苗栗,一等
2020-12-15,3160,5328,5092,10420,苗栗,一等
2020-12-16,3160,5367,5129,10496,苗栗,一等
2020-12-17,3160,5328,5258,10586,苗栗,一等
2020-12-18,3160,7479,7541,15020,苗栗,一等
2020-12-19,3160,5746,5914,11660,苗栗,一等
2020-12-20,3160,6220,5825,12045,苗栗,一等
2020-12-21,3160,5610,5358,10968,苗栗,一等
2020-12-22,3160,5262,5036,10298,苗栗,一等
2020-12-23,3160,4867,4720,9587,苗栗,一等
2020-12-24,3160,5223,5048,10271,苗栗,一等
2020-12-25,3160,8039,7451,15490,苗栗,一等
2020-12-26,3160,5014,5498,10512,苗栗,一等
2020-12-27,3160,5765,5452,11217,苗栗,一等
2020-12-28,3160,5462,5479,10941,苗栗,一等
2020-12-29,3160,5179,4982,10161,苗栗,一等
2020-12-30,3160,5034,4935,9969,苗栗,一等
2020-12-31,3160,8017,6826,14843,苗栗,一等
2020-01-01,3170,100,124,224,南勢,招呼
2020-01-02,3170,104,91,195,南勢,招呼
2020-01-03,3170,122,117,239,南勢,招呼
2020-01-04,3170,84,110,194,南勢,招呼
2020-01-05,3170,118,118,236,南勢,招呼
2020-01-06,3170,131,133,264,南勢,招呼
2020-01-07,3170,112,121,233,南勢,招呼
2020-01-08,3170,113,115,228,南勢,招呼
2020-01-09,3170,126,123,249,南勢,招呼
2020-01-10,3170,158,162,320,南勢,招呼
2020-01-11,3170,122,138,260,南勢,招呼
2020-01-12,3170,116,133,249,南勢,招呼
2020-01-13,3170,111,136,247,南勢,招呼
2020-01-14,3170,114,104,218,南勢,招呼
2020-01-15,3170,76,108,184,南勢,招呼
2020-01-16,3170,112,120,232,南勢,招呼
2020-01-17,3170,105,107,212,南勢,招呼
2020-01-18,3170,86,105,191,南勢,招呼
2020-01-19,3170,95,97,192,南勢,招呼
2020-01-20,3170,90,104,194,南勢,招呼
2020-01-21,3170,93,108,201,南勢,招呼
2020-01-22,3170,92,117,209,南勢,招呼
2020-01-23,3170,83,120,203,南勢,招呼
2020-01-24,3170,62,101,163,南勢,招呼
2020-01-25,3170,115,103,218,南勢,招呼
2020-01-26,3170,76,83,159,南勢,招呼
2020-01-27,3170,136,164,300,南勢,招呼
2020-01-28,3170,111,105,216,南勢,招呼
2020-01-29,3170,79,60,139,南勢,招呼
2020-01-30,3170,74,71,145,南勢,招呼
2020-01-31,3170,74,75,149,南勢,招呼
2020-02-01,3170,53,63,116,南勢,招呼
2020-02-02,3170,82,84,166,南勢,招呼
2020-02-03,3170,96,99,195,南勢,招呼
2020-02-04,3170,85,95,180,南勢,招呼
2020-02-05,3170,86,94,180,南勢,招呼
2020-02-06,3170,94,99,193,南勢,招呼
2020-02-07,3170,104,120,224,南勢,招呼
2020-02-08,3170,70,98,168,南勢,招呼
2020-02-09,3170,109,100,209,南勢,招呼
2020-02-10,3170,94,96,190,南勢,招呼
2020-02-11,3170,111,119,230,南勢,招呼
2020-02-12,3170,93,116,209,南勢,招呼
2020-02-13,3170,103,92,195,南勢,招呼
2020-02-14,3170,84,116,200,南勢,招呼
2020-02-15,3170,110,123,233,南勢,招呼
2020-02-16,3170,96,106,202,南勢,招呼
2020-02-17,3170,111,112,223,南勢,招呼
2020-02-18,3170,68,81,149,南勢,招呼
2020-02-19,3170,86,97,183,南勢,招呼
2020-02-20,3170,91,100,191,南勢,招呼
2020-02-21,3170,110,140,250,南勢,招呼
2020-02-22,3170,106,116,222,南勢,招呼
2020-02-23,3170,125,169,294,南勢,招呼
2020-02-24,3170,128,144,272,南勢,招呼
2020-02-25,3170,126,111,237,南勢,招呼
2020-02-26,3170,95,110,205,南勢,招呼
2020-02-27,3170,166,117,283,南勢,招呼
2020-02-28,3170,93,99,192,南勢,招呼
2020-02-29,3170,91,113,204,南勢,招呼
2020-03-01,3170,95,121,216,南勢,招呼
2020-03-02,3170,113,123,236,南勢,招呼
2020-03-03,3170,105,103,208,南勢,招呼
2020-03-04,3170,84,88,172,南勢,招呼
2020-03-05,3170,94,93,187,南勢,招呼
2020-03-06,3170,145,134,279,南勢,招呼
2020-03-07,3170,91,107,198,南勢,招呼
2020-03-08,3170,99,115,214,南勢,招呼
2020-03-09,3170,101,109,210,南勢,招呼
2020-03-10,3170,84,84,168,南勢,招呼
2020-03-11,3170,105,104,209,南勢,招呼
2020-03-12,3170,96,103,199,南勢,招呼
2020-03-13,3170,172,123,295,南勢,招呼
2020-03-14,3170,58,88,146,南勢,招呼
2020-03-15,3170,111,131,242,南勢,招呼
2020-03-16,3170,103,101,204,南勢,招呼
2020-03-17,3170,94,96,190,南勢,招呼
2020-03-18,3170,93,95,188,南勢,招呼
2020-03-19,3170,85,86,171,南勢,招呼
2020-03-20,3170,144,110,254,南勢,招呼
2020-03-21,3170,53,75,128,南勢,招呼
2020-03-22,3170,74,92,166,南勢,招呼
2020-03-23,3170,87,110,197,南勢,招呼
2020-03-24,3170,88,87,175,南勢,招呼
2020-03-25,3170,90,100,190,南勢,招呼
2020-03-26,3170,79,85,164,南勢,招呼
2020-03-27,3170,124,92,216,南勢,招呼
2020-03-28,3170,51,70,121,南勢,招呼
2020-03-29,3170,78,88,166,南勢,招呼
2020-03-30,3170,92,105,197,南勢,招呼
2020-03-31,3170,87,90,177,南勢,招呼
2020-04-01,3170,142,106,248,南勢,招呼
2020-04-02,3170,74,72,146,南勢,招呼
2020-04-03,3170,56,66,122,南勢,招呼
2020-04-04,3170,55,65,120,南勢,招呼
2020-04-05,3170,89,81,170,南勢,招呼
2020-04-06,3170,83,129,212,南勢,招呼
2020-04-07,3170,77,89,166,南勢,招呼
2020-04-08,3170,80,83,163,南勢,招呼
2020-04-09,3170,85,81,166,南勢,招呼
2020-04-10,3170,118,87,205,南勢,招呼
2020-04-11,3170,53,77,130,南勢,招呼
2020-04-12,3170,68,93,161,南勢,招呼
2020-04-13,3170,81,101,182,南勢,招呼
2020-04-14,3170,87,86,173,南勢,招呼
2020-04-15,3170,83,82,165,南勢,招呼
2020-04-16,3170,88,89,177,南勢,招呼
2020-04-17,3170,124,104,228,南勢,招呼
2020-04-18,3170,76,80,156,南勢,招呼
2020-04-19,3170,87,109,196,南勢,招呼
2020-04-20,3170,96,115,211,南勢,招呼
2020-04-21,3170,103,86,189,南勢,招呼
2020-04-22,3170,68,81,149,南勢,招呼
2020-04-23,3170,78,92,170,南勢,招呼
2020-04-24,3170,140,117,257,南勢,招呼
2020-04-25,3170,61,68,129,南勢,招呼
2020-04-26,3170,77,117,194,南勢,招呼
2020-04-27,3170,90,119,209,南勢,招呼
2020-04-28,3170,76,76,152,南勢,招呼
2020-04-29,3170,77,65,142,南勢,招呼
2020-04-30,3170,89,80,169,南勢,招呼
2020-05-01,3170,146,101,247,南勢,招呼
2020-05-02,3170,71,79,150,南勢,招呼
2020-05-03,3170,104,117,221,南勢,招呼
2020-05-04,3170,96,113,209,南勢,招呼
2020-05-05,3170,85,90,175,南勢,招呼
2020-05-06,3170,76,79,155,南勢,招呼
2020-05-07,3170,99,102,201,南勢,招呼
2020-05-08,3170,163,108,271,南勢,招呼
2020-05-09,3170,72,99,171,南勢,招呼
2020-05-10,3170,93,139,232,南勢,招呼
2020-05-11,3170,95,115,210,南勢,招呼
2020-05-12,3170,91,89,180,南勢,招呼
2020-05-13,3170,93,98,191,南勢,招呼
2020-05-14,3170,84,81,165,南勢,招呼
2020-05-15,3170,154,108,262,南勢,招呼
2020-05-16,3170,60,66,126,南勢,招呼
2020-05-17,3170,88,123,211,南勢,招呼
2020-05-18,3170,98,99,197,南勢,招呼
2020-05-19,3170,78,77,155,南勢,招呼
2020-05-20,3170,79,91,170,南勢,招呼
2020-05-21,3170,89,88,177,南勢,招呼
2020-05-22,3170,132,98,230,南勢,招呼
2020-05-23,3170,71,68,139,南勢,招呼
2020-05-24,3170,84,106,190,南勢,招呼
2020-05-25,3170,91,110,201,南勢,招呼
2020-05-26,3170,96,100,196,南勢,招呼
2020-05-27,3170,75,90,165,南勢,招呼
2020-05-28,3170,79,79,158,南勢,招呼
2020-05-29,3170,167,129,296,南勢,招呼
2020-05-30,3170,81,81,162,南勢,招呼
2020-05-31,3170,80,109,189,南勢,招呼
2020-06-01,3170,100,120,220,南勢,招呼
2020-06-02,3170,109,96,205,南勢,招呼
2020-06-03,3170,89,98,187,南勢,招呼
2020-06-04,3170,107,94,201,南勢,招呼
2020-06-05,3170,166,140,306,南勢,招呼
2020-06-06,3170,85,92,177,南勢,招呼
2020-06-07,3170,79,128,207,南勢,招呼
2020-06-08,3170,90,96,186,南勢,招呼
2020-06-09,3170,97,97,194,南勢,招呼
2020-06-10,3170,108,99,207,南勢,招呼
2020-06-11,3170,98,95,193,南勢,招呼
2020-06-12,3170,153,109,262,南勢,招呼
2020-06-13,3170,100,105,205,南勢,招呼
2020-06-14,3170,115,155,270,南勢,招呼
2020-06-15,3170,91,107,198,南勢,招呼
2020-06-16,3170,101,91,192,南勢,招呼
2020-06-17,3170,98,103,201,南勢,招呼
2020-06-18,3170,107,101,208,南勢,招呼
2020-06-19,3170,107,107,214,南勢,招呼
2020-06-20,3170,92,90,182,南勢,招呼
2020-06-21,3170,93,125,218,南勢,招呼
2020-06-22,3170,111,124,235,南勢,招呼
2020-06-23,3170,99,98,197,南勢,招呼
2020-06-24,3170,111,117,228,南勢,招呼
2020-06-25,3170,87,120,207,南勢,招呼
2020-06-26,3170,93,99,192,南勢,招呼
2020-06-27,3170,83,105,188,南勢,招呼
2020-06-28,3170,102,95,197,南勢,招呼
2020-06-29,3170,109,108,217,南勢,招呼
2020-06-30,3170,98,101,199,南勢,招呼
2020-07-01,3170,85,102,187,南勢,招呼
2020-07-02,3170,95,94,189,南勢,招呼
2020-07-03,3170,122,126,248,南勢,招呼
2020-07-04,3170,79,77,156,南勢,招呼
2020-07-05,3170,103,98,201,南勢,招呼
2020-07-06,3170,96,116,212,南勢,招呼
2020-07-07,3170,106,90,196,南勢,招呼
2020-07-08,3170,91,95,186,南勢,招呼
2020-07-09,3170,97,92,189,南勢,招呼
2020-07-10,3170,118,121,239,南勢,招呼
2020-07-11,3170,95,101,196,南勢,招呼
2020-07-12,3170,116,124,240,南勢,招呼
2020-07-13,3170,101,107,208,南勢,招呼
2020-07-14,3170,87,91,178,南勢,招呼
2020-07-15,3170,97,94,191,南勢,招呼
2020-07-16,3170,104,105,209,南勢,招呼
2020-07-17,3170,102,100,202,南勢,招呼
2020-07-18,3170,77,94,171,南勢,招呼
2020-07-19,3170,91,94,185,南勢,招呼
2020-07-20,3170,102,109,211,南勢,招呼
2020-07-21,3170,101,108,209,南勢,招呼
2020-07-22,3170,100,115,215,南勢,招呼
2020-07-23,3170,90,101,191,南勢,招呼
2020-07-24,3170,109,119,228,南勢,招呼
2020-07-25,3170,83,105,188,南勢,招呼
2020-07-26,3170,98,106,204,南勢,招呼
2020-07-27,3170,117,121,238,南勢,招呼
2020-07-28,3170,100,86,186,南勢,招呼
2020-07-29,3170,106,123,229,南勢,招呼
2020-07-30,3170,104,95,199,南勢,招呼
2020-07-31,3170,108,117,225,南勢,招呼
2020-08-01,3170,72,98,170,南勢,招呼
2020-08-02,3170,122,121,243,南勢,招呼
2020-08-03,3170,100,101,201,南勢,招呼
2020-08-04,3170,93,104,197,南勢,招呼
2020-08-05,3170,101,103,204,南勢,招呼
2020-08-06,3170,95,98,193,南勢,招呼
2020-08-07,3170,99,114,213,南勢,招呼
2020-08-08,3170,82,99,181,南勢,招呼
2020-08-09,3170,133,125,258,南勢,招呼
2020-08-10,3170,97,105,202,南勢,招呼
2020-08-11,3170,92,101,193,南勢,招呼
2020-08-12,3170,77,88,165,南勢,招呼
2020-08-13,3170,94,96,190,南勢,招呼
2020-08-14,3170,116,116,232,南勢,招呼
2020-08-15,3170,77,93,170,南勢,招呼
2020-08-16,3170,96,112,208,南勢,招呼
2020-08-17,3170,119,129,248,南勢,招呼
2020-08-18,3170,92,100,192,南勢,招呼
2020-08-19,3170,92,98,190,南勢,招呼
2020-08-20,3170,76,75,151,南勢,招呼
2020-08-21,3170,111,113,224,南勢,招呼
2020-08-22,3170,87,105,192,南勢,招呼
2020-08-23,3170,90,79,169,南勢,招呼
2020-08-24,3170,99,116,215,南勢,招呼
2020-08-25,3170,93,100,193,南勢,招呼
2020-08-26,3170,89,129,218,南勢,招呼
2020-08-27,3170,87,93,180,南勢,招呼
2020-08-28,3170,97,83,180,南勢,招呼
2020-08-29,3170,66,94,160,南勢,招呼
2020-08-30,3170,93,97,190,南勢,招呼
2020-08-31,3170,97,119,216,南勢,招呼
2020-09-01,3170,80,80,160,南勢,招呼
2020-09-02,3170,87,136,223,南勢,招呼
2020-09-03,3170,86,86,172,南勢,招呼
2020-09-04,3170,99,123,222,南勢,招呼
2020-09-05,3170,76,102,178,南勢,招呼
2020-09-06,3170,100,95,195,南勢,招呼
2020-09-07,3170,101,108,209,南勢,招呼
2020-09-08,3170,106,123,229,南勢,招呼
2020-09-09,3170,108,98,206,南勢,招呼
2020-09-10,3170,94,98,192,南勢,招呼
2020-09-11,3170,97,114,211,南勢,招呼
2020-09-12,3170,81,99,180,南勢,招呼
2020-09-13,3170,113,125,238,南勢,招呼
2020-09-14,3170,102,112,214,南勢,招呼
2020-09-15,3170,97,97,194,南勢,招呼
2020-09-16,3170,91,104,195,南勢,招呼
2020-09-17,3170,83,80,163,南勢,招呼
2020-09-18,3170,120,96,216,南勢,招呼
2020-09-19,3170,139,173,312,南勢,招呼
2020-09-20,3170,74,123,197,南勢,招呼
2020-09-21,3170,95,105,200,南勢,招呼
2020-09-22,3170,83,109,192,南勢,招呼
2020-09-23,3170,111,107,218,南勢,招呼
2020-09-24,3170,83,94,177,南勢,招呼
2020-09-25,3170,122,124,246,南勢,招呼
2020-09-26,3170,96,103,199,南勢,招呼
2020-09-27,3170,85,114,199,南勢,招呼
2020-09-28,3170,101,107,208,南勢,招呼
2020-09-29,3170,98,102,200,南勢,招呼
2020-09-30,3170,162,114,276,南勢,招呼
2020-10-01,3170,125,130,255,南勢,招呼
2020-10-02,3170,95,98,193,南勢,招呼
2020-10-03,3170,86,99,185,南勢,招呼
2020-10-04,3170,103,168,271,南勢,招呼
2020-10-05,3170,101,119,220,南勢,招呼
2020-10-06,3170,100,108,208,南勢,招呼
2020-10-07,3170,101,104,205,南勢,招呼
2020-10-08,3170,142,118,260,南勢,招呼
2020-10-09,3170,101,120,221,南勢,招呼
2020-10-10,3170,100,118,218,南勢,招呼
2020-10-11,3170,130,157,287,南勢,招呼
2020-10-12,3170,98,117,215,南勢,招呼
2020-10-13,3170,109,121,230,南勢,招呼
2020-10-14,3170,91,111,202,南勢,招呼
2020-10-15,3170,119,113,232,南勢,招呼
2020-10-16,3170,151,118,269,南勢,招呼
2020-10-17,3170,90,106,196,南勢,招呼
2020-10-18,3170,110,136,246,南勢,招呼
2020-10-19,3170,105,102,207,南勢,招呼
2020-10-20,3170,96,101,197,南勢,招呼
2020-10-21,3170,100,99,199,南勢,招呼
2020-10-22,3170,81,103,184,南勢,招呼
2020-10-23,3170,145,113,258,南勢,招呼
2020-10-24,3170,91,90,181,南勢,招呼
2020-10-25,3170,165,199,364,南勢,招呼
2020-10-26,3170,108,120,228,南勢,招呼
2020-10-27,3170,97,96,193,南勢,招呼
2020-10-28,3170,80,106,186,南勢,招呼
2020-10-29,3170,93,103,196,南勢,招呼
2020-10-30,3170,165,130,295,南勢,招呼
2020-10-31,3170,67,114,181,南勢,招呼
2020-11-01,3170,82,124,206,南勢,招呼
2020-11-02,3170,96,109,205,南勢,招呼
2020-11-03,3170,82,89,171,南勢,招呼
2020-11-04,3170,91,104,195,南勢,招呼
2020-11-05,3170,90,106,196,南勢,招呼
2020-11-06,3170,141,131,272,南勢,招呼
2020-11-07,3170,86,94,180,南勢,招呼
2020-11-08,3170,83,116,199,南勢,招呼
2020-11-09,3170,106,110,216,南勢,招呼
2020-11-10,3170,107,120,227,南勢,招呼
2020-11-11,3170,90,101,191,南勢,招呼
2020-11-12,3170,101,111,212,南勢,招呼
2020-11-13,3170,185,137,322,南勢,招呼
2020-11-14,3170,111,132,243,南勢,招呼
2020-11-15,3170,129,158,287,南勢,招呼
2020-11-16,3170,113,124,237,南勢,招呼
2020-11-17,3170,112,107,219,南勢,招呼
2020-11-18,3170,98,109,207,南勢,招呼
2020-11-19,3170,116,113,229,南勢,招呼
2020-11-20,3170,159,133,292,南勢,招呼
2020-11-21,3170,104,127,231,南勢,招呼
2020-11-22,3170,126,152,278,南勢,招呼
2020-11-23,3170,97,119,216,南勢,招呼
2020-11-24,3170,98,112,210,南勢,招呼
2020-11-25,3170,105,124,229,南勢,招呼
2020-11-26,3170,126,120,246,南勢,招呼
2020-11-27,3170,147,133,280,南勢,招呼
2020-11-28,3170,106,122,228,南勢,招呼
2020-11-29,3170,122,126,248,南勢,招呼
2020-11-30,3170,105,121,226,南勢,招呼
2020-12-01,3170,112,115,227,南勢,招呼
2020-12-02,3170,89,102,191,南勢,招呼
2020-12-03,3170,96,96,192,南勢,招呼
2020-12-04,3170,167,115,282,南勢,招呼
2020-12-05,3170,79,92,171,南勢,招呼
2020-12-06,3170,109,155,264,南勢,招呼
2020-12-07,3170,110,128,238,南勢,招呼
2020-12-08,3170,103,105,208,南勢,招呼
2020-12-09,3170,88,97,185,南勢,招呼
2020-12-10,3170,102,108,210,南勢,招呼
2020-12-11,3170,168,120,288,南勢,招呼
2020-12-12,3170,98,120,218,南勢,招呼
2020-12-13,3170,116,164,280,南勢,招呼
2020-12-14,3170,93,108,201,南勢,招呼
2020-12-15,3170,109,109,218,南勢,招呼
2020-12-16,3170,95,114,209,南勢,招呼
2020-12-17,3170,116,107,223,南勢,招呼
2020-12-18,3170,145,160,305,南勢,招呼
2020-12-19,3170,111,100,211,南勢,招呼
2020-12-20,3170,89,117,206,南勢,招呼
2020-12-21,3170,123,119,242,南勢,招呼
2020-12-22,3170,119,111,230,南勢,招呼
2020-12-23,3170,70,88,158,南勢,招呼
2020-12-24,3170,97,105,202,南勢,招呼
2020-12-25,3170,174,130,304,南勢,招呼
2020-12-26,3170,104,99,203,南勢,招呼
2020-12-27,3170,97,156,253,南勢,招呼
2020-12-28,3170,113,146,259,南勢,招呼
2020-12-29,3170,114,99,213,南勢,招呼
2020-12-30,3170,100,92,192,南勢,招呼
2020-12-31,3170,190,110,300,南勢,招呼
2020-01-01,3180,918,1062,1980,銅鑼,三等
2020-01-02,3180,784,760,1544,銅鑼,三等
2020-01-03,3180,784,943,1727,銅鑼,三等
2020-01-04,3180,950,1125,2075,銅鑼,三等
2020-01-05,3180,1129,906,2035,銅鑼,三等
2020-01-06,3180,794,770,1564,銅鑼,三等
2020-01-07,3180,769,776,1545,銅鑼,三等
2020-01-08,3180,759,751,1510,銅鑼,三等
2020-01-09,3180,759,764,1523,銅鑼,三等
2020-01-10,3180,845,1220,2065,銅鑼,三等
2020-01-11,3180,1238,1334,2572,銅鑼,三等
2020-01-12,3180,1530,1183,2713,銅鑼,三等
2020-01-13,3180,883,819,1702,銅鑼,三等
2020-01-14,3180,864,851,1715,銅鑼,三等
2020-01-15,3180,850,773,1623,銅鑼,三等
2020-01-16,3180,824,863,1687,銅鑼,三等
2020-01-17,3180,829,931,1760,銅鑼,三等
2020-01-18,3180,992,1115,2107,銅鑼,三等
2020-01-19,3180,1166,992,2158,銅鑼,三等
2020-01-20,3180,867,847,1714,銅鑼,三等
2020-01-21,3180,839,866,1705,銅鑼,三等
2020-01-22,3180,891,1008,1899,銅鑼,三等
2020-01-23,3180,824,1093,1917,銅鑼,三等
2020-01-24,3180,922,1154,2076,銅鑼,三等
2020-01-25,3180,1331,1211,2542,銅鑼,三等
2020-01-26,3180,1100,1115,2215,銅鑼,三等
2020-01-27,3180,1316,1125,2441,銅鑼,三等
2020-01-28,3180,1170,1042,2212,銅鑼,三等
2020-01-29,3180,1018,783,1801,銅鑼,三等
2020-01-30,3180,714,666,1380,銅鑼,三等
2020-01-31,3180,716,788,1504,銅鑼,三等
2020-02-01,3180,767,766,1533,銅鑼,三等
2020-02-02,3180,903,803,1706,銅鑼,三等
2020-02-03,3180,751,727,1478,銅鑼,三等
2020-02-04,3180,661,661,1322,銅鑼,三等
2020-02-05,3180,712,711,1423,銅鑼,三等
2020-02-06,3180,715,670,1385,銅鑼,三等
2020-02-07,3180,775,952,1727,銅鑼,三等
2020-02-08,3180,967,1200,2167,銅鑼,三等
2020-02-09,3180,1562,1306,2868,銅鑼,三等
2020-02-10,3180,850,761,1611,銅鑼,三等
2020-02-11,3180,694,684,1378,銅鑼,三等
2020-02-12,3180,829,804,1633,銅鑼,三等
2020-02-13,3180,658,654,1312,銅鑼,三等
2020-02-14,3180,795,839,1634,銅鑼,三等
2020-02-15,3180,975,1109,2084,銅鑼,三等
2020-02-16,3180,953,897,1850,銅鑼,三等
2020-02-17,3180,768,714,1482,銅鑼,三等
2020-02-18,3180,646,630,1276,銅鑼,三等
2020-02-19,3180,731,717,1448,銅鑼,三等
2020-02-20,3180,747,696,1443,銅鑼,三等
2020-02-21,3180,800,918,1718,銅鑼,三等
2020-02-22,3180,896,1033,1929,銅鑼,三等
2020-02-23,3180,1238,1014,2252,銅鑼,三等
2020-02-24,3180,722,670,1392,銅鑼,三等
2020-02-25,3180,678,654,1332,銅鑼,三等
2020-02-26,3180,671,701,1372,銅鑼,三等
2020-02-27,3180,761,904,1665,銅鑼,三等
2020-02-28,3180,812,1039,1851,銅鑼,三等
2020-02-29,3180,945,917,1862,銅鑼,三等
2020-03-01,3180,1197,792,1989,銅鑼,三等
2020-03-02,3180,739,692,1431,銅鑼,三等
2020-03-03,3180,651,632,1283,銅鑼,三等
2020-03-04,3180,670,617,1287,銅鑼,三等
2020-03-05,3180,534,575,1109,銅鑼,三等
2020-03-06,3180,703,963,1666,銅鑼,三等
2020-03-07,3180,805,951,1756,銅鑼,三等
2020-03-08,3180,1096,802,1898,銅鑼,三等
2020-03-09,3180,776,697,1473,銅鑼,三等
2020-03-10,3180,600,623,1223,銅鑼,三等
2020-03-11,3180,690,721,1411,銅鑼,三等
2020-03-12,3180,683,677,1360,銅鑼,三等
2020-03-13,3180,754,974,1728,銅鑼,三等
2020-03-14,3180,784,887,1671,銅鑼,三等
2020-03-15,3180,1235,928,2163,銅鑼,三等
2020-03-16,3180,752,712,1464,銅鑼,三等
2020-03-17,3180,635,601,1236,銅鑼,三等
2020-03-18,3180,580,619,1199,銅鑼,三等
2020-03-19,3180,556,575,1131,銅鑼,三等
2020-03-20,3180,661,899,1560,銅鑼,三等
2020-03-21,3180,638,770,1408,銅鑼,三等
2020-03-22,3180,910,634,1544,銅鑼,三等
2020-03-23,3180,709,619,1328,銅鑼,三等
2020-03-24,3180,545,562,1107,銅鑼,三等
2020-03-25,3180,554,561,1115,銅鑼,三等
2020-03-26,3180,561,575,1136,銅鑼,三等
2020-03-27,3180,611,813,1424,銅鑼,三等
2020-03-28,3180,499,623,1122,銅鑼,三等
2020-03-29,3180,877,545,1422,銅鑼,三等
2020-03-30,3180,656,623,1279,銅鑼,三等
2020-03-31,3180,562,613,1175,銅鑼,三等
2020-04-01,3180,634,834,1468,銅鑼,三等
2020-04-02,3180,425,645,1070,銅鑼,三等
2020-04-03,3180,571,597,1168,銅鑼,三等
2020-04-04,3180,606,549,1155,銅鑼,三等
2020-04-05,3180,959,529,1488,銅鑼,三等
2020-04-06,3180,687,568,1255,銅鑼,三等
2020-04-07,3180,528,529,1057,銅鑼,三等
2020-04-08,3180,548,537,1085,銅鑼,三等
2020-04-09,3180,542,542,1084,銅鑼,三等
2020-04-10,3180,702,837,1539,銅鑼,三等
2020-04-11,3180,662,688,1350,銅鑼,三等
2020-04-12,3180,895,684,1579,銅鑼,三等
2020-04-13,3180,655,614,1269,銅鑼,三等
2020-04-14,3180,564,545,1109,銅鑼,三等
2020-04-15,3180,570,580,1150,銅鑼,三等
2020-04-16,3180,536,600,1136,銅鑼,三等
2020-04-17,3180,680,867,1547,銅鑼,三等
2020-04-18,3180,780,799,1579,銅鑼,三等
2020-04-19,3180,1127,756,1883,銅鑼,三等
2020-04-20,3180,659,623,1282,銅鑼,三等
2020-04-21,3180,575,547,1122,銅鑼,三等
2020-04-22,3180,553,534,1087,銅鑼,三等
2020-04-23,3180,490,530,1020,銅鑼,三等
2020-04-24,3180,589,766,1355,銅鑼,三等
2020-04-25,3180,792,670,1462,銅鑼,三等
2020-04-26,3180,1001,617,1618,銅鑼,三等
2020-04-27,3180,646,618,1264,銅鑼,三等
2020-04-28,3180,595,572,1167,銅鑼,三等
2020-04-29,3180,597,610,1207,銅鑼,三等
2020-04-30,3180,669,741,1410,銅鑼,三等
2020-05-01,3180,880,1087,1967,銅鑼,三等
2020-05-02,3180,835,819,1654,銅鑼,三等
2020-05-03,3180,1078,663,1741,銅鑼,三等
2020-05-04,3180,708,625,1333,銅鑼,三等
2020-05-05,3180,623,592,1215,銅鑼,三等
2020-05-06,3180,592,572,1164,銅鑼,三等
2020-05-07,3180,561,608,1169,銅鑼,三等
2020-05-08,3180,724,963,1687,銅鑼,三等
2020-05-09,3180,882,1006,1888,銅鑼,三等
2020-05-10,3180,1231,845,2076,銅鑼,三等
2020-05-11,3180,753,649,1402,銅鑼,三等
2020-05-12,3180,596,572,1168,銅鑼,三等
2020-05-13,3180,605,587,1192,銅鑼,三等
2020-05-14,3180,616,620,1236,銅鑼,三等
2020-05-15,3180,725,964,1689,銅鑼,三等
2020-05-16,3180,805,883,1688,銅鑼,三等
2020-05-17,3180,1070,749,1819,銅鑼,三等
2020-05-18,3180,701,616,1317,銅鑼,三等
2020-05-19,3180,528,540,1068,銅鑼,三等
2020-05-20,3180,602,601,1203,銅鑼,三等
2020-05-21,3180,514,538,1052,銅鑼,三等
2020-05-22,3180,580,712,1292,銅鑼,三等
2020-05-23,3180,636,700,1336,銅鑼,三等
2020-05-24,3180,1129,870,1999,銅鑼,三等
2020-05-25,3180,750,674,1424,銅鑼,三等
2020-05-26,3180,606,613,1219,銅鑼,三等
2020-05-27,3180,559,584,1143,銅鑼,三等
2020-05-28,3180,527,567,1094,銅鑼,三等
2020-05-29,3180,692,909,1601,銅鑼,三等
2020-05-30,3180,801,915,1716,銅鑼,三等
2020-05-31,3180,1094,700,1794,銅鑼,三等
2020-06-01,3180,754,716,1470,銅鑼,三等
2020-06-02,3180,622,605,1227,銅鑼,三等
2020-06-03,3180,634,623,1257,銅鑼,三等
2020-06-04,3180,645,693,1338,銅鑼,三等
2020-06-05,3180,781,917,1698,銅鑼,三等
2020-06-06,3180,922,1007,1929,銅鑼,三等
2020-06-07,3180,1067,851,1918,銅鑼,三等
2020-06-08,3180,732,641,1373,銅鑼,三等
2020-06-09,3180,629,601,1230,銅鑼,三等
2020-06-10,3180,650,667,1317,銅鑼,三等
2020-06-11,3180,618,667,1285,銅鑼,三等
2020-06-12,3180,785,896,1681,銅鑼,三等
2020-06-13,3180,1019,1069,2088,銅鑼,三等
2020-06-14,3180,1251,1015,2266,銅鑼,三等
2020-06-15,3180,761,735,1496,銅鑼,三等
2020-06-16,3180,644,672,1316,銅鑼,三等
2020-06-17,3180,659,670,1329,銅鑼,三等
2020-06-18,3180,625,622,1247,銅鑼,三等
2020-06-19,3180,669,769,1438,銅鑼,三等
2020-06-20,3180,824,938,1762,銅鑼,三等
2020-06-21,3180,990,863,1853,銅鑼,三等
2020-06-22,3180,801,727,1528,銅鑼,三等
2020-06-23,3180,688,691,1379,銅鑼,三等
2020-06-24,3180,740,948,1688,銅鑼,三等
2020-06-25,3180,894,1247,2141,銅鑼,三等
2020-06-26,3180,1082,1017,2099,銅鑼,三等
2020-06-27,3180,1269,1100,2369,銅鑼,三等
2020-06-28,3180,1283,954,2237,銅鑼,三等
2020-06-29,3180,793,715,1508,銅鑼,三等
2020-06-30,3180,683,655,1338,銅鑼,三等
2020-07-01,3180,652,673,1325,銅鑼,三等
2020-07-02,3180,637,650,1287,銅鑼,三等
2020-07-03,3180,767,811,1578,銅鑼,三等
2020-07-04,3180,872,938,1810,銅鑼,三等
2020-07-05,3180,957,796,1753,銅鑼,三等
2020-07-06,3180,707,702,1409,銅鑼,三等
2020-07-07,3180,663,667,1330,銅鑼,三等
2020-07-08,3180,687,688,1375,銅鑼,三等
2020-07-09,3180,667,668,1335,銅鑼,三等
2020-07-10,3180,784,913,1697,銅鑼,三等
2020-07-11,3180,1062,1159,2221,銅鑼,三等
2020-07-12,3180,1261,1134,2395,銅鑼,三等
2020-07-13,3180,755,734,1489,銅鑼,三等
2020-07-14,3180,725,724,1449,銅鑼,三等
2020-07-15,3180,694,693,1387,銅鑼,三等
2020-07-16,3180,756,706,1462,銅鑼,三等
2020-07-17,3180,841,938,1779,銅鑼,三等
2020-07-18,3180,1049,1179,2228,銅鑼,三等
2020-07-19,3180,1241,1091,2332,銅鑼,三等
2020-07-20,3180,848,774,1622,銅鑼,三等
2020-07-21,3180,678,730,1408,銅鑼,三等
2020-07-22,3180,777,731,1508,銅鑼,三等
2020-07-23,3180,688,658,1346,銅鑼,三等
2020-07-24,3180,778,880,1658,銅鑼,三等
2020-07-25,3180,987,1066,2053,銅鑼,三等
2020-07-26,3180,1179,996,2175,銅鑼,三等
2020-07-27,3180,689,656,1345,銅鑼,三等
2020-07-28,3180,695,652,1347,銅鑼,三等
2020-07-29,3180,684,628,1312,銅鑼,三等
2020-07-30,3180,678,717,1395,銅鑼,三等
2020-07-31,3180,884,891,1775,銅鑼,三等
2020-08-01,3180,904,1019,1923,銅鑼,三等
2020-08-02,3180,987,841,1828,銅鑼,三等
2020-08-03,3180,645,614,1259,銅鑼,三等
2020-08-04,3180,671,658,1329,銅鑼,三等
2020-08-05,3180,722,692,1414,銅鑼,三等
2020-08-06,3180,717,733,1450,銅鑼,三等
2020-08-07,3180,922,1038,1960,銅鑼,三等
2020-08-08,3180,1060,1179,2239,銅鑼,三等
2020-08-09,3180,1249,963,2212,銅鑼,三等
2020-08-10,3180,797,750,1547,銅鑼,三等
2020-08-11,3180,670,646,1316,銅鑼,三等
2020-08-12,3180,673,668,1341,銅鑼,三等
2020-08-13,3180,743,724,1467,銅鑼,三等
2020-08-14,3180,817,863,1680,銅鑼,三等
2020-08-15,3180,1037,1042,2079,銅鑼,三等
2020-08-16,3180,1232,1130,2362,銅鑼,三等
2020-08-17,3180,776,772,1548,銅鑼,三等
2020-08-18,3180,693,659,1352,銅鑼,三等
2020-08-19,3180,715,719,1434,銅鑼,三等
2020-08-20,3180,726,738,1464,銅鑼,三等
2020-08-21,3180,843,947,1790,銅鑼,三等
2020-08-22,3180,914,971,1885,銅鑼,三等
2020-08-23,3180,1081,942,2023,銅鑼,三等
2020-08-24,3180,790,761,1551,銅鑼,三等
2020-08-25,3180,777,706,1483,銅鑼,三等
2020-08-26,3180,665,663,1328,銅鑼,三等
2020-08-27,3180,666,642,1308,銅鑼,三等
2020-08-28,3180,802,829,1631,銅鑼,三等
2020-08-29,3180,879,900,1779,銅鑼,三等
2020-08-30,3180,1046,908,1954,銅鑼,三等
2020-08-31,3180,755,717,1472,銅鑼,三等
2020-09-01,3180,677,696,1373,銅鑼,三等
2020-09-02,3180,675,648,1323,銅鑼,三等
2020-09-03,3180,671,666,1337,銅鑼,三等
2020-09-04,3180,763,877,1640,銅鑼,三等
2020-09-05,3180,988,1108,2096,銅鑼,三等
2020-09-06,3180,1163,972,2135,銅鑼,三等
2020-09-07,3180,754,728,1482,銅鑼,三等
2020-09-08,3180,734,695,1429,銅鑼,三等
2020-09-09,3180,706,706,1412,銅鑼,三等
2020-09-10,3180,701,705,1406,銅鑼,三等
2020-09-11,3180,867,969,1836,銅鑼,三等
2020-09-12,3180,1068,1062,2130,銅鑼,三等
2020-09-13,3180,1294,1081,2375,銅鑼,三等
2020-09-14,3180,768,756,1524,銅鑼,三等
2020-09-15,3180,698,723,1421,銅鑼,三等
2020-09-16,3180,749,704,1453,銅鑼,三等
2020-09-17,3180,650,675,1325,銅鑼,三等
2020-09-18,3180,793,1036,1829,銅鑼,三等
2020-09-19,3180,973,1061,2034,銅鑼,三等
2020-09-20,3180,1306,955,2261,銅鑼,三等
2020-09-21,3180,793,683,1476,銅鑼,三等
2020-09-22,3180,680,658,1338,銅鑼,三等
2020-09-23,3180,722,686,1408,銅鑼,三等
2020-09-24,3180,645,653,1298,銅鑼,三等
2020-09-25,3180,713,786,1499,銅鑼,三等
2020-09-26,3180,857,894,1751,銅鑼,三等
2020-09-27,3180,927,805,1732,銅鑼,三等
2020-09-28,3180,681,639,1320,銅鑼,三等
2020-09-29,3180,628,641,1269,銅鑼,三等
2020-09-30,3180,723,1052,1775,銅鑼,三等
2020-10-01,3180,943,1302,2245,銅鑼,三等
2020-10-02,3180,1144,1122,2266,銅鑼,三等
2020-10-03,3180,1222,1085,2307,銅鑼,三等
2020-10-04,3180,1350,865,2215,銅鑼,三等
2020-10-05,3180,786,710,1496,銅鑼,三等
2020-10-06,3180,718,725,1443,銅鑼,三等
2020-10-07,3180,661,651,1312,銅鑼,三等
2020-10-08,3180,812,998,1810,銅鑼,三等
2020-10-09,3180,978,1096,2074,銅鑼,三等
2020-10-10,3180,1129,1087,2216,銅鑼,三等
2020-10-11,3180,1398,1051,2449,銅鑼,三等
2020-10-12,3180,790,742,1532,銅鑼,三等
2020-10-13,3180,762,689,1451,銅鑼,三等
2020-10-14,3180,699,687,1386,銅鑼,三等
2020-10-15,3180,724,720,1444,銅鑼,三等
2020-10-16,3180,807,972,1779,銅鑼,三等
2020-10-17,3180,989,1080,2069,銅鑼,三等
2020-10-18,3180,1305,1069,2374,銅鑼,三等
2020-10-19,3180,753,721,1474,銅鑼,三等
2020-10-20,3180,687,677,1364,銅鑼,三等
2020-10-21,3180,693,696,1389,銅鑼,三等
2020-10-22,3180,633,631,1264,銅鑼,三等
2020-10-23,3180,709,906,1615,銅鑼,三等
2020-10-24,3180,872,1003,1875,銅鑼,三等
2020-10-25,3180,1155,890,2045,銅鑼,三等
2020-10-26,3180,751,733,1484,銅鑼,三等
2020-10-27,3180,642,677,1319,銅鑼,三等
2020-10-28,3180,690,683,1373,銅鑼,三等
2020-10-29,3180,682,666,1348,銅鑼,三等
2020-10-30,3180,799,1008,1807,銅鑼,三等
2020-10-31,3180,873,1014,1887,銅鑼,三等
2020-11-01,3180,1239,915,2154,銅鑼,三等
2020-11-02,3180,769,740,1509,銅鑼,三等
2020-11-03,3180,706,693,1399,銅鑼,三等
2020-11-04,3180,787,788,1575,銅鑼,三等
2020-11-05,3180,690,715,1405,銅鑼,三等
2020-11-06,3180,795,977,1772,銅鑼,三等
2020-11-07,3180,1129,1201,2330,銅鑼,三等
2020-11-08,3180,1533,1224,2757,銅鑼,三等
2020-11-09,3180,948,894,1842,銅鑼,三等
2020-11-10,3180,784,769,1553,銅鑼,三等
2020-11-11,3180,960,972,1932,銅鑼,三等
2020-11-12,3180,998,1037,2035,銅鑼,三等
2020-11-13,3180,1112,1347,2459,銅鑼,三等
2020-11-14,3180,2401,2516,4917,銅鑼,三等
2020-11-15,3180,3192,2763,5955,銅鑼,三等
2020-11-16,3180,1184,1093,2277,銅鑼,三等
2020-11-17,3180,959,949,1908,銅鑼,三等
2020-11-18,3180,1028,985,2013,銅鑼,三等
2020-11-19,3180,999,990,1989,銅鑼,三等
2020-11-20,3180,1103,1243,2346,銅鑼,三等
2020-11-21,3180,1684,1732,3416,銅鑼,三等
2020-11-22,3180,1837,1603,3440,銅鑼,三等
2020-11-23,3180,924,843,1767,銅鑼,三等
2020-11-24,3180,913,918,1831,銅鑼,三等
2020-11-25,3180,811,829,1640,銅鑼,三等
2020-11-26,3180,810,803,1613,銅鑼,三等
2020-11-27,3180,861,1030,1891,銅鑼,三等
2020-11-28,3180,1306,1312,2618,銅鑼,三等
2020-11-29,3180,1688,1142,2830,銅鑼,三等
2020-11-30,3180,792,735,1527,銅鑼,三等
2020-12-01,3180,701,696,1397,銅鑼,三等
2020-12-02,3180,742,727,1469,銅鑼,三等
2020-12-03,3180,674,649,1323,銅鑼,三等
2020-12-04,3180,744,1023,1767,銅鑼,三等
2020-12-05,3180,1091,1102,2193,銅鑼,三等
2020-12-06,3180,1594,1018,2612,銅鑼,三等
2020-12-07,3180,771,692,1463,銅鑼,三等
2020-12-08,3180,663,627,1290,銅鑼,三等
2020-12-09,3180,602,605,1207,銅鑼,三等
2020-12-10,3180,657,670,1327,銅鑼,三等
2020-12-11,3180,834,1025,1859,銅鑼,三等
2020-12-12,3180,1137,1137,2274,銅鑼,三等
2020-12-13,3180,1554,1153,2707,銅鑼,三等
2020-12-14,3180,812,753,1565,銅鑼,三等
2020-12-15,3180,681,677,1358,銅鑼,三等
2020-12-16,3180,714,680,1394,銅鑼,三等
2020-12-17,3180,673,656,1329,銅鑼,三等
2020-12-18,3180,825,1034,1859,銅鑼,三等
2020-12-19,3180,1016,1140,2156,銅鑼,三等
2020-12-20,3180,1339,983,2322,銅鑼,三等
2020-12-21,3180,801,678,1479,銅鑼,三等
2020-12-22,3180,708,689,1397,銅鑼,三等
2020-12-23,3180,628,631,1259,銅鑼,三等
2020-12-24,3180,641,663,1304,銅鑼,三等
2020-12-25,3180,806,1010,1816,銅鑼,三等
2020-12-26,3180,967,1094,2061,銅鑼,三等
2020-12-27,3180,1294,961,2255,銅鑼,三等
2020-12-28,3180,756,711,1467,銅鑼,三等
2020-12-29,3180,761,772,1533,銅鑼,三等
2020-12-30,3180,653,734,1387,銅鑼,三等
2020-12-31,3180,845,959,1804,銅鑼,三等
2020-01-01,3190,802,837,1639,三義,三等
2020-01-02,3190,691,765,1456,三義,三等
2020-01-03,3190,711,889,1600,三義,三等
2020-01-04,3190,793,929,1722,三義,三等
2020-01-05,3190,865,718,1583,三義,三等
2020-01-06,3190,753,725,1478,三義,三等
2020-01-07,3190,657,751,1408,三義,三等
2020-01-08,3190,716,732,1448,三義,三等
2020-01-09,3190,676,725,1401,三義,三等
2020-01-10,3190,811,1128,1939,三義,三等
2020-01-11,3190,908,996,1904,三義,三等
2020-01-12,3190,1000,820,1820,三義,三等
2020-01-13,3190,738,723,1461,三義,三等
2020-01-14,3190,735,752,1487,三義,三等
2020-01-15,3190,711,734,1445,三義,三等
2020-01-16,3190,817,924,1741,三義,三等
2020-01-17,3190,937,1053,1990,三義,三等
2020-01-18,3190,825,882,1707,三義,三等
2020-01-19,3190,802,751,1553,三義,三等
2020-01-20,3190,819,788,1607,三義,三等
2020-01-21,3190,773,826,1599,三義,三等
2020-01-22,3190,798,960,1758,三義,三等
2020-01-23,3190,589,866,1455,三義,三等
2020-01-24,3190,458,774,1232,三義,三等
2020-01-25,3190,854,803,1657,三義,三等
2020-01-26,3190,721,701,1422,三義,三等
2020-01-27,3190,1002,853,1855,三義,三等
2020-01-28,3190,1101,892,1993,三義,三等
2020-01-29,3190,876,625,1501,三義,三等
2020-01-30,3190,734,753,1487,三義,三等
2020-01-31,3190,778,749,1527,三義,三等
2020-02-01,3190,621,673,1294,三義,三等
2020-02-02,3190,676,636,1312,三義,三等
2020-02-03,3190,646,663,1309,三義,三等
2020-02-04,3190,648,640,1288,三義,三等
2020-02-05,3190,679,640,1319,三義,三等
2020-02-06,3190,671,717,1388,三義,三等
2020-02-07,3190,740,798,1538,三義,三等
2020-02-08,3190,693,953,1646,三義,三等
2020-02-09,3190,1005,837,1842,三義,三等
2020-02-10,3190,801,728,1529,三義,三等
2020-02-11,3190,700,679,1379,三義,三等
2020-02-12,3190,803,806,1609,三義,三等
2020-02-13,3190,662,642,1304,三義,三等
2020-02-14,3190,759,843,1602,三義,三等
2020-02-15,3190,750,896,1646,三義,三等
2020-02-16,3190,690,596,1286,三義,三等
2020-02-17,3190,672,631,1303,三義,三等
2020-02-18,3190,623,595,1218,三義,三等
2020-02-19,3190,759,752,1511,三義,三等
2020-02-20,3190,662,679,1341,三義,三等
2020-02-21,3190,759,860,1619,三義,三等
2020-02-22,3190,804,937,1741,三義,三等
2020-02-23,3190,856,721,1577,三義,三等
2020-02-24,3190,764,721,1485,三義,三等
2020-02-25,3190,654,706,1360,三義,三等
2020-02-26,3190,690,697,1387,三義,三等
2020-02-27,3190,713,906,1619,三義,三等
2020-02-28,3190,773,1019,1792,三義,三等
2020-02-29,3190,803,802,1605,三義,三等
2020-03-01,3190,864,614,1478,三義,三等
2020-03-02,3190,706,696,1402,三義,三等
2020-03-03,3190,616,634,1250,三義,三等
2020-03-04,3190,576,615,1191,三義,三等
2020-03-05,3190,516,592,1108,三義,三等
2020-03-06,3190,740,871,1611,三義,三等
2020-03-07,3190,559,712,1271,三義,三等
2020-03-08,3190,762,585,1347,三義,三等
2020-03-09,3190,665,659,1324,三義,三等
2020-03-10,3190,558,627,1185,三義,三等
2020-03-11,3190,627,696,1323,三義,三等
2020-03-12,3190,633,715,1348,三義,三等
2020-03-13,3190,726,905,1631,三義,三等
2020-03-14,3190,561,665,1226,三義,三等
2020-03-15,3190,822,658,1480,三義,三等
2020-03-16,3190,647,655,1302,三義,三等
2020-03-17,3190,588,641,1229,三義,三等
2020-03-18,3190,558,613,1171,三義,三等
2020-03-19,3190,556,594,1150,三義,三等
2020-03-20,3190,658,831,1489,三義,三等
2020-03-21,3190,476,666,1142,三義,三等
2020-03-22,3190,697,459,1156,三義,三等
2020-03-23,3190,647,603,1250,三義,三等
2020-03-24,3190,563,581,1144,三義,三等
2020-03-25,3190,565,591,1156,三義,三等
2020-03-26,3190,553,594,1147,三義,三等
2020-03-27,3190,629,785,1414,三義,三等
2020-03-28,3190,422,539,961,三義,三等
2020-03-29,3190,610,551,1161,三義,三等
2020-03-30,3190,620,595,1215,三義,三等
2020-03-31,3190,532,596,1128,三義,三等
2020-04-01,3190,617,790,1407,三義,三等
2020-04-02,3190,402,605,1007,三義,三等
2020-04-03,3190,516,603,1119,三義,三等
2020-04-04,3190,426,400,826,三義,三等
2020-04-05,3190,604,387,991,三義,三等
2020-04-06,3190,617,559,1176,三義,三等
2020-04-07,3190,528,526,1054,三義,三等
2020-04-08,3190,530,565,1095,三義,三等
2020-04-09,3190,553,573,1126,三義,三等
2020-04-10,3190,622,790,1412,三義,三等
2020-04-11,3190,471,603,1074,三義,三等
2020-04-12,3190,578,466,1044,三義,三等
2020-04-13,3190,603,579,1182,三義,三等
2020-04-14,3190,551,569,1120,三義,三等
2020-04-15,3190,574,624,1198,三義,三等
2020-04-16,3190,575,633,1208,三義,三等
2020-04-17,3190,660,826,1486,三義,三等
2020-04-18,3190,612,825,1437,三義,三等
2020-04-19,3190,768,682,1450,三義,三等
2020-04-20,3190,649,600,1249,三義,三等
2020-04-21,3190,552,567,1119,三義,三等
2020-04-22,3190,515,568,1083,三義,三等
2020-04-23,3190,468,524,992,三義,三等
2020-04-24,3190,554,745,1299,三義,三等
2020-04-25,3190,467,787,1254,三義,三等
2020-04-26,3190,711,674,1385,三義,三等
2020-04-27,3190,640,632,1272,三義,三等
2020-04-28,3190,573,653,1226,三義,三等
2020-04-29,3190,555,615,1170,三義,三等
2020-04-30,3190,622,728,1350,三義,三等
2020-05-01,3190,716,1060,1776,三義,三等
2020-05-02,3190,642,854,1496,三義,三等
2020-05-03,3190,814,625,1439,三義,三等
2020-05-04,3190,708,670,1378,三義,三等
2020-05-05,3190,594,634,1228,三義,三等
2020-05-06,3190,616,656,1272,三義,三等
2020-05-07,3190,584,635,1219,三義,三等
2020-05-08,3190,813,1013,1826,三義,三等
2020-05-09,3190,595,875,1470,三義,三等
2020-05-10,3190,925,675,1600,三義,三等
2020-05-11,3190,685,641,1326,三義,三等
2020-05-12,3190,613,633,1246,三義,三等
2020-05-13,3190,598,625,1223,三義,三等
2020-05-14,3190,583,620,1203,三義,三等
2020-05-15,3190,725,887,1612,三義,三等
2020-05-16,3190,681,872,1553,三義,三等
2020-05-17,3190,744,626,1370,三義,三等
2020-05-18,3190,607,555,1162,三義,三等
2020-05-19,3190,519,519,1038,三義,三等
2020-05-20,3190,583,609,1192,三義,三等
2020-05-21,3190,528,589,1117,三義,三等
2020-05-22,3190,558,679,1237,三義,三等
2020-05-23,3190,449,586,1035,三義,三等
2020-05-24,3190,804,681,1485,三義,三等
2020-05-25,3190,639,612,1251,三義,三等
2020-05-26,3190,529,567,1096,三義,三等
2020-05-27,3190,528,541,1069,三義,三等
2020-05-28,3190,503,538,1041,三義,三等
2020-05-29,3190,697,836,1533,三義,三等
2020-05-30,3190,681,844,1525,三義,三等
2020-05-31,3190,868,682,1550,三義,三等
2020-06-01,3190,676,659,1335,三義,三等
2020-06-02,3190,564,582,1146,三義,三等
2020-06-03,3190,665,705,1370,三義,三等
2020-06-04,3190,602,634,1236,三義,三等
2020-06-05,3190,745,934,1679,三義,三等
2020-06-06,3190,739,865,1604,三義,三等
2020-06-07,3190,797,643,1440,三義,三等
2020-06-08,3190,629,617,1246,三義,三等
2020-06-09,3190,580,608,1188,三義,三等
2020-06-10,3190,626,636,1262,三義,三等
2020-06-11,3190,630,632,1262,三義,三等
2020-06-12,3190,737,909,1646,三義,三等
2020-06-13,3190,809,939,1748,三義,三等
2020-06-14,3190,847,700,1547,三義,三等
2020-06-15,3190,653,645,1298,三義,三等
2020-06-16,3190,808,847,1655,三義,三等
2020-06-17,3190,649,658,1307,三義,三等
2020-06-18,3190,602,645,1247,三義,三等
2020-06-19,3190,667,771,1438,三義,三等
2020-06-20,3190,698,810,1508,三義,三等
2020-06-21,3190,706,621,1327,三義,三等
2020-06-22,3190,675,667,1342,三義,三等
2020-06-23,3190,616,652,1268,三義,三等
2020-06-24,3190,710,907,1617,三義,三等
2020-06-25,3190,685,936,1621,三義,三等
2020-06-26,3190,944,994,1938,三義,三等
2020-06-27,3190,908,801,1709,三義,三等
2020-06-28,3190,905,665,1570,三義,三等
2020-06-29,3190,694,674,1368,三義,三等
2020-06-30,3190,642,644,1286,三義,三等
2020-07-01,3190,594,590,1184,三義,三等
2020-07-02,3190,600,644,1244,三義,三等
2020-07-03,3190,687,767,1454,三義,三等
2020-07-04,3190,709,870,1579,三義,三等
2020-07-05,3190,751,682,1433,三義,三等
2020-07-06,3190,709,672,1381,三義,三等
2020-07-07,3190,647,662,1309,三義,三等
2020-07-08,3190,608,644,1252,三義,三等
2020-07-09,3190,644,632,1276,三義,三等
2020-07-10,3190,769,857,1626,三義,三等
2020-07-11,3190,696,754,1450,三義,三等
2020-07-12,3190,846,716,1562,三義,三等
2020-07-13,3190,701,716,1417,三義,三等
2020-07-14,3190,668,724,1392,三義,三等
2020-07-15,3190,755,733,1488,三義,三等
2020-07-16,3190,714,708,1422,三義,三等
2020-07-17,3190,901,957,1858,三義,三等
2020-07-18,3190,756,842,1598,三義,三等
2020-07-19,3190,961,792,1753,三義,三等
2020-07-20,3190,706,717,1423,三義,三等
2020-07-21,3190,613,596,1209,三義,三等
2020-07-22,3190,677,652,1329,三義,三等
2020-07-23,3190,645,666,1311,三義,三等
2020-07-24,3190,695,775,1470,三義,三等
2020-07-25,3190,767,855,1622,三義,三等
2020-07-26,3190,819,682,1501,三義,三等
2020-07-27,3190,744,743,1487,三義,三等
2020-07-28,3190,607,609,1216,三義,三等
2020-07-29,3190,697,705,1402,三義,三等
2020-07-30,3190,673,645,1318,三義,三等
2020-07-31,3190,731,827,1558,三義,三等
2020-08-01,3190,770,856,1626,三義,三等
2020-08-02,3190,849,693,1542,三義,三等
2020-08-03,3190,597,584,1181,三義,三等
2020-08-04,3190,655,625,1280,三義,三等
2020-08-05,3190,619,644,1263,三義,三等
2020-08-06,3190,688,705,1393,三義,三等
2020-08-07,3190,755,989,1744,三義,三等
2020-08-08,3190,861,924,1785,三義,三等
2020-08-09,3190,880,653,1533,三義,三等
2020-08-10,3190,693,706,1399,三義,三等
2020-08-11,3190,610,617,1227,三義,三等
2020-08-12,3190,673,581,1254,三義,三等
2020-08-13,3190,662,650,1312,三義,三等
2020-08-14,3190,757,900,1657,三義,三等
2020-08-15,3190,774,860,1634,三義,三等
2020-08-16,3190,946,734,1680,三義,三等
2020-08-17,3190,732,741,1473,三義,三等
2020-08-18,3190,711,717,1428,三義,三等
2020-08-19,3190,722,769,1491,三義,三等
2020-08-20,3190,691,728,1419,三義,三等
2020-08-21,3190,879,870,1749,三義,三等
2020-08-22,3190,721,730,1451,三義,三等
2020-08-23,3190,809,684,1493,三義,三等
2020-08-24,3190,756,705,1461,三義,三等
2020-08-25,3190,696,699,1395,三義,三等
2020-08-26,3190,606,684,1290,三義,三等
2020-08-27,3190,664,690,1354,三義,三等
2020-08-28,3190,783,767,1550,三義,三等
2020-08-29,3190,734,783,1517,三義,三等
2020-08-30,3190,763,624,1387,三義,三等
2020-08-31,3190,625,699,1324,三義,三等
2020-09-01,3190,658,670,1328,三義,三等
2020-09-02,3190,614,628,1242,三義,三等
2020-09-03,3190,608,601,1209,三義,三等
2020-09-04,3190,785,942,1727,三義,三等
2020-09-05,3190,972,1002,1974,三義,三等
2020-09-06,3190,842,691,1533,三義,三等
2020-09-07,3190,716,703,1419,三義,三等
2020-09-08,3190,666,671,1337,三義,三等
2020-09-09,3190,674,695,1369,三義,三等
2020-09-10,3190,622,640,1262,三義,三等
2020-09-11,3190,808,903,1711,三義,三等
2020-09-12,3190,732,851,1583,三義,三等
2020-09-13,3190,995,736,1731,三義,三等
2020-09-14,3190,698,665,1363,三義,三等
2020-09-15,3190,623,644,1267,三義,三等
2020-09-16,3190,634,676,1310,三義,三等
2020-09-17,3190,596,640,1236,三義,三等
2020-09-18,3190,703,922,1625,三義,三等
2020-09-19,3190,764,897,1661,三義,三等
2020-09-20,3190,904,646,1550,三義,三等
2020-09-21,3190,681,641,1322,三義,三等
2020-09-22,3190,625,647,1272,三義,三等
2020-09-23,3190,591,644,1235,三義,三等
2020-09-24,3190,580,679,1259,三義,三等
2020-09-25,3190,694,787,1481,三義,三等
2020-09-26,3190,682,827,1509,三義,三等
2020-09-27,3190,777,750,1527,三義,三等
2020-09-28,3190,662,635,1297,三義,三等
2020-09-29,3190,651,682,1333,三義,三等
2020-09-30,3190,715,1018,1733,三義,三等
2020-10-01,3190,858,1215,2073,三義,三等
2020-10-02,3190,1156,1086,2242,三義,三等
2020-10-03,3190,1057,887,1944,三義,三等
2020-10-04,3190,1081,651,1732,三義,三等
2020-10-05,3190,718,654,1372,三義,三等
2020-10-06,3190,587,629,1216,三義,三等
2020-10-07,3190,623,659,1282,三義,三等
2020-10-08,3190,746,964,1710,三義,三等
2020-10-09,3190,930,1156,2086,三義,三等
2020-10-10,3190,895,908,1803,三義,三等
2020-10-11,3190,1009,701,1710,三義,三等
2020-10-12,3190,735,696,1431,三義,三等
2020-10-13,3190,630,645,1275,三義,三等
2020-10-14,3190,668,682,1350,三義,三等
2020-10-15,3190,641,679,1320,三義,三等
2020-10-16,3190,736,916,1652,三義,三等
2020-10-17,3190,774,976,1750,三義,三等
2020-10-18,3190,984,804,1788,三義,三等
2020-10-19,3190,743,747,1490,三義,三等
2020-10-20,3190,677,669,1346,三義,三等
2020-10-21,3190,660,669,1329,三義,三等
2020-10-22,3190,642,666,1308,三義,三等
2020-10-23,3190,711,878,1589,三義,三等
2020-10-24,3190,712,919,1631,三義,三等
2020-10-25,3190,879,696,1575,三義,三等
2020-10-26,3190,814,746,1560,三義,三等
2020-10-27,3190,689,687,1376,三義,三等
2020-10-28,3190,634,690,1324,三義,三等
2020-10-29,3190,649,724,1373,三義,三等
2020-10-30,3190,843,944,1787,三義,三等
2020-10-31,3190,784,859,1643,三義,三等
2020-11-01,3190,931,698,1629,三義,三等
2020-11-02,3190,677,649,1326,三義,三等
2020-11-03,3190,676,699,1375,三義,三等
2020-11-04,3190,631,697,1328,三義,三等
2020-11-05,3190,605,606,1211,三義,三等
2020-11-06,3190,729,870,1599,三義,三等
2020-11-07,3190,784,898,1682,三義,三等
2020-11-08,3190,920,704,1624,三義,三等
2020-11-09,3190,734,669,1403,三義,三等
2020-11-10,3190,578,607,1185,三義,三等
2020-11-11,3190,633,658,1291,三義,三等
2020-11-12,3190,707,711,1418,三義,三等
2020-11-13,3190,729,925,1654,三義,三等
2020-11-14,3190,765,939,1704,三義,三等
2020-11-15,3190,1003,764,1767,三義,三等
2020-11-16,3190,753,691,1444,三義,三等
2020-11-17,3190,650,702,1352,三義,三等
2020-11-18,3190,651,676,1327,三義,三等
2020-11-19,3190,676,708,1384,三義,三等
2020-11-20,3190,850,1006,1856,三義,三等
2020-11-21,3190,816,982,1798,三義,三等
2020-11-22,3190,936,816,1752,三義,三等
2020-11-23,3190,722,685,1407,三義,三等
2020-11-24,3190,665,660,1325,三義,三等
2020-11-25,3190,628,646,1274,三義,三等
2020-11-26,3190,659,716,1375,三義,三等
2020-11-27,3190,764,988,1752,三義,三等
2020-11-28,3190,700,894,1594,三義,三等
2020-11-29,3190,893,737,1630,三義,三等
2020-11-30,3190,671,640,1311,三義,三等
2020-12-01,3190,620,634,1254,三義,三等
2020-12-02,3190,630,709,1339,三義,三等
2020-12-03,3190,604,656,1260,三義,三等
2020-12-04,3190,725,885,1610,三義,三等
2020-12-05,3190,790,955,1745,三義,三等
2020-12-06,3190,1001,988,1989,三義,三等
2020-12-07,3190,719,701,1420,三義,三等
2020-12-08,3190,604,616,1220,三義,三等
2020-12-09,3190,526,593,1119,三義,三等
2020-12-10,3190,625,665,1290,三義,三等
2020-12-11,3190,785,1009,1794,三義,三等
2020-12-12,3190,819,979,1798,三義,三等
2020-12-13,3190,977,841,1818,三義,三等
2020-12-14,3190,710,707,1417,三義,三等
2020-12-15,3190,628,645,1273,三義,三等
2020-12-16,3190,599,707,1306,三義,三等
2020-12-17,3190,719,687,1406,三義,三等
2020-12-18,3190,713,933,1646,三義,三等
2020-12-19,3190,855,1026,1881,三義,三等
2020-12-20,3190,1041,1014,2055,三義,三等
2020-12-21,3190,653,724,1377,三義,三等
2020-12-22,3190,642,693,1335,三義,三等
2020-12-23,3190,509,537,1046,三義,三等
2020-12-24,3190,641,660,1301,三義,三等
2020-12-25,3190,837,958,1795,三義,三等
2020-12-26,3190,746,890,1636,三義,三等
2020-12-27,3190,882,815,1697,三義,三等
2020-12-28,3190,671,639,1310,三義,三等
2020-12-29,3190,610,644,1254,三義,三等
2020-12-30,3190,564,626,1190,三義,三等
2020-12-31,3190,706,930,1636,三義,三等
2020-01-01,3210,750,719,1469,泰安,簡易
2020-01-02,3210,711,646,1357,泰安,簡易
2020-01-03,3210,492,564,1056,泰安,簡易
2020-01-04,3210,704,845,1549,泰安,簡易
2020-01-05,3210,801,686,1487,泰安,簡易
2020-01-06,3210,497,438,935,泰安,簡易
2020-01-07,3210,392,411,803,泰安,簡易
2020-01-08,3210,540,542,1082,泰安,簡易
2020-01-09,3210,590,579,1169,泰安,簡易
2020-01-10,3210,466,697,1163,泰安,簡易
2020-01-11,3210,636,768,1404,泰安,簡易
2020-01-12,3210,860,742,1602,泰安,簡易
2020-01-13,3210,434,391,825,泰安,簡易
2020-01-14,3210,419,404,823,泰安,簡易
2020-01-15,3210,408,424,832,泰安,簡易
2020-01-16,3210,462,500,962,泰安,簡易
2020-01-17,3210,446,485,931,泰安,簡易
2020-01-18,3210,599,696,1295,泰安,簡易
2020-01-19,3210,710,667,1377,泰安,簡易
2020-01-20,3210,417,441,858,泰安,簡易
2020-01-21,3210,412,465,877,泰安,簡易
2020-01-22,3210,377,501,878,泰安,簡易
2020-01-23,3210,417,576,993,泰安,簡易
2020-01-24,3210,503,661,1164,泰安,簡易
2020-01-25,3210,1276,1220,2496,泰安,簡易
2020-01-26,3210,459,599,1058,泰安,簡易
2020-01-27,3210,1134,1007,2141,泰安,簡易
2020-01-28,3210,1000,932,1932,泰安,簡易
2020-01-29,3210,900,797,1697,泰安,簡易
2020-01-30,3210,485,481,966,泰安,簡易
2020-01-31,3210,436,482,918,泰安,簡易
2020-02-01,3210,591,674,1265,泰安,簡易
2020-02-02,3210,705,692,1397,泰安,簡易
2020-02-03,3210,405,428,833,泰安,簡易
2020-02-04,3210,496,481,977,泰安,簡易
2020-02-05,3210,561,548,1109,泰安,簡易
2020-02-06,3210,408,450,858,泰安,簡易
2020-02-07,3210,425,471,896,泰安,簡易
2020-02-08,3210,653,950,1603,泰安,簡易
2020-02-09,3210,933,916,1849,泰安,簡易
2020-02-10,3210,481,540,1021,泰安,簡易
2020-02-11,3210,467,526,993,泰安,簡易
2020-02-12,3210,550,635,1185,泰安,簡易
2020-02-13,3210,447,469,916,泰安,簡易
2020-02-14,3210,491,558,1049,泰安,簡易
2020-02-15,3210,961,1176,2137,泰安,簡易
2020-02-16,3210,731,786,1517,泰安,簡易
2020-02-17,3210,446,473,919,泰安,簡易
2020-02-18,3210,525,559,1084,泰安,簡易
2020-02-19,3210,598,683,1281,泰安,簡易
2020-02-20,3210,599,723,1322,泰安,簡易
2020-02-21,3210,643,866,1509,泰安,簡易
2020-02-22,3210,1455,1819,3274,泰安,簡易
2020-02-23,3210,1364,1450,2814,泰安,簡易
2020-02-24,3210,524,505,1029,泰安,簡易
2020-02-25,3210,566,577,1143,泰安,簡易
2020-02-26,3210,701,701,1402,泰安,簡易
2020-02-27,3210,711,889,1600,泰安,簡易
2020-02-28,3210,1835,1917,3752,泰安,簡易
2020-02-29,3210,2307,2326,4633,泰安,簡易
2020-03-01,3210,2162,1936,4098,泰安,簡易
2020-03-02,3210,864,838,1702,泰安,簡易
2020-03-03,3210,853,843,1696,泰安,簡易
2020-03-04,3210,706,728,1434,泰安,簡易
2020-03-05,3210,387,418,805,泰安,簡易
2020-03-06,3210,662,851,1513,泰安,簡易
2020-03-07,3210,1035,1193,2228,泰安,簡易
2020-03-08,3210,1309,1199,2508,泰安,簡易
2020-03-09,3210,575,556,1131,泰安,簡易
2020-03-10,3210,322,320,642,泰安,簡易
2020-03-11,3210,587,580,1167,泰安,簡易
2020-03-12,3210,560,550,1110,泰安,簡易
2020-03-13,3210,409,573,982,泰安,簡易
2020-03-14,3210,466,586,1052,泰安,簡易
2020-03-15,3210,920,779,1699,泰安,簡易
2020-03-16,3210,418,354,772,泰安,簡易
2020-03-17,3210,349,334,683,泰安,簡易
2020-03-18,3210,364,360,724,泰安,簡易
2020-03-19,3210,317,320,637,泰安,簡易
2020-03-20,3210,340,497,837,泰安,簡易
2020-03-21,3210,458,579,1037,泰安,簡易
2020-03-22,3210,654,538,1192,泰安,簡易
2020-03-23,3210,341,313,654,泰安,簡易
2020-03-24,3210,319,302,621,泰安,簡易
2020-03-25,3210,330,312,642,泰安,簡易
2020-03-26,3210,290,321,611,泰安,簡易
2020-03-27,3210,322,443,765,泰安,簡易
2020-03-28,3210,389,460,849,泰安,簡易
2020-03-29,3210,501,400,901,泰安,簡易
2020-03-30,3210,306,291,597,泰安,簡易
2020-03-31,3210,258,278,536,泰安,簡易
2020-04-01,3210,285,434,719,泰安,簡易
2020-04-02,3210,215,376,591,泰安,簡易
2020-04-03,3210,349,437,786,泰安,簡易
2020-04-04,3210,344,347,691,泰安,簡易
2020-04-05,3210,564,318,882,泰安,簡易
2020-04-06,3210,320,260,580,泰安,簡易
2020-04-07,3210,257,248,505,泰安,簡易
2020-04-08,3210,308,300,608,泰安,簡易
2020-04-09,3210,277,268,545,泰安,簡易
2020-04-10,3210,337,475,812,泰安,簡易
2020-04-11,3210,365,452,817,泰安,簡易
2020-04-12,3210,482,351,833,泰安,簡易
2020-04-13,3210,298,265,563,泰安,簡易
2020-04-14,3210,265,249,514,泰安,簡易
2020-04-15,3210,301,309,610,泰安,簡易
2020-04-16,3210,311,318,629,泰安,簡易
2020-04-17,3210,334,460,794,泰安,簡易
2020-04-18,3210,383,516,899,泰安,簡易
2020-04-19,3210,536,413,949,泰安,簡易
2020-04-20,3210,315,265,580,泰安,簡易
2020-04-21,3210,260,268,528,泰安,簡易
2020-04-22,3210,273,275,548,泰安,簡易
2020-04-23,3210,268,254,522,泰安,簡易
2020-04-24,3210,281,373,654,泰安,簡易
2020-04-25,3210,308,404,712,泰安,簡易
2020-04-26,3210,461,349,810,泰安,簡易
2020-04-27,3210,296,273,569,泰安,簡易
2020-04-28,3210,328,331,659,泰安,簡易
2020-04-29,3210,308,324,632,泰安,簡易
2020-04-30,3210,440,516,956,泰安,簡易
2020-05-01,3210,335,559,894,泰安,簡易
2020-05-02,3210,405,497,902,泰安,簡易
2020-05-03,3210,539,387,926,泰安,簡易
2020-05-04,3210,361,325,686,泰安,簡易
2020-05-05,3210,283,267,550,泰安,簡易
2020-05-06,3210,267,288,555,泰安,簡易
2020-05-07,3210,278,303,581,泰安,簡易
2020-05-08,3210,311,514,825,泰安,簡易
2020-05-09,3210,353,579,932,泰安,簡易
2020-05-10,3210,665,442,1107,泰安,簡易
2020-05-11,3210,369,296,665,泰安,簡易
2020-05-12,3210,293,281,574,泰安,簡易
2020-05-13,3210,318,304,622,泰安,簡易
2020-05-14,3210,296,328,624,泰安,簡易
2020-05-15,3210,293,453,746,泰安,簡易
2020-05-16,3210,428,535,963,泰安,簡易
2020-05-17,3210,524,485,1009,泰安,簡易
2020-05-18,3210,381,324,705,泰安,簡易
2020-05-19,3210,244,226,470,泰安,簡易
2020-05-20,3210,252,294,546,泰安,簡易
2020-05-21,3210,264,306,570,泰安,簡易
2020-05-22,3210,235,397,632,泰安,簡易
2020-05-23,3210,346,432,778,泰安,簡易
2020-05-24,3210,566,494,1060,泰安,簡易
2020-05-25,3210,330,313,643,泰安,簡易
2020-05-26,3210,300,311,611,泰安,簡易
2020-05-27,3210,279,280,559,泰安,簡易
2020-05-28,3210,289,302,591,泰安,簡易
2020-05-29,3210,331,476,807,泰安,簡易
2020-05-30,3210,458,623,1081,泰安,簡易
2020-05-31,3210,637,571,1208,泰安,簡易
2020-06-01,3210,364,324,688,泰安,簡易
2020-06-02,3210,281,310,591,泰安,簡易
2020-06-03,3210,339,354,693,泰安,簡易
2020-06-04,3210,305,320,625,泰安,簡易
2020-06-05,3210,315,469,784,泰安,簡易
2020-06-06,3210,434,575,1009,泰安,簡易
2020-06-07,3210,638,513,1151,泰安,簡易
2020-06-08,3210,360,328,688,泰安,簡易
2020-06-09,3210,310,305,615,泰安,簡易
2020-06-10,3210,312,308,620,泰安,簡易
2020-06-11,3210,302,312,614,泰安,簡易
2020-06-12,3210,334,482,816,泰安,簡易
2020-06-13,3210,512,670,1182,泰安,簡易
2020-06-14,3210,635,591,1226,泰安,簡易
2020-06-15,3210,342,305,647,泰安,簡易
2020-06-16,3210,309,323,632,泰安,簡易
2020-06-17,3210,328,344,672,泰安,簡易
2020-06-18,3210,342,354,696,泰安,簡易
2020-06-19,3210,288,409,697,泰安,簡易
2020-06-20,3210,419,531,950,泰安,簡易
2020-06-21,3210,465,526,991,泰安,簡易
2020-06-22,3210,325,323,648,泰安,簡易
2020-06-23,3210,318,350,668,泰安,簡易
2020-06-24,3210,328,492,820,泰安,簡易
2020-06-25,3210,361,530,891,泰安,簡易
2020-06-26,3210,526,618,1144,泰安,簡易
2020-06-27,3210,613,671,1284,泰安,簡易
2020-06-28,3210,750,586,1336,泰安,簡易
2020-06-29,3210,393,340,733,泰安,簡易
2020-06-30,3210,312,325,637,泰安,簡易
2020-07-01,3210,323,298,621,泰安,簡易
2020-07-02,3210,313,342,655,泰安,簡易
2020-07-03,3210,326,410,736,泰安,簡易
2020-07-04,3210,468,587,1055,泰安,簡易
2020-07-05,3210,544,481,1025,泰安,簡易
2020-07-06,3210,353,325,678,泰安,簡易
2020-07-07,3210,328,358,686,泰安,簡易
2020-07-08,3210,350,355,705,泰安,簡易
2020-07-09,3210,347,338,685,泰安,簡易
2020-07-10,3210,338,482,820,泰安,簡易
2020-07-11,3210,456,583,1039,泰安,簡易
2020-07-12,3210,614,609,1223,泰安,簡易
2020-07-13,3210,414,363,777,泰安,簡易
2020-07-14,3210,312,355,667,泰安,簡易
2020-07-15,3210,360,360,720,泰安,簡易
2020-07-16,3210,340,344,684,泰安,簡易
2020-07-17,3210,413,495,908,泰安,簡易
2020-07-18,3210,522,715,1237,泰安,簡易
2020-07-19,3210,625,594,1219,泰安,簡易
2020-07-20,3210,388,369,757,泰安,簡易
2020-07-21,3210,275,295,570,泰安,簡易
2020-07-22,3210,349,336,685,泰安,簡易
2020-07-23,3210,327,346,673,泰安,簡易
2020-07-24,3210,361,461,822,泰安,簡易
2020-07-25,3210,524,633,1157,泰安,簡易
2020-07-26,3210,649,568,1217,泰安,簡易
2020-07-27,3210,335,339,674,泰安,簡易
2020-07-28,3210,295,299,594,泰安,簡易
2020-07-29,3210,436,427,863,泰安,簡易
2020-07-30,3210,409,440,849,泰安,簡易
2020-07-31,3210,368,466,834,泰安,簡易
2020-08-01,3210,523,661,1184,泰安,簡易
2020-08-02,3210,593,493,1086,泰安,簡易
2020-08-03,3210,324,291,615,泰安,簡易
2020-08-04,3210,314,326,640,泰安,簡易
2020-08-05,3210,331,345,676,泰安,簡易
2020-08-06,3210,310,350,660,泰安,簡易
2020-08-07,3210,469,658,1127,泰安,簡易
2020-08-08,3210,581,794,1375,泰安,簡易
2020-08-09,3210,672,559,1231,泰安,簡易
2020-08-10,3210,348,299,647,泰安,簡易
2020-08-11,3210,289,301,590,泰安,簡易
2020-08-12,3210,430,452,882,泰安,簡易
2020-08-13,3210,355,353,708,泰安,簡易
2020-08-14,3210,382,464,846,泰安,簡易
2020-08-15,3210,497,652,1149,泰安,簡易
2020-08-16,3210,600,667,1267,泰安,簡易
2020-08-17,3210,383,348,731,泰安,簡易
2020-08-18,3210,405,361,766,泰安,簡易
2020-08-19,3210,382,442,824,泰安,簡易
2020-08-20,3210,390,461,851,泰安,簡易
2020-08-21,3210,452,584,1036,泰安,簡易
2020-08-22,3210,429,527,956,泰安,簡易
2020-08-23,3210,524,565,1089,泰安,簡易
2020-08-24,3210,323,290,613,泰安,簡易
2020-08-25,3210,344,339,683,泰安,簡易
2020-08-26,3210,411,424,835,泰安,簡易
2020-08-27,3210,354,336,690,泰安,簡易
2020-08-28,3210,345,382,727,泰安,簡易
2020-08-29,3210,431,581,1012,泰安,簡易
2020-08-30,3210,547,509,1056,泰安,簡易
2020-08-31,3210,351,324,675,泰安,簡易
2020-09-01,3210,320,309,629,泰安,簡易
2020-09-02,3210,327,343,670,泰安,簡易
2020-09-03,3210,317,322,639,泰安,簡易
2020-09-04,3210,349,470,819,泰安,簡易
2020-09-05,3210,498,670,1168,泰安,簡易
2020-09-06,3210,585,513,1098,泰安,簡易
2020-09-07,3210,349,330,679,泰安,簡易
2020-09-08,3210,320,336,656,泰安,簡易
2020-09-09,3210,337,369,706,泰安,簡易
2020-09-10,3210,323,331,654,泰安,簡易
2020-09-11,3210,363,503,866,泰安,簡易
2020-09-12,3210,523,652,1175,泰安,簡易
2020-09-13,3210,633,643,1276,泰安,簡易
2020-09-14,3210,353,340,693,泰安,簡易
2020-09-15,3210,324,372,696,泰安,簡易
2020-09-16,3210,424,495,919,泰安,簡易
2020-09-17,3210,296,304,600,泰安,簡易
2020-09-18,3210,341,483,824,泰安,簡易
2020-09-19,3210,494,631,1125,泰安,簡易
2020-09-20,3210,605,602,1207,泰安,簡易
2020-09-21,3210,344,307,651,泰安,簡易
2020-09-22,3210,308,337,645,泰安,簡易
2020-09-23,3210,342,394,736,泰安,簡易
2020-09-24,3210,321,331,652,泰安,簡易
2020-09-25,3210,340,412,752,泰安,簡易
2020-09-26,3210,327,512,839,泰安,簡易
2020-09-27,3210,574,519,1093,泰安,簡易
2020-09-28,3210,313,330,643,泰安,簡易
2020-09-29,3210,298,327,625,泰安,簡易
2020-09-30,3210,333,573,906,泰安,簡易
2020-10-01,3210,445,715,1160,泰安,簡易
2020-10-02,3210,563,683,1246,泰安,簡易
2020-10-03,3210,621,715,1336,泰安,簡易
2020-10-04,3210,780,550,1330,泰安,簡易
2020-10-05,3210,371,312,683,泰安,簡易
2020-10-06,3210,305,317,622,泰安,簡易
2020-10-07,3210,327,350,677,泰安,簡易
2020-10-08,3210,336,475,811,泰安,簡易
2020-10-09,3210,427,623,1050,泰安,簡易
2020-10-10,3210,548,633,1181,泰安,簡易
2020-10-11,3210,632,519,1151,泰安,簡易
2020-10-12,3210,391,355,746,泰安,簡易
2020-10-13,3210,322,342,664,泰安,簡易
2020-10-14,3210,340,353,693,泰安,簡易
2020-10-15,3210,370,385,755,泰安,簡易
2020-10-16,3210,358,496,854,泰安,簡易
2020-10-17,3210,452,541,993,泰安,簡易
2020-10-18,3210,694,611,1305,泰安,簡易
2020-10-19,3210,363,330,693,泰安,簡易
2020-10-20,3210,309,360,669,泰安,簡易
2020-10-21,3210,369,383,752,泰安,簡易
2020-10-22,3210,361,433,794,泰安,簡易
2020-10-23,3210,348,498,846,泰安,簡易
2020-10-24,3210,396,566,962,泰安,簡易
2020-10-25,3210,596,453,1049,泰安,簡易
2020-10-26,3210,378,364,742,泰安,簡易
2020-10-27,3210,327,319,646,泰安,簡易
2020-10-28,3210,333,391,724,泰安,簡易
2020-10-29,3210,339,352,691,泰安,簡易
2020-10-30,3210,369,588,957,泰安,簡易
2020-10-31,3210,474,614,1088,泰安,簡易
2020-11-01,3210,737,710,1447,泰安,簡易
2020-11-02,3210,377,390,767,泰安,簡易
2020-11-03,3210,389,454,843,泰安,簡易
2020-11-04,3210,479,562,1041,泰安,簡易
2020-11-05,3210,379,406,785,泰安,簡易
2020-11-06,3210,366,530,896,泰安,簡易
2020-11-07,3210,563,782,1345,泰安,簡易
2020-11-08,3210,801,781,1582,泰安,簡易
2020-11-09,3210,403,388,791,泰安,簡易
2020-11-10,3210,344,340,684,泰安,簡易
2020-11-11,3210,422,429,851,泰安,簡易
2020-11-12,3210,399,418,817,泰安,簡易
2020-11-13,3210,405,552,957,泰安,簡易
2020-11-14,3210,597,782,1379,泰安,簡易
2020-11-15,3210,934,1058,1992,泰安,簡易
2020-11-16,3210,500,493,993,泰安,簡易
2020-11-17,3210,427,423,850,泰安,簡易
2020-11-18,3210,433,491,924,泰安,簡易
2020-11-19,3210,482,471,953,泰安,簡易
2020-11-20,3210,467,640,1107,泰安,簡易
2020-11-21,3210,783,986,1769,泰安,簡易
2020-11-22,3210,982,953,1935,泰安,簡易
2020-11-23,3210,488,469,957,泰安,簡易
2020-11-24,3210,385,424,809,泰安,簡易
2020-11-25,3210,453,462,915,泰安,簡易
2020-11-26,3210,492,518,1010,泰安,簡易
2020-11-27,3210,471,622,1093,泰安,簡易
2020-11-28,3210,720,875,1595,泰安,簡易
2020-11-29,3210,941,958,1899,泰安,簡易
2020-11-30,3210,475,446,921,泰安,簡易
2020-12-01,3210,427,457,884,泰安,簡易
2020-12-02,3210,432,437,869,泰安,簡易
2020-12-03,3210,400,441,841,泰安,簡易
2020-12-04,3210,423,596,1019,泰安,簡易
2020-12-05,3210,567,847,1414,泰安,簡易
2020-12-06,3210,997,885,1882,泰安,簡易
2020-12-07,3210,469,446,915,泰安,簡易
2020-12-08,3210,419,415,834,泰安,簡易
2020-12-09,3210,345,349,694,泰安,簡易
2020-12-10,3210,389,392,781,泰安,簡易
2020-12-11,3210,493,675,1168,泰安,簡易
2020-12-12,3210,792,949,1741,泰安,簡易
2020-12-13,3210,1092,1144,2236,泰安,簡易
2020-12-14,3210,544,541,1085,泰安,簡易
2020-12-15,3210,517,502,1019,泰安,簡易
2020-12-16,3210,524,566,1090,泰安,簡易
2020-12-17,3210,659,724,1383,泰安,簡易
2020-12-18,3210,657,796,1453,泰安,簡易
2020-12-19,3210,886,1087,1973,泰安,簡易
2020-12-20,3210,1374,1184,2558,泰安,簡易
2020-12-21,3210,508,458,966,泰安,簡易
2020-12-22,3210,706,722,1428,泰安,簡易
2020-12-23,3210,412,409,821,泰安,簡易
2020-12-24,3210,585,653,1238,泰安,簡易
2020-12-25,3210,701,903,1604,泰安,簡易
2020-12-26,3210,1007,1094,2101,泰安,簡易
2020-12-27,3210,1179,967,2146,泰安,簡易
2020-12-28,3210,717,682,1399,泰安,簡易
2020-12-29,3210,726,740,1466,泰安,簡易
2020-12-30,3210,512,546,1058,泰安,簡易
2020-12-31,3210,484,654,1138,泰安,簡易
2020-01-01,3220,3827,3407,7234,后里,三等
2020-01-02,3220,2318,2282,4600,后里,三等
2020-01-03,3220,2573,2479,5052,后里,三等
2020-01-04,3220,2147,2151,4298,后里,三等
2020-01-05,3220,2445,2528,4973,后里,三等
2020-01-06,3220,2264,2215,4479,后里,三等
2020-01-07,3220,2246,2144,4390,后里,三等
2020-01-08,3220,2143,2166,4309,后里,三等
2020-01-09,3220,2172,2244,4416,后里,三等
2020-01-10,3220,2898,2953,5851,后里,三等
2020-01-11,3220,2335,2448,4783,后里,三等
2020-01-12,3220,2979,2996,5975,后里,三等
2020-01-13,3220,2375,2439,4814,后里,三等
2020-01-14,3220,2210,2264,4474,后里,三等
2020-01-15,3220,2240,2398,4638,后里,三等
2020-01-16,3220,2711,2704,5415,后里,三等
2020-01-17,3220,2901,2771,5672,后里,三等
2020-01-18,3220,2279,2331,4610,后里,三等
2020-01-19,3220,2610,2864,5474,后里,三等
2020-01-20,3220,2508,2649,5157,后里,三等
2020-01-21,3220,2730,2746,5476,后里,三等
2020-01-22,3220,2893,2741,5634,后里,三等
2020-01-23,3220,2113,2250,4363,后里,三等
2020-01-24,3220,1948,2165,4113,后里,三等
2020-01-25,3220,3998,3866,7864,后里,三等
2020-01-26,3220,2309,2361,4670,后里,三等
2020-01-27,3220,4653,4436,9089,后里,三等
2020-01-28,3220,3412,3300,6712,后里,三等
2020-01-29,3220,2693,2929,5622,后里,三等
2020-01-30,3220,2495,2475,4970,后里,三等
2020-01-31,3220,2833,2531,5364,后里,三等
2020-02-01,3220,2236,2255,4491,后里,三等
2020-02-02,3220,2566,2734,5300,后里,三等
2020-02-03,3220,2490,2651,5141,后里,三等
2020-02-04,3220,2215,2263,4478,后里,三等
2020-02-05,3220,2617,2654,5271,后里,三等
2020-02-06,3220,3248,3303,6551,后里,三等
2020-02-07,3220,4268,4165,8433,后里,三等
2020-02-08,3220,16418,14238,30656,后里,三等
2020-02-09,3220,13955,12835,26790,后里,三等
2020-02-10,3220,8467,8097,16564,后里,三等
2020-02-11,3220,9074,8534,17608,后里,三等
2020-02-12,3220,11382,10565,21947,后里,三等
2020-02-13,3220,6640,6349,12989,后里,三等
2020-02-14,3220,10249,9150,19399,后里,三等
2020-02-15,3220,19955,18110,38065,后里,三等
2020-02-16,3220,9209,8622,17831,后里,三等
2020-02-17,3220,7365,6881,14246,后里,三等
2020-02-18,3220,7849,7379,15228,后里,三等
2020-02-19,3220,10791,9669,20460,后里,三等
2020-02-20,3220,12121,11220,23341,后里,三等
2020-02-21,3220,13602,12505,26107,后里,三等
2020-02-22,3220,25247,23248,48495,后里,三等
2020-02-23,3220,19006,18226,37232,后里,三等
2020-02-24,3220,2612,2807,5419,后里,三等
2020-02-25,3220,2188,2169,4357,后里,三等
2020-02-26,3220,2194,2244,4438,后里,三等
2020-02-27,3220,2688,2532,5220,后里,三等
2020-02-28,3220,2337,2405,4742,后里,三等
2020-02-29,3220,2390,2360,4750,后里,三等
2020-03-01,3220,2231,2309,4540,后里,三等
2020-03-02,3220,2171,2221,4392,后里,三等
2020-03-03,3220,1974,1985,3959,后里,三等
2020-03-04,3220,1947,1941,3888,后里,三等
2020-03-05,3220,1828,1819,3647,后里,三等
2020-03-06,3220,2396,2439,4835,后里,三等
2020-03-07,3220,2022,2095,4117,后里,三等
2020-03-08,3220,2190,2191,4381,后里,三等
2020-03-09,3220,2077,2095,4172,后里,三等
2020-03-10,3220,1791,1823,3614,后里,三等
2020-03-11,3220,2042,1993,4035,后里,三等
2020-03-12,3220,2021,1970,3991,后里,三等
2020-03-13,3220,2402,2430,4832,后里,三等
2020-03-14,3220,1707,1698,3405,后里,三等
2020-03-15,3220,2470,2490,4960,后里,三等
2020-03-16,3220,2005,2070,4075,后里,三等
2020-03-17,3220,2031,2009,4040,后里,三等
2020-03-18,3220,1970,1926,3896,后里,三等
2020-03-19,3220,1795,1822,3617,后里,三等
2020-03-20,3220,2300,2322,4622,后里,三等
2020-03-21,3220,1536,1657,3193,后里,三等
2020-03-22,3220,1868,1922,3790,后里,三等
2020-03-23,3220,1939,1909,3848,后里,三等
2020-03-24,3220,1791,1790,3581,后里,三等
2020-03-25,3220,1773,1798,3571,后里,三等
2020-03-26,3220,1817,1757,3574,后里,三等
2020-03-27,3220,2170,2129,4299,后里,三等
2020-03-28,3220,1230,1302,2532,后里,三等
2020-03-29,3220,1531,1637,3168,后里,三等
2020-03-30,3220,1838,1857,3695,后里,三等
2020-03-31,3220,1797,1836,3633,后里,三等
2020-04-01,3220,2200,2224,4424,后里,三等
2020-04-02,3220,1211,1291,2502,后里,三等
2020-04-03,3220,1598,1716,3314,后里,三等
2020-04-04,3220,1240,1220,2460,后里,三等
2020-04-05,3220,1589,1479,3068,后里,三等
2020-04-06,3220,1785,1707,3492,后里,三等
2020-04-07,3220,1636,1601,3237,后里,三等
2020-04-08,3220,1720,1675,3395,后里,三等
2020-04-09,3220,1696,1636,3332,后里,三等
2020-04-10,3220,2081,2060,4141,后里,三等
2020-04-11,3220,1386,1328,2714,后里,三等
2020-04-12,3220,1545,1663,3208,后里,三等
2020-04-13,3220,1749,1744,3493,后里,三等
2020-04-14,3220,1713,1690,3403,后里,三等
2020-04-15,3220,1756,1741,3497,后里,三等
2020-04-16,3220,1755,1743,3498,后里,三等
2020-04-17,3220,2178,2163,4341,后里,三等
2020-04-18,3220,1437,1436,2873,后里,三等
2020-04-19,3220,1748,1702,3450,后里,三等
2020-04-20,3220,1790,1763,3553,后里,三等
2020-04-21,3220,1651,1693,3344,后里,三等
2020-04-22,3220,1672,1671,3343,后里,三等
2020-04-23,3220,1634,1616,3250,后里,三等
2020-04-24,3220,1963,1933,3896,后里,三等
2020-04-25,3220,1193,1177,2370,后里,三等
2020-04-26,3220,1417,1474,2891,后里,三等
2020-04-27,3220,1806,1774,3580,后里,三等
2020-04-28,3220,1688,1683,3371,后里,三等
2020-04-29,3220,1682,1660,3342,后里,三等
2020-04-30,3220,2010,1824,3834,后里,三等
2020-05-01,3220,1847,1987,3834,后里,三等
2020-05-02,3220,1567,1578,3145,后里,三等
2020-05-03,3220,1735,1705,3440,后里,三等
2020-05-04,3220,1844,1792,3636,后里,三等
2020-05-05,3220,1707,1693,3400,后里,三等
2020-05-06,3220,1787,1747,3534,后里,三等
2020-05-07,3220,1824,1818,3642,后里,三等
2020-05-08,3220,2311,2437,4748,后里,三等
2020-05-09,3220,1579,1626,3205,后里,三等
2020-05-10,3220,1898,1789,3687,后里,三等
2020-05-11,3220,1942,1868,3810,后里,三等
2020-05-12,3220,1829,1838,3667,后里,三等
2020-05-13,3220,1921,1874,3795,后里,三等
2020-05-14,3220,1946,1920,3866,后里,三等
2020-05-15,3220,2371,2374,4745,后里,三等
2020-05-16,3220,1649,1643,3292,后里,三等
2020-05-17,3220,1928,2017,3945,后里,三等
2020-05-18,3220,1863,1877,3740,后里,三等
2020-05-19,3220,1650,1661,3311,后里,三等
2020-05-20,3220,1862,1815,3677,后里,三等
2020-05-21,3220,1776,1720,3496,后里,三等
2020-05-22,3220,2013,1928,3941,后里,三等
2020-05-23,3220,1386,1325,2711,后里,三等
2020-05-24,3220,2158,2267,4425,后里,三等
2020-05-25,3220,2005,2027,4032,后里,三等
2020-05-26,3220,1804,1783,3587,后里,三等
2020-05-27,3220,1715,1740,3455,后里,三等
2020-05-28,3220,1759,1753,3512,后里,三等
2020-05-29,3220,2364,2321,4685,后里,三等
2020-05-30,3220,1826,1879,3705,后里,三等
2020-05-31,3220,2216,2167,4383,后里,三等
2020-06-01,3220,2023,1985,4008,后里,三等
2020-06-02,3220,1925,1967,3892,后里,三等
2020-06-03,3220,1917,1912,3829,后里,三等
2020-06-04,3220,2099,2000,4099,后里,三等
2020-06-05,3220,2444,2319,4763,后里,三等
2020-06-06,3220,1980,1966,3946,后里,三等
2020-06-07,3220,2065,2239,4304,后里,三等
2020-06-08,3220,1927,1928,3855,后里,三等
2020-06-09,3220,1845,1859,3704,后里,三等
2020-06-10,3220,1988,1941,3929,后里,三等
2020-06-11,3220,2084,2092,4176,后里,三等
2020-06-12,3220,2659,2570,5229,后里,三等
2020-06-13,3220,2317,2277,4594,后里,三等
2020-06-14,3220,2321,2444,4765,后里,三等
2020-06-15,3220,2095,2144,4239,后里,三等
2020-06-16,3220,2218,2260,4478,后里,三等
2020-06-17,3220,1987,1996,3983,后里,三等
2020-06-18,3220,1966,1954,3920,后里,三等
2020-06-19,3220,2420,2226,4646,后里,三等
2020-06-20,3220,2025,2003,4028,后里,三等
2020-06-21,3220,2202,2334,4536,后里,三等
2020-06-22,3220,2124,2179,4303,后里,三等
2020-06-23,3220,2165,2324,4489,后里,三等
2020-06-24,3220,2630,2570,5200,后里,三等
2020-06-25,3220,2261,2431,4692,后里,三等
2020-06-26,3220,2725,2699,5424,后里,三等
2020-06-27,3220,2495,2533,5028,后里,三等
2020-06-28,3220,2513,2519,5032,后里,三等
2020-06-29,3220,2198,2234,4432,后里,三等
2020-06-30,3220,2127,2178,4305,后里,三等
2020-07-01,3220,2684,2861,5545,后里,三等
2020-07-02,3220,3081,3086,6167,后里,三等
2020-07-03,3220,3180,2981,6161,后里,三等
2020-07-04,3220,2171,2156,4327,后里,三等
2020-07-05,3220,2345,2536,4881,后里,三等
2020-07-06,3220,3455,3615,7070,后里,三等
2020-07-07,3220,3528,3484,7012,后里,三等
2020-07-08,3220,3552,3527,7079,后里,三等
2020-07-09,3220,3508,3472,6980,后里,三等
2020-07-10,3220,3420,3102,6522,后里,三等
2020-07-11,3220,3034,2943,5977,后里,三等
2020-07-12,3220,3235,3515,6750,后里,三等
2020-07-13,3220,4585,4782,9367,后里,三等
2020-07-14,3220,4267,4252,8519,后里,三等
2020-07-15,3220,5395,5317,10712,后里,三等
2020-07-16,3220,5115,5129,10244,后里,三等
2020-07-17,3220,5561,5330,10891,后里,三等
2020-07-18,3220,4277,4166,8443,后里,三等
2020-07-19,3220,4460,4621,9081,后里,三等
2020-07-20,3220,4314,4507,8821,后里,三等
2020-07-21,3220,3395,3583,6978,后里,三等
2020-07-22,3220,3585,3535,7120,后里,三等
2020-07-23,3220,3662,3597,7259,后里,三等
2020-07-24,3220,3982,3729,7711,后里,三等
2020-07-25,3220,3611,3628,7239,后里,三等
2020-07-26,3220,3527,3680,7207,后里,三等
2020-07-27,3220,3251,3318,6569,后里,三等
2020-07-28,3220,3213,3265,6478,后里,三等
2020-07-29,3220,3065,3100,6165,后里,三等
2020-07-30,3220,3028,2946,5974,后里,三等
2020-07-31,3220,3261,3230,6491,后里,三等
2020-08-01,3220,3226,3229,6455,后里,三等
2020-08-02,3220,3077,3213,6290,后里,三等
2020-08-03,3220,2167,2266,4433,后里,三等
2020-08-04,3220,2408,2420,4828,后里,三等
2020-08-05,3220,2618,2736,5354,后里,三等
2020-08-06,3220,2830,2877,5707,后里,三等
2020-08-07,3220,3155,2919,6074,后里,三等
2020-08-08,3220,2637,2556,5193,后里,三等
2020-08-09,3220,3349,3351,6700,后里,三等
2020-08-10,3220,3421,3549,6970,后里,三等
2020-08-11,3220,2589,2660,5249,后里,三等
2020-08-12,3220,2982,3059,6041,后里,三等
2020-08-13,3220,3182,3168,6350,后里,三等
2020-08-14,3220,3734,3576,7310,后里,三等
2020-08-15,3220,3459,3461,6920,后里,三等
2020-08-16,3220,4016,4182,8198,后里,三等
2020-08-17,3220,3960,3976,7936,后里,三等
2020-08-18,3220,3726,3789,7515,后里,三等
2020-08-19,3220,3172,3212,6384,后里,三等
2020-08-20,3220,3451,3401,6852,后里,三等
2020-08-21,3220,3817,3658,7475,后里,三等
2020-08-22,3220,3248,3324,6572,后里,三等
2020-08-23,3220,3057,3273,6330,后里,三等
2020-08-24,3220,3910,3863,7773,后里,三等
2020-08-25,3220,3785,3838,7623,后里,三等
2020-08-26,3220,3613,3601,7214,后里,三等
2020-08-27,3220,3756,3605,7361,后里,三等
2020-08-28,3220,3305,3122,6427,后里,三等
2020-08-29,3220,3884,3873,7757,后里,三等
2020-08-30,3220,2792,2949,5741,后里,三等
2020-08-31,3220,2544,2576,5120,后里,三等
2020-09-01,3220,2044,2077,4121,后里,三等
2020-09-02,3220,2036,1904,3940,后里,三等
2020-09-03,3220,2107,2138,4245,后里,三等
2020-09-04,3220,2525,2463,4988,后里,三等
2020-09-05,3220,2077,2095,4172,后里,三等
2020-09-06,3220,2095,2231,4326,后里,三等
2020-09-07,3220,2131,2118,4249,后里,三等
2020-09-08,3220,2013,2042,4055,后里,三等
2020-09-09,3220,2109,2076,4185,后里,三等
2020-09-10,3220,2059,2144,4203,后里,三等
2020-09-11,3220,2674,2555,5229,后里,三等
2020-09-12,3220,2672,2513,5185,后里,三等
2020-09-13,3220,2427,2488,4915,后里,三等
2020-09-14,3220,2142,2161,4303,后里,三等
2020-09-15,3220,1951,1980,3931,后里,三等
2020-09-16,3220,2013,1940,3953,后里,三等
2020-09-17,3220,1943,1910,3853,后里,三等
2020-09-18,3220,2535,2571,5106,后里,三等
2020-09-19,3220,2263,2414,4677,后里,三等
2020-09-20,3220,2575,2564,5139,后里,三等
2020-09-21,3220,2094,2031,4125,后里,三等
2020-09-22,3220,1989,1994,3983,后里,三等
2020-09-23,3220,2020,1982,4002,后里,三等
2020-09-24,3220,1985,1920,3905,后里,三等
2020-09-25,3220,2250,2192,4442,后里,三等
2020-09-26,3220,1943,2025,3968,后里,三等
2020-09-27,3220,2132,2169,4301,后里,三等
2020-09-28,3220,1881,1978,3859,后里,三等
2020-09-29,3220,1911,1928,3839,后里,三等
2020-09-30,3220,2469,2674,5143,后里,三等
2020-10-01,3220,2142,2563,4705,后里,三等
2020-10-02,3220,2711,2682,5393,后里,三等
2020-10-03,3220,2543,2367,4910,后里,三等
2020-10-04,3220,2524,2274,4798,后里,三等
2020-10-05,3220,2148,2054,4202,后里,三等
2020-10-06,3220,1973,1968,3941,后里,三等
2020-10-07,3220,1941,1920,3861,后里,三等
2020-10-08,3220,2519,2573,5092,后里,三等
2020-10-09,3220,2566,2762,5328,后里,三等
2020-10-10,3220,2554,2521,5075,后里,三等
2020-10-11,3220,2790,2762,5552,后里,三等
2020-10-12,3220,2139,2091,4230,后里,三等
2020-10-13,3220,1975,1972,3947,后里,三等
2020-10-14,3220,2090,2030,4120,后里,三等
2020-10-15,3220,2062,2081,4143,后里,三等
2020-10-16,3220,2489,2541,5030,后里,三等
2020-10-17,3220,2562,2553,5115,后里,三等
2020-10-18,3220,2690,2781,5471,后里,三等
2020-10-19,3220,2147,2103,4250,后里,三等
2020-10-20,3220,2000,1992,3992,后里,三等
2020-10-21,3220,2020,2061,4081,后里,三等
2020-10-22,3220,1999,1939,3938,后里,三等
2020-10-23,3220,2393,2487,4880,后里,三等
2020-10-24,3220,2288,2219,4507,后里,三等
2020-10-25,3220,2486,2548,5034,后里,三等
2020-10-26,3220,2190,2156,4346,后里,三等
2020-10-27,3220,2065,2058,4123,后里,三等
2020-10-28,3220,2008,1982,3990,后里,三等
2020-10-29,3220,1978,2036,4014,后里,三等
2020-10-30,3220,2509,2578,5087,后里,三等
2020-10-31,3220,2054,2124,4178,后里,三等
2020-11-01,3220,2419,2438,4857,后里,三等
2020-11-02,3220,2117,2041,4158,后里,三等
2020-11-03,3220,1933,1903,3836,后里,三等
2020-11-04,3220,2112,2012,4124,后里,三等
2020-11-05,3220,1974,1957,3931,后里,三等
2020-11-06,3220,2528,2502,5030,后里,三等
2020-11-07,3220,2122,2179,4301,后里,三等
2020-11-08,3220,2458,2508,4966,后里,三等
2020-11-09,3220,2240,2213,4453,后里,三等
2020-11-10,3220,2033,2038,4071,后里,三等
2020-11-11,3220,2237,2223,4460,后里,三等
2020-11-12,3220,2124,2073,4197,后里,三等
2020-11-13,3220,2456,2545,5001,后里,三等
2020-11-14,3220,2283,2342,4625,后里,三等
2020-11-15,3220,3153,3043,6196,后里,三等
2020-11-16,3220,2238,2181,4419,后里,三等
2020-11-17,3220,2139,2123,4262,后里,三等
2020-11-18,3220,2137,2144,4281,后里,三等
2020-11-19,3220,2116,2049,4165,后里,三等
2020-11-20,3220,2597,2726,5323,后里,三等
2020-11-21,3220,2382,2431,4813,后里,三等
2020-11-22,3220,3085,2918,6003,后里,三等
2020-11-23,3220,2339,2310,4649,后里,三等
2020-11-24,3220,2078,2051,4129,后里,三等
2020-11-25,3220,2166,2103,4269,后里,三等
2020-11-26,3220,2087,2042,4129,后里,三等
2020-11-27,3220,2616,2673,5289,后里,三等
2020-11-28,3220,2215,2238,4453,后里,三等
2020-11-29,3220,2687,2446,5133,后里,三等
2020-11-30,3220,2160,2071,4231,后里,三等
2020-12-01,3220,1992,1964,3956,后里,三等
2020-12-02,3220,1974,2024,3998,后里,三等
2020-12-03,3220,1980,2010,3990,后里,三等
2020-12-04,3220,2545,2485,5030,后里,三等
2020-12-05,3220,2189,2141,4330,后里,三等
2020-12-06,3220,2493,2600,5093,后里,三等
2020-12-07,3220,2248,2153,4401,后里,三等
2020-12-08,3220,2034,2018,4052,后里,三等
2020-12-09,3220,1813,1773,3586,后里,三等
2020-12-10,3220,2001,2004,4005,后里,三等
2020-12-11,3220,2596,2689,5285,后里,三等
2020-12-12,3220,2457,2504,4961,后里,三等
2020-12-13,3220,3209,3199,6408,后里,三等
2020-12-14,3220,2255,2185,4440,后里,三等
2020-12-15,3220,2038,1978,4016,后里,三等
2020-12-16,3220,1966,1987,3953,后里,三等
2020-12-17,3220,2155,2132,4287,后里,三等
2020-12-18,3220,2637,2720,5357,后里,三等
2020-12-19,3220,2286,2262,4548,后里,三等
2020-12-20,3220,2860,2870,5730,后里,三等
2020-12-21,3220,2140,2075,4215,后里,三等
2020-12-22,3220,2067,2048,4115,后里,三等
2020-12-23,3220,1826,1813,3639,后里,三等
2020-12-24,3220,2046,2025,4071,后里,三等
2020-12-25,3220,2760,2772,5532,后里,三等
2020-12-26,3220,2084,2209,4293,后里,三等
2020-12-27,3220,2446,2468,4914,后里,三等
2020-12-28,3220,2146,2105,4251,后里,三等
2020-12-29,3220,2023,2041,4064,后里,三等
2020-12-30,3220,1963,2023,3986,后里,三等
2020-12-31,3220,2698,3343,6041,后里,三等
2020-01-01,3230,9622,9591,19213,豐原,一等
2020-01-02,3230,6275,6663,12938,豐原,一等
2020-01-03,3230,7455,8926,16381,豐原,一等
2020-01-04,3230,8223,8853,17076,豐原,一等
2020-01-05,3230,9936,9074,19010,豐原,一等
2020-01-06,3230,6517,6604,13121,豐原,一等
2020-01-07,3230,6036,6180,12216,豐原,一等
2020-01-08,3230,6055,6413,12468,豐原,一等
2020-01-09,3230,6368,7352,13720,豐原,一等
2020-01-10,3230,8351,12196,20547,豐原,一等
2020-01-11,3230,10479,11071,21550,豐原,一等
2020-01-12,3230,13093,11223,24316,豐原,一等
2020-01-13,3230,7747,7325,15072,豐原,一等
2020-01-14,3230,6411,6519,12930,豐原,一等
2020-01-15,3230,6438,6678,13116,豐原,一等
2020-01-16,3230,7410,7734,15144,豐原,一等
2020-01-17,3230,8196,8788,16984,豐原,一等
2020-01-18,3230,8545,8528,17073,豐原,一等
2020-01-19,3230,9350,9567,18917,豐原,一等
2020-01-20,3230,7122,7392,14514,豐原,一等
2020-01-21,3230,6773,7681,14454,豐原,一等
2020-01-22,3230,8343,10139,18482,豐原,一等
2020-01-23,3230,8011,10424,18435,豐原,一等
2020-01-24,3230,7559,8838,16397,豐原,一等
2020-01-25,3230,11266,10616,21882,豐原,一等
2020-01-26,3230,10083,10256,20339,豐原,一等
2020-01-27,3230,12828,12164,24992,豐原,一等
2020-01-28,3230,11105,10363,21468,豐原,一等
2020-01-29,3230,9952,8949,18901,豐原,一等
2020-01-30,3230,7452,6918,14370,豐原,一等
2020-01-31,3230,7507,7720,15227,豐原,一等
2020-02-01,3230,7031,7087,14118,豐原,一等
2020-02-02,3230,8049,7841,15890,豐原,一等
2020-02-03,3230,6471,6605,13076,豐原,一等
2020-02-04,3230,5475,5783,11258,豐原,一等
2020-02-05,3230,5919,5990,11909,豐原,一等
2020-02-06,3230,6140,6190,12330,豐原,一等
2020-02-07,3230,7522,8691,16213,豐原,一等
2020-02-08,3230,9288,10135,19423,豐原,一等
2020-02-09,3230,10810,10466,21276,豐原,一等
2020-02-10,3230,7803,7798,15601,豐原,一等
2020-02-11,3230,7114,7253,14367,豐原,一等
2020-02-12,3230,7550,7858,15408,豐原,一等
2020-02-13,3230,6540,6674,13214,豐原,一等
2020-02-14,3230,8230,8938,17168,豐原,一等
2020-02-15,3230,10232,10988,21220,豐原,一等
2020-02-16,3230,9965,9654,19619,豐原,一等
2020-02-17,3230,7000,6872,13872,豐原,一等
2020-02-18,3230,6406,6537,12943,豐原,一等
2020-02-19,3230,6868,7217,14085,豐原,一等
2020-02-20,3230,7285,7604,14889,豐原,一等
2020-02-21,3230,8728,9964,18692,豐原,一等
2020-02-22,3230,10257,11446,21703,豐原,一等
2020-02-23,3230,11063,10313,21376,豐原,一等
2020-02-24,3230,6257,5810,12067,豐原,一等
2020-02-25,3230,5496,5748,11244,豐原,一等
2020-02-26,3230,5477,5770,11247,豐原,一等
2020-02-27,3230,7762,9369,17131,豐原,一等
2020-02-28,3230,7575,8428,16003,豐原,一等
2020-02-29,3230,7207,7137,14344,豐原,一等
2020-03-01,3230,9929,8214,18143,豐原,一等
2020-03-02,3230,6268,5895,12163,豐原,一等
2020-03-03,3230,5108,5323,10431,豐原,一等
2020-03-04,3230,5091,5363,10454,豐原,一等
2020-03-05,3230,5072,5442,10514,豐原,一等
2020-03-06,3230,6913,8981,15894,豐原,一等
2020-03-07,3230,6421,7043,13464,豐原,一等
2020-03-08,3230,8717,7517,16234,豐原,一等
2020-03-09,3230,6003,5878,11881,豐原,一等
2020-03-10,3230,4941,5198,10139,豐原,一等
2020-03-11,3230,5481,5777,11258,豐原,一等
2020-03-12,3230,5104,5631,10735,豐原,一等
2020-03-13,3230,7148,9525,16673,豐原,一等
2020-03-14,3230,6657,7419,14076,豐原,一等
2020-03-15,3230,10214,8590,18804,豐原,一等
2020-03-16,3230,6064,5876,11940,豐原,一等
2020-03-17,3230,5188,5428,10616,豐原,一等
2020-03-18,3230,4960,5248,10208,豐原,一等
2020-03-19,3230,4861,5264,10125,豐原,一等
2020-03-20,3230,6620,8849,15469,豐原,一等
2020-03-21,3230,5446,6162,11608,豐原,一等
2020-03-22,3230,8015,6575,14590,豐原,一等
2020-03-23,3230,5597,5330,10927,豐原,一等
2020-03-24,3230,4564,4843,9407,豐原,一等
2020-03-25,3230,4673,5033,9706,豐原,一等
2020-03-26,3230,4631,5141,9772,豐原,一等
2020-03-27,3230,6180,7922,14102,豐原,一等
2020-03-28,3230,4652,5194,9846,豐原,一等
2020-03-29,3230,6463,5575,12038,豐原,一等
2020-03-30,3230,5207,5174,10381,豐原,一等
2020-03-31,3230,4564,5453,10017,豐原,一等
2020-04-01,3230,6282,8644,14926,豐原,一等
2020-04-02,3230,4695,6366,11061,豐原,一等
2020-04-03,3230,5075,5522,10597,豐原,一等
2020-04-04,3230,4900,4461,9361,豐原,一等
2020-04-05,3230,8020,5569,13589,豐原,一等
2020-04-06,3230,6102,5086,11188,豐原,一等
2020-04-07,3230,4447,4496,8943,豐原,一等
2020-04-08,3230,4358,4664,9022,豐原,一等
2020-04-09,3230,4396,4813,9209,豐原,一等
2020-04-10,3230,5819,7318,13137,豐原,一等
2020-04-11,3230,5085,5417,10502,豐原,一等
2020-04-12,3230,6958,6075,13033,豐原,一等
2020-04-13,3230,5089,4882,9971,豐原,一等
2020-04-14,3230,4432,4669,9101,豐原,一等
2020-04-15,3230,4586,4760,9346,豐原,一等
2020-04-16,3230,4627,5047,9674,豐原,一等
2020-04-17,3230,6241,8117,14358,豐原,一等
2020-04-18,3230,5450,5952,11402,豐原,一等
2020-04-19,3230,7619,6576,14195,豐原,一等
2020-04-20,3230,5403,5169,10572,豐原,一等
2020-04-21,3230,4458,4628,9086,豐原,一等
2020-04-22,3230,4343,4579,8922,豐原,一等
2020-04-23,3230,4251,4717,8968,豐原,一等
2020-04-24,3230,5608,7451,13059,豐原,一等
2020-04-25,3230,4787,5083,9870,豐原,一等
2020-04-26,3230,6389,5403,11792,豐原,一等
2020-04-27,3230,5032,4793,9825,豐原,一等
2020-04-28,3230,4479,4559,9038,豐原,一等
2020-04-29,3230,4441,4764,9205,豐原,一等
2020-04-30,3230,5349,6495,11844,豐原,一等
2020-05-01,3230,6269,8650,14919,豐原,一等
2020-05-02,3230,5400,5731,11131,豐原,一等
2020-05-03,3230,8381,6624,15005,豐原,一等
2020-05-04,3230,5656,5158,10814,豐原,一等
2020-05-05,3230,4667,4691,9358,豐原,一等
2020-05-06,3230,4744,4878,9622,豐原,一等
2020-05-07,3230,4777,5323,10100,豐原,一等
2020-05-08,3230,6724,9834,16558,豐原,一等
2020-05-09,3230,6308,7570,13878,豐原,一等
2020-05-10,3230,9499,7290,16789,豐原,一等
2020-05-11,3230,6434,5536,11970,豐原,一等
2020-05-12,3230,4945,4976,9921,豐原,一等
2020-05-13,3230,4969,5188,10157,豐原,一等
2020-05-14,3230,4992,5509,10501,豐原,一等
2020-05-15,3230,7090,9009,16099,豐原,一等
2020-05-16,3230,6075,6614,12689,豐原,一等
2020-05-17,3230,8354,7364,15718,豐原,一等
2020-05-18,3230,5562,5320,10882,豐原,一等
2020-05-19,3230,4469,4633,9102,豐原,一等
2020-05-20,3230,4871,5130,10001,豐原,一等
2020-05-21,3230,4681,5155,9836,豐原,一等
2020-05-22,3230,5984,8080,14064,豐原,一等
2020-05-23,3230,5975,6420,12395,豐原,一等
2020-05-24,3230,9397,8377,17774,豐原,一等
2020-05-25,3230,5951,5746,11697,豐原,一等
2020-05-26,3230,4797,4929,9726,豐原,一等
2020-05-27,3230,4591,4895,9486,豐原,一等
2020-05-28,3230,4768,5176,9944,豐原,一等
2020-05-29,3230,6809,9064,15873,豐原,一等
2020-05-30,3230,6906,7516,14422,豐原,一等
2020-05-31,3230,9361,7915,17276,豐原,一等
2020-06-01,3230,5936,5692,11628,豐原,一等
2020-06-02,3230,5101,5255,10356,豐原,一等
2020-06-03,3230,5104,5309,10413,豐原,一等
2020-06-04,3230,5178,5709,10887,豐原,一等
2020-06-05,3230,7228,9092,16320,豐原,一等
2020-06-06,3230,7146,7641,14787,豐原,一等
2020-06-07,3230,9209,8232,17441,豐原,一等
2020-06-08,3230,5890,5694,11584,豐原,一等
2020-06-09,3230,4972,5244,10216,豐原,一等
2020-06-10,3230,5346,5558,10904,豐原,一等
2020-06-11,3230,5503,5980,11483,豐原,一等
2020-06-12,3230,7795,9388,17183,豐原,一等
2020-06-13,3230,8548,8764,17312,豐原,一等
2020-06-14,3230,10275,9826,20101,豐原,一等
2020-06-15,3230,6488,6316,12804,豐原,一等
2020-06-16,3230,5898,6043,11941,豐原,一等
2020-06-17,3230,5426,5721,11147,豐原,一等
2020-06-18,3230,5346,5634,10980,豐原,一等
2020-06-19,3230,6359,7182,13541,豐原,一等
2020-06-20,3230,7419,7739,15158,豐原,一等
2020-06-21,3230,8151,7881,16032,豐原,一等
2020-06-22,3230,6040,6143,12183,豐原,一等
2020-06-23,3230,5471,6039,11510,豐原,一等
2020-06-24,3230,7603,10108,17711,豐原,一等
2020-06-25,3230,7831,9324,17155,豐原,一等
2020-06-26,3230,8906,9088,17994,豐原,一等
2020-06-27,3230,9801,9241,19042,豐原,一等
2020-06-28,3230,11175,9970,21145,豐原,一等
2020-06-29,3230,7056,6546,13602,豐原,一等
2020-06-30,3230,5732,5872,11604,豐原,一等
2020-07-01,3230,5264,5508,10772,豐原,一等
2020-07-02,3230,5384,5676,11060,豐原,一等
2020-07-03,3230,7234,8104,15338,豐原,一等
2020-07-04,3230,7287,7679,14966,豐原,一等
2020-07-05,3230,8168,8083,16251,豐原,一等
2020-07-06,3230,6205,6443,12648,豐原,一等
2020-07-07,3230,5894,6021,11915,豐原,一等
2020-07-08,3230,5809,6051,11860,豐原,一等
2020-07-09,3230,5893,6091,11984,豐原,一等
2020-07-10,3230,8462,9244,17706,豐原,一等
2020-07-11,3230,8821,8975,17796,豐原,一等
2020-07-12,3230,10468,10352,20820,豐原,一等
2020-07-13,3230,6716,6975,13691,豐原,一等
2020-07-14,3230,6507,6883,13390,豐原,一等
2020-07-15,3230,7112,7172,14284,豐原,一等
2020-07-16,3230,6715,7037,13752,豐原,一等
2020-07-17,3230,8683,9399,18082,豐原,一等
2020-07-18,3230,8624,9108,17732,豐原,一等
2020-07-19,3230,10630,10437,21067,豐原,一等
2020-07-20,3230,7264,7297,14561,豐原,一等
2020-07-21,3230,6153,6491,12644,豐原,一等
2020-07-22,3230,6565,6798,13363,豐原,一等
2020-07-23,3230,6362,6833,13195,豐原,一等
2020-07-24,3230,8292,9075,17367,豐原,一等
2020-07-25,3230,8497,8753,17250,豐原,一等
2020-07-26,3230,9823,9757,19580,豐原,一等
2020-07-27,3230,6748,6935,13683,豐原,一等
2020-07-28,3230,6065,6276,12341,豐原,一等
2020-07-29,3230,6340,6502,12842,豐原,一等
2020-07-30,3230,6536,6839,13375,豐原,一等
2020-07-31,3230,8333,9451,17784,豐原,一等
2020-08-01,3230,8387,8723,17110,豐原,一等
2020-08-02,3230,9147,8952,18099,豐原,一等
2020-08-03,3230,6207,6125,12332,豐原,一等
2020-08-04,3230,5743,5892,11635,豐原,一等
2020-08-05,3230,5912,6360,12272,豐原,一等
2020-08-06,3230,6190,6704,12894,豐原,一等
2020-08-07,3230,8197,9698,17895,豐原,一等
2020-08-08,3230,7711,8380,16091,豐原,一等
2020-08-09,3230,10634,9618,20252,豐原,一等
2020-08-10,3230,7113,6840,13953,豐原,一等
2020-08-11,3230,6184,6393,12577,豐原,一等
2020-08-12,3230,6603,6666,13269,豐原,一等
2020-08-13,3230,6610,6843,13453,豐原,一等
2020-08-14,3230,9078,9409,18487,豐原,一等
2020-08-15,3230,9183,9630,18813,豐原,一等
2020-08-16,3230,11303,11457,22760,豐原,一等
2020-08-17,3230,7410,7401,14811,豐原,一等
2020-08-18,3230,6633,6756,13389,豐原,一等
2020-08-19,3230,6430,6704,13134,豐原,一等
2020-08-20,3230,6760,6994,13754,豐原,一等
2020-08-21,3230,7972,9091,17063,豐原,一等
2020-08-22,3230,8486,8732,17218,豐原,一等
2020-08-23,3230,10155,10083,20238,豐原,一等
2020-08-24,3230,7822,7901,15723,豐原,一等
2020-08-25,3230,7423,7526,14949,豐原,一等
2020-08-26,3230,6966,7370,14336,豐原,一等
2020-08-27,3230,6965,7347,14312,豐原,一等
2020-08-28,3230,7769,8601,16370,豐原,一等
2020-08-29,3230,7916,8129,16045,豐原,一等
2020-08-30,3230,9070,8901,17971,豐原,一等
2020-08-31,3230,6293,6371,12664,豐原,一等
2020-09-01,3230,5606,5762,11368,豐原,一等
2020-09-02,3230,5322,5460,10782,豐原,一等
2020-09-03,3230,5830,6050,11880,豐原,一等
2020-09-04,3230,7717,9079,16796,豐原,一等
2020-09-05,3230,8240,8597,16837,豐原,一等
2020-09-06,3230,9718,8838,18556,豐原,一等
2020-09-07,3230,6250,6382,12632,豐原,一等
2020-09-08,3230,5618,5756,11374,豐原,一等
2020-09-09,3230,5465,5865,11330,豐原,一等
2020-09-10,3230,5785,6315,12100,豐原,一等
2020-09-11,3230,8015,9398,17413,豐原,一等
2020-09-12,3230,8940,9038,17978,豐原,一等
2020-09-13,3230,11227,10088,21315,豐原,一等
2020-09-14,3230,6119,6095,12214,豐原,一等
2020-09-15,3230,5419,5580,10999,豐原,一等
2020-09-16,3230,5251,5601,10852,豐原,一等
2020-09-17,3230,5667,6003,11670,豐原,一等
2020-09-18,3230,7762,9996,17758,豐原,一等
2020-09-19,3230,8764,9393,18157,豐原,一等
2020-09-20,3230,11295,10084,21379,豐原,一等
2020-09-21,3230,6445,6299,12744,豐原,一等
2020-09-22,3230,5474,5707,11181,豐原,一等
2020-09-23,3230,5651,5992,11643,豐原,一等
2020-09-24,3230,5590,5919,11509,豐原,一等
2020-09-25,3230,6390,7474,13864,豐原,一等
2020-09-26,3230,7179,7786,14965,豐原,一等
2020-09-27,3230,8684,8352,17036,豐原,一等
2020-09-28,3230,6066,6030,12096,豐原,一等
2020-09-29,3230,5514,6093,11607,豐原,一等
2020-09-30,3230,7595,11561,19156,豐原,一等
2020-10-01,3230,8038,11021,19059,豐原,一等
2020-10-02,3230,9663,10052,19715,豐原,一等
2020-10-03,3230,10474,9892,20366,豐原,一等
2020-10-04,3230,12962,9499,22461,豐原,一等
2020-10-05,3230,7191,6156,13347,豐原,一等
2020-10-06,3230,5491,5771,11262,豐原,一等
2020-10-07,3230,5677,5961,11638,豐原,一等
2020-10-08,3230,7438,10051,17489,豐原,一等
2020-10-09,3230,8942,9900,18842,豐原,一等
2020-10-10,3230,9635,9750,19385,豐原,一等
2020-10-11,3230,12178,10720,22898,豐原,一等
2020-10-12,3230,6779,6233,13012,豐原,一等
2020-10-13,3230,5711,5883,11594,豐原,一等
2020-10-14,3230,5729,6032,11761,豐原,一等
2020-10-15,3230,5718,6038,11756,豐原,一等
2020-10-16,3230,7553,9643,17196,豐原,一等
2020-10-17,3230,8349,8888,17237,豐原,一等
2020-10-18,3230,11505,10613,22118,豐原,一等
2020-10-19,3230,6411,6149,12560,豐原,一等
2020-10-20,3230,5679,5961,11640,豐原,一等
2020-10-21,3230,5634,5924,11558,豐原,一等
2020-10-22,3230,5616,6002,11618,豐原,一等
2020-10-23,3230,7599,9638,17237,豐原,一等
2020-10-24,3230,8625,9409,18034,豐原,一等
2020-10-25,3230,10684,9625,20309,豐原,一等
2020-10-26,3230,6698,6241,12939,豐原,一等
2020-10-27,3230,5592,5805,11397,豐原,一等
2020-10-28,3230,5443,5807,11250,豐原,一等
2020-10-29,3230,5563,5832,11395,豐原,一等
2020-10-30,3230,7706,9996,17702,豐原,一等
2020-10-31,3230,7919,8807,16726,豐原,一等
2020-11-01,3230,11035,9823,20858,豐原,一等
2020-11-02,3230,6369,6187,12556,豐原,一等
2020-11-03,3230,5323,5555,10878,豐原,一等
2020-11-04,3230,5517,5675,11192,豐原,一等
2020-11-05,3230,5393,5896,11289,豐原,一等
2020-11-06,3230,7659,9911,17570,豐原,一等
2020-11-07,3230,8139,8540,16679,豐原,一等
2020-11-08,3230,10513,9690,20203,豐原,一等
2020-11-09,3230,6638,6336,12974,豐原,一等
2020-11-10,3230,5513,5880,11393,豐原,一等
2020-11-11,3230,5989,6288,12277,豐原,一等
2020-11-12,3230,5857,6448,12305,豐原,一等
2020-11-13,3230,7783,10530,18313,豐原,一等
2020-11-14,3230,10534,10953,21487,豐原,一等
2020-11-15,3230,14183,12607,26790,豐原,一等
2020-11-16,3230,7909,7643,15552,豐原,一等
2020-11-17,3230,7077,7354,14431,豐原,一等
2020-11-18,3230,7384,7768,15152,豐原,一等
2020-11-19,3230,7148,7621,14769,豐原,一等
2020-11-20,3230,9276,11670,20946,豐原,一等
2020-11-21,3230,11130,11603,22733,豐原,一等
2020-11-22,3230,14155,13072,27227,豐原,一等
2020-11-23,3230,8014,7793,15807,豐原,一等
2020-11-24,3230,6932,7253,14185,豐原,一等
2020-11-25,3230,6970,7286,14256,豐原,一等
2020-11-26,3230,7169,7646,14815,豐原,一等
2020-11-27,3230,8846,11303,20149,豐原,一等
2020-11-28,3230,10358,11160,21518,豐原,一等
2020-11-29,3230,12799,11597,24396,豐原,一等
2020-11-30,3230,7719,7499,15218,豐原,一等
2020-12-01,3230,6434,6930,13364,豐原,一等
2020-12-02,3230,6565,6873,13438,豐原,一等
2020-12-03,3230,6363,6863,13226,豐原,一等
2020-12-04,3230,8581,11129,19710,豐原,一等
2020-12-05,3230,10785,11123,21908,豐原,一等
2020-12-06,3230,12764,11485,24249,豐原,一等
2020-12-07,3230,6762,6492,13254,豐原,一等
2020-12-08,3230,5548,5806,11354,豐原,一等
2020-12-09,3230,5350,5720,11070,豐原,一等
2020-12-10,3230,5991,6504,12495,豐原,一等
2020-12-11,3230,8434,10672,19106,豐原,一等
2020-12-12,3230,10298,10549,20847,豐原,一等
2020-12-13,3230,13187,12393,25580,豐原,一等
2020-12-14,3230,6833,6562,13395,豐原,一等
2020-12-15,3230,5709,5950,11659,豐原,一等
2020-12-16,3230,5854,6087,11941,豐原,一等
2020-12-17,3230,5803,6323,12126,豐原,一等
2020-12-18,3230,8251,10413,18664,豐原,一等
2020-12-19,3230,9926,10413,20339,豐原,一等
2020-12-20,3230,11982,10951,22933,豐原,一等
2020-12-21,3230,6508,6350,12858,豐原,一等
2020-12-22,3230,5726,5923,11649,豐原,一等
2020-12-23,3230,5220,5521,10741,豐原,一等
2020-12-24,3230,5835,6406,12241,豐原,一等
2020-12-25,3230,8055,10088,18143,豐原,一等
2020-12-26,3230,8490,8876,17366,豐原,一等
2020-12-27,3230,10177,9382,19559,豐原,一等
2020-12-28,3230,6600,6186,12786,豐原,一等
2020-12-29,3230,5499,5859,11358,豐原,一等
2020-12-30,3230,5852,6698,12550,豐原,一等
2020-12-31,3230,8679,10798,19477,豐原,一等
2020-01-01,3240,636,647,1283,栗林,簡易
2020-01-02,3240,593,562,1155,栗林,簡易
2020-01-03,3240,670,669,1339,栗林,簡易
2020-01-04,3240,743,683,1426,栗林,簡易
2020-01-05,3240,800,739,1539,栗林,簡易
2020-01-06,3240,583,556,1139,栗林,簡易
2020-01-07,3240,576,544,1120,栗林,簡易
2020-01-08,3240,571,569,1140,栗林,簡易
2020-01-09,3240,559,597,1156,栗林,簡易
2020-01-10,3240,706,867,1573,栗林,簡易
2020-01-11,3240,819,788,1607,栗林,簡易
2020-01-12,3240,1035,908,1943,栗林,簡易
2020-01-13,3240,647,637,1284,栗林,簡易
2020-01-14,3240,589,570,1159,栗林,簡易
2020-01-15,3240,543,552,1095,栗林,簡易
2020-01-16,3240,714,596,1310,栗林,簡易
2020-01-17,3240,664,604,1268,栗林,簡易
2020-01-18,3240,739,661,1400,栗林,簡易
2020-01-19,3240,790,761,1551,栗林,簡易
2020-01-20,3240,547,574,1121,栗林,簡易
2020-01-21,3240,545,594,1139,栗林,簡易
2020-01-22,3240,588,602,1190,栗林,簡易
2020-01-23,3240,651,623,1274,栗林,簡易
2020-01-24,3240,495,491,986,栗林,簡易
2020-01-25,3240,829,731,1560,栗林,簡易
2020-01-26,3240,580,553,1133,栗林,簡易
2020-01-27,3240,825,779,1604,栗林,簡易
2020-01-28,3240,668,636,1304,栗林,簡易
2020-01-29,3240,600,555,1155,栗林,簡易
2020-01-30,3240,546,494,1040,栗林,簡易
2020-01-31,3240,511,507,1018,栗林,簡易
2020-02-01,3240,496,455,951,栗林,簡易
2020-02-02,3240,632,579,1211,栗林,簡易
2020-02-03,3240,492,493,985,栗林,簡易
2020-02-04,3240,492,459,951,栗林,簡易
2020-02-05,3240,531,487,1018,栗林,簡易
2020-02-06,3240,509,488,997,栗林,簡易
2020-02-07,3240,585,556,1141,栗林,簡易
2020-02-08,3240,839,874,1713,栗林,簡易
2020-02-09,3240,933,919,1852,栗林,簡易
2020-02-10,3240,589,604,1193,栗林,簡易
2020-02-11,3240,634,619,1253,栗林,簡易
2020-02-12,3240,763,783,1546,栗林,簡易
2020-02-13,3240,557,562,1119,栗林,簡易
2020-02-14,3240,774,758,1532,栗林,簡易
2020-02-15,3240,1073,1011,2084,栗林,簡易
2020-02-16,3240,793,749,1542,栗林,簡易
2020-02-17,3240,584,617,1201,栗林,簡易
2020-02-18,3240,569,512,1081,栗林,簡易
2020-02-19,3240,686,682,1368,栗林,簡易
2020-02-20,3240,677,687,1364,栗林,簡易
2020-02-21,3240,832,842,1674,栗林,簡易
2020-02-22,3240,1067,983,2050,栗林,簡易
2020-02-23,3240,1064,1051,2115,栗林,簡易
2020-02-24,3240,522,488,1010,栗林,簡易
2020-02-25,3240,565,506,1071,栗林,簡易
2020-02-26,3240,570,566,1136,栗林,簡易
2020-02-27,3240,666,655,1321,栗林,簡易
2020-02-28,3240,591,562,1153,栗林,簡易
2020-02-29,3240,546,471,1017,栗林,簡易
2020-03-01,3240,620,548,1168,栗林,簡易
2020-03-02,3240,603,566,1169,栗林,簡易
2020-03-03,3240,546,545,1091,栗林,簡易
2020-03-04,3240,556,550,1106,栗林,簡易
2020-03-05,3240,566,545,1111,栗林,簡易
2020-03-06,3240,657,759,1416,栗林,簡易
2020-03-07,3240,536,540,1076,栗林,簡易
2020-03-08,3240,571,495,1066,栗林,簡易
2020-03-09,3240,614,565,1179,栗林,簡易
2020-03-10,3240,537,515,1052,栗林,簡易
2020-03-11,3240,597,588,1185,栗林,簡易
2020-03-12,3240,547,525,1072,栗林,簡易
2020-03-13,3240,655,720,1375,栗林,簡易
2020-03-14,3240,629,561,1190,栗林,簡易
2020-03-15,3240,692,629,1321,栗林,簡易
2020-03-16,3240,609,561,1170,栗林,簡易
2020-03-17,3240,556,514,1070,栗林,簡易
2020-03-18,3240,582,562,1144,栗林,簡易
2020-03-19,3240,550,552,1102,栗林,簡易
2020-03-20,3240,652,692,1344,栗林,簡易
2020-03-21,3240,510,435,945,栗林,簡易
2020-03-22,3240,544,482,1026,栗林,簡易
2020-03-23,3240,557,513,1070,栗林,簡易
2020-03-24,3240,491,479,970,栗林,簡易
2020-03-25,3240,509,498,1007,栗林,簡易
2020-03-26,3240,540,517,1057,栗林,簡易
2020-03-27,3240,600,609,1209,栗林,簡易
2020-03-28,3240,448,410,858,栗林,簡易
2020-03-29,3240,462,400,862,栗林,簡易
2020-03-30,3240,520,498,1018,栗林,簡易
2020-03-31,3240,507,499,1006,栗林,簡易
2020-04-01,3240,574,630,1204,栗林,簡易
2020-04-02,3240,378,388,766,栗林,簡易
2020-04-03,3240,389,369,758,栗林,簡易
2020-04-04,3240,376,341,717,栗林,簡易
2020-04-05,3240,489,394,883,栗林,簡易
2020-04-06,3240,556,456,1012,栗林,簡易
2020-04-07,3240,483,453,936,栗林,簡易
2020-04-08,3240,518,491,1009,栗林,簡易
2020-04-09,3240,488,486,974,栗林,簡易
2020-04-10,3240,582,584,1166,栗林,簡易
2020-04-11,3240,448,446,894,栗林,簡易
2020-04-12,3240,551,504,1055,栗林,簡易
2020-04-13,3240,531,497,1028,栗林,簡易
2020-04-14,3240,490,457,947,栗林,簡易
2020-04-15,3240,493,480,973,栗林,簡易
2020-04-16,3240,521,513,1034,栗林,簡易
2020-04-17,3240,546,577,1123,栗林,簡易
2020-04-18,3240,523,496,1019,栗林,簡易
2020-04-19,3240,567,477,1044,栗林,簡易
2020-04-20,3240,536,478,1014,栗林,簡易
2020-04-21,3240,475,462,937,栗林,簡易
2020-04-22,3240,494,507,1001,栗林,簡易
2020-04-23,3240,485,481,966,栗林,簡易
2020-04-24,3240,555,591,1146,栗林,簡易
2020-04-25,3240,432,402,834,栗林,簡易
2020-04-26,3240,397,338,735,栗林,簡易
2020-04-27,3240,530,504,1034,栗林,簡易
2020-04-28,3240,476,460,936,栗林,簡易
2020-04-29,3240,516,489,1005,栗林,簡易
2020-04-30,3240,557,558,1115,栗林,簡易
2020-05-01,3240,595,645,1240,栗林,簡易
2020-05-02,3240,465,455,920,栗林,簡易
2020-05-03,3240,530,424,954,栗林,簡易
2020-05-04,3240,541,478,1019,栗林,簡易
2020-05-05,3240,490,485,975,栗林,簡易
2020-05-06,3240,497,466,963,栗林,簡易
2020-05-07,3240,510,510,1020,栗林,簡易
2020-05-08,3240,641,729,1370,栗林,簡易
2020-05-09,3240,570,548,1118,栗林,簡易
2020-05-10,3240,637,481,1118,栗林,簡易
2020-05-11,3240,574,485,1059,栗林,簡易
2020-05-12,3240,516,494,1010,栗林,簡易
2020-05-13,3240,509,499,1008,栗林,簡易
2020-05-14,3240,543,503,1046,栗林,簡易
2020-05-15,3240,733,651,1384,栗林,簡易
2020-05-16,3240,486,457,943,栗林,簡易
2020-05-17,3240,610,521,1131,栗林,簡易
2020-05-18,3240,525,512,1037,栗林,簡易
2020-05-19,3240,525,492,1017,栗林,簡易
2020-05-20,3240,545,531,1076,栗林,簡易
2020-05-21,3240,519,510,1029,栗林,簡易
2020-05-22,3240,567,606,1173,栗林,簡易
2020-05-23,3240,536,498,1034,栗林,簡易
2020-05-24,3240,708,592,1300,栗林,簡易
2020-05-25,3240,569,557,1126,栗林,簡易
2020-05-26,3240,504,477,981,栗林,簡易
2020-05-27,3240,512,512,1024,栗林,簡易
2020-05-28,3240,541,548,1089,栗林,簡易
2020-05-29,3240,616,653,1269,栗林,簡易
2020-05-30,3240,607,558,1165,栗林,簡易
2020-05-31,3240,620,527,1147,栗林,簡易
2020-06-01,3240,574,520,1094,栗林,簡易
2020-06-02,3240,548,519,1067,栗林,簡易
2020-06-03,3240,532,547,1079,栗林,簡易
2020-06-04,3240,576,550,1126,栗林,簡易
2020-06-05,3240,638,681,1319,栗林,簡易
2020-06-06,3240,594,538,1132,栗林,簡易
2020-06-07,3240,636,534,1170,栗林,簡易
2020-06-08,3240,548,524,1072,栗林,簡易
2020-06-09,3240,540,513,1053,栗林,簡易
2020-06-10,3240,559,547,1106,栗林,簡易
2020-06-11,3240,543,509,1052,栗林,簡易
2020-06-12,3240,650,687,1337,栗林,簡易
2020-06-13,3240,715,604,1319,栗林,簡易
2020-06-14,3240,732,635,1367,栗林,簡易
2020-06-15,3240,608,569,1177,栗林,簡易
2020-06-16,3240,550,540,1090,栗林,簡易
2020-06-17,3240,558,549,1107,栗林,簡易
2020-06-18,3240,565,504,1069,栗林,簡易
2020-06-19,3240,568,602,1170,栗林,簡易
2020-06-20,3240,706,595,1301,栗林,簡易
2020-06-21,3240,638,596,1234,栗林,簡易
2020-06-22,3240,565,566,1131,栗林,簡易
2020-06-23,3240,546,509,1055,栗林,簡易
2020-06-24,3240,663,702,1365,栗林,簡易
2020-06-25,3240,592,544,1136,栗林,簡易
2020-06-26,3240,668,671,1339,栗林,簡易
2020-06-27,3240,714,608,1322,栗林,簡易
2020-06-28,3240,676,647,1323,栗林,簡易
2020-06-29,3240,588,524,1112,栗林,簡易
2020-06-30,3240,572,536,1108,栗林,簡易
2020-07-01,3240,524,489,1013,栗林,簡易
2020-07-02,3240,546,508,1054,栗林,簡易
2020-07-03,3240,620,642,1262,栗林,簡易
2020-07-04,3240,582,504,1086,栗林,簡易
2020-07-05,3240,566,508,1074,栗林,簡易
2020-07-06,3240,597,583,1180,栗林,簡易
2020-07-07,3240,572,540,1112,栗林,簡易
2020-07-08,3240,570,527,1097,栗林,簡易
2020-07-09,3240,602,579,1181,栗林,簡易
2020-07-10,3240,770,655,1425,栗林,簡易
2020-07-11,3240,726,634,1360,栗林,簡易
2020-07-12,3240,808,735,1543,栗林,簡易
2020-07-13,3240,617,597,1214,栗林,簡易
2020-07-14,3240,720,579,1299,栗林,簡易
2020-07-15,3240,622,604,1226,栗林,簡易
2020-07-16,3240,542,536,1078,栗林,簡易
2020-07-17,3240,655,641,1296,栗林,簡易
2020-07-18,3240,750,657,1407,栗林,簡易
2020-07-19,3240,730,696,1426,栗林,簡易
2020-07-20,3240,654,611,1265,栗林,簡易
2020-07-21,3240,591,489,1080,栗林,簡易
2020-07-22,3240,565,568,1133,栗林,簡易
2020-07-23,3240,571,535,1106,栗林,簡易
2020-07-24,3240,667,656,1323,栗林,簡易
2020-07-25,3240,708,655,1363,栗林,簡易
2020-07-26,3240,739,725,1464,栗林,簡易
2020-07-27,3240,603,562,1165,栗林,簡易
2020-07-28,3240,582,535,1117,栗林,簡易
2020-07-29,3240,585,577,1162,栗林,簡易
2020-07-30,3240,601,578,1179,栗林,簡易
2020-07-31,3240,636,662,1298,栗林,簡易
2020-08-01,3240,718,636,1354,栗林,簡易
2020-08-02,3240,698,643,1341,栗林,簡易
2020-08-03,3240,533,552,1085,栗林,簡易
2020-08-04,3240,586,567,1153,栗林,簡易
2020-08-05,3240,594,560,1154,栗林,簡易
2020-08-06,3240,559,539,1098,栗林,簡易
2020-08-07,3240,698,722,1420,栗林,簡易
2020-08-08,3240,618,541,1159,栗林,簡易
2020-08-09,3240,803,694,1497,栗林,簡易
2020-08-10,3240,602,604,1206,栗林,簡易
2020-08-11,3240,644,605,1249,栗林,簡易
2020-08-12,3240,588,555,1143,栗林,簡易
2020-08-13,3240,625,578,1203,栗林,簡易
2020-08-14,3240,716,682,1398,栗林,簡易
2020-08-15,3240,776,658,1434,栗林,簡易
2020-08-16,3240,791,761,1552,栗林,簡易
2020-08-17,3240,597,604,1201,栗林,簡易
2020-08-18,3240,570,525,1095,栗林,簡易
2020-08-19,3240,581,566,1147,栗林,簡易
2020-08-20,3240,577,555,1132,栗林,簡易
2020-08-21,3240,711,672,1383,栗林,簡易
2020-08-22,3240,689,629,1318,栗林,簡易
2020-08-23,3240,733,726,1459,栗林,簡易
2020-08-24,3240,591,592,1183,栗林,簡易
2020-08-25,3240,664,599,1263,栗林,簡易
2020-08-26,3240,599,606,1205,栗林,簡易
2020-08-27,3240,575,548,1123,栗林,簡易
2020-08-28,3240,663,637,1300,栗林,簡易
2020-08-29,3240,661,612,1273,栗林,簡易
2020-08-30,3240,591,538,1129,栗林,簡易
2020-08-31,3240,629,614,1243,栗林,簡易
2020-09-01,3240,600,556,1156,栗林,簡易
2020-09-02,3240,555,561,1116,栗林,簡易
2020-09-03,3240,647,615,1262,栗林,簡易
2020-09-04,3240,738,702,1440,栗林,簡易
2020-09-05,3240,688,593,1281,栗林,簡易
2020-09-06,3240,715,681,1396,栗林,簡易
2020-09-07,3240,652,639,1291,栗林,簡易
2020-09-08,3240,627,610,1237,栗林,簡易
2020-09-09,3240,602,594,1196,栗林,簡易
2020-09-10,3240,661,646,1307,栗林,簡易
2020-09-11,3240,738,753,1491,栗林,簡易
2020-09-12,3240,781,692,1473,栗林,簡易
2020-09-13,3240,833,708,1541,栗林,簡易
2020-09-14,3240,630,593,1223,栗林,簡易
2020-09-15,3240,629,599,1228,栗林,簡易
2020-09-16,3240,634,628,1262,栗林,簡易
2020-09-17,3240,628,607,1235,栗林,簡易
2020-09-18,3240,740,783,1523,栗林,簡易
2020-09-19,3240,736,674,1410,栗林,簡易
2020-09-20,3240,837,685,1522,栗林,簡易
2020-09-21,3240,662,624,1286,栗林,簡易
2020-09-22,3240,666,624,1290,栗林,簡易
2020-09-23,3240,628,637,1265,栗林,簡易
2020-09-24,3240,638,664,1302,栗林,簡易
2020-09-25,3240,660,670,1330,栗林,簡易
2020-09-26,3240,653,604,1257,栗林,簡易
2020-09-27,3240,733,672,1405,栗林,簡易
2020-09-28,3240,631,611,1242,栗林,簡易
2020-09-29,3240,630,626,1256,栗林,簡易
2020-09-30,3240,732,951,1683,栗林,簡易
2020-10-01,3240,736,770,1506,栗林,簡易
2020-10-02,3240,821,761,1582,栗林,簡易
2020-10-03,3240,839,706,1545,栗林,簡易
2020-10-04,3240,901,672,1573,栗林,簡易
2020-10-05,3240,695,613,1308,栗林,簡易
2020-10-06,3240,697,654,1351,栗林,簡易
2020-10-07,3240,653,613,1266,栗林,簡易
2020-10-08,3240,739,784,1523,栗林,簡易
2020-10-09,3240,765,733,1498,栗林,簡易
2020-10-10,3240,840,710,1550,栗林,簡易
2020-10-11,3240,916,769,1685,栗林,簡易
2020-10-12,3240,713,658,1371,栗林,簡易
2020-10-13,3240,683,639,1322,栗林,簡易
2020-10-14,3240,652,609,1261,栗林,簡易
2020-10-15,3240,638,648,1286,栗林,簡易
2020-10-16,3240,784,760,1544,栗林,簡易
2020-10-17,3240,807,722,1529,栗林,簡易
2020-10-18,3240,968,884,1852,栗林,簡易
2020-10-19,3240,646,621,1267,栗林,簡易
2020-10-20,3240,615,593,1208,栗林,簡易
2020-10-21,3240,640,629,1269,栗林,簡易
2020-10-22,3240,655,627,1282,栗林,簡易
2020-10-23,3240,716,771,1487,栗林,簡易
2020-10-24,3240,817,741,1558,栗林,簡易
2020-10-25,3240,788,697,1485,栗林,簡易
2020-10-26,3240,671,646,1317,栗林,簡易
2020-10-27,3240,680,641,1321,栗林,簡易
2020-10-28,3240,668,656,1324,栗林,簡易
2020-10-29,3240,653,622,1275,栗林,簡易
2020-10-30,3240,741,805,1546,栗林,簡易
2020-10-31,3240,643,624,1267,栗林,簡易
2020-11-01,3240,800,745,1545,栗林,簡易
2020-11-02,3240,718,651,1369,栗林,簡易
2020-11-03,3240,607,589,1196,栗林,簡易
2020-11-04,3240,621,592,1213,栗林,簡易
2020-11-05,3240,632,632,1264,栗林,簡易
2020-11-06,3240,726,784,1510,栗林,簡易
2020-11-07,3240,703,635,1338,栗林,簡易
2020-11-08,3240,895,766,1661,栗林,簡易
2020-11-09,3240,703,650,1353,栗林,簡易
2020-11-10,3240,644,624,1268,栗林,簡易
2020-11-11,3240,664,691,1355,栗林,簡易
2020-11-12,3240,645,618,1263,栗林,簡易
2020-11-13,3240,742,829,1571,栗林,簡易
2020-11-14,3240,880,807,1687,栗林,簡易
2020-11-15,3240,1017,866,1883,栗林,簡易
2020-11-16,3240,827,756,1583,栗林,簡易
2020-11-17,3240,736,707,1443,栗林,簡易
2020-11-18,3240,772,749,1521,栗林,簡易
2020-11-19,3240,734,711,1445,栗林,簡易
2020-11-20,3240,828,874,1702,栗林,簡易
2020-11-21,3240,1006,924,1930,栗林,簡易
2020-11-22,3240,977,833,1810,栗林,簡易
2020-11-23,3240,717,665,1382,栗林,簡易
2020-11-24,3240,677,645,1322,栗林,簡易
2020-11-25,3240,662,636,1298,栗林,簡易
2020-11-26,3240,660,660,1320,栗林,簡易
2020-11-27,3240,772,847,1619,栗林,簡易
2020-11-28,3240,777,674,1451,栗林,簡易
2020-11-29,3240,770,678,1448,栗林,簡易
2020-11-30,3240,653,659,1312,栗林,簡易
2020-12-01,3240,662,645,1307,栗林,簡易
2020-12-02,3240,654,649,1303,栗林,簡易
2020-12-03,3240,610,592,1202,栗林,簡易
2020-12-04,3240,768,836,1604,栗林,簡易
2020-12-05,3240,797,716,1513,栗林,簡易
2020-12-06,3240,966,791,1757,栗林,簡易
2020-12-07,3240,689,666,1355,栗林,簡易
2020-12-08,3240,625,605,1230,栗林,簡易
2020-12-09,3240,640,592,1232,栗林,簡易
2020-12-10,3240,635,632,1267,栗林,簡易
2020-12-11,3240,736,825,1561,栗林,簡易
2020-12-12,3240,965,850,1815,栗林,簡易
2020-12-13,3240,1072,945,2017,栗林,簡易
2020-12-14,3240,680,654,1334,栗林,簡易
2020-12-15,3240,644,629,1273,栗林,簡易
2020-12-16,3240,667,652,1319,栗林,簡易
2020-12-17,3240,662,663,1325,栗林,簡易
2020-12-18,3240,774,860,1634,栗林,簡易
2020-12-19,3240,1003,891,1894,栗林,簡易
2020-12-20,3240,1024,941,1965,栗林,簡易
2020-12-21,3240,645,647,1292,栗林,簡易
2020-12-22,3240,657,600,1257,栗林,簡易
2020-12-23,3240,624,586,1210,栗林,簡易
2020-12-24,3240,679,684,1363,栗林,簡易
2020-12-25,3240,814,869,1683,栗林,簡易
2020-12-26,3240,785,706,1491,栗林,簡易
2020-12-27,3240,855,749,1604,栗林,簡易
2020-12-28,3240,622,595,1217,栗林,簡易
2020-12-29,3240,655,624,1279,栗林,簡易
2020-12-30,3240,643,625,1268,栗林,簡易
2020-12-31,3240,765,806,1571,栗林,簡易
2020-01-01,3250,2679,2971,5650,潭子,三等
2020-01-02,3250,2235,2215,4450,潭子,三等
2020-01-03,3250,2480,2572,5052,潭子,三等
2020-01-04,3250,2760,2620,5380,潭子,三等
2020-01-05,3250,3198,3087,6285,潭子,三等
2020-01-06,3250,2290,2257,4547,潭子,三等
2020-01-07,3250,2042,2005,4047,潭子,三等
2020-01-08,3250,2170,2099,4269,潭子,三等
2020-01-09,3250,2171,2166,4337,潭子,三等
2020-01-10,3250,2778,3224,6002,潭子,三等
2020-01-11,3250,3699,3487,7186,潭子,三等
2020-01-12,3250,4116,3823,7939,潭子,三等
2020-01-13,3250,2313,2233,4546,潭子,三等
2020-01-14,3250,2147,1956,4103,潭子,三等
2020-01-15,3250,2076,2050,4126,潭子,三等
2020-01-16,3250,2256,2213,4469,潭子,三等
2020-01-17,3250,2460,2379,4839,潭子,三等
2020-01-18,3250,2840,2586,5426,潭子,三等
2020-01-19,3250,3143,3040,6183,潭子,三等
2020-01-20,3250,2048,2153,4201,潭子,三等
2020-01-21,3250,2108,2177,4285,潭子,三等
2020-01-22,3250,2579,2583,5162,潭子,三等
2020-01-23,3250,2927,2824,5751,潭子,三等
2020-01-24,3250,3199,2525,5724,潭子,三等
2020-01-25,3250,3658,3424,7082,潭子,三等
2020-01-26,3250,3220,3069,6289,潭子,三等
2020-01-27,3250,3506,3317,6823,潭子,三等
2020-01-28,3250,2890,2897,5787,潭子,三等
2020-01-29,3250,2603,2487,5090,潭子,三等
2020-01-30,3250,2010,1925,3935,潭子,三等
2020-01-31,3250,2078,1976,4054,潭子,三等
2020-02-01,3250,2003,1970,3973,潭子,三等
2020-02-02,3250,2577,2489,5066,潭子,三等
2020-02-03,3250,1910,1813,3723,潭子,三等
2020-02-04,3250,1680,1662,3342,潭子,三等
2020-02-05,3250,1934,1869,3803,潭子,三等
2020-02-06,3250,1907,1826,3733,潭子,三等
2020-02-07,3250,2316,2193,4509,潭子,三等
2020-02-08,3250,3022,2901,5923,潭子,三等
2020-02-09,3250,3413,3434,6847,潭子,三等
2020-02-10,3250,2347,2304,4651,潭子,三等
2020-02-11,3250,2251,2175,4426,潭子,三等
2020-02-12,3250,2449,2440,4889,潭子,三等
2020-02-13,3250,2020,1963,3983,潭子,三等
2020-02-14,3250,2759,2741,5500,潭子,三等
2020-02-15,3250,3485,3415,6900,潭子,三等
2020-02-16,3250,3323,3311,6634,潭子,三等
2020-02-17,3250,2054,2068,4122,潭子,三等
2020-02-18,3250,1979,2001,3980,潭子,三等
2020-02-19,3250,2064,2015,4079,潭子,三等
2020-02-20,3250,2212,2161,4373,潭子,三等
2020-02-21,3250,2651,2658,5309,潭子,三等
2020-02-22,3250,3550,3410,6960,潭子,三等
2020-02-23,3250,3620,3417,7037,潭子,三等
2020-02-24,3250,1873,1812,3685,潭子,三等
2020-02-25,3250,1826,1769,3595,潭子,三等
2020-02-26,3250,1858,1772,3630,潭子,三等
2020-02-27,3250,2322,2407,4729,潭子,三等
2020-02-28,3250,2426,2301,4727,潭子,三等
2020-02-29,3250,2342,2268,4610,潭子,三等
2020-03-01,3250,2877,2631,5508,潭子,三等
2020-03-02,3250,2033,2010,4043,潭子,三等
2020-03-03,3250,1779,1746,3525,潭子,三等
2020-03-04,3250,1743,1750,3493,潭子,三等
2020-03-05,3250,1770,1762,3532,潭子,三等
2020-03-06,3250,2330,2434,4764,潭子,三等
2020-03-07,3250,2279,2224,4503,潭子,三等
2020-03-08,3250,2705,2479,5184,潭子,三等
2020-03-09,3250,2067,2007,4074,潭子,三等
2020-03-10,3250,1763,1736,3499,潭子,三等
2020-03-11,3250,1861,1809,3670,潭子,三等
2020-03-12,3250,1851,1930,3781,潭子,三等
2020-03-13,3250,2267,2551,4818,潭子,三等
2020-03-14,3250,2291,2154,4445,潭子,三等
2020-03-15,3250,2980,2680,5660,潭子,三等
2020-03-16,3250,1987,2002,3989,潭子,三等
2020-03-17,3250,1787,1714,3501,潭子,三等
2020-03-18,3250,1733,1741,3474,潭子,三等
2020-03-19,3250,1655,1699,3354,潭子,三等
2020-03-20,3250,2107,2335,4442,潭子,三等
2020-03-21,3250,2044,1899,3943,潭子,三等
2020-03-22,3250,2200,2018,4218,潭子,三等
2020-03-23,3250,1834,1872,3706,潭子,三等
2020-03-24,3250,1629,1592,3221,潭子,三等
2020-03-25,3250,1632,1622,3254,潭子,三等
2020-03-26,3250,1649,1643,3292,潭子,三等
2020-03-27,3250,1970,2135,4105,潭子,三等
2020-03-28,3250,1548,1532,3080,潭子,三等
2020-03-29,3250,1798,1734,3532,潭子,三等
2020-03-30,3250,1721,1684,3405,潭子,三等
2020-03-31,3250,1525,1617,3142,潭子,三等
2020-04-01,3250,1847,2174,4021,潭子,三等
2020-04-02,3250,1473,1455,2928,潭子,三等
2020-04-03,3250,1618,1527,3145,潭子,三等
2020-04-04,3250,1365,1327,2692,潭子,三等
2020-04-05,3250,2047,1743,3790,潭子,三等
2020-04-06,3250,1894,1758,3652,潭子,三等
2020-04-07,3250,1587,1576,3163,潭子,三等
2020-04-08,3250,1602,1596,3198,潭子,三等
2020-04-09,3250,1566,1608,3174,潭子,三等
2020-04-10,3250,1999,2212,4211,潭子,三等
2020-04-11,3250,1909,1795,3704,潭子,三等
2020-04-12,3250,2245,2085,4330,潭子,三等
2020-04-13,3250,1708,1729,3437,潭子,三等
2020-04-14,3250,1591,1561,3152,潭子,三等
2020-04-15,3250,1605,1633,3238,潭子,三等
2020-04-16,3250,1559,1615,3174,潭子,三等
2020-04-17,3250,2023,2182,4205,潭子,三等
2020-04-18,3250,1896,1804,3700,潭子,三等
2020-04-19,3250,2220,2045,4265,潭子,三等
2020-04-20,3250,1790,1735,3525,潭子,三等
2020-04-21,3250,1551,1563,3114,潭子,三等
2020-04-22,3250,1489,1544,3033,潭子,三等
2020-04-23,3250,1449,1497,2946,潭子,三等
2020-04-24,3250,1776,1969,3745,潭子,三等
2020-04-25,3250,1611,1538,3149,潭子,三等
2020-04-26,3250,1835,1690,3525,潭子,三等
2020-04-27,3250,1748,1720,3468,潭子,三等
2020-04-28,3250,1549,1586,3135,潭子,三等
2020-04-29,3250,1559,1551,3110,潭子,三等
2020-04-30,3250,1835,1893,3728,潭子,三等
2020-05-01,3250,2118,2246,4364,潭子,三等
2020-05-02,3250,1873,1814,3687,潭子,三等
2020-05-03,3250,2237,2021,4258,潭子,三等
2020-05-04,3250,1807,1709,3516,潭子,三等
2020-05-05,3250,1662,1630,3292,潭子,三等
2020-05-06,3250,1721,1712,3433,潭子,三等
2020-05-07,3250,1705,1744,3449,潭子,三等
2020-05-08,3250,2223,2572,4795,潭子,三等
2020-05-09,3250,2465,2366,4831,潭子,三等
2020-05-10,3250,2644,2388,5032,潭子,三等
2020-05-11,3250,1989,1854,3843,潭子,三等
2020-05-12,3250,1771,1729,3500,潭子,三等
2020-05-13,3250,1723,1737,3460,潭子,三等
2020-05-14,3250,1866,1859,3725,潭子,三等
2020-05-15,3250,2232,2394,4626,潭子,三等
2020-05-16,3250,2099,2004,4103,潭子,三等
2020-05-17,3250,2576,2410,4986,潭子,三等
2020-05-18,3250,1842,1825,3667,潭子,三等
2020-05-19,3250,1556,1576,3132,潭子,三等
2020-05-20,3250,1685,1689,3374,潭子,三等
2020-05-21,3250,1624,1617,3241,潭子,三等
2020-05-22,3250,1832,2052,3884,潭子,三等
2020-05-23,3250,1954,1802,3756,潭子,三等
2020-05-24,3250,2565,2475,5040,潭子,三等
2020-05-25,3250,1972,1915,3887,潭子,三等
2020-05-26,3250,1659,1682,3341,潭子,三等
2020-05-27,3250,1566,1552,3118,潭子,三等
2020-05-28,3250,1679,1631,3310,潭子,三等
2020-05-29,3250,2146,2289,4435,潭子,三等
2020-05-30,3250,2227,2178,4405,潭子,三等
2020-05-31,3250,2624,2447,5071,潭子,三等
2020-06-01,3250,2014,1970,3984,潭子,三等
2020-06-02,3250,1722,1706,3428,潭子,三等
2020-06-03,3250,1741,1726,3467,潭子,三等
2020-06-04,3250,1808,1731,3539,潭子,三等
2020-06-05,3250,2244,2413,4657,潭子,三等
2020-06-06,3250,2503,2210,4713,潭子,三等
2020-06-07,3250,2712,2426,5138,潭子,三等
2020-06-08,3250,2005,1937,3942,潭子,三等
2020-06-09,3250,1791,1755,3546,潭子,三等
2020-06-10,3250,1933,1897,3830,潭子,三等
2020-06-11,3250,1953,1953,3906,潭子,三等
2020-06-12,3250,2392,2463,4855,潭子,三等
2020-06-13,3250,2804,2482,5286,潭子,三等
2020-06-14,3250,2998,2777,5775,潭子,三等
2020-06-15,3250,1991,2089,4080,潭子,三等
2020-06-16,3250,1850,1906,3756,潭子,三等
2020-06-17,3250,1805,1802,3607,潭子,三等
2020-06-18,3250,1831,1829,3660,潭子,三等
2020-06-19,3250,2042,2053,4095,潭子,三等
2020-06-20,3250,2441,2214,4655,潭子,三等
2020-06-21,3250,2585,2541,5126,潭子,三等
2020-06-22,3250,1915,1881,3796,潭子,三等
2020-06-23,3250,1971,1870,3841,潭子,三等
2020-06-24,3250,2345,2596,4941,潭子,三等
2020-06-25,3250,2489,2446,4935,潭子,三等
2020-06-26,3250,2858,2582,5440,潭子,三等
2020-06-27,3250,2852,2766,5618,潭子,三等
2020-06-28,3250,3187,3085,6272,潭子,三等
2020-06-29,3250,2079,2003,4082,潭子,三等
2020-06-30,3250,1888,1879,3767,潭子,三等
2020-07-01,3250,1790,1719,3509,潭子,三等
2020-07-02,3250,1726,1708,3434,潭子,三等
2020-07-03,3250,2171,2228,4399,潭子,三等
2020-07-04,3250,2398,2098,4496,潭子,三等
2020-07-05,3250,2650,2657,5307,潭子,三等
2020-07-06,3250,2066,2083,4149,潭子,三等
2020-07-07,3250,1928,1918,3846,潭子,三等
2020-07-08,3250,1837,1824,3661,潭子,三等
2020-07-09,3250,1876,1885,3761,潭子,三等
2020-07-10,3250,2500,2446,4946,潭子,三等
2020-07-11,3250,3018,2757,5775,潭子,三等
2020-07-12,3250,3372,3332,6704,潭子,三等
2020-07-13,3250,2131,2193,4324,潭子,三等
2020-07-14,3250,2020,2030,4050,潭子,三等
2020-07-15,3250,2157,2003,4160,潭子,三等
2020-07-16,3250,2026,1918,3944,潭子,三等
2020-07-17,3250,2463,2335,4798,潭子,三等
2020-07-18,3250,2723,2567,5290,潭子,三等
2020-07-19,3250,3158,3055,6213,潭子,三等
2020-07-20,3250,2112,2031,4143,潭子,三等
2020-07-21,3250,1874,1828,3702,潭子,三等
2020-07-22,3250,1910,1801,3711,潭子,三等
2020-07-23,3250,1964,1981,3945,潭子,三等
2020-07-24,3250,2377,2311,4688,潭子,三等
2020-07-25,3250,2767,2549,5316,潭子,三等
2020-07-26,3250,2966,2845,5811,潭子,三等
2020-07-27,3250,2031,2164,4195,潭子,三等
2020-07-28,3250,1868,1793,3661,潭子,三等
2020-07-29,3250,2040,1920,3960,潭子,三等
2020-07-30,3250,1975,1882,3857,潭子,三等
2020-07-31,3250,2562,2468,5030,潭子,三等
2020-08-01,3250,2497,2445,4942,潭子,三等
2020-08-02,3250,2797,2781,5578,潭子,三等
2020-08-03,3250,1929,1900,3829,潭子,三等
2020-08-04,3250,1972,1875,3847,潭子,三等
2020-08-05,3250,2082,2029,4111,潭子,三等
2020-08-06,3250,2028,1956,3984,潭子,三等
2020-08-07,3250,2489,2561,5050,潭子,三等
2020-08-08,3250,2590,2464,5054,潭子,三等
2020-08-09,3250,3134,2964,6098,潭子,三等
2020-08-10,3250,2349,2335,4684,潭子,三等
2020-08-11,3250,1949,1852,3801,潭子,三等
2020-08-12,3250,2012,1883,3895,潭子,三等
2020-08-13,3250,1995,2020,4015,潭子,三等
2020-08-14,3250,2600,2499,5099,潭子,三等
2020-08-15,3250,2796,2563,5359,潭子,三等
2020-08-16,3250,3456,3472,6928,潭子,三等
2020-08-17,3250,2087,2212,4299,潭子,三等
2020-08-18,3250,2048,2014,4062,潭子,三等
2020-08-19,3250,2016,1971,3987,潭子,三等
2020-08-20,3250,2068,1948,4016,潭子,三等
2020-08-21,3250,2462,2376,4838,潭子,三等
2020-08-22,3250,2534,2315,4849,潭子,三等
2020-08-23,3250,3003,3050,6053,潭子,三等
2020-08-24,3250,2214,2136,4350,潭子,三等
2020-08-25,3250,2034,1999,4033,潭子,三等
2020-08-26,3250,2022,1930,3952,潭子,三等
2020-08-27,3250,1902,1803,3705,潭子,三等
2020-08-28,3250,2323,2160,4483,潭子,三等
2020-08-29,3250,2528,2293,4821,潭子,三等
2020-08-30,3250,2966,2906,5872,潭子,三等
2020-08-31,3250,1902,1913,3815,潭子,三等
2020-09-01,3250,1871,1879,3750,潭子,三等
2020-09-02,3250,1795,1887,3682,潭子,三等
2020-09-03,3250,1887,1836,3723,潭子,三等
2020-09-04,3250,2359,2331,4690,潭子,三等
2020-09-05,3250,2647,2390,5037,潭子,三等
2020-09-06,3250,2952,2875,5827,潭子,三等
2020-09-07,3250,2123,2120,4243,潭子,三等
2020-09-08,3250,1993,1918,3911,潭子,三等
2020-09-09,3250,1929,1868,3797,潭子,三等
2020-09-10,3250,1981,1998,3979,潭子,三等
2020-09-11,3250,2556,2550,5106,潭子,三等
2020-09-12,3250,2925,2609,5534,潭子,三等
2020-09-13,3250,3435,3266,6701,潭子,三等
2020-09-14,3250,2073,2157,4230,潭子,三等
2020-09-15,3250,1828,1843,3671,潭子,三等
2020-09-16,3250,1864,1813,3677,潭子,三等
2020-09-17,3250,1918,1873,3791,潭子,三等
2020-09-18,3250,2421,2511,4932,潭子,三等
2020-09-19,3250,2694,2608,5302,潭子,三等
2020-09-20,3250,3223,3060,6283,潭子,三等
2020-09-21,3250,2122,2097,4219,潭子,三等
2020-09-22,3250,1941,1897,3838,潭子,三等
2020-09-23,3250,1943,1891,3834,潭子,三等
2020-09-24,3250,1997,1954,3951,潭子,三等
2020-09-25,3250,2127,2161,4288,潭子,三等
2020-09-26,3250,2368,2271,4639,潭子,三等
2020-09-27,3250,2819,2709,5528,潭子,三等
2020-09-28,3250,2071,2025,4096,潭子,三等
2020-09-29,3250,1952,1977,3929,潭子,三等
2020-09-30,3250,2422,2929,5351,潭子,三等
2020-10-01,3250,2762,2763,5525,潭子,三等
2020-10-02,3250,2824,2672,5496,潭子,三等
2020-10-03,3250,2944,2895,5839,潭子,三等
2020-10-04,3250,3514,3022,6536,潭子,三等
2020-10-05,3250,2190,2031,4221,潭子,三等
2020-10-06,3250,2020,1979,3999,潭子,三等
2020-10-07,3250,1987,1991,3978,潭子,三等
2020-10-08,3250,2480,2693,5173,潭子,三等
2020-10-09,3250,2909,2799,5708,潭子,三等
2020-10-10,3250,3162,2928,6090,潭子,三等
2020-10-11,3250,3665,3533,7198,潭子,三等
2020-10-12,3250,2257,2125,4382,潭子,三等
2020-10-13,3250,1939,1927,3866,潭子,三等
2020-10-14,3250,2029,1934,3963,潭子,三等
2020-10-15,3250,1915,1994,3909,潭子,三等
2020-10-16,3250,2325,2598,4923,潭子,三等
2020-10-17,3250,2766,2513,5279,潭子,三等
2020-10-18,3250,3458,3237,6695,潭子,三等
2020-10-19,3250,2138,2133,4271,潭子,三等
2020-10-20,3250,1982,1916,3898,潭子,三等
2020-10-21,3250,2007,1976,3983,潭子,三等
2020-10-22,3250,1940,1911,3851,潭子,三等
2020-10-23,3250,2422,2598,5020,潭子,三等
2020-10-24,3250,2813,2648,5461,潭子,三等
2020-10-25,3250,3165,3041,6206,潭子,三等
2020-10-26,3250,2176,2076,4252,潭子,三等
2020-10-27,3250,1874,1797,3671,潭子,三等
2020-10-28,3250,1892,1860,3752,潭子,三等
2020-10-29,3250,1930,1911,3841,潭子,三等
2020-10-30,3250,2361,2707,5068,潭子,三等
2020-10-31,3250,2595,2466,5061,潭子,三等
2020-11-01,3250,3067,2943,6010,潭子,三等
2020-11-02,3250,2129,2011,4140,潭子,三等
2020-11-03,3250,1842,1812,3654,潭子,三等
2020-11-04,3250,1917,1813,3730,潭子,三等
2020-11-05,3250,1889,1949,3838,潭子,三等
2020-11-06,3250,2460,2626,5086,潭子,三等
2020-11-07,3250,2734,2576,5310,潭子,三等
2020-11-08,3250,3250,3174,6424,潭子,三等
2020-11-09,3250,2199,2031,4230,潭子,三等
2020-11-10,3250,1983,1960,3943,潭子,三等
2020-11-11,3250,2022,2014,4036,潭子,三等
2020-11-12,3250,1993,1992,3985,潭子,三等
2020-11-13,3250,2447,2672,5119,潭子,三等
2020-11-14,3250,3136,2947,6083,潭子,三等
2020-11-15,3250,3836,3409,7245,潭子,三等
2020-11-16,3250,2356,2208,4564,潭子,三等
2020-11-17,3250,2024,1977,4001,潭子,三等
2020-11-18,3250,2071,2087,4158,潭子,三等
2020-11-19,3250,2025,2064,4089,潭子,三等
2020-11-20,3250,2487,2723,5210,潭子,三等
2020-11-21,3250,2997,2721,5718,潭子,三等
2020-11-22,3250,3411,3325,6736,潭子,三等
2020-11-23,3250,2150,2038,4188,潭子,三等
2020-11-24,3250,1981,1902,3883,潭子,三等
2020-11-25,3250,1991,1958,3949,潭子,三等
2020-11-26,3250,1966,2048,4014,潭子,三等
2020-11-27,3250,2402,2631,5033,潭子,三等
2020-11-28,3250,3022,2810,5832,潭子,三等
2020-11-29,3250,3082,2920,6002,潭子,三等
2020-11-30,3250,2213,2153,4366,潭子,三等
2020-12-01,3250,1885,1833,3718,潭子,三等
2020-12-02,3250,1961,1913,3874,潭子,三等
2020-12-03,3250,1916,1905,3821,潭子,三等
2020-12-04,3250,2357,2682,5039,潭子,三等
2020-12-05,3250,2685,2688,5373,潭子,三等
2020-12-06,3250,3359,3188,6547,潭子,三等
2020-12-07,3250,2265,2102,4367,潭子,三等
2020-12-08,3250,1951,1938,3889,潭子,三等
2020-12-09,3250,1845,1803,3648,潭子,三等
2020-12-10,3250,2125,2089,4214,潭子,三等
2020-12-11,3250,2459,2745,5204,潭子,三等
2020-12-12,3250,3332,3097,6429,潭子,三等
2020-12-13,3250,3914,3690,7604,潭子,三等
2020-12-14,3250,2112,2102,4214,潭子,三等
2020-12-15,3250,1998,1953,3951,潭子,三等
2020-12-16,3250,2030,1950,3980,潭子,三等
2020-12-17,3250,1954,1963,3917,潭子,三等
2020-12-18,3250,2515,2738,5253,潭子,三等
2020-12-19,3250,3098,2955,6053,潭子,三等
2020-12-20,3250,3565,3494,7059,潭子,三等
2020-12-21,3250,2089,1933,4022,潭子,三等
2020-12-22,3250,1981,1993,3974,潭子,三等
2020-12-23,3250,1779,1764,3543,潭子,三等
2020-12-24,3250,2065,1986,4051,潭子,三等
2020-12-25,3250,2668,2773,5441,潭子,三等
2020-12-26,3250,2768,2596,5364,潭子,三等
2020-12-27,3250,3071,2943,6014,潭子,三等
2020-12-28,3250,2073,2047,4120,潭子,三等
2020-12-29,3250,1903,1924,3827,潭子,三等
2020-12-30,3250,1992,1951,3943,潭子,三等
2020-12-31,3250,2675,2709,5384,潭子,三等
2020-01-01,3260,471,492,963,頭家厝,簡易
2020-01-02,3260,462,453,915,頭家厝,簡易
2020-01-03,3260,526,569,1095,頭家厝,簡易
2020-01-04,3260,519,518,1037,頭家厝,簡易
2020-01-05,3260,538,489,1027,頭家厝,簡易
2020-01-06,3260,489,473,962,頭家厝,簡易
2020-01-07,3260,443,422,865,頭家厝,簡易
2020-01-08,3260,456,451,907,頭家厝,簡易
2020-01-09,3260,481,497,978,頭家厝,簡易
2020-01-10,3260,541,797,1338,頭家厝,簡易
2020-01-11,3260,540,579,1119,頭家厝,簡易
2020-01-12,3260,630,486,1116,頭家厝,簡易
2020-01-13,3260,528,472,1000,頭家厝,簡易
2020-01-14,3260,481,481,962,頭家厝,簡易
2020-01-15,3260,488,484,972,頭家厝,簡易
2020-01-16,3260,476,474,950,頭家厝,簡易
2020-01-17,3260,541,535,1076,頭家厝,簡易
2020-01-18,3260,464,493,957,頭家厝,簡易
2020-01-19,3260,539,484,1023,頭家厝,簡易
2020-01-20,3260,482,464,946,頭家厝,簡易
2020-01-21,3260,491,492,983,頭家厝,簡易
2020-01-22,3260,539,566,1105,頭家厝,簡易
2020-01-23,3260,403,399,802,頭家厝,簡易
2020-01-24,3260,346,302,648,頭家厝,簡易
2020-01-25,3260,435,437,872,頭家厝,簡易
2020-01-26,3260,420,394,814,頭家厝,簡易
2020-01-27,3260,550,557,1107,頭家厝,簡易
2020-01-28,3260,488,533,1021,頭家厝,簡易
2020-01-29,3260,481,437,918,頭家厝,簡易
2020-01-30,3260,436,369,805,頭家厝,簡易
2020-01-31,3260,456,446,902,頭家厝,簡易
2020-02-01,3260,414,364,778,頭家厝,簡易
2020-02-02,3260,445,403,848,頭家厝,簡易
2020-02-03,3260,513,394,907,頭家厝,簡易
2020-02-04,3260,380,361,741,頭家厝,簡易
2020-02-05,3260,457,441,898,頭家厝,簡易
2020-02-06,3260,440,412,852,頭家厝,簡易
2020-02-07,3260,560,554,1114,頭家厝,簡易
2020-02-08,3260,731,639,1370,頭家厝,簡易
2020-02-09,3260,653,602,1255,頭家厝,簡易
2020-02-10,3260,593,542,1135,頭家厝,簡易
2020-02-11,3260,554,552,1106,頭家厝,簡易
2020-02-12,3260,596,586,1182,頭家厝,簡易
2020-02-13,3260,483,447,930,頭家厝,簡易
2020-02-14,3260,651,618,1269,頭家厝,簡易
2020-02-15,3260,815,807,1622,頭家厝,簡易
2020-02-16,3260,508,476,984,頭家厝,簡易
2020-02-17,3260,526,526,1052,頭家厝,簡易
2020-02-18,3260,528,497,1025,頭家厝,簡易
2020-02-19,3260,581,558,1139,頭家厝,簡易
2020-02-20,3260,594,603,1197,頭家厝,簡易
2020-02-21,3260,660,649,1309,頭家厝,簡易
2020-02-22,3260,896,851,1747,頭家厝,簡易
2020-02-23,3260,816,767,1583,頭家厝,簡易
2020-02-24,3260,483,406,889,頭家厝,簡易
2020-02-25,3260,425,390,815,頭家厝,簡易
2020-02-26,3260,417,423,840,頭家厝,簡易
2020-02-27,3260,471,541,1012,頭家厝,簡易
2020-02-28,3260,462,441,903,頭家厝,簡易
2020-02-29,3260,460,383,843,頭家厝,簡易
2020-03-01,3260,491,428,919,頭家厝,簡易
2020-03-02,3260,468,396,864,頭家厝,簡易
2020-03-03,3260,444,389,833,頭家厝,簡易
2020-03-04,3260,429,449,878,頭家厝,簡易
2020-03-05,3260,419,412,831,頭家厝,簡易
2020-03-06,3260,483,548,1031,頭家厝,簡易
2020-03-07,3260,413,404,817,頭家厝,簡易
2020-03-08,3260,443,349,792,頭家厝,簡易
2020-03-09,3260,479,397,876,頭家厝,簡易
2020-03-10,3260,408,395,803,頭家厝,簡易
2020-03-11,3260,436,419,855,頭家厝,簡易
2020-03-12,3260,405,420,825,頭家厝,簡易
2020-03-13,3260,505,599,1104,頭家厝,簡易
2020-03-14,3260,430,370,800,頭家厝,簡易
2020-03-15,3260,465,342,807,頭家厝,簡易
2020-03-16,3260,432,389,821,頭家厝,簡易
2020-03-17,3260,426,399,825,頭家厝,簡易
2020-03-18,3260,417,412,829,頭家厝,簡易
2020-03-19,3260,387,416,803,頭家厝,簡易
2020-03-20,3260,482,523,1005,頭家厝,簡易
2020-03-21,3260,336,351,687,頭家厝,簡易
2020-03-22,3260,396,295,691,頭家厝,簡易
2020-03-23,3260,457,351,808,頭家厝,簡易
2020-03-24,3260,367,349,716,頭家厝,簡易
2020-03-25,3260,370,369,739,頭家厝,簡易
2020-03-26,3260,396,385,781,頭家厝,簡易
2020-03-27,3260,431,526,957,頭家厝,簡易
2020-03-28,3260,280,269,549,頭家厝,簡易
2020-03-29,3260,349,297,646,頭家厝,簡易
2020-03-30,3260,429,396,825,頭家厝,簡易
2020-03-31,3260,358,374,732,頭家厝,簡易
2020-04-01,3260,411,501,912,頭家厝,簡易
2020-04-02,3260,311,345,656,頭家厝,簡易
2020-04-03,3260,316,282,598,頭家厝,簡易
2020-04-04,3260,267,230,497,頭家厝,簡易
2020-04-05,3260,400,282,682,頭家厝,簡易
2020-04-06,3260,425,337,762,頭家厝,簡易
2020-04-07,3260,380,319,699,頭家厝,簡易
2020-04-08,3260,351,341,692,頭家厝,簡易
2020-04-09,3260,354,370,724,頭家厝,簡易
2020-04-10,3260,415,457,872,頭家厝,簡易
2020-04-11,3260,310,292,602,頭家厝,簡易
2020-04-12,3260,337,287,624,頭家厝,簡易
2020-04-13,3260,387,343,730,頭家厝,簡易
2020-04-14,3260,355,328,683,頭家厝,簡易
2020-04-15,3260,366,381,747,頭家厝,簡易
2020-04-16,3260,381,365,746,頭家厝,簡易
2020-04-17,3260,428,508,936,頭家厝,簡易
2020-04-18,3260,325,292,617,頭家厝,簡易
2020-04-19,3260,392,274,666,頭家厝,簡易
2020-04-20,3260,390,343,733,頭家厝,簡易
2020-04-21,3260,340,332,672,頭家厝,簡易
2020-04-22,3260,359,351,710,頭家厝,簡易
2020-04-23,3260,329,361,690,頭家厝,簡易
2020-04-24,3260,432,490,922,頭家厝,簡易
2020-04-25,3260,301,291,592,頭家厝,簡易
2020-04-26,3260,356,266,622,頭家厝,簡易
2020-04-27,3260,386,364,750,頭家厝,簡易
2020-04-28,3260,335,334,669,頭家厝,簡易
2020-04-29,3260,376,365,741,頭家厝,簡易
2020-04-30,3260,396,456,852,頭家厝,簡易
2020-05-01,3260,479,492,971,頭家厝,簡易
2020-05-02,3260,326,291,617,頭家厝,簡易
2020-05-03,3260,393,311,704,頭家厝,簡易
2020-05-04,3260,439,354,793,頭家厝,簡易
2020-05-05,3260,342,338,680,頭家厝,簡易
2020-05-06,3260,357,372,729,頭家厝,簡易
2020-05-07,3260,387,421,808,頭家厝,簡易
2020-05-08,3260,475,575,1050,頭家厝,簡易
2020-05-09,3260,371,402,773,頭家厝,簡易
2020-05-10,3260,526,384,910,頭家厝,簡易
2020-05-11,3260,472,378,850,頭家厝,簡易
2020-05-12,3260,391,378,769,頭家厝,簡易
2020-05-13,3260,371,346,717,頭家厝,簡易
2020-05-14,3260,388,381,769,頭家厝,簡易
2020-05-15,3260,425,540,965,頭家厝,簡易
2020-05-16,3260,344,329,673,頭家厝,簡易
2020-05-17,3260,410,354,764,頭家厝,簡易
2020-05-18,3260,454,398,852,頭家厝,簡易
2020-05-19,3260,390,374,764,頭家厝,簡易
2020-05-20,3260,394,377,771,頭家厝,簡易
2020-05-21,3260,397,421,818,頭家厝,簡易
2020-05-22,3260,435,517,952,頭家厝,簡易
2020-05-23,3260,391,328,719,頭家厝,簡易
2020-05-24,3260,483,401,884,頭家厝,簡易
2020-05-25,3260,469,410,879,頭家厝,簡易
2020-05-26,3260,385,374,759,頭家厝,簡易
2020-05-27,3260,403,398,801,頭家厝,簡易
2020-05-28,3260,392,418,810,頭家厝,簡易
2020-05-29,3260,494,549,1043,頭家厝,簡易
2020-05-30,3260,433,415,848,頭家厝,簡易
2020-05-31,3260,501,388,889,頭家厝,簡易
2020-06-01,3260,482,401,883,頭家厝,簡易
2020-06-02,3260,441,399,840,頭家厝,簡易
2020-06-03,3260,402,385,787,頭家厝,簡易
2020-06-04,3260,405,417,822,頭家厝,簡易
2020-06-05,3260,485,563,1048,頭家厝,簡易
2020-06-06,3260,459,420,879,頭家厝,簡易
2020-06-07,3260,484,397,881,頭家厝,簡易
2020-06-08,3260,474,382,856,頭家厝,簡易
2020-06-09,3260,427,385,812,頭家厝,簡易
2020-06-10,3260,449,431,880,頭家厝,簡易
2020-06-11,3260,433,446,879,頭家厝,簡易
2020-06-12,3260,511,563,1074,頭家厝,簡易
2020-06-13,3260,481,407,888,頭家厝,簡易
2020-06-14,3260,510,420,930,頭家厝,簡易
2020-06-15,3260,501,432,933,頭家厝,簡易
2020-06-16,3260,437,408,845,頭家厝,簡易
2020-06-17,3260,464,441,905,頭家厝,簡易
2020-06-18,3260,435,420,855,頭家厝,簡易
2020-06-19,3260,426,478,904,頭家厝,簡易
2020-06-20,3260,456,464,920,頭家厝,簡易
2020-06-21,3260,440,359,799,頭家厝,簡易
2020-06-22,3260,486,428,914,頭家厝,簡易
2020-06-23,3260,443,430,873,頭家厝,簡易
2020-06-24,3260,509,581,1090,頭家厝,簡易
2020-06-25,3260,491,472,963,頭家厝,簡易
2020-06-26,3260,523,504,1027,頭家厝,簡易
2020-06-27,3260,492,422,914,頭家厝,簡易
2020-06-28,3260,535,460,995,頭家厝,簡易
2020-06-29,3260,534,398,932,頭家厝,簡易
2020-06-30,3260,430,399,829,頭家厝,簡易
2020-07-01,3260,431,415,846,頭家厝,簡易
2020-07-02,3260,423,399,822,頭家厝,簡易
2020-07-03,3260,555,528,1083,頭家厝,簡易
2020-07-04,3260,513,463,976,頭家厝,簡易
2020-07-05,3260,450,428,878,頭家厝,簡易
2020-07-06,3260,496,462,958,頭家厝,簡易
2020-07-07,3260,445,423,868,頭家厝,簡易
2020-07-08,3260,446,422,868,頭家厝,簡易
2020-07-09,3260,452,442,894,頭家厝,簡易
2020-07-10,3260,492,469,961,頭家厝,簡易
2020-07-11,3260,483,450,933,頭家厝,簡易
2020-07-12,3260,543,464,1007,頭家厝,簡易
2020-07-13,3260,504,485,989,頭家厝,簡易
2020-07-14,3260,456,456,912,頭家厝,簡易
2020-07-15,3260,478,469,947,頭家厝,簡易
2020-07-16,3260,526,437,963,頭家厝,簡易
2020-07-17,3260,548,580,1128,頭家厝,簡易
2020-07-18,3260,520,474,994,頭家厝,簡易
2020-07-19,3260,512,509,1021,頭家厝,簡易
2020-07-20,3260,530,456,986,頭家厝,簡易
2020-07-21,3260,453,404,857,頭家厝,簡易
2020-07-22,3260,486,423,909,頭家厝,簡易
2020-07-23,3260,528,500,1028,頭家厝,簡易
2020-07-24,3260,592,588,1180,頭家厝,簡易
2020-07-25,3260,509,452,961,頭家厝,簡易
2020-07-26,3260,535,497,1032,頭家厝,簡易
2020-07-27,3260,515,438,953,頭家厝,簡易
2020-07-28,3260,456,407,863,頭家厝,簡易
2020-07-29,3260,477,433,910,頭家厝,簡易
2020-07-30,3260,490,454,944,頭家厝,簡易
2020-07-31,3260,576,572,1148,頭家厝,簡易
2020-08-01,3260,574,498,1072,頭家厝,簡易
2020-08-02,3260,541,470,1011,頭家厝,簡易
2020-08-03,3260,507,402,909,頭家厝,簡易
2020-08-04,3260,458,422,880,頭家厝,簡易
2020-08-05,3260,506,425,931,頭家厝,簡易
2020-08-06,3260,502,462,964,頭家厝,簡易
2020-08-07,3260,558,595,1153,頭家厝,簡易
2020-08-08,3260,484,463,947,頭家厝,簡易
2020-08-09,3260,571,465,1036,頭家厝,簡易
2020-08-10,3260,545,442,987,頭家厝,簡易
2020-08-11,3260,481,438,919,頭家厝,簡易
2020-08-12,3260,489,456,945,頭家厝,簡易
2020-08-13,3260,557,499,1056,頭家厝,簡易
2020-08-14,3260,570,557,1127,頭家厝,簡易
2020-08-15,3260,542,488,1030,頭家厝,簡易
2020-08-16,3260,574,554,1128,頭家厝,簡易
2020-08-17,3260,559,501,1060,頭家厝,簡易
2020-08-18,3260,511,465,976,頭家厝,簡易
2020-08-19,3260,525,482,1007,頭家厝,簡易
2020-08-20,3260,519,494,1013,頭家厝,簡易
2020-08-21,3260,981,603,1584,頭家厝,簡易
2020-08-22,3260,518,436,954,頭家厝,簡易
2020-08-23,3260,546,522,1068,頭家厝,簡易
2020-08-24,3260,534,470,1004,頭家厝,簡易
2020-08-25,3260,546,474,1020,頭家厝,簡易
2020-08-26,3260,496,475,971,頭家厝,簡易
2020-08-27,3260,537,490,1027,頭家厝,簡易
2020-08-28,3260,551,560,1111,頭家厝,簡易
2020-08-29,3260,489,461,950,頭家厝,簡易
2020-08-30,3260,550,441,991,頭家厝,簡易
2020-08-31,3260,489,419,908,頭家厝,簡易
2020-09-01,3260,479,413,892,頭家厝,簡易
2020-09-02,3260,471,432,903,頭家厝,簡易
2020-09-03,3260,473,445,918,頭家厝,簡易
2020-09-04,3260,563,617,1180,頭家厝,簡易
2020-09-05,3260,590,474,1064,頭家厝,簡易
2020-09-06,3260,521,433,954,頭家厝,簡易
2020-09-07,3260,518,435,953,頭家厝,簡易
2020-09-08,3260,482,449,931,頭家厝,簡易
2020-09-09,3260,487,442,929,頭家厝,簡易
2020-09-10,3260,497,484,981,頭家厝,簡易
2020-09-11,3260,563,582,1145,頭家厝,簡易
2020-09-12,3260,564,502,1066,頭家厝,簡易
2020-09-13,3260,518,472,990,頭家厝,簡易
2020-09-14,3260,540,427,967,頭家厝,簡易
2020-09-15,3260,482,424,906,頭家厝,簡易
2020-09-16,3260,485,434,919,頭家厝,簡易
2020-09-17,3260,513,481,994,頭家厝,簡易
2020-09-18,3260,579,636,1215,頭家厝,簡易
2020-09-19,3260,535,516,1051,頭家厝,簡易
2020-09-20,3260,614,494,1108,頭家厝,簡易
2020-09-21,3260,554,438,992,頭家厝,簡易
2020-09-22,3260,490,415,905,頭家厝,簡易
2020-09-23,3260,474,473,947,頭家厝,簡易
2020-09-24,3260,495,458,953,頭家厝,簡易
2020-09-25,3260,508,487,995,頭家厝,簡易
2020-09-26,3260,477,489,966,頭家厝,簡易
2020-09-27,3260,484,442,926,頭家厝,簡易
2020-09-28,3260,534,410,944,頭家厝,簡易
2020-09-29,3260,479,453,932,頭家厝,簡易
2020-09-30,3260,586,746,1332,頭家厝,簡易
2020-10-01,3260,627,602,1229,頭家厝,簡易
2020-10-02,3260,618,577,1195,頭家厝,簡易
2020-10-03,3260,614,532,1146,頭家厝,簡易
2020-10-04,3260,698,506,1204,頭家厝,簡易
2020-10-05,3260,615,450,1065,頭家厝,簡易
2020-10-06,3260,487,441,928,頭家厝,簡易
2020-10-07,3260,484,471,955,頭家厝,簡易
2020-10-08,3260,569,645,1214,頭家厝,簡易
2020-10-09,3260,577,584,1161,頭家厝,簡易
2020-10-10,3260,522,490,1012,頭家厝,簡易
2020-10-11,3260,619,506,1125,頭家厝,簡易
2020-10-12,3260,542,446,988,頭家厝,簡易
2020-10-13,3260,510,439,949,頭家厝,簡易
2020-10-14,3260,506,459,965,頭家厝,簡易
2020-10-15,3260,488,455,943,頭家厝,簡易
2020-10-16,3260,571,638,1209,頭家厝,簡易
2020-10-17,3260,582,535,1117,頭家厝,簡易
2020-10-18,3260,551,505,1056,頭家厝,簡易
2020-10-19,3260,575,458,1033,頭家厝,簡易
2020-10-20,3260,479,447,926,頭家厝,簡易
2020-10-21,3260,475,465,940,頭家厝,簡易
2020-10-22,3260,513,471,984,頭家厝,簡易
2020-10-23,3260,577,573,1150,頭家厝,簡易
2020-10-24,3260,565,588,1153,頭家厝,簡易
2020-10-25,3260,641,552,1193,頭家厝,簡易
2020-10-26,3260,568,458,1026,頭家厝,簡易
2020-10-27,3260,501,465,966,頭家厝,簡易
2020-10-28,3260,472,451,923,頭家厝,簡易
2020-10-29,3260,487,449,936,頭家厝,簡易
2020-10-30,3260,591,648,1239,頭家厝,簡易
2020-10-31,3260,595,572,1167,頭家厝,簡易
2020-11-01,3260,594,524,1118,頭家厝,簡易
2020-11-02,3260,528,424,952,頭家厝,簡易
2020-11-03,3260,482,423,905,頭家厝,簡易
2020-11-04,3260,458,450,908,頭家厝,簡易
2020-11-05,3260,459,439,898,頭家厝,簡易
2020-11-06,3260,529,621,1150,頭家厝,簡易
2020-11-07,3260,560,534,1094,頭家厝,簡易
2020-11-08,3260,559,520,1079,頭家厝,簡易
2020-11-09,3260,571,442,1013,頭家厝,簡易
2020-11-10,3260,470,418,888,頭家厝,簡易
2020-11-11,3260,464,460,924,頭家厝,簡易
2020-11-12,3260,478,461,939,頭家厝,簡易
2020-11-13,3260,647,681,1328,頭家厝,簡易
2020-11-14,3260,574,574,1148,頭家厝,簡易
2020-11-15,3260,686,553,1239,頭家厝,簡易
2020-11-16,3260,547,457,1004,頭家厝,簡易
2020-11-17,3260,579,515,1094,頭家厝,簡易
2020-11-18,3260,516,495,1011,頭家厝,簡易
2020-11-19,3260,534,478,1012,頭家厝,簡易
2020-11-20,3260,631,653,1284,頭家厝,簡易
2020-11-21,3260,630,581,1211,頭家厝,簡易
2020-11-22,3260,669,578,1247,頭家厝,簡易
2020-11-23,3260,609,486,1095,頭家厝,簡易
2020-11-24,3260,520,474,994,頭家厝,簡易
2020-11-25,3260,492,457,949,頭家厝,簡易
2020-11-26,3260,545,499,1044,頭家厝,簡易
2020-11-27,3260,578,656,1234,頭家厝,簡易
2020-11-28,3260,615,539,1154,頭家厝,簡易
2020-11-29,3260,649,554,1203,頭家厝,簡易
2020-11-30,3260,498,424,922,頭家厝,簡易
2020-12-01,3260,477,431,908,頭家厝,簡易
2020-12-02,3260,499,508,1007,頭家厝,簡易
2020-12-03,3260,487,431,918,頭家厝,簡易
2020-12-04,3260,569,679,1248,頭家厝,簡易
2020-12-05,3260,598,576,1174,頭家厝,簡易
2020-12-06,3260,676,546,1222,頭家厝,簡易
2020-12-07,3260,536,467,1003,頭家厝,簡易
2020-12-08,3260,479,435,914,頭家厝,簡易
2020-12-09,3260,434,425,859,頭家厝,簡易
2020-12-10,3260,516,501,1017,頭家厝,簡易
2020-12-11,3260,590,681,1271,頭家厝,簡易
2020-12-12,3260,775,674,1449,頭家厝,簡易
2020-12-13,3260,698,636,1334,頭家厝,簡易
2020-12-14,3260,525,472,997,頭家厝,簡易
2020-12-15,3260,495,463,958,頭家厝,簡易
2020-12-16,3260,503,457,960,頭家厝,簡易
2020-12-17,3260,527,511,1038,頭家厝,簡易
2020-12-18,3260,644,680,1324,頭家厝,簡易
2020-12-19,3260,627,559,1186,頭家厝,簡易
2020-12-20,3260,668,559,1227,頭家厝,簡易
2020-12-21,3260,521,434,955,頭家厝,簡易
2020-12-22,3260,534,465,999,頭家厝,簡易
2020-12-23,3260,452,428,880,頭家厝,簡易
2020-12-24,3260,488,491,979,頭家厝,簡易
2020-12-25,3260,601,674,1275,頭家厝,簡易
2020-12-26,3260,574,561,1135,頭家厝,簡易
2020-12-27,3260,572,513,1085,頭家厝,簡易
2020-12-28,3260,557,434,991,頭家厝,簡易
2020-12-29,3260,499,494,993,頭家厝,簡易
2020-12-30,3260,511,494,1005,頭家厝,簡易
2020-12-31,3260,618,688,1306,頭家厝,簡易
2020-01-01,3270,1096,1070,2166,松竹,簡易
2020-01-02,3270,923,974,1897,松竹,簡易
2020-01-03,3270,1125,1329,2454,松竹,簡易
2020-01-04,3270,1130,1217,2347,松竹,簡易
2020-01-05,3270,1176,1086,2262,松竹,簡易
2020-01-06,3270,984,974,1958,松竹,簡易
2020-01-07,3270,940,986,1926,松竹,簡易
2020-01-08,3270,981,1096,2077,松竹,簡易
2020-01-09,3270,993,1109,2102,松竹,簡易
2020-01-10,3270,1342,1837,3179,松竹,簡易
2020-01-11,3270,1324,1409,2733,松竹,簡易
2020-01-12,3270,1445,1140,2585,松竹,簡易
2020-01-13,3270,1136,1085,2221,松竹,簡易
2020-01-14,3270,1001,996,1997,松竹,簡易
2020-01-15,3270,957,1020,1977,松竹,簡易
2020-01-16,3270,1080,1091,2171,松竹,簡易
2020-01-17,3270,1135,1292,2427,松竹,簡易
2020-01-18,3270,1061,1091,2152,松竹,簡易
2020-01-19,3270,1119,1291,2410,松竹,簡易
2020-01-20,3270,1146,1076,2222,松竹,簡易
2020-01-21,3270,1094,1104,2198,松竹,簡易
2020-01-22,3270,1188,1292,2480,松竹,簡易
2020-01-23,3270,1008,999,2007,松竹,簡易
2020-01-24,3270,822,650,1472,松竹,簡易
2020-01-25,3270,966,968,1934,松竹,簡易
2020-01-26,3270,922,930,1852,松竹,簡易
2020-01-27,3270,1131,1203,2334,松竹,簡易
2020-01-28,3270,1080,1102,2182,松竹,簡易
2020-01-29,3270,1075,996,2071,松竹,簡易
2020-01-30,3270,939,913,1852,松竹,簡易
2020-01-31,3270,927,965,1892,松竹,簡易
2020-02-01,3270,893,854,1747,松竹,簡易
2020-02-02,3270,892,875,1767,松竹,簡易
2020-02-03,3270,989,857,1846,松竹,簡易
2020-02-04,3270,888,839,1727,松竹,簡易
2020-02-05,3270,983,935,1918,松竹,簡易
2020-02-06,3270,967,952,1919,松竹,簡易
2020-02-07,3270,1128,1208,2336,松竹,簡易
2020-02-08,3270,1535,1598,3133,松竹,簡易
2020-02-09,3270,1599,1558,3157,松竹,簡易
2020-02-10,3270,1245,1209,2454,松竹,簡易
2020-02-11,3270,1225,1177,2402,松竹,簡易
2020-02-12,3270,1385,1432,2817,松竹,簡易
2020-02-13,3270,1059,1032,2091,松竹,簡易
2020-02-14,3270,1365,1496,2861,松竹,簡易
2020-02-15,3270,1967,2051,4018,松竹,簡易
2020-02-16,3270,1216,1119,2335,松竹,簡易
2020-02-17,3270,1165,1126,2291,松竹,簡易
2020-02-18,3270,1197,1216,2413,松竹,簡易
2020-02-19,3270,1367,1435,2802,松竹,簡易
2020-02-20,3270,1517,1547,3064,松竹,簡易
2020-02-21,3270,1682,1835,3517,松竹,簡易
2020-02-22,3270,2172,2183,4355,松竹,簡易
2020-02-23,3270,1895,1863,3758,松竹,簡易
2020-02-24,3270,1045,848,1893,松竹,簡易
2020-02-25,3270,959,950,1909,松竹,簡易
2020-02-26,3270,909,955,1864,松竹,簡易
2020-02-27,3270,1019,1260,2279,松竹,簡易
2020-02-28,3270,1096,1074,2170,松竹,簡易
2020-02-29,3270,982,924,1906,松竹,簡易
2020-03-01,3270,1198,893,2091,松竹,簡易
2020-03-02,3270,962,931,1893,松竹,簡易
2020-03-03,3270,901,934,1835,松竹,簡易
2020-03-04,3270,834,922,1756,松竹,簡易
2020-03-05,3270,815,891,1706,松竹,簡易
2020-03-06,3270,1047,1370,2417,松竹,簡易
2020-03-07,3270,853,845,1698,松竹,簡易
2020-03-08,3270,1040,824,1864,松竹,簡易
2020-03-09,3270,986,901,1887,松竹,簡易
2020-03-10,3270,799,818,1617,松竹,簡易
2020-03-11,3270,818,917,1735,松竹,簡易
2020-03-12,3270,895,927,1822,松竹,簡易
2020-03-13,3270,974,1346,2320,松竹,簡易
2020-03-14,3270,828,823,1651,松竹,簡易
2020-03-15,3270,1099,889,1988,松竹,簡易
2020-03-16,3270,989,863,1852,松竹,簡易
2020-03-17,3270,915,888,1803,松竹,簡易
2020-03-18,3270,889,892,1781,松竹,簡易
2020-03-19,3270,825,900,1725,松竹,簡易
2020-03-20,3270,1007,1257,2264,松竹,簡易
2020-03-21,3270,818,732,1550,松竹,簡易
2020-03-22,3270,938,754,1692,松竹,簡易
2020-03-23,3270,871,813,1684,松竹,簡易
2020-03-24,3270,770,795,1565,松竹,簡易
2020-03-25,3270,771,793,1564,松竹,簡易
2020-03-26,3270,774,810,1584,松竹,簡易
2020-03-27,3270,917,1116,2033,松竹,簡易
2020-03-28,3270,705,655,1360,松竹,簡易
2020-03-29,3270,799,730,1529,松竹,簡易
2020-03-30,3270,866,837,1703,松竹,簡易
2020-03-31,3270,762,844,1606,松竹,簡易
2020-04-01,3270,916,1260,2176,松竹,簡易
2020-04-02,3270,698,756,1454,松竹,簡易
2020-04-03,3270,690,651,1341,松竹,簡易
2020-04-04,3270,586,600,1186,松竹,簡易
2020-04-05,3270,909,629,1538,松竹,簡易
2020-04-06,3270,919,759,1678,松竹,簡易
2020-04-07,3270,749,725,1474,松竹,簡易
2020-04-08,3270,709,743,1452,松竹,簡易
2020-04-09,3270,749,830,1579,松竹,簡易
2020-04-10,3270,850,1049,1899,松竹,簡易
2020-04-11,3270,644,655,1299,松竹,簡易
2020-04-12,3270,775,629,1404,松竹,簡易
2020-04-13,3270,831,768,1599,松竹,簡易
2020-04-14,3270,761,783,1544,松竹,簡易
2020-04-15,3270,791,807,1598,松竹,簡易
2020-04-16,3270,769,803,1572,松竹,簡易
2020-04-17,3270,935,1275,2210,松竹,簡易
2020-04-18,3270,778,737,1515,松竹,簡易
2020-04-19,3270,958,743,1701,松竹,簡易
2020-04-20,3270,885,806,1691,松竹,簡易
2020-04-21,3270,796,726,1522,松竹,簡易
2020-04-22,3270,722,770,1492,松竹,簡易
2020-04-23,3270,697,747,1444,松竹,簡易
2020-04-24,3270,822,1079,1901,松竹,簡易
2020-04-25,3270,649,601,1250,松竹,簡易
2020-04-26,3270,732,575,1307,松竹,簡易
2020-04-27,3270,848,793,1641,松竹,簡易
2020-04-28,3270,802,815,1617,松竹,簡易
2020-04-29,3270,785,814,1599,松竹,簡易
2020-04-30,3270,818,978,1796,松竹,簡易
2020-05-01,3270,901,1110,2011,松竹,簡易
2020-05-02,3270,726,698,1424,松竹,簡易
2020-05-03,3270,891,690,1581,松竹,簡易
2020-05-04,3270,953,830,1783,松竹,簡易
2020-05-05,3270,795,799,1594,松竹,簡易
2020-05-06,3270,831,863,1694,松竹,簡易
2020-05-07,3270,857,906,1763,松竹,簡易
2020-05-08,3270,1037,1389,2426,松竹,簡易
2020-05-09,3270,862,857,1719,松竹,簡易
2020-05-10,3270,1092,836,1928,松竹,簡易
2020-05-11,3270,987,840,1827,松竹,簡易
2020-05-12,3270,821,770,1591,松竹,簡易
2020-05-13,3270,825,837,1662,松竹,簡易
2020-05-14,3270,860,851,1711,松竹,簡易
2020-05-15,3270,987,1329,2316,松竹,簡易
2020-05-16,3270,818,764,1582,松竹,簡易
2020-05-17,3270,936,787,1723,松竹,簡易
2020-05-18,3270,891,825,1716,松竹,簡易
2020-05-19,3270,734,743,1477,松竹,簡易
2020-05-20,3270,813,831,1644,松竹,簡易
2020-05-21,3270,781,827,1608,松竹,簡易
2020-05-22,3270,882,1171,2053,松竹,簡易
2020-05-23,3270,672,691,1363,松竹,簡易
2020-05-24,3270,1000,844,1844,松竹,簡易
2020-05-25,3270,994,854,1848,松竹,簡易
2020-05-26,3270,837,808,1645,松竹,簡易
2020-05-27,3270,799,784,1583,松竹,簡易
2020-05-28,3270,764,835,1599,松竹,簡易
2020-05-29,3270,991,1291,2282,松竹,簡易
2020-05-30,3270,948,995,1943,松竹,簡易
2020-05-31,3270,1110,922,2032,松竹,簡易
2020-06-01,3270,950,887,1837,松竹,簡易
2020-06-02,3270,856,848,1704,松竹,簡易
2020-06-03,3270,924,925,1849,松竹,簡易
2020-06-04,3270,867,870,1737,松竹,簡易
2020-06-05,3270,1100,1360,2460,松竹,簡易
2020-06-06,3270,1017,952,1969,松竹,簡易
2020-06-07,3270,1077,937,2014,松竹,簡易
2020-06-08,3270,1026,866,1892,松竹,簡易
2020-06-09,3270,840,827,1667,松竹,簡易
2020-06-10,3270,913,931,1844,松竹,簡易
2020-06-11,3270,932,931,1863,松竹,簡易
2020-06-12,3270,1105,1299,2404,松竹,簡易
2020-06-13,3270,1106,1060,2166,松竹,簡易
2020-06-14,3270,1143,922,2065,松竹,簡易
2020-06-15,3270,991,933,1924,松竹,簡易
2020-06-16,3270,933,893,1826,松竹,簡易
2020-06-17,3270,990,917,1907,松竹,簡易
2020-06-18,3270,948,1003,1951,松竹,簡易
2020-06-19,3270,985,1070,2055,松竹,簡易
2020-06-20,3270,1054,1050,2104,松竹,簡易
2020-06-21,3270,1061,995,2056,松竹,簡易
2020-06-22,3270,1003,941,1944,松竹,簡易
2020-06-23,3270,983,1026,2009,松竹,簡易
2020-06-24,3270,1146,1443,2589,松竹,簡易
2020-06-25,3270,1144,1139,2283,松竹,簡易
2020-06-26,3270,1161,1152,2313,松竹,簡易
2020-06-27,3270,1219,1115,2334,松竹,簡易
2020-06-28,3270,1285,1091,2376,松竹,簡易
2020-06-29,3270,1145,956,2101,松竹,簡易
2020-06-30,3270,922,949,1871,松竹,簡易
2020-07-01,3270,891,868,1759,松竹,簡易
2020-07-02,3270,930,929,1859,松竹,簡易
2020-07-03,3270,1137,1191,2328,松竹,簡易
2020-07-04,3270,1070,920,1990,松竹,簡易
2020-07-05,3270,1079,1041,2120,松竹,簡易
2020-07-06,3270,1037,997,2034,松竹,簡易
2020-07-07,3270,1072,1022,2094,松竹,簡易
2020-07-08,3270,1009,1015,2024,松竹,簡易
2020-07-09,3270,1061,1057,2118,松竹,簡易
2020-07-10,3270,1095,1248,2343,松竹,簡易
2020-07-11,3270,1146,1093,2239,松竹,簡易
2020-07-12,3270,1180,1069,2249,松竹,簡易
2020-07-13,3270,1117,1060,2177,松竹,簡易
2020-07-14,3270,1060,1055,2115,松竹,簡易
2020-07-15,3270,1157,1152,2309,松竹,簡易
2020-07-16,3270,1139,1093,2232,松竹,簡易
2020-07-17,3270,1326,1401,2727,松竹,簡易
2020-07-18,3270,1255,1220,2475,松竹,簡易
2020-07-19,3270,1295,1159,2454,松竹,簡易
2020-07-20,3270,1195,1079,2274,松竹,簡易
2020-07-21,3270,1045,938,1983,松竹,簡易
2020-07-22,3270,1060,1033,2093,松竹,簡易
2020-07-23,3270,1050,1036,2086,松竹,簡易
2020-07-24,3270,1191,1385,2576,松竹,簡易
2020-07-25,3270,1211,1197,2408,松竹,簡易
2020-07-26,3270,1320,1211,2531,松竹,簡易
2020-07-27,3270,1171,1021,2192,松竹,簡易
2020-07-28,3270,1067,1026,2093,松竹,簡易
2020-07-29,3270,1085,1082,2167,松竹,簡易
2020-07-30,3270,1126,1048,2174,松竹,簡易
2020-07-31,3270,1247,1406,2653,松竹,簡易
2020-08-01,3270,1153,1135,2288,松竹,簡易
2020-08-02,3270,1221,1164,2385,松竹,簡易
2020-08-03,3270,1026,886,1912,松竹,簡易
2020-08-04,3270,1006,934,1940,松竹,簡易
2020-08-05,3270,1095,1091,2186,松竹,簡易
2020-08-06,3270,1066,1208,2274,松竹,簡易
2020-08-07,3270,1305,1395,2700,松竹,簡易
2020-08-08,3270,1187,1093,2280,松竹,簡易
2020-08-09,3270,1230,1225,2455,松竹,簡易
2020-08-10,3270,1155,1054,2209,松竹,簡易
2020-08-11,3270,1061,951,2012,松竹,簡易
2020-08-12,3270,1201,1024,2225,松竹,簡易
2020-08-13,3270,1143,1051,2194,松竹,簡易
2020-08-14,3270,1277,1403,2680,松竹,簡易
2020-08-15,3270,1281,1223,2504,松竹,簡易
2020-08-16,3270,1415,1324,2739,松竹,簡易
2020-08-17,3270,1179,1062,2241,松竹,簡易
2020-08-18,3270,1101,1082,2183,松竹,簡易
2020-08-19,3270,1087,1073,2160,松竹,簡易
2020-08-20,3270,1100,1095,2195,松竹,簡易
2020-08-21,3270,1306,1339,2645,松竹,簡易
2020-08-22,3270,1355,1145,2500,松竹,簡易
2020-08-23,3270,1274,1249,2523,松竹,簡易
2020-08-24,3270,1099,1049,2148,松竹,簡易
2020-08-25,3270,1175,1106,2281,松竹,簡易
2020-08-26,3270,1111,1098,2209,松竹,簡易
2020-08-27,3270,1058,1039,2097,松竹,簡易
2020-08-28,3270,1143,1289,2432,松竹,簡易
2020-08-29,3270,1121,1096,2217,松竹,簡易
2020-08-30,3270,1179,1040,2219,松竹,簡易
2020-08-31,3270,1007,990,1997,松竹,簡易
2020-09-01,3270,1031,954,1985,松竹,簡易
2020-09-02,3270,988,965,1953,松竹,簡易
2020-09-03,3270,1023,1034,2057,松竹,簡易
2020-09-04,3270,1340,1395,2735,松竹,簡易
2020-09-05,3270,1166,1086,2252,松竹,簡易
2020-09-06,3270,1291,1106,2397,松竹,簡易
2020-09-07,3270,1088,1018,2106,松竹,簡易
2020-09-08,3270,1051,1000,2051,松竹,簡易
2020-09-09,3270,1024,984,2008,松竹,簡易
2020-09-10,3270,959,984,1943,松竹,簡易
2020-09-11,3270,1194,1398,2592,松竹,簡易
2020-09-12,3270,1213,1125,2338,松竹,簡易
2020-09-13,3270,1304,1215,2519,松竹,簡易
2020-09-14,3270,1045,960,2005,松竹,簡易
2020-09-15,3270,977,971,1948,松竹,簡易
2020-09-16,3270,943,953,1896,松竹,簡易
2020-09-17,3270,1039,1044,2083,松竹,簡易
2020-09-18,3270,1236,1470,2706,松竹,簡易
2020-09-19,3270,1367,1257,2624,松竹,簡易
2020-09-20,3270,1466,1359,2825,松竹,簡易
2020-09-21,3270,1092,953,2045,松竹,簡易
2020-09-22,3270,1001,945,1946,松竹,簡易
2020-09-23,3270,1040,1006,2046,松竹,簡易
2020-09-24,3270,1029,997,2026,松竹,簡易
2020-09-25,3270,1094,1166,2260,松竹,簡易
2020-09-26,3270,1162,1159,2321,松竹,簡易
2020-09-27,3270,1186,1080,2266,松竹,簡易
2020-09-28,3270,1104,960,2064,松竹,簡易
2020-09-29,3270,998,1026,2024,松竹,簡易
2020-09-30,3270,1290,1803,3093,松竹,簡易
2020-10-01,3270,1351,1409,2760,松竹,簡易
2020-10-02,3270,1392,1360,2752,松竹,簡易
2020-10-03,3270,1319,1241,2560,松竹,簡易
2020-10-04,3270,1659,1345,3004,松竹,簡易
2020-10-05,3270,1248,1006,2254,松竹,簡易
2020-10-06,3270,1054,1039,2093,松竹,簡易
2020-10-07,3270,1001,1055,2056,松竹,簡易
2020-10-08,3270,1223,1507,2730,松竹,簡易
2020-10-09,3270,1621,1590,3211,松竹,簡易
2020-10-10,3270,1379,1315,2694,松竹,簡易
2020-10-11,3270,1479,1307,2786,松竹,簡易
2020-10-12,3270,1137,995,2132,松竹,簡易
2020-10-13,3270,1048,999,2047,松竹,簡易
2020-10-14,3270,1011,988,1999,松竹,簡易
2020-10-15,3270,1072,1017,2089,松竹,簡易
2020-10-16,3270,1300,1547,2847,松竹,簡易
2020-10-17,3270,1398,1370,2768,松竹,簡易
2020-10-18,3270,1559,1427,2986,松竹,簡易
2020-10-19,3270,1123,996,2119,松竹,簡易
2020-10-20,3270,1040,1014,2054,松竹,簡易
2020-10-21,3270,996,988,1984,松竹,簡易
2020-10-22,3270,1057,1075,2132,松竹,簡易
2020-10-23,3270,1262,1487,2749,松竹,簡易
2020-10-24,3270,1420,1363,2783,松竹,簡易
2020-10-25,3270,1433,1326,2759,松竹,簡易
2020-10-26,3270,1138,1037,2175,松竹,簡易
2020-10-27,3270,1025,973,1998,松竹,簡易
2020-10-28,3270,1027,980,2007,松竹,簡易
2020-10-29,3270,1034,1004,2038,松竹,簡易
2020-10-30,3270,1221,1533,2754,松竹,簡易
2020-10-31,3270,1335,1267,2602,松竹,簡易
2020-11-01,3270,1385,1338,2723,松竹,簡易
2020-11-02,3270,1091,976,2067,松竹,簡易
2020-11-03,3270,941,940,1881,松竹,簡易
2020-11-04,3270,1019,984,2003,松竹,簡易
2020-11-05,3270,1014,1019,2033,松竹,簡易
2020-11-06,3270,1239,1596,2835,松竹,簡易
2020-11-07,3270,1338,1307,2645,松竹,簡易
2020-11-08,3270,1531,1251,2782,松竹,簡易
2020-11-09,3270,1139,1007,2146,松竹,簡易
2020-11-10,3270,992,968,1960,松竹,簡易
2020-11-11,3270,1132,1084,2216,松竹,簡易
2020-11-12,3270,1062,1177,2239,松竹,簡易
2020-11-13,3270,1383,1677,3060,松竹,簡易
2020-11-14,3270,1403,1369,2772,松竹,簡易
2020-11-15,3270,1754,1412,3166,松竹,簡易
2020-11-16,3270,2091,2158,4249,松竹,簡易
2020-11-17,3270,2059,2137,4196,松竹,簡易
2020-11-18,3270,2119,2204,4323,松竹,簡易
2020-11-19,3270,2045,2333,4378,松竹,簡易
2020-11-20,3270,2553,2715,5268,松竹,簡易
2020-11-21,3270,3583,3957,7540,松竹,簡易
2020-11-22,3270,2269,2071,4340,松竹,簡易
2020-11-23,3270,1348,1274,2622,松竹,簡易
2020-11-24,3270,1159,1145,2304,松竹,簡易
2020-11-25,3270,1212,1262,2474,松竹,簡易
2020-11-26,3270,1176,1262,2438,松竹,簡易
2020-11-27,3270,1540,1821,3361,松竹,簡易
2020-11-28,3270,1697,1618,3315,松竹,簡易
2020-11-29,3270,1803,1606,3409,松竹,簡易
2020-11-30,3270,1271,1165,2436,松竹,簡易
2020-12-01,3270,1113,1094,2207,松竹,簡易
2020-12-02,3270,1102,1087,2189,松竹,簡易
2020-12-03,3270,1089,1122,2211,松竹,簡易
2020-12-04,3270,1418,1826,3244,松竹,簡易
2020-12-05,3270,1776,1778,3554,松竹,簡易
2020-12-06,3270,1813,1606,3419,松竹,簡易
2020-12-07,3270,1284,1172,2456,松竹,簡易
2020-12-08,3270,1129,1152,2281,松竹,簡易
2020-12-09,3270,1051,1066,2117,松竹,簡易
2020-12-10,3270,1094,1121,2215,松竹,簡易
2020-12-11,3270,1545,1877,3422,松竹,簡易
2020-12-12,3270,1701,1674,3375,松竹,簡易
2020-12-13,3270,1873,1705,3578,松竹,簡易
2020-12-14,3270,1320,1183,2503,松竹,簡易
2020-12-15,3270,1099,1102,2201,松竹,簡易
2020-12-16,3270,1144,1193,2337,松竹,簡易
2020-12-17,3270,1201,1248,2449,松竹,簡易
2020-12-18,3270,1524,1843,3367,松竹,簡易
2020-12-19,3270,1740,1672,3412,松竹,簡易
2020-12-20,3270,1701,1572,3273,松竹,簡易
2020-12-21,3270,1164,1122,2286,松竹,簡易
2020-12-22,3270,1171,1110,2281,松竹,簡易
2020-12-23,3270,1027,993,2020,松竹,簡易
2020-12-24,3270,1112,1174,2286,松竹,簡易
2020-12-25,3270,1582,1801,3383,松竹,簡易
2020-12-26,3270,1576,1524,3100,松竹,簡易
2020-12-27,3270,1589,1558,3147,松竹,簡易
2020-12-28,3270,1271,1089,2360,松竹,簡易
2020-12-29,3270,1105,1062,2167,松竹,簡易
2020-12-30,3270,1079,1190,2269,松竹,簡易
2020-12-31,3270,1553,1935,3488,松竹,簡易
2020-01-01,3280,3011,2903,5914,太原,乙簡
2020-01-02,3280,2697,2618,5315,太原,乙簡
2020-01-03,3280,2943,3113,6056,太原,乙簡
2020-01-04,3280,3091,2958,6049,太原,乙簡
2020-01-05,3280,3394,3549,6943,太原,乙簡
2020-01-06,3280,2642,2510,5152,太原,乙簡
2020-01-07,3280,2586,2490,5076,太原,乙簡
2020-01-08,3280,2541,2532,5073,太原,乙簡
2020-01-09,3280,2579,2745,5324,太原,乙簡
2020-01-10,3280,3752,4065,7817,太原,乙簡
2020-01-11,3280,4373,4287,8660,太原,乙簡
2020-01-12,3280,4477,4346,8823,太原,乙簡
2020-01-13,3280,2963,2649,5612,太原,乙簡
2020-01-14,3280,2524,2495,5019,太原,乙簡
2020-01-15,3280,2527,2512,5039,太原,乙簡
2020-01-16,3280,2774,2718,5492,太原,乙簡
2020-01-17,3280,3040,2972,6012,太原,乙簡
2020-01-18,3280,3303,3158,6461,太原,乙簡
2020-01-19,3280,3374,3487,6861,太原,乙簡
2020-01-20,3280,2782,2831,5613,太原,乙簡
2020-01-21,3280,2781,2720,5501,太原,乙簡
2020-01-22,3280,2855,3171,6026,太原,乙簡
2020-01-23,3280,3129,2869,5998,太原,乙簡
2020-01-24,3280,2918,2226,5144,太原,乙簡
2020-01-25,3280,2931,2897,5828,太原,乙簡
2020-01-26,3280,2628,2729,5357,太原,乙簡
2020-01-27,3280,3325,3664,6989,太原,乙簡
2020-01-28,3280,3012,3243,6255,太原,乙簡
2020-01-29,3280,2962,2981,5943,太原,乙簡
2020-01-30,3280,2512,2288,4800,太原,乙簡
2020-01-31,3280,2482,2610,5092,太原,乙簡
2020-02-01,3280,2467,2441,4908,太原,乙簡
2020-02-02,3280,2801,2822,5623,太原,乙簡
2020-02-03,3280,2483,2257,4740,太原,乙簡
2020-02-04,3280,2108,2148,4256,太原,乙簡
2020-02-05,3280,2191,2208,4399,太原,乙簡
2020-02-06,3280,2233,2267,4500,太原,乙簡
2020-02-07,3280,2795,2806,5601,太原,乙簡
2020-02-08,3280,3444,3373,6817,太原,乙簡
2020-02-09,3280,3738,3952,7690,太原,乙簡
2020-02-10,3280,2883,2796,5679,太原,乙簡
2020-02-11,3280,2756,2723,5479,太原,乙簡
2020-02-12,3280,3042,3086,6128,太原,乙簡
2020-02-13,3280,2456,2481,4937,太原,乙簡
2020-02-14,3280,2947,3197,6144,太原,乙簡
2020-02-15,3280,4014,4031,8045,太原,乙簡
2020-02-16,3280,3253,3347,6600,太原,乙簡
2020-02-17,3280,2660,2586,5246,太原,乙簡
2020-02-18,3280,2804,2730,5534,太原,乙簡
2020-02-19,3280,2945,3031,5976,太原,乙簡
2020-02-20,3280,3171,3211,6382,太原,乙簡
2020-02-21,3280,3559,3825,7384,太原,乙簡
2020-02-22,3280,4503,4431,8934,太原,乙簡
2020-02-23,3280,4382,4288,8670,太原,乙簡
2020-02-24,3280,2467,2194,4661,太原,乙簡
2020-02-25,3280,2207,2211,4418,太原,乙簡
2020-02-26,3280,2210,2225,4435,太原,乙簡
2020-02-27,3280,2706,3096,5802,太原,乙簡
2020-02-28,3280,2750,2680,5430,太原,乙簡
2020-02-29,3280,2508,2408,4916,太原,乙簡
2020-03-01,3280,3028,3005,6033,太原,乙簡
2020-03-02,3280,2464,2283,4747,太原,乙簡
2020-03-03,3280,2178,2149,4327,太原,乙簡
2020-03-04,3280,2128,2124,4252,太原,乙簡
2020-03-05,3280,2104,2126,4230,太原,乙簡
2020-03-06,3280,2872,3052,5924,太原,乙簡
2020-03-07,3280,2447,2503,4950,太原,乙簡
2020-03-08,3280,3020,2900,5920,太原,乙簡
2020-03-09,3280,2488,2260,4748,太原,乙簡
2020-03-10,3280,1959,2040,3999,太原,乙簡
2020-03-11,3280,2209,2220,4429,太原,乙簡
2020-03-12,3280,2245,2279,4524,太原,乙簡
2020-03-13,3280,2777,3057,5834,太原,乙簡
2020-03-14,3280,2351,2253,4604,太原,乙簡
2020-03-15,3280,3124,3150,6274,太原,乙簡
2020-03-16,3280,2461,2270,4731,太原,乙簡
2020-03-17,3280,2126,2154,4280,太原,乙簡
2020-03-18,3280,2087,2102,4189,太原,乙簡
2020-03-19,3280,1960,2011,3971,太原,乙簡
2020-03-20,3280,2647,2886,5533,太原,乙簡
2020-03-21,3280,2171,2073,4244,太原,乙簡
2020-03-22,3280,2393,2403,4796,太原,乙簡
2020-03-23,3280,2291,2122,4413,太原,乙簡
2020-03-24,3280,1917,1912,3829,太原,乙簡
2020-03-25,3280,1971,1993,3964,太原,乙簡
2020-03-26,3280,2007,2016,4023,太原,乙簡
2020-03-27,3280,2449,2570,5019,太原,乙簡
2020-03-28,3280,1779,1807,3586,太原,乙簡
2020-03-29,3280,2104,2177,4281,太原,乙簡
2020-03-30,3280,2083,2029,4112,太原,乙簡
2020-03-31,3280,1859,1980,3839,太原,乙簡
2020-04-01,3280,2493,2670,5163,太原,乙簡
2020-04-02,3280,1901,1848,3749,太原,乙簡
2020-04-03,3280,1929,1670,3599,太原,乙簡
2020-04-04,3280,1608,1591,3199,太原,乙簡
2020-04-05,3280,2213,2353,4566,太原,乙簡
2020-04-06,3280,2158,2046,4204,太原,乙簡
2020-04-07,3280,1777,1836,3613,太原,乙簡
2020-04-08,3280,1774,1739,3513,太原,乙簡
2020-04-09,3280,1835,1878,3713,太原,乙簡
2020-04-10,3280,2244,2425,4669,太原,乙簡
2020-04-11,3280,1966,1908,3874,太原,乙簡
2020-04-12,3280,2329,2341,4670,太原,乙簡
2020-04-13,3280,2035,1921,3956,太原,乙簡
2020-04-14,3280,1787,1872,3659,太原,乙簡
2020-04-15,3280,1853,1880,3733,太原,乙簡
2020-04-16,3280,1853,1923,3776,太原,乙簡
2020-04-17,3280,2527,2686,5213,太原,乙簡
2020-04-18,3280,2152,2054,4206,太原,乙簡
2020-04-19,3280,2380,2372,4752,太原,乙簡
2020-04-20,3280,2121,1970,4091,太原,乙簡
2020-04-21,3280,1837,1848,3685,太原,乙簡
2020-04-22,3280,1755,1810,3565,太原,乙簡
2020-04-23,3280,1784,1816,3600,太原,乙簡
2020-04-24,3280,2179,2378,4557,太原,乙簡
2020-04-25,3280,1811,1738,3549,太原,乙簡
2020-04-26,3280,2049,1998,4047,太原,乙簡
2020-04-27,3280,1953,1981,3934,太原,乙簡
2020-04-28,3280,1870,1821,3691,太原,乙簡
2020-04-29,3280,1765,1843,3608,太原,乙簡
2020-04-30,3280,2103,2360,4463,太原,乙簡
2020-05-01,3280,2484,2601,5085,太原,乙簡
2020-05-02,3280,2144,1980,4124,太原,乙簡
2020-05-03,3280,2486,2406,4892,太原,乙簡
2020-05-04,3280,2148,2076,4224,太原,乙簡
2020-05-05,3280,1903,1953,3856,太原,乙簡
2020-05-06,3280,1862,1936,3798,太原,乙簡
2020-05-07,3280,2062,2064,4126,太原,乙簡
2020-05-08,3280,2769,3002,5771,太原,乙簡
2020-05-09,3280,2803,2508,5311,太原,乙簡
2020-05-10,3280,2986,3119,6105,太原,乙簡
2020-05-11,3280,2363,2144,4507,太原,乙簡
2020-05-12,3280,1941,1997,3938,太原,乙簡
2020-05-13,3280,1994,1970,3964,太原,乙簡
2020-05-14,3280,2095,2066,4161,太原,乙簡
2020-05-15,3280,2668,2953,5621,太原,乙簡
2020-05-16,3280,2356,2285,4641,太原,乙簡
2020-05-17,3280,2632,2716,5348,太原,乙簡
2020-05-18,3280,2214,2102,4316,太原,乙簡
2020-05-19,3280,1810,1833,3643,太原,乙簡
2020-05-20,3280,1940,1919,3859,太原,乙簡
2020-05-21,3280,1986,2014,4000,太原,乙簡
2020-05-22,3280,2199,2522,4721,太原,乙簡
2020-05-23,3280,2019,1912,3931,太原,乙簡
2020-05-24,3280,2658,2685,5343,太原,乙簡
2020-05-25,3280,2366,2182,4548,太原,乙簡
2020-05-26,3280,1953,1923,3876,太原,乙簡
2020-05-27,3280,1829,1861,3690,太原,乙簡
2020-05-28,3280,1994,2048,4042,太原,乙簡
2020-05-29,3280,2690,2821,5511,太原,乙簡
2020-05-30,3280,2586,2460,5046,太原,乙簡
2020-05-31,3280,2842,2991,5833,太原,乙簡
2020-06-01,3280,2352,2226,4578,太原,乙簡
2020-06-02,3280,2073,2083,4156,太原,乙簡
2020-06-03,3280,2027,2065,4092,太原,乙簡
2020-06-04,3280,2118,2162,4280,太原,乙簡
2020-06-05,3280,2813,2993,5806,太原,乙簡
2020-06-06,3280,2709,2573,5282,太原,乙簡
2020-06-07,3280,2746,2820,5566,太原,乙簡
2020-06-08,3280,2264,2173,4437,太原,乙簡
2020-06-09,3280,2057,2076,4133,太原,乙簡
2020-06-10,3280,2101,2200,4301,太原,乙簡
2020-06-11,3280,2289,2334,4623,太原,乙簡
2020-06-12,3280,2908,3039,5947,太原,乙簡
2020-06-13,3280,3165,2859,6024,太原,乙簡
2020-06-14,3280,3173,3242,6415,太原,乙簡
2020-06-15,3280,2383,2317,4700,太原,乙簡
2020-06-16,3280,2261,2261,4522,太原,乙簡
2020-06-17,3280,2210,2187,4397,太原,乙簡
2020-06-18,3280,2324,2256,4580,太原,乙簡
2020-06-19,3280,2537,2625,5162,太原,乙簡
2020-06-20,3280,2560,2590,5150,太原,乙簡
2020-06-21,3280,2777,2844,5621,太原,乙簡
2020-06-22,3280,2429,2302,4731,太原,乙簡
2020-06-23,3280,2275,2386,4661,太原,乙簡
2020-06-24,3280,2876,3145,6021,太原,乙簡
2020-06-25,3280,2984,2817,5801,太原,乙簡
2020-06-26,3280,2762,2801,5563,太原,乙簡
2020-06-27,3280,2999,2958,5957,太原,乙簡
2020-06-28,3280,3257,3223,6480,太原,乙簡
2020-06-29,3280,2561,2259,4820,太原,乙簡
2020-06-30,3280,2155,2222,4377,太原,乙簡
2020-07-01,3280,2120,2122,4242,太原,乙簡
2020-07-02,3280,2269,2244,4513,太原,乙簡
2020-07-03,3280,2505,2691,5196,太原,乙簡
2020-07-04,3280,2704,2517,5221,太原,乙簡
2020-07-05,3280,2694,2864,5558,太原,乙簡
2020-07-06,3280,2433,2270,4703,太原,乙簡
2020-07-07,3280,2326,2397,4723,太原,乙簡
2020-07-08,3280,2314,2246,4560,太原,乙簡
2020-07-09,3280,2350,2285,4635,太原,乙簡
2020-07-10,3280,2674,2844,5518,太原,乙簡
2020-07-11,3280,3044,2815,5859,太原,乙簡
2020-07-12,3280,3313,3434,6747,太原,乙簡
2020-07-13,3280,2650,2523,5173,太原,乙簡
2020-07-14,3280,2421,2565,4986,太原,乙簡
2020-07-15,3280,2434,2446,4880,太原,乙簡
2020-07-16,3280,2545,2476,5021,太原,乙簡
2020-07-17,3280,3048,3176,6224,太原,乙簡
2020-07-18,3280,2999,2955,5954,太原,乙簡
2020-07-19,3280,3268,3290,6558,太原,乙簡
2020-07-20,3280,2578,2575,5153,太原,乙簡
2020-07-21,3280,2305,2269,4574,太原,乙簡
2020-07-22,3280,2572,2441,5013,太原,乙簡
2020-07-23,3280,2497,2566,5063,太原,乙簡
2020-07-24,3280,2839,3039,5878,太原,乙簡
2020-07-25,3280,2957,2810,5767,太原,乙簡
2020-07-26,3280,3153,3079,6232,太原,乙簡
2020-07-27,3280,2563,2457,5020,太原,乙簡
2020-07-28,3280,2287,2308,4595,太原,乙簡
2020-07-29,3280,2411,2339,4750,太原,乙簡
2020-07-30,3280,2535,2474,5009,太原,乙簡
2020-07-31,3280,2892,3180,6072,太原,乙簡
2020-08-01,3280,2999,2882,5881,太原,乙簡
2020-08-02,3280,2988,3042,6030,太原,乙簡
2020-08-03,3280,2337,2163,4500,太原,乙簡
2020-08-04,3280,2218,2187,4405,太原,乙簡
2020-08-05,3280,2348,2316,4664,太原,乙簡
2020-08-06,3280,2508,2472,4980,太原,乙簡
2020-08-07,3280,3003,3167,6170,太原,乙簡
2020-08-08,3280,3019,2904,5923,太原,乙簡
2020-08-09,3280,3301,3361,6662,太原,乙簡
2020-08-10,3280,2547,2460,5007,太原,乙簡
2020-08-11,3280,2290,2222,4512,太原,乙簡
2020-08-12,3280,2390,2335,4725,太原,乙簡
2020-08-13,3280,2522,2537,5059,太原,乙簡
2020-08-14,3280,2977,3127,6104,太原,乙簡
2020-08-15,3280,3295,3127,6422,太原,乙簡
2020-08-16,3280,3515,3638,7153,太原,乙簡
2020-08-17,3280,2690,2600,5290,太原,乙簡
2020-08-18,3280,2451,2414,4865,太原,乙簡
2020-08-19,3280,2333,2343,4676,太原,乙簡
2020-08-20,3280,2555,2538,5093,太原,乙簡
2020-08-21,3280,2954,3062,6016,太原,乙簡
2020-08-22,3280,3158,2783,5941,太原,乙簡
2020-08-23,3280,3042,3173,6215,太原,乙簡
2020-08-24,3280,2620,2530,5150,太原,乙簡
2020-08-25,3280,2464,2513,4977,太原,乙簡
2020-08-26,3280,2347,2289,4636,太原,乙簡
2020-08-27,3280,2469,2449,4918,太原,乙簡
2020-08-28,3280,2689,2895,5584,太原,乙簡
2020-08-29,3280,2881,2800,5681,太原,乙簡
2020-08-30,3280,2931,2841,5772,太原,乙簡
2020-08-31,3280,2376,2276,4652,太原,乙簡
2020-09-01,3280,2234,2209,4443,太原,乙簡
2020-09-02,3280,2076,2124,4200,太原,乙簡
2020-09-03,3280,2298,2295,4593,太原,乙簡
2020-09-04,3280,2759,2968,5727,太原,乙簡
2020-09-05,3280,2872,2560,5432,太原,乙簡
2020-09-06,3280,2982,2984,5966,太原,乙簡
2020-09-07,3280,2410,2331,4741,太原,乙簡
2020-09-08,3280,2299,2335,4634,太原,乙簡
2020-09-09,3280,2195,2246,4441,太原,乙簡
2020-09-10,3280,2326,2368,4694,太原,乙簡
2020-09-11,3280,2845,3083,5928,太原,乙簡
2020-09-12,3280,3116,2964,6080,太原,乙簡
2020-09-13,3280,3547,3525,7072,太原,乙簡
2020-09-14,3280,2400,2303,4703,太原,乙簡
2020-09-15,3280,2224,2349,4573,太原,乙簡
2020-09-16,3280,2195,2208,4403,太原,乙簡
2020-09-17,3280,2330,2375,4705,太原,乙簡
2020-09-18,3280,3017,3158,6175,太原,乙簡
2020-09-19,3280,3195,2989,6184,太原,乙簡
2020-09-20,3280,3571,3708,7279,太原,乙簡
2020-09-21,3280,2583,2353,4936,太原,乙簡
2020-09-22,3280,2296,2333,4629,太原,乙簡
2020-09-23,3280,2238,2240,4478,太原,乙簡
2020-09-24,3280,2350,2404,4754,太原,乙簡
2020-09-25,3280,2712,2601,5313,太原,乙簡
2020-09-26,3280,2778,2677,5455,太原,乙簡
2020-09-27,3280,2806,2912,5718,太原,乙簡
2020-09-28,3280,2318,2244,4562,太原,乙簡
2020-09-29,3280,2321,2392,4713,太原,乙簡
2020-09-30,3280,3162,3616,6778,太原,乙簡
2020-10-01,3280,3525,3106,6631,太原,乙簡
2020-10-02,3280,3179,3104,6283,太原,乙簡
2020-10-03,3280,3154,3209,6363,太原,乙簡
2020-10-04,3280,3637,3704,7341,太原,乙簡
2020-10-05,3280,2605,2364,4969,太原,乙簡
2020-10-06,3280,2258,2302,4560,太原,乙簡
2020-10-07,3280,2221,2249,4470,太原,乙簡
2020-10-08,3280,2973,3152,6125,太原,乙簡
2020-10-09,3280,3216,3009,6225,太原,乙簡
2020-10-10,3280,3142,3137,6279,太原,乙簡
2020-10-11,3280,3740,3800,7540,太原,乙簡
2020-10-12,3280,2514,2262,4776,太原,乙簡
2020-10-13,3280,2220,2271,4491,太原,乙簡
2020-10-14,3280,2251,2306,4557,太原,乙簡
2020-10-15,3280,2360,2353,4713,太原,乙簡
2020-10-16,3280,3027,3251,6278,太原,乙簡
2020-10-17,3280,3246,3030,6276,太原,乙簡
2020-10-18,3280,3633,3715,7348,太原,乙簡
2020-10-19,3280,2484,2374,4858,太原,乙簡
2020-10-20,3280,2269,2283,4552,太原,乙簡
2020-10-21,3280,2281,2311,4592,太原,乙簡
2020-10-22,3280,2374,2298,4672,太原,乙簡
2020-10-23,3280,3163,3272,6435,太原,乙簡
2020-10-24,3280,3245,3087,6332,太原,乙簡
2020-10-25,3280,3547,3721,7268,太原,乙簡
2020-10-26,3280,2668,2450,5118,太原,乙簡
2020-10-27,3280,2310,2292,4602,太原,乙簡
2020-10-28,3280,2271,2245,4516,太原,乙簡
2020-10-29,3280,2359,2413,4772,太原,乙簡
2020-10-30,3280,3118,3292,6410,太原,乙簡
2020-10-31,3280,3097,2888,5985,太原,乙簡
2020-11-01,3280,3425,3613,7038,太原,乙簡
2020-11-02,3280,2437,2374,4811,太原,乙簡
2020-11-03,3280,2250,2264,4514,太原,乙簡
2020-11-04,3280,2237,2224,4461,太原,乙簡
2020-11-05,3280,2261,2319,4580,太原,乙簡
2020-11-06,3280,3065,3294,6359,太原,乙簡
2020-11-07,3280,3063,3018,6081,太原,乙簡
2020-11-08,3280,3328,3362,6690,太原,乙簡
2020-11-09,3280,2443,2338,4781,太原,乙簡
2020-11-10,3280,2283,2261,4544,太原,乙簡
2020-11-11,3280,2324,2338,4662,太原,乙簡
2020-11-12,3280,2392,2461,4853,太原,乙簡
2020-11-13,3280,3119,3368,6487,太原,乙簡
2020-11-14,3280,3379,3191,6570,太原,乙簡
2020-11-15,3280,4082,4083,8165,太原,乙簡
2020-11-16,3280,2609,2396,5005,太原,乙簡
2020-11-17,3280,2317,2248,4565,太原,乙簡
2020-11-18,3280,2233,2261,4494,太原,乙簡
2020-11-19,3280,2269,2289,4558,太原,乙簡
2020-11-20,3280,3018,3081,6099,太原,乙簡
2020-11-21,3280,3207,3146,6353,太原,乙簡
2020-11-22,3280,4009,4014,8023,太原,乙簡
2020-11-23,3280,2752,2545,5297,太原,乙簡
2020-11-24,3280,2453,2402,4855,太原,乙簡
2020-11-25,3280,2437,2335,4772,太原,乙簡
2020-11-26,3280,2512,2556,5068,太原,乙簡
2020-11-27,3280,3278,3401,6679,太原,乙簡
2020-11-28,3280,3368,3144,6512,太原,乙簡
2020-11-29,3280,3373,3465,6838,太原,乙簡
2020-11-30,3280,2495,2393,4888,太原,乙簡
2020-12-01,3280,2319,2267,4586,太原,乙簡
2020-12-02,3280,2319,2344,4663,太原,乙簡
2020-12-03,3280,2344,2416,4760,太原,乙簡
2020-12-04,3280,3067,3362,6429,太原,乙簡
2020-12-05,3280,3185,3104,6289,太原,乙簡
2020-12-06,3280,3475,3570,7045,太原,乙簡
2020-12-07,3280,2677,2565,5242,太原,乙簡
2020-12-08,3280,2432,2414,4846,太原,乙簡
2020-12-09,3280,2022,2100,4122,太原,乙簡
2020-12-10,3280,2328,2406,4734,太原,乙簡
2020-12-11,3280,3221,3485,6706,太原,乙簡
2020-12-12,3280,3708,3518,7226,太原,乙簡
2020-12-13,3280,4040,4201,8241,太原,乙簡
2020-12-14,3280,2628,2532,5160,太原,乙簡
2020-12-15,3280,2317,2334,4651,太原,乙簡
2020-12-16,3280,2319,2327,4646,太原,乙簡
2020-12-17,3280,2454,2484,4938,太原,乙簡
2020-12-18,3280,3242,3540,6782,太原,乙簡
2020-12-19,3280,3473,3287,6760,太原,乙簡
2020-12-20,3280,3724,3941,7665,太原,乙簡
2020-12-21,3280,2560,2403,4963,太原,乙簡
2020-12-22,3280,2352,2419,4771,太原,乙簡
2020-12-23,3280,2089,2158,4247,太原,乙簡
2020-12-24,3280,2413,2455,4868,太原,乙簡
2020-12-25,3280,3136,3406,6542,太原,乙簡
2020-12-26,3280,3068,2935,6003,太原,乙簡
2020-12-27,3280,3184,3355,6539,太原,乙簡
2020-12-28,3280,2558,2393,4951,太原,乙簡
2020-12-29,3280,2332,2344,4676,太原,乙簡
2020-12-30,3280,2195,2344,4539,太原,乙簡
2020-12-31,3280,3259,3515,6774,太原,乙簡
2020-01-01,3290,1219,1281,2500,精武,簡易
2020-01-02,3290,942,914,1856,精武,簡易
2020-01-03,3290,1192,1316,2508,精武,簡易
2020-01-04,3290,1203,1127,2330,精武,簡易
2020-01-05,3290,1292,1286,2578,精武,簡易
2020-01-06,3290,946,923,1869,精武,簡易
2020-01-07,3290,867,931,1798,精武,簡易
2020-01-08,3290,932,947,1879,精武,簡易
2020-01-09,3290,1037,1065,2102,精武,簡易
2020-01-10,3290,1633,1527,3160,精武,簡易
2020-01-11,3290,1586,1550,3136,精武,簡易
2020-01-12,3290,1408,1562,2970,精武,簡易
2020-01-13,3290,1098,1070,2168,精武,簡易
2020-01-14,3290,982,958,1940,精武,簡易
2020-01-15,3290,921,969,1890,精武,簡易
2020-01-16,3290,1015,1033,2048,精武,簡易
2020-01-17,3290,1233,1252,2485,精武,簡易
2020-01-18,3290,1148,1125,2273,精武,簡易
2020-01-19,3290,1164,1197,2361,精武,簡易
2020-01-20,3290,1109,1089,2198,精武,簡易
2020-01-21,3290,1045,1079,2124,精武,簡易
2020-01-22,3290,1142,1346,2488,精武,簡易
2020-01-23,3290,1161,1186,2347,精武,簡易
2020-01-24,3290,1038,799,1837,精武,簡易
2020-01-25,3290,1182,1156,2338,精武,簡易
2020-01-26,3290,1188,1161,2349,精武,簡易
2020-01-27,3290,1416,1445,2861,精武,簡易
2020-01-28,3290,1337,1435,2772,精武,簡易
2020-01-29,3290,1294,1331,2625,精武,簡易
2020-01-30,3290,962,896,1858,精武,簡易
2020-01-31,3290,984,1007,1991,精武,簡易
2020-02-01,3290,973,911,1884,精武,簡易
2020-02-02,3290,1081,1056,2137,精武,簡易
2020-02-03,3290,1016,913,1929,精武,簡易
2020-02-04,3290,791,870,1661,精武,簡易
2020-02-05,3290,977,934,1911,精武,簡易
2020-02-06,3290,990,927,1917,精武,簡易
2020-02-07,3290,1149,1172,2321,精武,簡易
2020-02-08,3290,1567,1494,3061,精武,簡易
2020-02-09,3290,1541,1604,3145,精武,簡易
2020-02-10,3290,1199,1171,2370,精武,簡易
2020-02-11,3290,1169,1177,2346,精武,簡易
2020-02-12,3290,1347,1321,2668,精武,簡易
2020-02-13,3290,1087,1094,2181,精武,簡易
2020-02-14,3290,1359,1393,2752,精武,簡易
2020-02-15,3290,1670,1755,3425,精武,簡易
2020-02-16,3290,1361,1295,2656,精武,簡易
2020-02-17,3290,1160,1109,2269,精武,簡易
2020-02-18,3290,1137,1125,2262,精武,簡易
2020-02-19,3290,1245,1319,2564,精武,簡易
2020-02-20,3290,1378,1413,2791,精武,簡易
2020-02-21,3290,1600,1638,3238,精武,簡易
2020-02-22,3290,2036,1975,4011,精武,簡易
2020-02-23,3290,1798,1794,3592,精武,簡易
2020-02-24,3290,990,901,1891,精武,簡易
2020-02-25,3290,836,835,1671,精武,簡易
2020-02-26,3290,877,890,1767,精武,簡易
2020-02-27,3290,1180,1232,2412,精武,簡易
2020-02-28,3290,1225,1089,2314,精武,簡易
2020-02-29,3290,1105,1055,2160,精武,簡易
2020-03-01,3290,1243,1400,2643,精武,簡易
2020-03-02,3290,983,892,1875,精武,簡易
2020-03-03,3290,823,813,1636,精武,簡易
2020-03-04,3290,825,822,1647,精武,簡易
2020-03-05,3290,822,815,1637,精武,簡易
2020-03-06,3290,1214,1217,2431,精武,簡易
2020-03-07,3290,1131,968,2099,精武,簡易
2020-03-08,3290,1052,1235,2287,精武,簡易
2020-03-09,3290,929,843,1772,精武,簡易
2020-03-10,3290,785,792,1577,精武,簡易
2020-03-11,3290,868,836,1704,精武,簡易
2020-03-12,3290,863,872,1735,精武,簡易
2020-03-13,3290,1203,1269,2472,精武,簡易
2020-03-14,3290,992,863,1855,精武,簡易
2020-03-15,3290,1143,1167,2310,精武,簡易
2020-03-16,3290,919,874,1793,精武,簡易
2020-03-17,3290,833,824,1657,精武,簡易
2020-03-18,3290,807,819,1626,精武,簡易
2020-03-19,3290,798,741,1539,精武,簡易
2020-03-20,3290,1121,1161,2282,精武,簡易
2020-03-21,3290,934,830,1764,精武,簡易
2020-03-22,3290,972,1026,1998,精武,簡易
2020-03-23,3290,845,787,1632,精武,簡易
2020-03-24,3290,781,761,1542,精武,簡易
2020-03-25,3290,734,716,1450,精武,簡易
2020-03-26,3290,793,810,1603,精武,簡易
2020-03-27,3290,1071,1085,2156,精武,簡易
2020-03-28,3290,891,760,1651,精武,簡易
2020-03-29,3290,803,871,1674,精武,簡易
2020-03-30,3290,826,732,1558,精武,簡易
2020-03-31,3290,753,783,1536,精武,簡易
2020-04-01,3290,1114,1095,2209,精武,簡易
2020-04-02,3290,913,786,1699,精武,簡易
2020-04-03,3290,852,768,1620,精武,簡易
2020-04-04,3290,663,678,1341,精武,簡易
2020-04-05,3290,905,1108,2013,精武,簡易
2020-04-06,3290,791,802,1593,精武,簡易
2020-04-07,3290,652,668,1320,精武,簡易
2020-04-08,3290,687,661,1348,精武,簡易
2020-04-09,3290,680,687,1367,精武,簡易
2020-04-10,3290,941,988,1929,精武,簡易
2020-04-11,3290,779,697,1476,精武,簡易
2020-04-12,3290,821,831,1652,精武,簡易
2020-04-13,3290,761,710,1471,精武,簡易
2020-04-14,3290,676,704,1380,精武,簡易
2020-04-15,3290,671,688,1359,精武,簡易
2020-04-16,3290,737,742,1479,精武,簡易
2020-04-17,3290,1067,1127,2194,精武,簡易
2020-04-18,3290,922,812,1734,精武,簡易
2020-04-19,3290,912,984,1896,精武,簡易
2020-04-20,3290,837,760,1597,精武,簡易
2020-04-21,3290,692,720,1412,精武,簡易
2020-04-22,3290,692,646,1338,精武,簡易
2020-04-23,3290,715,703,1418,精武,簡易
2020-04-24,3290,905,990,1895,精武,簡易
2020-04-25,3290,774,671,1445,精武,簡易
2020-04-26,3290,801,814,1615,精武,簡易
2020-04-27,3290,844,758,1602,精武,簡易
2020-04-28,3290,668,720,1388,精武,簡易
2020-04-29,3290,724,684,1408,精武,簡易
2020-04-30,3290,878,924,1802,精武,簡易
2020-05-01,3290,1127,1062,2189,精武,簡易
2020-05-02,3290,902,769,1671,精武,簡易
2020-05-03,3290,972,1146,2118,精武,簡易
2020-05-04,3290,851,809,1660,精武,簡易
2020-05-05,3290,698,726,1424,精武,簡易
2020-05-06,3290,780,744,1524,精武,簡易
2020-05-07,3290,774,812,1586,精武,簡易
2020-05-08,3290,1321,1261,2582,精武,簡易
2020-05-09,3290,1094,901,1995,精武,簡易
2020-05-10,3290,1051,1240,2291,精武,簡易
2020-05-11,3290,889,845,1734,精武,簡易
2020-05-12,3290,739,751,1490,精武,簡易
2020-05-13,3290,782,801,1583,精武,簡易
2020-05-14,3290,840,832,1672,精武,簡易
2020-05-15,3290,1138,1179,2317,精武,簡易
2020-05-16,3290,956,868,1824,精武,簡易
2020-05-17,3290,1047,1080,2127,精武,簡易
2020-05-18,3290,868,812,1680,精武,簡易
2020-05-19,3290,741,747,1488,精武,簡易
2020-05-20,3290,767,782,1549,精武,簡易
2020-05-21,3290,816,806,1622,精武,簡易
2020-05-22,3290,1032,1039,2071,精武,簡易
2020-05-23,3290,885,810,1695,精武,簡易
2020-05-24,3290,1062,1207,2269,精武,簡易
2020-05-25,3290,937,897,1834,精武,簡易
2020-05-26,3290,779,773,1552,精武,簡易
2020-05-27,3290,814,775,1589,精武,簡易
2020-05-28,3290,795,823,1618,精武,簡易
2020-05-29,3290,1221,1258,2479,精武,簡易
2020-05-30,3290,1089,982,2071,精武,簡易
2020-05-31,3290,1117,1247,2364,精武,簡易
2020-06-01,3290,915,878,1793,精武,簡易
2020-06-02,3290,814,882,1696,精武,簡易
2020-06-03,3290,875,832,1707,精武,簡易
2020-06-04,3290,868,862,1730,精武,簡易
2020-06-05,3290,1248,1196,2444,精武,簡易
2020-06-06,3290,1144,1002,2146,精武,簡易
2020-06-07,3290,1103,1207,2310,精武,簡易
2020-06-08,3290,952,900,1852,精武,簡易
2020-06-09,3290,781,768,1549,精武,簡易
2020-06-10,3290,889,869,1758,精武,簡易
2020-06-11,3290,977,933,1910,精武,簡易
2020-06-12,3290,1248,1327,2575,精武,簡易
2020-06-13,3290,1236,1066,2302,精武,簡易
2020-06-14,3290,1205,1235,2440,精武,簡易
2020-06-15,3290,1022,962,1984,精武,簡易
2020-06-16,3290,920,892,1812,精武,簡易
2020-06-17,3290,952,948,1900,精武,簡易
2020-06-18,3290,959,955,1914,精武,簡易
2020-06-19,3290,1118,1104,2222,精武,簡易
2020-06-20,3290,1156,1050,2206,精武,簡易
2020-06-21,3290,1103,1174,2277,精武,簡易
2020-06-22,3290,993,1035,2028,精武,簡易
2020-06-23,3290,950,948,1898,精武,簡易
2020-06-24,3290,1362,1350,2712,精武,簡易
2020-06-25,3290,1344,1195,2539,精武,簡易
2020-06-26,3290,1285,1222,2507,精武,簡易
2020-06-27,3290,1194,1201,2395,精武,簡易
2020-06-28,3290,1396,1418,2814,精武,簡易
2020-06-29,3290,1084,1058,2142,精武,簡易
2020-06-30,3290,966,927,1893,精武,簡易
2020-07-01,3290,979,937,1916,精武,簡易
2020-07-02,3290,946,905,1851,精武,簡易
2020-07-03,3290,1118,1136,2254,精武,簡易
2020-07-04,3290,1183,1074,2257,精武,簡易
2020-07-05,3290,1139,1229,2368,精武,簡易
2020-07-06,3290,1017,1052,2069,精武,簡易
2020-07-07,3290,928,923,1851,精武,簡易
2020-07-08,3290,977,916,1893,精武,簡易
2020-07-09,3290,950,955,1905,精武,簡易
2020-07-10,3290,1202,1191,2393,精武,簡易
2020-07-11,3290,1293,1145,2438,精武,簡易
2020-07-12,3290,1264,1222,2486,精武,簡易
2020-07-13,3290,1059,1039,2098,精武,簡易
2020-07-14,3290,1000,1031,2031,精武,簡易
2020-07-15,3290,1083,1093,2176,精武,簡易
2020-07-16,3290,1047,1036,2083,精武,簡易
2020-07-17,3290,1368,1324,2692,精武,簡易
2020-07-18,3290,1355,1193,2548,精武,簡易
2020-07-19,3290,1250,1365,2615,精武,簡易
2020-07-20,3290,1102,1081,2183,精武,簡易
2020-07-21,3290,911,884,1795,精武,簡易
2020-07-22,3290,992,965,1957,精武,簡易
2020-07-23,3290,1049,1027,2076,精武,簡易
2020-07-24,3290,1194,1319,2513,精武,簡易
2020-07-25,3290,1358,1260,2618,精武,簡易
2020-07-26,3290,1291,1273,2564,精武,簡易
2020-07-27,3290,1021,982,2003,精武,簡易
2020-07-28,3290,993,937,1930,精武,簡易
2020-07-29,3290,1063,1008,2071,精武,簡易
2020-07-30,3290,1012,987,1999,精武,簡易
2020-07-31,3290,1260,1360,2620,精武,簡易
2020-08-01,3290,1307,1135,2442,精武,簡易
2020-08-02,3290,1233,1279,2512,精武,簡易
2020-08-03,3290,971,889,1860,精武,簡易
2020-08-04,3290,934,936,1870,精武,簡易
2020-08-05,3290,970,984,1954,精武,簡易
2020-08-06,3290,1023,978,2001,精武,簡易
2020-08-07,3290,1307,1309,2616,精武,簡易
2020-08-08,3290,1401,1230,2631,精武,簡易
2020-08-09,3290,1305,1364,2669,精武,簡易
2020-08-10,3290,1133,1096,2229,精武,簡易
2020-08-11,3290,979,942,1921,精武,簡易
2020-08-12,3290,1016,1007,2023,精武,簡易
2020-08-13,3290,1068,1076,2144,精武,簡易
2020-08-14,3290,1330,1299,2629,精武,簡易
2020-08-15,3290,1318,1236,2554,精武,簡易
2020-08-16,3290,1390,1425,2815,精武,簡易
2020-08-17,3290,1115,1103,2218,精武,簡易
2020-08-18,3290,1020,1068,2088,精武,簡易
2020-08-19,3290,1074,1015,2089,精武,簡易
2020-08-20,3290,1070,1014,2084,精武,簡易
2020-08-21,3290,1279,1358,2637,精武,簡易
2020-08-22,3290,1302,1092,2394,精武,簡易
2020-08-23,3290,1222,1338,2560,精武,簡易
2020-08-24,3290,1148,1118,2266,精武,簡易
2020-08-25,3290,1067,1064,2131,精武,簡易
2020-08-26,3290,1084,1087,2171,精武,簡易
2020-08-27,3290,971,979,1950,精武,簡易
2020-08-28,3290,1195,1258,2453,精武,簡易
2020-08-29,3290,1324,1227,2551,精武,簡易
2020-08-30,3290,1197,1243,2440,精武,簡易
2020-08-31,3290,1018,931,1949,精武,簡易
2020-09-01,3290,932,917,1849,精武,簡易
2020-09-02,3290,920,915,1835,精武,簡易
2020-09-03,3290,977,947,1924,精武,簡易
2020-09-04,3290,1173,1231,2404,精武,簡易
2020-09-05,3290,1299,1142,2441,精武,簡易
2020-09-06,3290,1180,1277,2457,精武,簡易
2020-09-07,3290,1064,984,2048,精武,簡易
2020-09-08,3290,999,975,1974,精武,簡易
2020-09-09,3290,1037,1006,2043,精武,簡易
2020-09-10,3290,1016,1000,2016,精武,簡易
2020-09-11,3290,1355,1336,2691,精武,簡易
2020-09-12,3290,1277,1146,2423,精武,簡易
2020-09-13,3290,1364,1461,2825,精武,簡易
2020-09-14,3290,1041,997,2038,精武,簡易
2020-09-15,3290,928,936,1864,精武,簡易
2020-09-16,3290,993,925,1918,精武,簡易
2020-09-17,3290,989,960,1949,精武,簡易
2020-09-18,3290,1458,1473,2931,精武,簡易
2020-09-19,3290,1608,1351,2959,精武,簡易
2020-09-20,3290,1412,1525,2937,精武,簡易
2020-09-21,3290,1087,1047,2134,精武,簡易
2020-09-22,3290,960,935,1895,精武,簡易
2020-09-23,3290,1010,983,1993,精武,簡易
2020-09-24,3290,995,944,1939,精武,簡易
2020-09-25,3290,1180,1123,2303,精武,簡易
2020-09-26,3290,1219,1140,2359,精武,簡易
2020-09-27,3290,1274,1290,2564,精武,簡易
2020-09-28,3290,1084,1041,2125,精武,簡易
2020-09-29,3290,987,1038,2025,精武,簡易
2020-09-30,3290,1660,1607,3267,精武,簡易
2020-10-01,3290,1834,1512,3346,精武,簡易
2020-10-02,3290,1429,1424,2853,精武,簡易
2020-10-03,3290,1404,1355,2759,精武,簡易
2020-10-04,3290,1599,1849,3448,精武,簡易
2020-10-05,3290,1142,1024,2166,精武,簡易
2020-10-06,3290,949,982,1931,精武,簡易
2020-10-07,3290,1031,1002,2033,精武,簡易
2020-10-08,3290,1448,1464,2912,精武,簡易
2020-10-09,3290,1613,1342,2955,精武,簡易
2020-10-10,3290,1320,1279,2599,精武,簡易
2020-10-11,3290,1505,1798,3303,精武,簡易
2020-10-12,3290,1109,1025,2134,精武,簡易
2020-10-13,3290,1026,974,2000,精武,簡易
2020-10-14,3290,999,972,1971,精武,簡易
2020-10-15,3290,1027,1030,2057,精武,簡易
2020-10-16,3290,1508,1456,2964,精武,簡易
2020-10-17,3290,1434,1211,2645,精武,簡易
2020-10-18,3290,1428,1607,3035,精武,簡易
2020-10-19,3290,1099,1086,2185,精武,簡易
2020-10-20,3290,986,953,1939,精武,簡易
2020-10-21,3290,1054,1048,2102,精武,簡易
2020-10-22,3290,1080,1037,2117,精武,簡易
2020-10-23,3290,1593,1469,3062,精武,簡易
2020-10-24,3290,1487,1375,2862,精武,簡易
2020-10-25,3290,1537,1629,3166,精武,簡易
2020-10-26,3290,1185,1150,2335,精武,簡易
2020-10-27,3290,927,973,1900,精武,簡易
2020-10-28,3290,986,972,1958,精武,簡易
2020-10-29,3290,980,1005,1985,精武,簡易
2020-10-30,3290,1536,1519,3055,精武,簡易
2020-10-31,3290,1469,1209,2678,精武,簡易
2020-11-01,3290,1458,1672,3130,精武,簡易
2020-11-02,3290,1117,1097,2214,精武,簡易
2020-11-03,3290,954,964,1918,精武,簡易
2020-11-04,3290,947,950,1897,精武,簡易
2020-11-05,3290,1020,970,1990,精武,簡易
2020-11-06,3290,1500,1487,2987,精武,簡易
2020-11-07,3290,1372,1323,2695,精武,簡易
2020-11-08,3290,1317,1437,2754,精武,簡易
2020-11-09,3290,1102,1092,2194,精武,簡易
2020-11-10,3290,990,967,1957,精武,簡易
2020-11-11,3290,992,992,1984,精武,簡易
2020-11-12,3290,1085,1077,2162,精武,簡易
2020-11-13,3290,1690,1676,3366,精武,簡易
2020-11-14,3290,1558,1451,3009,精武,簡易
2020-11-15,3290,1613,1787,3400,精武,簡易
2020-11-16,3290,1299,1251,2550,精武,簡易
2020-11-17,3290,1113,1141,2254,精武,簡易
2020-11-18,3290,1195,1147,2342,精武,簡易
2020-11-19,3290,1169,1181,2350,精武,簡易
2020-11-20,3290,1777,1728,3505,精武,簡易
2020-11-21,3290,1819,1602,3421,精武,簡易
2020-11-22,3290,1674,1794,3468,精武,簡易
2020-11-23,3290,1183,1169,2352,精武,簡易
2020-11-24,3290,1127,1080,2207,精武,簡易
2020-11-25,3290,1064,1014,2078,精武,簡易
2020-11-26,3290,1089,1071,2160,精武,簡易
2020-11-27,3290,1586,1550,3136,精武,簡易
2020-11-28,3290,1707,1474,3181,精武,簡易
2020-11-29,3290,1457,1549,3006,精武,簡易
2020-11-30,3290,1132,1212,2344,精武,簡易
2020-12-01,3290,1082,1051,2133,精武,簡易
2020-12-02,3290,975,936,1911,精武,簡易
2020-12-03,3290,1061,1010,2071,精武,簡易
2020-12-04,3290,1578,1625,3203,精武,簡易
2020-12-05,3290,1584,1419,3003,精武,簡易
2020-12-06,3290,1591,1687,3278,精武,簡易
2020-12-07,3290,1179,1147,2326,精武,簡易
2020-12-08,3290,1080,1088,2168,精武,簡易
2020-12-09,3290,973,967,1940,精武,簡易
2020-12-10,3290,1088,1065,2153,精武,簡易
2020-12-11,3290,1629,1560,3189,精武,簡易
2020-12-12,3290,1637,1445,3082,精武,簡易
2020-12-13,3290,1598,1732,3330,精武,簡易
2020-12-14,3290,1236,1198,2434,精武,簡易
2020-12-15,3290,1101,1057,2158,精武,簡易
2020-12-16,3290,1098,1030,2128,精武,簡易
2020-12-17,3290,1162,1103,2265,精武,簡易
2020-12-18,3290,1747,1605,3352,精武,簡易
2020-12-19,3290,1691,1458,3149,精武,簡易
2020-12-20,3290,1628,1846,3474,精武,簡易
2020-12-21,3290,1116,1152,2268,精武,簡易
2020-12-22,3290,1067,1085,2152,精武,簡易
2020-12-23,3290,917,915,1832,精武,簡易
2020-12-24,3290,1102,1079,2181,精武,簡易
2020-12-25,3290,1632,1563,3195,精武,簡易
2020-12-26,3290,1521,1227,2748,精武,簡易
2020-12-27,3290,1456,1679,3135,精武,簡易
2020-12-28,3290,1171,1139,2310,精武,簡易
2020-12-29,3290,1070,992,2062,精武,簡易
2020-12-30,3290,1125,1033,2158,精武,簡易
2020-12-31,3290,1730,1585,3315,精武,簡易
2020-01-01,3300,36979,34662,71641,臺中,特等
2020-01-02,3300,20531,19501,40032,臺中,特等
2020-01-03,3300,24174,23899,48073,臺中,特等
2020-01-04,3300,27263,27049,54312,臺中,特等
2020-01-05,3300,31171,31739,62910,臺中,特等
2020-01-06,3300,19300,18871,38171,臺中,特等
2020-01-07,3300,17290,17243,34533,臺中,特等
2020-01-08,3300,18033,17655,35688,臺中,特等
2020-01-09,3300,21199,19427,40626,臺中,特等
2020-01-10,3300,36046,29690,65736,臺中,特等
2020-01-11,3300,35003,36670,71673,臺中,特等
2020-01-12,3300,40580,45367,85947,臺中,特等
2020-01-13,3300,23765,23373,47138,臺中,特等
2020-01-14,3300,20396,20422,40818,臺中,特等
2020-01-15,3300,20722,20104,40826,臺中,特等
2020-01-16,3300,24043,23244,47287,臺中,特等
2020-01-17,3300,25540,26911,52451,臺中,特等
2020-01-18,3300,29494,30546,60040,臺中,特等
2020-01-19,3300,34457,33729,68186,臺中,特等
2020-01-20,3300,24133,23390,47523,臺中,特等
2020-01-21,3300,24189,24008,48197,臺中,特等
2020-01-22,3300,29667,28417,58084,臺中,特等
2020-01-23,3300,33020,28301,61321,臺中,特等
2020-01-24,3300,27648,24819,52467,臺中,特等
2020-01-25,3300,32986,36898,69884,臺中,特等
2020-01-26,3300,33090,33854,66944,臺中,特等
2020-01-27,3300,36704,40201,76905,臺中,特等
2020-01-28,3300,32617,35109,67726,臺中,特等
2020-01-29,3300,28128,29831,57959,臺中,特等
2020-01-30,3300,21908,22384,44292,臺中,特等
2020-01-31,3300,23181,24406,47587,臺中,特等
2020-02-01,3300,23715,23731,47446,臺中,特等
2020-02-02,3300,25645,25534,51179,臺中,特等
2020-02-03,3300,19713,19894,39607,臺中,特等
2020-02-04,3300,17787,17911,35698,臺中,特等
2020-02-05,3300,18450,18744,37194,臺中,特等
2020-02-06,3300,19858,20563,40421,臺中,特等
2020-02-07,3300,24481,25734,50215,臺中,特等
2020-02-08,3300,28110,30002,58112,臺中,特等
2020-02-09,3300,32445,32852,65297,臺中,特等
2020-02-10,3300,22459,21773,44232,臺中,特等
2020-02-11,3300,19814,20504,40318,臺中,特等
2020-02-12,3300,21011,21324,42335,臺中,特等
2020-02-13,3300,19496,19652,39148,臺中,特等
2020-02-14,3300,23876,25505,49381,臺中,特等
2020-02-15,3300,27322,29800,57122,臺中,特等
2020-02-16,3300,34266,33224,67490,臺中,特等
2020-02-17,3300,20067,19762,39829,臺中,特等
2020-02-18,3300,17980,18281,36261,臺中,特等
2020-02-19,3300,18786,19328,38114,臺中,特等
2020-02-20,3300,19355,19685,39040,臺中,特等
2020-02-21,3300,24036,25419,49455,臺中,特等
2020-02-22,3300,27900,29565,57465,臺中,特等
2020-02-23,3300,30952,30358,61310,臺中,特等
2020-02-24,3300,18246,17997,36243,臺中,特等
2020-02-25,3300,15821,16008,31829,臺中,特等
2020-02-26,3300,16436,16247,32683,臺中,特等
2020-02-27,3300,24300,24256,48556,臺中,特等
2020-02-28,3300,25971,26537,52508,臺中,特等
2020-02-29,3300,23942,24077,48019,臺中,特等
2020-03-01,3300,27173,30834,58007,臺中,特等
2020-03-02,3300,16841,16404,33245,臺中,特等
2020-03-03,3300,13950,13955,27905,臺中,特等
2020-03-04,3300,13918,13615,27533,臺中,特等
2020-03-05,3300,14158,13896,28054,臺中,特等
2020-03-06,3300,24360,22648,47008,臺中,特等
2020-03-07,3300,21992,21868,43860,臺中,特等
2020-03-08,3300,25697,27672,53369,臺中,特等
2020-03-09,3300,16305,16327,32632,臺中,特等
2020-03-10,3300,13873,13774,27647,臺中,特等
2020-03-11,3300,14820,14770,29590,臺中,特等
2020-03-12,3300,15486,15120,30606,臺中,特等
2020-03-13,3300,25895,23677,49572,臺中,特等
2020-03-14,3300,23268,24597,47865,臺中,特等
2020-03-15,3300,31471,33295,64766,臺中,特等
2020-03-16,3300,17134,16909,34043,臺中,特等
2020-03-17,3300,14585,14379,28964,臺中,特等
2020-03-18,3300,14014,13609,27623,臺中,特等
2020-03-19,3300,14120,13675,27795,臺中,特等
2020-03-20,3300,23648,22002,45650,臺中,特等
2020-03-21,3300,19270,19451,38721,臺中,特等
2020-03-22,3300,22589,24237,46826,臺中,特等
2020-03-23,3300,14862,14990,29852,臺中,特等
2020-03-24,3300,12860,12888,25748,臺中,特等
2020-03-25,3300,12982,12668,25650,臺中,特等
2020-03-26,3300,13579,13138,26717,臺中,特等
2020-03-27,3300,21415,19389,40804,臺中,特等
2020-03-28,3300,17160,16314,33474,臺中,特等
2020-03-29,3300,19166,19061,38227,臺中,特等
2020-03-30,3300,14862,14308,29170,臺中,特等
2020-03-31,3300,15279,13833,29112,臺中,特等
2020-04-01,3300,23383,21045,44428,臺中,特等
2020-04-02,3300,19062,17532,36594,臺中,特等
2020-04-03,3300,17683,16683,34366,臺中,特等
2020-04-04,3300,15087,15768,30855,臺中,特等
2020-04-05,3300,19225,26360,45585,臺中,特等
2020-04-06,3300,15452,16283,31735,臺中,特等
2020-04-07,3300,12154,11924,24078,臺中,特等
2020-04-08,3300,11837,11576,23413,臺中,特等
2020-04-09,3300,12243,11741,23984,臺中,特等
2020-04-10,3300,19125,18177,37302,臺中,特等
2020-04-11,3300,16580,17102,33682,臺中,特等
2020-04-12,3300,21139,21348,42487,臺中,特等
2020-04-13,3300,13637,13601,27238,臺中,特等
2020-04-14,3300,11952,11709,23661,臺中,特等
2020-04-15,3300,12467,12256,24723,臺中,特等
2020-04-16,3300,13294,12779,26073,臺中,特等
2020-04-17,3300,22180,21144,43324,臺中,特等
2020-04-18,3300,19109,19468,38577,臺中,特等
2020-04-19,3300,23113,23777,46890,臺中,特等
2020-04-20,3300,14139,14365,28504,臺中,特等
2020-04-21,3300,11796,11698,23494,臺中,特等
2020-04-22,3300,11870,11624,23494,臺中,特等
2020-04-23,3300,12250,11701,23951,臺中,特等
2020-04-24,3300,18843,17890,36733,臺中,特等
2020-04-25,3300,14738,15100,29838,臺中,特等
2020-04-26,3300,17429,18062,35491,臺中,特等
2020-04-27,3300,13490,13743,27233,臺中,特等
2020-04-28,3300,12518,11933,24451,臺中,特等
2020-04-29,3300,12065,11772,23837,臺中,特等
2020-04-30,3300,15394,16123,31517,臺中,特等
2020-05-01,3300,23090,21022,44112,臺中,特等
2020-05-02,3300,17398,17186,34584,臺中,特等
2020-05-03,3300,21282,22993,44275,臺中,特等
2020-05-04,3300,14311,14476,28787,臺中,特等
2020-05-05,3300,12013,12777,24790,臺中,特等
2020-05-06,3300,13042,13134,26176,臺中,特等
2020-05-07,3300,14446,13833,28279,臺中,特等
2020-05-08,3300,27033,23112,50145,臺中,特等
2020-05-09,3300,22749,21405,44154,臺中,特等
2020-05-10,3300,24638,29872,54510,臺中,特等
2020-05-11,3300,16188,17347,33535,臺中,特等
2020-05-12,3300,13081,13303,26384,臺中,特等
2020-05-13,3300,13665,13717,27382,臺中,特等
2020-05-14,3300,14320,14179,28499,臺中,特等
2020-05-15,3300,24139,23223,47362,臺中,特等
2020-05-16,3300,21406,22270,43676,臺中,特等
2020-05-17,3300,25885,26661,52546,臺中,特等
2020-05-18,3300,15367,15201,30568,臺中,特等
2020-05-19,3300,12514,12326,24840,臺中,特等
2020-05-20,3300,13410,13142,26552,臺中,特等
2020-05-21,3300,13725,13322,27047,臺中,特等
2020-05-22,3300,21724,20275,41999,臺中,特等
2020-05-23,3300,20157,22886,43043,臺中,特等
2020-05-24,3300,34091,34272,68363,臺中,特等
2020-05-25,3300,16708,15835,32543,臺中,特等
2020-05-26,3300,13188,13262,26450,臺中,特等
2020-05-27,3300,13006,12716,25722,臺中,特等
2020-05-28,3300,13987,13525,27512,臺中,特等
2020-05-29,3300,24185,22854,47039,臺中,特等
2020-05-30,3300,24125,24525,48650,臺中,特等
2020-05-31,3300,27530,29240,56770,臺中,特等
2020-06-01,3300,16190,16158,32348,臺中,特等
2020-06-02,3300,13868,13773,27641,臺中,特等
2020-06-03,3300,14167,13945,28112,臺中,特等
2020-06-04,3300,15101,14572,29673,臺中,特等
2020-06-05,3300,25429,23966,49395,臺中,特等
2020-06-06,3300,26814,27180,53994,臺中,特等
2020-06-07,3300,28458,31072,59530,臺中,特等
2020-06-08,3300,17044,16750,33794,臺中,特等
2020-06-09,3300,14239,14334,28573,臺中,特等
2020-06-10,3300,15184,15527,30711,臺中,特等
2020-06-11,3300,17000,16776,33776,臺中,特等
2020-06-12,3300,25575,25256,50831,臺中,特等
2020-06-13,3300,28574,31483,60057,臺中,特等
2020-06-14,3300,35539,36083,71622,臺中,特等
2020-06-15,3300,20076,18853,38929,臺中,特等
2020-06-16,3300,17264,17461,34725,臺中,特等
2020-06-17,3300,16076,16146,32222,臺中,特等
2020-06-18,3300,16418,16428,32846,臺中,特等
2020-06-19,3300,20751,20782,41533,臺中,特等
2020-06-20,3300,23450,24713,48163,臺中,特等
2020-06-21,3300,30855,30061,60916,臺中,特等
2020-06-22,3300,18787,18395,37182,臺中,特等
2020-06-23,3300,17271,17351,34622,臺中,特等
2020-06-24,3300,28379,26266,54645,臺中,特等
2020-06-25,3300,30418,29382,59800,臺中,特等
2020-06-26,3300,30574,31520,62094,臺中,特等
2020-06-27,3300,32478,34492,66970,臺中,特等
2020-06-28,3300,33336,35656,68992,臺中,特等
2020-06-29,3300,20889,20706,41595,臺中,特等
2020-06-30,3300,17590,17511,35101,臺中,特等
2020-07-01,3300,17271,17211,34482,臺中,特等
2020-07-02,3300,16894,16659,33553,臺中,特等
2020-07-03,3300,21818,22497,44315,臺中,特等
2020-07-04,3300,24151,24204,48355,臺中,特等
2020-07-05,3300,26955,26793,53748,臺中,特等
2020-07-06,3300,19821,19662,39483,臺中,特等
2020-07-07,3300,18245,18428,36673,臺中,特等
2020-07-08,3300,18636,19260,37896,臺中,特等
2020-07-09,3300,19464,19194,38658,臺中,特等
2020-07-10,3300,24419,25731,50150,臺中,特等
2020-07-11,3300,28967,32275,61242,臺中,特等
2020-07-12,3300,37182,36143,73325,臺中,特等
2020-07-13,3300,21534,21012,42546,臺中,特等
2020-07-14,3300,22323,22739,45062,臺中,特等
2020-07-15,3300,23307,23180,46487,臺中,特等
2020-07-16,3300,22456,22491,44947,臺中,特等
2020-07-17,3300,27470,28797,56267,臺中,特等
2020-07-18,3300,31878,33144,65022,臺中,特等
2020-07-19,3300,37498,37527,75025,臺中,特等
2020-07-20,3300,23117,22658,45775,臺中,特等
2020-07-21,3300,20549,20277,40826,臺中,特等
2020-07-22,3300,21466,21777,43243,臺中,特等
2020-07-23,3300,21417,21384,42801,臺中,特等
2020-07-24,3300,25879,28226,54105,臺中,特等
2020-07-25,3300,30208,31497,61705,臺中,特等
2020-07-26,3300,33305,33412,66717,臺中,特等
2020-07-27,3300,22698,21343,44041,臺中,特等
2020-07-28,3300,19462,20014,39476,臺中,特等
2020-07-29,3300,20518,20923,41441,臺中,特等
2020-07-30,3300,20348,20488,40836,臺中,特等
2020-07-31,3300,25908,26945,52853,臺中,特等
2020-08-01,3300,28432,29727,58159,臺中,特等
2020-08-02,3300,30273,30225,60498,臺中,特等
2020-08-03,3300,19190,18673,37863,臺中,特等
2020-08-04,3300,17378,17615,34993,臺中,特等
2020-08-05,3300,19585,19480,39065,臺中,特等
2020-08-06,3300,19931,20011,39942,臺中,特等
2020-08-07,3300,27156,26877,54033,臺中,特等
2020-08-08,3300,26930,26707,53637,臺中,特等
2020-08-09,3300,31877,34833,66710,臺中,特等
2020-08-10,3300,22655,22183,44838,臺中,特等
2020-08-11,3300,19163,19764,38927,臺中,特等
2020-08-12,3300,20683,20900,41583,臺中,特等
2020-08-13,3300,21495,21944,43439,臺中,特等
2020-08-14,3300,27656,28649,56305,臺中,特等
2020-08-15,3300,33389,36393,69782,臺中,特等
2020-08-16,3300,43009,43270,86279,臺中,特等
2020-08-17,3300,25195,23476,48671,臺中,特等
2020-08-18,3300,21353,21915,43268,臺中,特等
2020-08-19,3300,21690,21174,42864,臺中,特等
2020-08-20,3300,21825,22175,44000,臺中,特等
2020-08-21,3300,27382,28534,55916,臺中,特等
2020-08-22,3300,30106,31141,61247,臺中,特等
2020-08-23,3300,34916,35373,70289,臺中,特等
2020-08-24,3300,23980,23382,47362,臺中,特等
2020-08-25,3300,21577,22457,44034,臺中,特等
2020-08-26,3300,21494,21728,43222,臺中,特等
2020-08-27,3300,21415,21186,42601,臺中,特等
2020-08-28,3300,24933,25934,50867,臺中,特等
2020-08-29,3300,27782,28692,56474,臺中,特等
2020-08-30,3300,29219,29117,58336,臺中,特等
2020-08-31,3300,19263,18454,37717,臺中,特等
2020-09-01,3300,16741,16717,33458,臺中,特等
2020-09-02,3300,16022,16563,32585,臺中,特等
2020-09-03,3300,18282,18798,37080,臺中,特等
2020-09-04,3300,24063,24828,48891,臺中,特等
2020-09-05,3300,27222,28321,55543,臺中,特等
2020-09-06,3300,30069,31265,61334,臺中,特等
2020-09-07,3300,20121,19064,39185,臺中,特等
2020-09-08,3300,17236,17449,34685,臺中,特等
2020-09-09,3300,17699,18004,35703,臺中,特等
2020-09-10,3300,19412,19148,38560,臺中,特等
2020-09-11,3300,26334,26300,52634,臺中,特等
2020-09-12,3300,30891,33684,64575,臺中,特等
2020-09-13,3300,39086,40676,79762,臺中,特等
2020-09-14,3300,19127,17963,37090,臺中,特等
2020-09-15,3300,15737,15876,31613,臺中,特等
2020-09-16,3300,16086,16181,32267,臺中,特等
2020-09-17,3300,17104,16929,34033,臺中,特等
2020-09-18,3300,28866,26772,55638,臺中,特等
2020-09-19,3300,31299,31995,63294,臺中,特等
2020-09-20,3300,37327,39648,76975,臺中,特等
2020-09-21,3300,18782,18690,37472,臺中,特等
2020-09-22,3300,16023,16148,32171,臺中,特等
2020-09-23,3300,16217,16400,32617,臺中,特等
2020-09-24,3300,16896,16638,33534,臺中,特等
2020-09-25,3300,21618,20850,42468,臺中,特等
2020-09-26,3300,23822,24583,48405,臺中,特等
2020-09-27,3300,30630,31053,61683,臺中,特等
2020-09-28,3300,17210,17321,34531,臺中,特等
2020-09-29,3300,16556,16877,33433,臺中,特等
2020-09-30,3300,34334,28300,62634,臺中,特等
2020-10-01,3300,34226,30178,64404,臺中,特等
2020-10-02,3300,30581,31580,62161,臺中,特等
2020-10-03,3300,32435,34451,66886,臺中,特等
2020-10-04,3300,34542,43398,77940,臺中,特等
2020-10-05,3300,19055,20233,39288,臺中,特等
2020-10-06,3300,15990,15913,31903,臺中,特等
2020-10-07,3300,16348,16644,32992,臺中,特等
2020-10-08,3300,29736,26462,56198,臺中,特等
2020-10-09,3300,34170,33866,68036,臺中,特等
2020-10-10,3300,33105,35281,68386,臺中,特等
2020-10-11,3300,40032,42921,82953,臺中,特等
2020-10-12,3300,18850,19647,38497,臺中,特等
2020-10-13,3300,16605,16602,33207,臺中,特等
2020-10-14,3300,16591,16743,33334,臺中,特等
2020-10-15,3300,17594,17497,35091,臺中,特等
2020-10-16,3300,27718,26426,54144,臺中,特等
2020-10-17,3300,31646,33239,64885,臺中,特等
2020-10-18,3300,41020,41238,82258,臺中,特等
2020-10-19,3300,18793,19212,38005,臺中,特等
2020-10-20,3300,16279,16807,33086,臺中,特等
2020-10-21,3300,16761,16741,33502,臺中,特等
2020-10-22,3300,17164,17197,34361,臺中,特等
2020-10-23,3300,28058,26091,54149,臺中,特等
2020-10-24,3300,30578,31351,61929,臺中,特等
2020-10-25,3300,34494,36765,71259,臺中,特等
2020-10-26,3300,18946,19132,38078,臺中,特等
2020-10-27,3300,16004,16147,32151,臺中,特等
2020-10-28,3300,15873,15891,31764,臺中,特等
2020-10-29,3300,16869,16718,33587,臺中,特等
2020-10-30,3300,28804,25605,54409,臺中,特等
2020-10-31,3300,29088,29777,58865,臺中,特等
2020-11-01,3300,31764,34733,66497,臺中,特等
2020-11-02,3300,17512,17938,35450,臺中,特等
2020-11-03,3300,14818,14886,29704,臺中,特等
2020-11-04,3300,15437,15358,30795,臺中,特等
2020-11-05,3300,16698,16247,32945,臺中,特等
2020-11-06,3300,27959,26502,54461,臺中,特等
2020-11-07,3300,29040,31113,60153,臺中,特等
2020-11-08,3300,35229,36612,71841,臺中,特等
2020-11-09,3300,18207,18509,36716,臺中,特等
2020-11-10,3300,15601,15892,31493,臺中,特等
2020-11-11,3300,16744,17022,33766,臺中,特等
2020-11-12,3300,18075,17908,35983,臺中,特等
2020-11-13,3300,30524,28293,58817,臺中,特等
2020-11-14,3300,34536,37152,71688,臺中,特等
2020-11-15,3300,45610,47130,92740,臺中,特等
2020-11-16,3300,19740,19835,39575,臺中,特等
2020-11-17,3300,16610,16390,33000,臺中,特等
2020-11-18,3300,16795,16837,33632,臺中,特等
2020-11-19,3300,18522,18072,36594,臺中,特等
2020-11-20,3300,29947,28521,58468,臺中,特等
2020-11-21,3300,31355,32818,64173,臺中,特等
2020-11-22,3300,39421,41241,80662,臺中,特等
2020-11-23,3300,20031,20161,40192,臺中,特等
2020-11-24,3300,16809,16730,33539,臺中,特等
2020-11-25,3300,16962,17332,34294,臺中,特等
2020-11-26,3300,18385,18118,36503,臺中,特等
2020-11-27,3300,29918,27279,57197,臺中,特等
2020-11-28,3300,30527,30716,61243,臺中,特等
2020-11-29,3300,33660,35825,69485,臺中,特等
2020-11-30,3300,18618,19543,38161,臺中,特等
2020-12-01,3300,15269,15800,31069,臺中,特等
2020-12-02,3300,15975,15752,31727,臺中,特等
2020-12-03,3300,16901,16678,33579,臺中,特等
2020-12-04,3300,28780,27723,56503,臺中,特等
2020-12-05,3300,31591,32570,64161,臺中,特等
2020-12-06,3300,36936,38990,75926,臺中,特等
2020-12-07,3300,20103,19821,39924,臺中,特等
2020-12-08,3300,16189,16017,32206,臺中,特等
2020-12-09,3300,15305,15189,30494,臺中,特等
2020-12-10,3300,17654,17286,34940,臺中,特等
2020-12-11,3300,30221,28005,58226,臺中,特等
2020-12-12,3300,36124,36913,73037,臺中,特等
2020-12-13,3300,43903,46957,90860,臺中,特等
2020-12-14,3300,19949,20636,40585,臺中,特等
2020-12-15,3300,16472,16730,33202,臺中,特等
2020-12-16,3300,16837,16904,33741,臺中,特等
2020-12-17,3300,18166,17805,35971,臺中,特等
2020-12-18,3300,30738,28650,59388,臺中,特等
2020-12-19,3300,35538,36574,72112,臺中,特等
2020-12-20,3300,41066,43678,84744,臺中,特等
2020-12-21,3300,18882,19915,38797,臺中,特等
2020-12-22,3300,16734,16945,33679,臺中,特等
2020-12-23,3300,15761,15596,31357,臺中,特等
2020-12-24,3300,19298,18926,38224,臺中,特等
2020-12-25,3300,30901,29439,60340,臺中,特等
2020-12-26,3300,32946,32868,65814,臺中,特等
2020-12-27,3300,35092,37011,72103,臺中,特等
2020-12-28,3300,18827,18864,37691,臺中,特等
2020-12-29,3300,16465,16259,32724,臺中,特等
2020-12-30,3300,18641,17909,36550,臺中,特等
2020-12-31,3300,32540,32977,65517,臺中,特等
2020-01-01,3310,1278,1360,2638,五權,簡易
2020-01-02,3310,1253,1328,2581,五權,簡易
2020-01-03,3310,1499,1524,3023,五權,簡易
2020-01-04,3310,1414,1346,2760,五權,簡易
2020-01-05,3310,1293,1568,2861,五權,簡易
2020-01-06,3310,1281,1314,2595,五權,簡易
2020-01-07,3310,1253,1278,2531,五權,簡易
2020-01-08,3310,1287,1331,2618,五權,簡易
2020-01-09,3310,1265,1293,2558,五權,簡易
2020-01-10,3310,2225,1753,3978,五權,簡易
2020-01-11,3310,1859,1801,3660,五權,簡易
2020-01-12,3310,1444,2035,3479,五權,簡易
2020-01-13,3310,1396,1506,2902,五權,簡易
2020-01-14,3310,1316,1327,2643,五權,簡易
2020-01-15,3310,1262,1290,2552,五權,簡易
2020-01-16,3310,1403,1460,2863,五權,簡易
2020-01-17,3310,1535,1563,3098,五權,簡易
2020-01-18,3310,1421,1440,2861,五權,簡易
2020-01-19,3310,1292,1561,2853,五權,簡易
2020-01-20,3310,1388,1418,2806,五權,簡易
2020-01-21,3310,1505,1541,3046,五權,簡易
2020-01-22,3310,1624,1529,3153,五權,簡易
2020-01-23,3310,1518,1031,2549,五權,簡易
2020-01-24,3310,1202,680,1882,五權,簡易
2020-01-25,3310,951,1066,2017,五權,簡易
2020-01-26,3310,912,965,1877,五權,簡易
2020-01-27,3310,1305,1592,2897,五權,簡易
2020-01-28,3310,1193,1473,2666,五權,簡易
2020-01-29,3310,1059,1463,2522,五權,簡易
2020-01-30,3310,1137,1211,2348,五權,簡易
2020-01-31,3310,1182,1287,2469,五權,簡易
2020-02-01,3310,1252,1242,2494,五權,簡易
2020-02-02,3310,1074,1180,2254,五權,簡易
2020-02-03,3310,1155,1204,2359,五權,簡易
2020-02-04,3310,1185,1281,2466,五權,簡易
2020-02-05,3310,1247,1281,2528,五權,簡易
2020-02-06,3310,1226,1196,2422,五權,簡易
2020-02-07,3310,1592,1521,3113,五權,簡易
2020-02-08,3310,1702,1628,3330,五權,簡易
2020-02-09,3310,1615,1823,3438,五權,簡易
2020-02-10,3310,1424,1484,2908,五權,簡易
2020-02-11,3310,1484,1544,3028,五權,簡易
2020-02-12,3310,1578,1662,3240,五權,簡易
2020-02-13,3310,1364,1397,2761,五權,簡易
2020-02-14,3310,1729,1748,3477,五權,簡易
2020-02-15,3310,2038,1992,4030,五權,簡易
2020-02-16,3310,1446,1483,2929,五權,簡易
2020-02-17,3310,1306,1343,2649,五權,簡易
2020-02-18,3310,1446,1522,2968,五權,簡易
2020-02-19,3310,1650,1724,3374,五權,簡易
2020-02-20,3310,1710,1723,3433,五權,簡易
2020-02-21,3310,1928,1925,3853,五權,簡易
2020-02-22,3310,2255,2164,4419,五權,簡易
2020-02-23,3310,1862,2096,3958,五權,簡易
2020-02-24,3310,1199,1245,2444,五權,簡易
2020-02-25,3310,1200,1217,2417,五權,簡易
2020-02-26,3310,1176,1165,2341,五權,簡易
2020-02-27,3310,1493,1465,2958,五權,簡易
2020-02-28,3310,1534,1250,2784,五權,簡易
2020-02-29,3310,1215,1247,2462,五權,簡易
2020-03-01,3310,1144,1595,2739,五權,簡易
2020-03-02,3310,1215,1144,2359,五權,簡易
2020-03-03,3310,1109,1102,2211,五權,簡易
2020-03-04,3310,1148,1147,2295,五權,簡易
2020-03-05,3310,1071,1008,2079,五權,簡易
2020-03-06,3310,1387,1414,2801,五權,簡易
2020-03-07,3310,1251,1108,2359,五權,簡易
2020-03-08,3310,1132,1292,2424,五權,簡易
2020-03-09,3310,1201,1147,2348,五權,簡易
2020-03-10,3310,1021,1005,2026,五權,簡易
2020-03-11,3310,1190,1179,2369,五權,簡易
2020-03-12,3310,1141,1121,2262,五權,簡易
2020-03-13,3310,1486,1487,2973,五權,簡易
2020-03-14,3310,1239,1079,2318,五權,簡易
2020-03-15,3310,1234,1534,2768,五權,簡易
2020-03-16,3310,1163,1131,2294,五權,簡易
2020-03-17,3310,1114,1117,2231,五權,簡易
2020-03-18,3310,1118,1176,2294,五權,簡易
2020-03-19,3310,1097,1095,2192,五權,簡易
2020-03-20,3310,1431,1389,2820,五權,簡易
2020-03-21,3310,1074,927,2001,五權,簡易
2020-03-22,3310,960,1205,2165,五權,簡易
2020-03-23,3310,1095,1074,2169,五權,簡易
2020-03-24,3310,1034,1063,2097,五權,簡易
2020-03-25,3310,1055,1049,2104,五權,簡易
2020-03-26,3310,1064,1037,2101,五權,簡易
2020-03-27,3310,1320,1315,2635,五權,簡易
2020-03-28,3310,1084,933,2017,五權,簡易
2020-03-29,3310,912,1026,1938,五權,簡易
2020-03-30,3310,1099,1074,2173,五權,簡易
2020-03-31,3310,1033,1035,2068,五權,簡易
2020-04-01,3310,1327,1300,2627,五權,簡易
2020-04-02,3310,1104,816,1920,五權,簡易
2020-04-03,3310,990,796,1786,五權,簡易
2020-04-04,3310,726,759,1485,五權,簡易
2020-04-05,3310,794,1384,2178,五權,簡易
2020-04-06,3310,1023,1021,2044,五權,簡易
2020-04-07,3310,977,930,1907,五權,簡易
2020-04-08,3310,976,962,1938,五權,簡易
2020-04-09,3310,969,950,1919,五權,簡易
2020-04-10,3310,1233,1217,2450,五權,簡易
2020-04-11,3310,945,887,1832,五權,簡易
2020-04-12,3310,865,984,1849,五權,簡易
2020-04-13,3310,1015,1008,2023,五權,簡易
2020-04-14,3310,975,1011,1986,五權,簡易
2020-04-15,3310,1018,1000,2018,五權,簡易
2020-04-16,3310,1024,1056,2080,五權,簡易
2020-04-17,3310,1367,1334,2701,五權,簡易
2020-04-18,3310,1118,955,2073,五權,簡易
2020-04-19,3310,954,1163,2117,五權,簡易
2020-04-20,3310,1030,1025,2055,五權,簡易
2020-04-21,3310,1004,1040,2044,五權,簡易
2020-04-22,3310,1002,1003,2005,五權,簡易
2020-04-23,3310,962,944,1906,五權,簡易
2020-04-24,3310,1215,1176,2391,五權,簡易
2020-04-25,3310,970,874,1844,五權,簡易
2020-04-26,3310,845,997,1842,五權,簡易
2020-04-27,3310,989,1012,2001,五權,簡易
2020-04-28,3310,996,969,1965,五權,簡易
2020-04-29,3310,1018,1004,2022,五權,簡易
2020-04-30,3310,1164,1154,2318,五權,簡易
2020-05-01,3310,1377,1211,2588,五權,簡易
2020-05-02,3310,1017,954,1971,五權,簡易
2020-05-03,3310,920,1186,2106,五權,簡易
2020-05-04,3310,1065,1070,2135,五權,簡易
2020-05-05,3310,987,985,1972,五權,簡易
2020-05-06,3310,1048,1012,2060,五權,簡易
2020-05-07,3310,1101,1104,2205,五權,簡易
2020-05-08,3310,1471,1401,2872,五權,簡易
2020-05-09,3310,1392,1053,2445,五權,簡易
2020-05-10,3310,981,1413,2394,五權,簡易
2020-05-11,3310,1099,1140,2239,五權,簡易
2020-05-12,3310,1063,1074,2137,五權,簡易
2020-05-13,3310,1052,1048,2100,五權,簡易
2020-05-14,3310,1100,1069,2169,五權,簡易
2020-05-15,3310,1325,1373,2698,五權,簡易
2020-05-16,3310,1133,1006,2139,五權,簡易
2020-05-17,3310,1041,1153,2194,五權,簡易
2020-05-18,3310,1099,1093,2192,五權,簡易
2020-05-19,3310,1004,998,2002,五權,簡易
2020-05-20,3310,1066,1021,2087,五權,簡易
2020-05-21,3310,1020,1038,2058,五權,簡易
2020-05-22,3310,1234,1254,2488,五權,簡易
2020-05-23,3310,1016,1009,2025,五權,簡易
2020-05-24,3310,1059,1258,2317,五權,簡易
2020-05-25,3310,1141,1114,2255,五權,簡易
2020-05-26,3310,1056,1016,2072,五權,簡易
2020-05-27,3310,1030,1039,2069,五權,簡易
2020-05-28,3310,1052,1068,2120,五權,簡易
2020-05-29,3310,1385,1427,2812,五權,簡易
2020-05-30,3310,1271,1138,2409,五權,簡易
2020-05-31,3310,1073,1251,2324,五權,簡易
2020-06-01,3310,1162,1145,2307,五權,簡易
2020-06-02,3310,1066,1060,2126,五權,簡易
2020-06-03,3310,1085,1070,2155,五權,簡易
2020-06-04,3310,1144,1141,2285,五權,簡易
2020-06-05,3310,1469,1390,2859,五權,簡易
2020-06-06,3310,1379,1149,2528,五權,簡易
2020-06-07,3310,1112,1389,2501,五權,簡易
2020-06-08,3310,1099,1106,2205,五權,簡易
2020-06-09,3310,1060,1091,2151,五權,簡易
2020-06-10,3310,1179,1138,2317,五權,簡易
2020-06-11,3310,1172,1183,2355,五權,簡易
2020-06-12,3310,1401,1391,2792,五權,簡易
2020-06-13,3310,1380,1210,2590,五權,簡易
2020-06-14,3310,1160,1360,2520,五權,簡易
2020-06-15,3310,1236,1187,2423,五權,簡易
2020-06-16,3310,1130,1163,2293,五權,簡易
2020-06-17,3310,1186,1207,2393,五權,簡易
2020-06-18,3310,1199,1142,2341,五權,簡易
2020-06-19,3310,1286,1385,2671,五權,簡易
2020-06-20,3310,1435,1324,2759,五權,簡易
2020-06-21,3310,1150,1264,2414,五權,簡易
2020-06-22,3310,1198,1150,2348,五權,簡易
2020-06-23,3310,1240,1219,2459,五權,簡易
2020-06-24,3310,1581,1397,2978,五權,簡易
2020-06-25,3310,1609,1176,2785,五權,簡易
2020-06-26,3310,1376,1365,2741,五權,簡易
2020-06-27,3310,1309,1366,2675,五權,簡易
2020-06-28,3310,1202,1591,2793,五權,簡易
2020-06-29,3310,1284,1336,2620,五權,簡易
2020-06-30,3310,1161,1194,2355,五權,簡易
2020-07-01,3310,1150,1152,2302,五權,簡易
2020-07-02,3310,1174,1150,2324,五權,簡易
2020-07-03,3310,1461,1412,2873,五權,簡易
2020-07-04,3310,1340,1239,2579,五權,簡易
2020-07-05,3310,1152,1428,2580,五權,簡易
2020-07-06,3310,1310,1327,2637,五權,簡易
2020-07-07,3310,1180,1157,2337,五權,簡易
2020-07-08,3310,1293,1266,2559,五權,簡易
2020-07-09,3310,1333,1237,2570,五權,簡易
2020-07-10,3310,1537,1432,2969,五權,簡易
2020-07-11,3310,1379,1331,2710,五權,簡易
2020-07-12,3310,1354,1546,2900,五權,簡易
2020-07-13,3310,1387,1352,2739,五權,簡易
2020-07-14,3310,1195,1283,2478,五權,簡易
2020-07-15,3310,1368,1377,2745,五權,簡易
2020-07-16,3310,1334,1322,2656,五權,簡易
2020-07-17,3310,1708,1693,3401,五權,簡易
2020-07-18,3310,1682,1633,3315,五權,簡易
2020-07-19,3310,1333,1606,2939,五權,簡易
2020-07-20,3310,1303,1409,2712,五權,簡易
2020-07-21,3310,1300,1294,2594,五權,簡易
2020-07-22,3310,1269,1339,2608,五權,簡易
2020-07-23,3310,1317,1267,2584,五權,簡易
2020-07-24,3310,1572,1480,3052,五權,簡易
2020-07-25,3310,1450,1413,2863,五權,簡易
2020-07-26,3310,1279,1466,2745,五權,簡易
2020-07-27,3310,1307,1353,2660,五權,簡易
2020-07-28,3310,1278,1258,2536,五權,簡易
2020-07-29,3310,1284,1330,2614,五權,簡易
2020-07-30,3310,1352,1328,2680,五權,簡易
2020-07-31,3310,1602,1534,3136,五權,簡易
2020-08-01,3310,1495,1406,2901,五權,簡易
2020-08-02,3310,1277,1422,2699,五權,簡易
2020-08-03,3310,1219,1186,2405,五權,簡易
2020-08-04,3310,1135,1133,2268,五權,簡易
2020-08-05,3310,1320,1329,2649,五權,簡易
2020-08-06,3310,1283,1251,2534,五權,簡易
2020-08-07,3310,1780,1535,3315,五權,簡易
2020-08-08,3310,1629,1310,2939,五權,簡易
2020-08-09,3310,1188,1697,2885,五權,簡易
2020-08-10,3310,1302,1379,2681,五權,簡易
2020-08-11,3310,1279,1268,2547,五權,簡易
2020-08-12,3310,1237,1225,2462,五權,簡易
2020-08-13,3310,1321,1271,2592,五權,簡易
2020-08-14,3310,1671,1624,3295,五權,簡易
2020-08-15,3310,1511,1473,2984,五權,簡易
2020-08-16,3310,1469,1698,3167,五權,簡易
2020-08-17,3310,1415,1385,2800,五權,簡易
2020-08-18,3310,1330,1336,2666,五權,簡易
2020-08-19,3310,1346,1344,2690,五權,簡易
2020-08-20,3310,1348,1344,2692,五權,簡易
2020-08-21,3310,1633,1568,3201,五權,簡易
2020-08-22,3310,1579,1383,2962,五權,簡易
2020-08-23,3310,1348,1574,2922,五權,簡易
2020-08-24,3310,1480,1478,2958,五權,簡易
2020-08-25,3310,1376,1420,2796,五權,簡易
2020-08-26,3310,1329,1383,2712,五權,簡易
2020-08-27,3310,1369,1335,2704,五權,簡易
2020-08-28,3310,1665,1580,3245,五權,簡易
2020-08-29,3310,1504,1296,2800,五權,簡易
2020-08-30,3310,1187,1420,2607,五權,簡易
2020-08-31,3310,1293,1276,2569,五權,簡易
2020-09-01,3310,1240,1156,2396,五權,簡易
2020-09-02,3310,1219,1223,2442,五權,簡易
2020-09-03,3310,1255,1315,2570,五權,簡易
2020-09-04,3310,1593,1519,3112,五權,簡易
2020-09-05,3310,1452,1313,2765,五權,簡易
2020-09-06,3310,1256,1532,2788,五權,簡易
2020-09-07,3310,1311,1280,2591,五權,簡易
2020-09-08,3310,1229,1230,2459,五權,簡易
2020-09-09,3310,1248,1266,2514,五權,簡易
2020-09-10,3310,1299,1289,2588,五權,簡易
2020-09-11,3310,1550,1518,3068,五權,簡易
2020-09-12,3310,1603,1424,3027,五權,簡易
2020-09-13,3310,1436,1664,3100,五權,簡易
2020-09-14,3310,1333,1281,2614,五權,簡易
2020-09-15,3310,1119,1165,2284,五權,簡易
2020-09-16,3310,1207,1197,2404,五權,簡易
2020-09-17,3310,1197,1193,2390,五權,簡易
2020-09-18,3310,1638,1601,3239,五權,簡易
2020-09-19,3310,1658,1497,3155,五權,簡易
2020-09-20,3310,1401,1641,3042,五權,簡易
2020-09-21,3310,1281,1285,2566,五權,簡易
2020-09-22,3310,1213,1169,2382,五權,簡易
2020-09-23,3310,1272,1256,2528,五權,簡易
2020-09-24,3310,1249,1217,2466,五權,簡易
2020-09-25,3310,1414,1369,2783,五權,簡易
2020-09-26,3310,1432,1288,2720,五權,簡易
2020-09-27,3310,1385,1397,2782,五權,簡易
2020-09-28,3310,1309,1230,2539,五權,簡易
2020-09-29,3310,1282,1251,2533,五權,簡易
2020-09-30,3310,1913,1762,3675,五權,簡易
2020-10-01,3310,1972,1287,3259,五權,簡易
2020-10-02,3310,1612,1609,3221,五權,簡易
2020-10-03,3310,1323,1597,2920,五權,簡易
2020-10-04,3310,1308,1910,3218,五權,簡易
2020-10-05,3310,1325,1373,2698,五權,簡易
2020-10-06,3310,1252,1195,2447,五權,簡易
2020-10-07,3310,1317,1273,2590,五權,簡易
2020-10-08,3310,1638,1563,3201,五權,簡易
2020-10-09,3310,1764,1498,3262,五權,簡易
2020-10-10,3310,1470,1430,2900,五權,簡易
2020-10-11,3310,1377,1763,3140,五權,簡易
2020-10-12,3310,1399,1338,2737,五權,簡易
2020-10-13,3310,1280,1263,2543,五權,簡易
2020-10-14,3310,1219,1227,2446,五權,簡易
2020-10-15,3310,1306,1234,2540,五權,簡易
2020-10-16,3310,1635,1595,3230,五權,簡易
2020-10-17,3310,1569,1422,2991,五權,簡易
2020-10-18,3310,1580,1726,3306,五權,簡易
2020-10-19,3310,1349,1335,2684,五權,簡易
2020-10-20,3310,1281,1251,2532,五權,簡易
2020-10-21,3310,1324,1288,2612,五權,簡易
2020-10-22,3310,1258,1259,2517,五權,簡易
2020-10-23,3310,1719,1600,3319,五權,簡易
2020-10-24,3310,1699,1490,3189,五權,簡易
2020-10-25,3310,1478,1766,3244,五權,簡易
2020-10-26,3310,1420,1382,2802,五權,簡易
2020-10-27,3310,1237,1232,2469,五權,簡易
2020-10-28,3310,1309,1292,2601,五權,簡易
2020-10-29,3310,1283,1217,2500,五權,簡易
2020-10-30,3310,1645,1568,3213,五權,簡易
2020-10-31,3310,1596,1458,3054,五權,簡易
2020-11-01,3310,1501,1688,3189,五權,簡易
2020-11-02,3310,1330,1286,2616,五權,簡易
2020-11-03,3310,1277,1276,2553,五權,簡易
2020-11-04,3310,1291,1250,2541,五權,簡易
2020-11-05,3310,1261,1237,2498,五權,簡易
2020-11-06,3310,1712,1602,3314,五權,簡易
2020-11-07,3310,1691,1448,3139,五權,簡易
2020-11-08,3310,1443,1732,3175,五權,簡易
2020-11-09,3310,1371,1281,2652,五權,簡易
2020-11-10,3310,1245,1248,2493,五權,簡易
2020-11-11,3310,1277,1213,2490,五權,簡易
2020-11-12,3310,1350,1354,2704,五權,簡易
2020-11-13,3310,1728,1734,3462,五權,簡易
2020-11-14,3310,1779,1594,3373,五權,簡易
2020-11-15,3310,1653,1897,3550,五權,簡易
2020-11-16,3310,1497,1469,2966,五權,簡易
2020-11-17,3310,1477,1411,2888,五權,簡易
2020-11-18,3310,1463,1389,2852,五權,簡易
2020-11-19,3310,1437,1432,2869,五權,簡易
2020-11-20,3310,1903,1868,3771,五權,簡易
2020-11-21,3310,2013,1785,3798,五權,簡易
2020-11-22,3310,1765,1987,3752,五權,簡易
2020-11-23,3310,1484,1437,2921,五權,簡易
2020-11-24,3310,1410,1380,2790,五權,簡易
2020-11-25,3310,1404,1351,2755,五權,簡易
2020-11-26,3310,1371,1371,2742,五權,簡易
2020-11-27,3310,1802,1650,3452,五權,簡易
2020-11-28,3310,1784,1637,3421,五權,簡易
2020-11-29,3310,1547,1833,3380,五權,簡易
2020-11-30,3310,1408,1439,2847,五權,簡易
2020-12-01,3310,1322,1253,2575,五權,簡易
2020-12-02,3310,1322,1288,2610,五權,簡易
2020-12-03,3310,1364,1323,2687,五權,簡易
2020-12-04,3310,1713,1712,3425,五權,簡易
2020-12-05,3310,1613,1510,3123,五權,簡易
2020-12-06,3310,1593,1864,3457,五權,簡易
2020-12-07,3310,1424,1407,2831,五權,簡易
2020-12-08,3310,1272,1291,2563,五權,簡易
2020-12-09,3310,1204,1196,2400,五權,簡易
2020-12-10,3310,1298,1314,2612,五權,簡易
2020-12-11,3310,1796,1750,3546,五權,簡易
2020-12-12,3310,1735,1523,3258,五權,簡易
2020-12-13,3310,1518,1778,3296,五權,簡易
2020-12-14,3310,1410,1379,2789,五權,簡易
2020-12-15,3310,1306,1294,2600,五權,簡易
2020-12-16,3310,1283,1270,2553,五權,簡易
2020-12-17,3310,1369,1374,2743,五權,簡易
2020-12-18,3310,1751,1692,3443,五權,簡易
2020-12-19,3310,1834,1646,3480,五權,簡易
2020-12-20,3310,1527,1859,3386,五權,簡易
2020-12-21,3310,1321,1288,2609,五權,簡易
2020-12-22,3310,1292,1297,2589,五權,簡易
2020-12-23,3310,1121,1102,2223,五權,簡易
2020-12-24,3310,1303,1302,2605,五權,簡易
2020-12-25,3310,1673,1731,3404,五權,簡易
2020-12-26,3310,1774,1466,3240,五權,簡易
2020-12-27,3310,1461,1725,3186,五權,簡易
2020-12-28,3310,1374,1303,2677,五權,簡易
2020-12-29,3310,1297,1305,2602,五權,簡易
2020-12-30,3310,1248,1253,2501,五權,簡易
2020-12-31,3310,1688,1695,3383,五權,簡易
2020-01-01,3320,2692,2634,5326,大慶,簡易
2020-01-02,3320,2937,2875,5812,大慶,簡易
2020-01-03,3320,3533,3217,6750,大慶,簡易
2020-01-04,3320,2872,2524,5396,大慶,簡易
2020-01-05,3320,2432,2626,5058,大慶,簡易
2020-01-06,3320,2869,2903,5772,大慶,簡易
2020-01-07,3320,2875,2814,5689,大慶,簡易
2020-01-08,3320,2970,2888,5858,大慶,簡易
2020-01-09,3320,3159,2848,6007,大慶,簡易
2020-01-10,3320,4612,3422,8034,大慶,簡易
2020-01-11,3320,3392,2922,6314,大慶,簡易
2020-01-12,3320,2502,3156,5658,大慶,簡易
2020-01-13,3320,2917,2998,5915,大慶,簡易
2020-01-14,3320,2818,2763,5581,大慶,簡易
2020-01-15,3320,3002,2831,5833,大慶,簡易
2020-01-16,3320,3113,2923,6036,大慶,簡易
2020-01-17,3320,3118,3009,6127,大慶,簡易
2020-01-18,3320,2714,2482,5196,大慶,簡易
2020-01-19,3320,2285,2433,4718,大慶,簡易
2020-01-20,3320,2872,2884,5756,大慶,簡易
2020-01-21,3320,2867,2792,5659,大慶,簡易
2020-01-22,3320,3059,2900,5959,大慶,簡易
2020-01-23,3320,2833,2027,4860,大慶,簡易
2020-01-24,3320,2066,1307,3373,大慶,簡易
2020-01-25,3320,1761,1839,3600,大慶,簡易
2020-01-26,3320,1429,1518,2947,大慶,簡易
2020-01-27,3320,2126,2379,4505,大慶,簡易
2020-01-28,3320,2096,2462,4558,大慶,簡易
2020-01-29,3320,1937,2230,4167,大慶,簡易
2020-01-30,3320,2246,2217,4463,大慶,簡易
2020-01-31,3320,2437,2478,4915,大慶,簡易
2020-02-01,3320,1879,1724,3603,大慶,簡易
2020-02-02,3320,1823,2015,3838,大慶,簡易
2020-02-03,3320,2430,2447,4877,大慶,簡易
2020-02-04,3320,2410,2330,4740,大慶,簡易
2020-02-05,3320,2533,2445,4978,大慶,簡易
2020-02-06,3320,2416,2479,4895,大慶,簡易
2020-02-07,3320,2955,2846,5801,大慶,簡易
2020-02-08,3320,2717,2395,5112,大慶,簡易
2020-02-09,3320,2531,2835,5366,大慶,簡易
2020-02-10,3320,2871,2902,5773,大慶,簡易
2020-02-11,3320,2716,2619,5335,大慶,簡易
2020-02-12,3320,2802,2881,5683,大慶,簡易
2020-02-13,3320,2642,2644,5286,大慶,簡易
2020-02-14,3320,2944,2925,5869,大慶,簡易
2020-02-15,3320,3200,3134,6334,大慶,簡易
2020-02-16,3320,2283,2333,4616,大慶,簡易
2020-02-17,3320,2546,2613,5159,大慶,簡易
2020-02-18,3320,2543,2597,5140,大慶,簡易
2020-02-19,3320,2848,2829,5677,大慶,簡易
2020-02-20,3320,2822,2822,5644,大慶,簡易
2020-02-21,3320,3128,3113,6241,大慶,簡易
2020-02-22,3320,3170,3145,6315,大慶,簡易
2020-02-23,3320,2765,2842,5607,大慶,簡易
2020-02-24,3320,2450,2538,4988,大慶,簡易
2020-02-25,3320,2391,2352,4743,大慶,簡易
2020-02-26,3320,2554,2493,5047,大慶,簡易
2020-02-27,3320,3150,2795,5945,大慶,簡易
2020-02-28,3320,2464,2105,4569,大慶,簡易
2020-02-29,3320,1972,1872,3844,大慶,簡易
2020-03-01,3320,1846,2580,4426,大慶,簡易
2020-03-02,3320,2612,2664,5276,大慶,簡易
2020-03-03,3320,2508,2467,4975,大慶,簡易
2020-03-04,3320,2516,2476,4992,大慶,簡易
2020-03-05,3320,2415,2253,4668,大慶,簡易
2020-03-06,3320,3424,2942,6366,大慶,簡易
2020-03-07,3320,2189,1905,4094,大慶,簡易
2020-03-08,3320,1959,2369,4328,大慶,簡易
2020-03-09,3320,2570,2751,5321,大慶,簡易
2020-03-10,3320,2430,2360,4790,大慶,簡易
2020-03-11,3320,2572,2491,5063,大慶,簡易
2020-03-12,3320,2536,2436,4972,大慶,簡易
2020-03-13,3320,3555,2964,6519,大慶,簡易
2020-03-14,3320,2127,1720,3847,大慶,簡易
2020-03-15,3320,1875,2480,4355,大慶,簡易
2020-03-16,3320,2594,2790,5384,大慶,簡易
2020-03-17,3320,2514,2444,4958,大慶,簡易
2020-03-18,3320,2423,2409,4832,大慶,簡易
2020-03-19,3320,2418,2270,4688,大慶,簡易
2020-03-20,3320,3330,2754,6084,大慶,簡易
2020-03-21,3320,1904,1544,3448,大慶,簡易
2020-03-22,3320,1619,2070,3689,大慶,簡易
2020-03-23,3320,2381,2546,4927,大慶,簡易
2020-03-24,3320,2335,2301,4636,大慶,簡易
2020-03-25,3320,2335,2281,4616,大慶,簡易
2020-03-26,3320,2319,2238,4557,大慶,簡易
2020-03-27,3320,2950,2586,5536,大慶,簡易
2020-03-28,3320,1720,1404,3124,大慶,簡易
2020-03-29,3320,1375,1759,3134,大慶,簡易
2020-03-30,3320,2305,2405,4710,大慶,簡易
2020-03-31,3320,2307,2225,4532,大慶,簡易
2020-04-01,3320,3564,2565,6129,大慶,簡易
2020-04-02,3320,2039,1463,3502,大慶,簡易
2020-04-03,3320,1606,1358,2964,大慶,簡易
2020-04-04,3320,1131,1154,2285,大慶,簡易
2020-04-05,3320,1170,2168,3338,大慶,簡易
2020-04-06,3320,2242,2504,4746,大慶,簡易
2020-04-07,3320,2117,2089,4206,大慶,簡易
2020-04-08,3320,2156,2121,4277,大慶,簡易
2020-04-09,3320,2243,2093,4336,大慶,簡易
2020-04-10,3320,2873,2513,5386,大慶,簡易
2020-04-11,3320,1683,1405,3088,大慶,簡易
2020-04-12,3320,1523,1846,3369,大慶,簡易
2020-04-13,3320,2299,2366,4665,大慶,簡易
2020-04-14,3320,2212,2130,4342,大慶,簡易
2020-04-15,3320,2277,2256,4533,大慶,簡易
2020-04-16,3320,2291,2218,4509,大慶,簡易
2020-04-17,3320,3160,2585,5745,大慶,簡易
2020-04-18,3320,1991,1730,3721,大慶,簡易
2020-04-19,3320,1565,2074,3639,大慶,簡易
2020-04-20,3320,2386,2494,4880,大慶,簡易
2020-04-21,3320,2143,2143,4286,大慶,簡易
2020-04-22,3320,2179,2061,4240,大慶,簡易
2020-04-23,3320,2137,2040,4177,大慶,簡易
2020-04-24,3320,2744,2415,5159,大慶,簡易
2020-04-25,3320,1731,1556,3287,大慶,簡易
2020-04-26,3320,1418,1672,3090,大慶,簡易
2020-04-27,3320,2232,2274,4506,大慶,簡易
2020-04-28,3320,2276,2214,4490,大慶,簡易
2020-04-29,3320,2236,2175,4411,大慶,簡易
2020-04-30,3320,2516,2387,4903,大慶,簡易
2020-05-01,3320,2977,2278,5255,大慶,簡易
2020-05-02,3320,1814,1608,3422,大慶,簡易
2020-05-03,3320,1596,2029,3625,大慶,簡易
2020-05-04,3320,2454,2620,5074,大慶,簡易
2020-05-05,3320,2318,2271,4589,大慶,簡易
2020-05-06,3320,2369,2320,4689,大慶,簡易
2020-05-07,3320,2540,2297,4837,大慶,簡易
2020-05-08,3320,3708,2847,6555,大慶,簡易
2020-05-09,3320,2260,1700,3960,大慶,簡易
2020-05-10,3320,1602,2401,4003,大慶,簡易
2020-05-11,3320,2443,2762,5205,大慶,簡易
2020-05-12,3320,2439,2414,4853,大慶,簡易
2020-05-13,3320,2465,2450,4915,大慶,簡易
2020-05-14,3320,2503,2382,4885,大慶,簡易
2020-05-15,3320,3191,2876,6067,大慶,簡易
2020-05-16,3320,2004,1675,3679,大慶,簡易
2020-05-17,3320,1693,2059,3752,大慶,簡易
2020-05-18,3320,2397,2508,4905,大慶,簡易
2020-05-19,3320,2194,2164,4358,大慶,簡易
2020-05-20,3320,2315,2280,4595,大慶,簡易
2020-05-21,3320,2419,2283,4702,大慶,簡易
2020-05-22,3320,3030,2453,5483,大慶,簡易
2020-05-23,3320,1892,1669,3561,大慶,簡易
2020-05-24,3320,1806,2255,4061,大慶,簡易
2020-05-25,3320,2560,2703,5263,大慶,簡易
2020-05-26,3320,2322,2355,4677,大慶,簡易
2020-05-27,3320,2314,2190,4504,大慶,簡易
2020-05-28,3320,2361,2266,4627,大慶,簡易
2020-05-29,3320,3339,2793,6132,大慶,簡易
2020-05-30,3320,2213,1883,4096,大慶,簡易
2020-05-31,3320,1913,2316,4229,大慶,簡易
2020-06-01,3320,2654,2834,5488,大慶,簡易
2020-06-02,3320,2443,2447,4890,大慶,簡易
2020-06-03,3320,2453,2381,4834,大慶,簡易
2020-06-04,3320,2525,2475,5000,大慶,簡易
2020-06-05,3320,3419,2955,6374,大慶,簡易
2020-06-06,3320,2560,2242,4802,大慶,簡易
2020-06-07,3320,1924,2313,4237,大慶,簡易
2020-06-08,3320,2509,2679,5188,大慶,簡易
2020-06-09,3320,2433,2458,4891,大慶,簡易
2020-06-10,3320,2532,2475,5007,大慶,簡易
2020-06-11,3320,2679,2571,5250,大慶,簡易
2020-06-12,3320,3415,3079,6494,大慶,簡易
2020-06-13,3320,2462,2222,4684,大慶,簡易
2020-06-14,3320,1854,2197,4051,大慶,簡易
2020-06-15,3320,2606,2695,5301,大慶,簡易
2020-06-16,3320,2586,2488,5074,大慶,簡易
2020-06-17,3320,2547,2543,5090,大慶,簡易
2020-06-18,3320,2587,2542,5129,大慶,簡易
2020-06-19,3320,2775,2674,5449,大慶,簡易
2020-06-20,3320,2591,2380,4971,大慶,簡易
2020-06-21,3320,1975,2083,4058,大慶,簡易
2020-06-22,3320,2626,2619,5245,大慶,簡易
2020-06-23,3320,2635,2634,5269,大慶,簡易
2020-06-24,3320,3564,3020,6584,大慶,簡易
2020-06-25,3320,2667,1968,4635,大慶,簡易
2020-06-26,3320,2487,2383,4870,大慶,簡易
2020-06-27,3320,2025,2148,4173,大慶,簡易
2020-06-28,3320,1931,2481,4412,大慶,簡易
2020-06-29,3320,2628,2683,5311,大慶,簡易
2020-06-30,3320,2549,2535,5084,大慶,簡易
2020-07-01,3320,2299,2362,4661,大慶,簡易
2020-07-02,3320,2353,2340,4693,大慶,簡易
2020-07-03,3320,2884,2734,5618,大慶,簡易
2020-07-04,3320,2276,1947,4223,大慶,簡易
2020-07-05,3320,1915,2207,4122,大慶,簡易
2020-07-06,3320,2642,2621,5263,大慶,簡易
2020-07-07,3320,2610,2550,5160,大慶,簡易
2020-07-08,3320,2617,2601,5218,大慶,簡易
2020-07-09,3320,2532,2526,5058,大慶,簡易
2020-07-10,3320,2998,2736,5734,大慶,簡易
2020-07-11,3320,2544,2247,4791,大慶,簡易
2020-07-12,3320,2233,2509,4742,大慶,簡易
2020-07-13,3320,2706,2805,5511,大慶,簡易
2020-07-14,3320,2740,2710,5450,大慶,簡易
2020-07-15,3320,2788,2659,5447,大慶,簡易
2020-07-16,3320,2623,2660,5283,大慶,簡易
2020-07-17,3320,2929,2903,5832,大慶,簡易
2020-07-18,3320,2533,2365,4898,大慶,簡易
2020-07-19,3320,2160,2254,4414,大慶,簡易
2020-07-20,3320,2679,2757,5436,大慶,簡易
2020-07-21,3320,2607,2621,5228,大慶,簡易
2020-07-22,3320,2779,2749,5528,大慶,簡易
2020-07-23,3320,2656,2533,5189,大慶,簡易
2020-07-24,3320,3041,2879,5920,大慶,簡易
2020-07-25,3320,2565,2411,4976,大慶,簡易
2020-07-26,3320,2099,2383,4482,大慶,簡易
2020-07-27,3320,2612,2569,5181,大慶,簡易
2020-07-28,3320,2536,2486,5022,大慶,簡易
2020-07-29,3320,2506,2581,5087,大慶,簡易
2020-07-30,3320,2681,2733,5414,大慶,簡易
2020-07-31,3320,3043,2992,6035,大慶,簡易
2020-08-01,3320,2408,2182,4590,大慶,簡易
2020-08-02,3320,2088,2360,4448,大慶,簡易
2020-08-03,3320,2395,2444,4839,大慶,簡易
2020-08-04,3320,2471,2398,4869,大慶,簡易
2020-08-05,3320,2530,2589,5119,大慶,簡易
2020-08-06,3320,2620,2573,5193,大慶,簡易
2020-08-07,3320,3186,2920,6106,大慶,簡易
2020-08-08,3320,2414,2029,4443,大慶,簡易
2020-08-09,3320,1989,2583,4572,大慶,簡易
2020-08-10,3320,2585,2657,5242,大慶,簡易
2020-08-11,3320,2387,2368,4755,大慶,簡易
2020-08-12,3320,2629,2624,5253,大慶,簡易
2020-08-13,3320,2647,2568,5215,大慶,簡易
2020-08-14,3320,3122,3059,6181,大慶,簡易
2020-08-15,3320,2604,2320,4924,大慶,簡易
2020-08-16,3320,2462,2696,5158,大慶,簡易
2020-08-17,3320,2791,2832,5623,大慶,簡易
2020-08-18,3320,2643,2607,5250,大慶,簡易
2020-08-19,3320,2710,2675,5385,大慶,簡易
2020-08-20,3320,2595,2610,5205,大慶,簡易
2020-08-21,3320,3111,3094,6205,大慶,簡易
2020-08-22,3320,2555,2310,4865,大慶,簡易
2020-08-23,3320,2029,2358,4387,大慶,簡易
2020-08-24,3320,2772,2820,5592,大慶,簡易
2020-08-25,3320,2663,2710,5373,大慶,簡易
2020-08-26,3320,2769,2667,5436,大慶,簡易
2020-08-27,3320,2498,2538,5036,大慶,簡易
2020-08-28,3320,2849,2820,5669,大慶,簡易
2020-08-29,3320,2681,2342,5023,大慶,簡易
2020-08-30,3320,2084,2288,4372,大慶,簡易
2020-08-31,3320,2450,2565,5015,大慶,簡易
2020-09-01,3320,2443,2389,4832,大慶,簡易
2020-09-02,3320,2378,2455,4833,大慶,簡易
2020-09-03,3320,2608,2578,5186,大慶,簡易
2020-09-04,3320,3259,3027,6286,大慶,簡易
2020-09-05,3320,2579,2356,4935,大慶,簡易
2020-09-06,3320,2171,2581,4752,大慶,簡易
2020-09-07,3320,2840,2813,5653,大慶,簡易
2020-09-08,3320,2744,2674,5418,大慶,簡易
2020-09-09,3320,2895,2673,5568,大慶,簡易
2020-09-10,3320,2849,2613,5462,大慶,簡易
2020-09-11,3320,3309,3060,6369,大慶,簡易
2020-09-12,3320,2977,2648,5625,大慶,簡易
2020-09-13,3320,2380,3040,5420,大慶,簡易
2020-09-14,3320,2733,2829,5562,大慶,簡易
2020-09-15,3320,2684,2709,5393,大慶,簡易
2020-09-16,3320,2731,2684,5415,大慶,簡易
2020-09-17,3320,2853,2786,5639,大慶,簡易
2020-09-18,3320,3700,3241,6941,大慶,簡易
2020-09-19,3320,2957,2612,5569,大慶,簡易
2020-09-20,3320,2505,3081,5586,大慶,簡易
2020-09-21,3320,2759,2872,5631,大慶,簡易
2020-09-22,3320,2734,2641,5375,大慶,簡易
2020-09-23,3320,2764,2731,5495,大慶,簡易
2020-09-24,3320,2766,2762,5528,大慶,簡易
2020-09-25,3320,3113,2929,6042,大慶,簡易
2020-09-26,3320,2742,2481,5223,大慶,簡易
2020-09-27,3320,2265,2509,4774,大慶,簡易
2020-09-28,3320,2685,2725,5410,大慶,簡易
2020-09-29,3320,2800,2737,5537,大慶,簡易
2020-09-30,3320,4491,3407,7898,大慶,簡易
2020-10-01,3320,3285,2301,5586,大慶,簡易
2020-10-02,3320,2716,2669,5385,大慶,簡易
2020-10-03,3320,2389,2444,4833,大慶,簡易
2020-10-04,3320,2204,3372,5576,大慶,簡易
2020-10-05,3320,2827,3065,5892,大慶,簡易
2020-10-06,3320,2754,2767,5521,大慶,簡易
2020-10-07,3320,2884,2697,5581,大慶,簡易
2020-10-08,3320,4022,3307,7329,大慶,簡易
2020-10-09,3320,2969,2569,5538,大慶,簡易
2020-10-10,3320,2310,2222,4532,大慶,簡易
2020-10-11,3320,2265,3061,5326,大慶,簡易
2020-10-12,3320,2825,2944,5769,大慶,簡易
2020-10-13,3320,2750,2758,5508,大慶,簡易
2020-10-14,3320,2789,2717,5506,大慶,簡易
2020-10-15,3320,2831,2732,5563,大慶,簡易
2020-10-16,3320,3737,3291,7028,大慶,簡易
2020-10-17,3320,3240,2942,6182,大慶,簡易
2020-10-18,3320,2359,2829,5188,大慶,簡易
2020-10-19,3320,2879,2968,5847,大慶,簡易
2020-10-20,3320,2766,2700,5466,大慶,簡易
2020-10-21,3320,2722,2654,5376,大慶,簡易
2020-10-22,3320,2858,2722,5580,大慶,簡易
2020-10-23,3320,3871,3200,7071,大慶,簡易
2020-10-24,3320,3280,2947,6227,大慶,簡易
2020-10-25,3320,2395,2973,5368,大慶,簡易
2020-10-26,3320,2852,3012,5864,大慶,簡易
2020-10-27,3320,2750,2721,5471,大慶,簡易
2020-10-28,3320,2777,2687,5464,大慶,簡易
2020-10-29,3320,2841,2722,5563,大慶,簡易
2020-10-30,3320,3604,3197,6801,大慶,簡易
2020-10-31,3320,2556,2334,4890,大慶,簡易
2020-11-01,3320,2378,2830,5208,大慶,簡易
2020-11-02,3320,2719,2713,5432,大慶,簡易
2020-11-03,3320,2632,2594,5226,大慶,簡易
2020-11-04,3320,2679,2574,5253,大慶,簡易
2020-11-05,3320,2808,2645,5453,大慶,簡易
2020-11-06,3320,4003,3239,7242,大慶,簡易
2020-11-07,3320,2739,2358,5097,大慶,簡易
2020-11-08,3320,2402,3193,5595,大慶,簡易
2020-11-09,3320,2731,2874,5605,大慶,簡易
2020-11-10,3320,2686,2651,5337,大慶,簡易
2020-11-11,3320,3092,2932,6024,大慶,簡易
2020-11-12,3320,2866,2768,5634,大慶,簡易
2020-11-13,3320,3902,3290,7192,大慶,簡易
2020-11-14,3320,3029,2711,5740,大慶,簡易
2020-11-15,3320,2583,3141,5724,大慶,簡易
2020-11-16,3320,3132,3180,6312,大慶,簡易
2020-11-17,3320,3007,2886,5893,大慶,簡易
2020-11-18,3320,3115,3001,6116,大慶,簡易
2020-11-19,3320,3078,2911,5989,大慶,簡易
2020-11-20,3320,4374,3691,8065,大慶,簡易
2020-11-21,3320,4695,4467,9162,大慶,簡易
2020-11-22,3320,2999,3574,6573,大慶,簡易
2020-11-23,3320,3044,3183,6227,大慶,簡易
2020-11-24,3320,2885,2880,5765,大慶,簡易
2020-11-25,3320,2945,2886,5831,大慶,簡易
2020-11-26,3320,2990,2856,5846,大慶,簡易
2020-11-27,3320,4092,3406,7498,大慶,簡易
2020-11-28,3320,2860,2526,5386,大慶,簡易
2020-11-29,3320,2551,3247,5798,大慶,簡易
2020-11-30,3320,2899,3076,5975,大慶,簡易
2020-12-01,3320,2754,2760,5514,大慶,簡易
2020-12-02,3320,2808,2782,5590,大慶,簡易
2020-12-03,3320,2784,2725,5509,大慶,簡易
2020-12-04,3320,4210,3424,7634,大慶,簡易
2020-12-05,3320,2843,2687,5530,大慶,簡易
2020-12-06,3320,2786,3480,6266,大慶,簡易
2020-12-07,3320,2930,3048,5978,大慶,簡易
2020-12-08,3320,2767,2703,5470,大慶,簡易
2020-12-09,3320,2669,2594,5263,大慶,簡易
2020-12-10,3320,2816,2685,5501,大慶,簡易
2020-12-11,3320,4146,3386,7532,大慶,簡易
2020-12-12,3320,3049,2685,5734,大慶,簡易
2020-12-13,3320,2744,3299,6043,大慶,簡易
2020-12-14,3320,2943,3048,5991,大慶,簡易
2020-12-15,3320,2829,2772,5601,大慶,簡易
2020-12-16,3320,2857,2786,5643,大慶,簡易
2020-12-17,3320,2985,2819,5804,大慶,簡易
2020-12-18,3320,4059,3402,7461,大慶,簡易
2020-12-19,3320,3113,2712,5825,大慶,簡易
2020-12-20,3320,2534,3249,5783,大慶,簡易
2020-12-21,3320,2789,2970,5759,大慶,簡易
2020-12-22,3320,2762,2826,5588,大慶,簡易
2020-12-23,3320,2477,2295,4772,大慶,簡易
2020-12-24,3320,2867,2762,5629,大慶,簡易
2020-12-25,3320,3965,3455,7420,大慶,簡易
2020-12-26,3320,2854,2576,5430,大慶,簡易
2020-12-27,3320,2235,2712,4947,大慶,簡易
2020-12-28,3320,2875,3000,5875,大慶,簡易
2020-12-29,3320,2786,2747,5533,大慶,簡易
2020-12-30,3320,2849,2794,5643,大慶,簡易
2020-12-31,3320,4131,3350,7481,大慶,簡易
2020-01-01,3330,941,918,1859,烏日,簡易
2020-01-02,3330,708,764,1472,烏日,簡易
2020-01-03,3330,723,755,1478,烏日,簡易
2020-01-04,3330,946,900,1846,烏日,簡易
2020-01-05,3330,998,1029,2027,烏日,簡易
2020-01-06,3330,661,714,1375,烏日,簡易
2020-01-07,3330,637,652,1289,烏日,簡易
2020-01-08,3330,653,690,1343,烏日,簡易
2020-01-09,3330,631,682,1313,烏日,簡易
2020-01-10,3330,837,929,1766,烏日,簡易
2020-01-11,3330,1191,1164,2355,烏日,簡易
2020-01-12,3330,1444,1365,2809,烏日,簡易
2020-01-13,3330,705,809,1514,烏日,簡易
2020-01-14,3330,662,692,1354,烏日,簡易
2020-01-15,3330,678,682,1360,烏日,簡易
2020-01-16,3330,782,789,1571,烏日,簡易
2020-01-17,3330,747,775,1522,烏日,簡易
2020-01-18,3330,969,932,1901,烏日,簡易
2020-01-19,3330,1070,1056,2126,烏日,簡易
2020-01-20,3330,739,803,1542,烏日,簡易
2020-01-21,3330,637,652,1289,烏日,簡易
2020-01-22,3330,737,820,1557,烏日,簡易
2020-01-23,3330,1061,1031,2092,烏日,簡易
2020-01-24,3330,1147,1065,2212,烏日,簡易
2020-01-25,3330,1297,1256,2553,烏日,簡易
2020-01-26,3330,1085,1173,2258,烏日,簡易
2020-01-27,3330,1400,1491,2891,烏日,簡易
2020-01-28,3330,1134,1210,2344,烏日,簡易
2020-01-29,3330,934,952,1886,烏日,簡易
2020-01-30,3330,595,578,1173,烏日,簡易
2020-01-31,3330,614,655,1269,烏日,簡易
2020-02-01,3330,702,737,1439,烏日,簡易
2020-02-02,3330,896,883,1779,烏日,簡易
2020-02-03,3330,538,562,1100,烏日,簡易
2020-02-04,3330,498,557,1055,烏日,簡易
2020-02-05,3330,530,567,1097,烏日,簡易
2020-02-06,3330,502,499,1001,烏日,簡易
2020-02-07,3330,651,717,1368,烏日,簡易
2020-02-08,3330,910,864,1774,烏日,簡易
2020-02-09,3330,987,1019,2006,烏日,簡易
2020-02-10,3330,656,731,1387,烏日,簡易
2020-02-11,3330,654,650,1304,烏日,簡易
2020-02-12,3330,727,768,1495,烏日,簡易
2020-02-13,3330,564,586,1150,烏日,簡易
2020-02-14,3330,690,723,1413,烏日,簡易
2020-02-15,3330,1081,1085,2166,烏日,簡易
2020-02-16,3330,1126,1147,2273,烏日,簡易
2020-02-17,3330,560,663,1223,烏日,簡易
2020-02-18,3330,542,558,1100,烏日,簡易
2020-02-19,3330,626,660,1286,烏日,簡易
2020-02-20,3330,594,626,1220,烏日,簡易
2020-02-21,3330,830,873,1703,烏日,簡易
2020-02-22,3330,1028,1010,2038,烏日,簡易
2020-02-23,3330,1111,1134,2245,烏日,簡易
2020-02-24,3330,581,605,1186,烏日,簡易
2020-02-25,3330,548,590,1138,烏日,簡易
2020-02-26,3330,570,575,1145,烏日,簡易
2020-02-27,3330,702,776,1478,烏日,簡易
2020-02-28,3330,706,741,1447,烏日,簡易
2020-02-29,3330,815,764,1579,烏日,簡易
2020-03-01,3330,960,888,1848,烏日,簡易
2020-03-02,3330,605,638,1243,烏日,簡易
2020-03-03,3330,595,602,1197,烏日,簡易
2020-03-04,3330,545,570,1115,烏日,簡易
2020-03-05,3330,547,581,1128,烏日,簡易
2020-03-06,3330,688,774,1462,烏日,簡易
2020-03-07,3330,749,766,1515,烏日,簡易
2020-03-08,3330,888,908,1796,烏日,簡易
2020-03-09,3330,631,624,1255,烏日,簡易
2020-03-10,3330,508,566,1074,烏日,簡易
2020-03-11,3330,584,607,1191,烏日,簡易
2020-03-12,3330,581,600,1181,烏日,簡易
2020-03-13,3330,674,794,1468,烏日,簡易
2020-03-14,3330,832,798,1630,烏日,簡易
2020-03-15,3330,1139,1063,2202,烏日,簡易
2020-03-16,3330,594,624,1218,烏日,簡易
2020-03-17,3330,545,566,1111,烏日,簡易
2020-03-18,3330,541,550,1091,烏日,簡易
2020-03-19,3330,491,500,991,烏日,簡易
2020-03-20,3330,614,686,1300,烏日,簡易
2020-03-21,3330,706,648,1354,烏日,簡易
2020-03-22,3330,785,776,1561,烏日,簡易
2020-03-23,3330,558,556,1114,烏日,簡易
2020-03-24,3330,491,518,1009,烏日,簡易
2020-03-25,3330,495,527,1022,烏日,簡易
2020-03-26,3330,502,515,1017,烏日,簡易
2020-03-27,3330,605,660,1265,烏日,簡易
2020-03-28,3330,568,594,1162,烏日,簡易
2020-03-29,3330,595,558,1153,烏日,簡易
2020-03-30,3330,551,589,1140,烏日,簡易
2020-03-31,3330,507,552,1059,烏日,簡易
2020-04-01,3330,599,657,1256,烏日,簡易
2020-04-02,3330,514,522,1036,烏日,簡易
2020-04-03,3330,542,554,1096,烏日,簡易
2020-04-04,3330,560,542,1102,烏日,簡易
2020-04-05,3330,655,578,1233,烏日,簡易
2020-04-06,3330,534,528,1062,烏日,簡易
2020-04-07,3330,468,494,962,烏日,簡易
2020-04-08,3330,452,476,928,烏日,簡易
2020-04-09,3330,486,475,961,烏日,簡易
2020-04-10,3330,587,633,1220,烏日,簡易
2020-04-11,3330,649,627,1276,烏日,簡易
2020-04-12,3330,765,817,1582,烏日,簡易
2020-04-13,3330,539,526,1065,烏日,簡易
2020-04-14,3330,504,512,1016,烏日,簡易
2020-04-15,3330,523,496,1019,烏日,簡易
2020-04-16,3330,476,497,973,烏日,簡易
2020-04-17,3330,577,698,1275,烏日,簡易
2020-04-18,3330,648,650,1298,烏日,簡易
2020-04-19,3330,790,782,1572,烏日,簡易
2020-04-20,3330,512,516,1028,烏日,簡易
2020-04-21,3330,470,484,954,烏日,簡易
2020-04-22,3330,476,494,970,烏日,簡易
2020-04-23,3330,461,471,932,烏日,簡易
2020-04-24,3330,531,595,1126,烏日,簡易
2020-04-25,3330,516,583,1099,烏日,簡易
2020-04-26,3330,659,631,1290,烏日,簡易
2020-04-27,3330,502,480,982,烏日,簡易
2020-04-28,3330,473,491,964,烏日,簡易
2020-04-29,3330,483,475,958,烏日,簡易
2020-04-30,3330,558,591,1149,烏日,簡易
2020-05-01,3330,702,775,1477,烏日,簡易
2020-05-02,3330,729,737,1466,烏日,簡易
2020-05-03,3330,775,698,1473,烏日,簡易
2020-05-04,3330,551,523,1074,烏日,簡易
2020-05-05,3330,511,515,1026,烏日,簡易
2020-05-06,3330,508,517,1025,烏日,簡易
2020-05-07,3330,517,536,1053,烏日,簡易
2020-05-08,3330,688,780,1468,烏日,簡易
2020-05-09,3330,781,780,1561,烏日,簡易
2020-05-10,3330,959,928,1887,烏日,簡易
2020-05-11,3330,619,603,1222,烏日,簡易
2020-05-12,3330,551,521,1072,烏日,簡易
2020-05-13,3330,533,510,1043,烏日,簡易
2020-05-14,3330,511,531,1042,烏日,簡易
2020-05-15,3330,645,709,1354,烏日,簡易
2020-05-16,3330,764,728,1492,烏日,簡易
2020-05-17,3330,908,849,1757,烏日,簡易
2020-05-18,3330,567,540,1107,烏日,簡易
2020-05-19,3330,447,453,900,烏日,簡易
2020-05-20,3330,520,515,1035,烏日,簡易
2020-05-21,3330,479,498,977,烏日,簡易
2020-05-22,3330,533,634,1167,烏日,簡易
2020-05-23,3330,711,734,1445,烏日,簡易
2020-05-24,3330,1021,971,1992,烏日,簡易
2020-05-25,3330,597,620,1217,烏日,簡易
2020-05-26,3330,527,523,1050,烏日,簡易
2020-05-27,3330,468,509,977,烏日,簡易
2020-05-28,3330,488,529,1017,烏日,簡易
2020-05-29,3330,650,793,1443,烏日,簡易
2020-05-30,3330,811,772,1583,烏日,簡易
2020-05-31,3330,920,910,1830,烏日,簡易
2020-06-01,3330,590,574,1164,烏日,簡易
2020-06-02,3330,593,585,1178,烏日,簡易
2020-06-03,3330,532,552,1084,烏日,簡易
2020-06-04,3330,557,556,1113,烏日,簡易
2020-06-05,3330,707,779,1486,烏日,簡易
2020-06-06,3330,841,814,1655,烏日,簡易
2020-06-07,3330,959,913,1872,烏日,簡易
2020-06-08,3330,556,579,1135,烏日,簡易
2020-06-09,3330,530,547,1077,烏日,簡易
2020-06-10,3330,627,623,1250,烏日,簡易
2020-06-11,3330,589,607,1196,烏日,簡易
2020-06-12,3330,749,820,1569,烏日,簡易
2020-06-13,3330,984,993,1977,烏日,簡易
2020-06-14,3330,1069,1037,2106,烏日,簡易
2020-06-15,3330,622,644,1266,烏日,簡易
2020-06-16,3330,620,602,1222,烏日,簡易
2020-06-17,3330,590,578,1168,烏日,簡易
2020-06-18,3330,564,599,1163,烏日,簡易
2020-06-19,3330,650,705,1355,烏日,簡易
2020-06-20,3330,815,890,1705,烏日,簡易
2020-06-21,3330,922,922,1844,烏日,簡易
2020-06-22,3330,585,611,1196,烏日,簡易
2020-06-23,3330,589,602,1191,烏日,簡易
2020-06-24,3330,705,773,1478,烏日,簡易
2020-06-25,3330,858,823,1681,烏日,簡易
2020-06-26,3330,930,875,1805,烏日,簡易
2020-06-27,3330,1029,1012,2041,烏日,簡易
2020-06-28,3330,1091,1113,2204,烏日,簡易
2020-06-29,3330,673,642,1315,烏日,簡易
2020-06-30,3330,590,605,1195,烏日,簡易
2020-07-01,3330,603,573,1176,烏日,簡易
2020-07-02,3330,584,609,1193,烏日,簡易
2020-07-03,3330,630,671,1301,烏日,簡易
2020-07-04,3330,818,732,1550,烏日,簡易
2020-07-05,3330,869,895,1764,烏日,簡易
2020-07-06,3330,660,677,1337,烏日,簡易
2020-07-07,3330,672,641,1313,烏日,簡易
2020-07-08,3330,622,611,1233,烏日,簡易
2020-07-09,3330,609,659,1268,烏日,簡易
2020-07-10,3330,793,790,1583,烏日,簡易
2020-07-11,3330,1042,972,2014,烏日,簡易
2020-07-12,3330,1121,1182,2303,烏日,簡易
2020-07-13,3330,608,667,1275,烏日,簡易
2020-07-14,3330,610,619,1229,烏日,簡易
2020-07-15,3330,590,585,1175,烏日,簡易
2020-07-16,3330,643,618,1261,烏日,簡易
2020-07-17,3330,728,763,1491,烏日,簡易
2020-07-18,3330,933,939,1872,烏日,簡易
2020-07-19,3330,1105,1149,2254,烏日,簡易
2020-07-20,3330,638,689,1327,烏日,簡易
2020-07-21,3330,595,617,1212,烏日,簡易
2020-07-22,3330,593,619,1212,烏日,簡易
2020-07-23,3330,600,630,1230,烏日,簡易
2020-07-24,3330,740,774,1514,烏日,簡易
2020-07-25,3330,912,895,1807,烏日,簡易
2020-07-26,3330,939,924,1863,烏日,簡易
2020-07-27,3330,610,657,1267,烏日,簡易
2020-07-28,3330,557,575,1132,烏日,簡易
2020-07-29,3330,617,630,1247,烏日,簡易
2020-07-30,3330,636,635,1271,烏日,簡易
2020-07-31,3330,739,804,1543,烏日,簡易
2020-08-01,3330,823,777,1600,烏日,簡易
2020-08-02,3330,914,957,1871,烏日,簡易
2020-08-03,3330,614,613,1227,烏日,簡易
2020-08-04,3330,585,565,1150,烏日,簡易
2020-08-05,3330,630,623,1253,烏日,簡易
2020-08-06,3330,593,647,1240,烏日,簡易
2020-08-07,3330,728,740,1468,烏日,簡易
2020-08-08,3330,878,841,1719,烏日,簡易
2020-08-09,3330,972,1029,2001,烏日,簡易
2020-08-10,3330,664,729,1393,烏日,簡易
2020-08-11,3330,591,599,1190,烏日,簡易
2020-08-12,3330,566,630,1196,烏日,簡易
2020-08-13,3330,583,585,1168,烏日,簡易
2020-08-14,3330,770,792,1562,烏日,簡易
2020-08-15,3330,1048,1017,2065,烏日,簡易
2020-08-16,3330,1119,1177,2296,烏日,簡易
2020-08-17,3330,641,728,1369,烏日,簡易
2020-08-18,3330,614,613,1227,烏日,簡易
2020-08-19,3330,616,598,1214,烏日,簡易
2020-08-20,3330,646,608,1254,烏日,簡易
2020-08-21,3330,788,837,1625,烏日,簡易
2020-08-22,3330,857,816,1673,烏日,簡易
2020-08-23,3330,959,974,1933,烏日,簡易
2020-08-24,3330,659,706,1365,烏日,簡易
2020-08-25,3330,611,578,1189,烏日,簡易
2020-08-26,3330,607,626,1233,烏日,簡易
2020-08-27,3330,576,583,1159,烏日,簡易
2020-08-28,3330,660,752,1412,烏日,簡易
2020-08-29,3330,775,809,1584,烏日,簡易
2020-08-30,3330,849,889,1738,烏日,簡易
2020-08-31,3330,624,639,1263,烏日,簡易
2020-09-01,3330,565,586,1151,烏日,簡易
2020-09-02,3330,560,529,1089,烏日,簡易
2020-09-03,3330,597,627,1224,烏日,簡易
2020-09-04,3330,688,742,1430,烏日,簡易
2020-09-05,3330,887,776,1663,烏日,簡易
2020-09-06,3330,950,976,1926,烏日,簡易
2020-09-07,3330,625,678,1303,烏日,簡易
2020-09-08,3330,597,607,1204,烏日,簡易
2020-09-09,3330,587,585,1172,烏日,簡易
2020-09-10,3330,607,623,1230,烏日,簡易
2020-09-11,3330,769,782,1551,烏日,簡易
2020-09-12,3330,1004,975,1979,烏日,簡易
2020-09-13,3330,1144,1141,2285,烏日,簡易
2020-09-14,3330,648,695,1343,烏日,簡易
2020-09-15,3330,590,612,1202,烏日,簡易
2020-09-16,3330,591,571,1162,烏日,簡易
2020-09-17,3330,630,623,1253,烏日,簡易
2020-09-18,3330,741,787,1528,烏日,簡易
2020-09-19,3330,1025,1014,2039,烏日,簡易
2020-09-20,3330,1132,1152,2284,烏日,簡易
2020-09-21,3330,627,627,1254,烏日,簡易
2020-09-22,3330,607,597,1204,烏日,簡易
2020-09-23,3330,602,615,1217,烏日,簡易
2020-09-24,3330,597,631,1228,烏日,簡易
2020-09-25,3330,616,686,1302,烏日,簡易
2020-09-26,3330,836,767,1603,烏日,簡易
2020-09-27,3330,967,947,1914,烏日,簡易
2020-09-28,3330,670,618,1288,烏日,簡易
2020-09-29,3330,594,613,1207,烏日,簡易
2020-09-30,3330,799,918,1717,烏日,簡易
2020-10-01,3330,948,1009,1957,烏日,簡易
2020-10-02,3330,972,1014,1986,烏日,簡易
2020-10-03,3330,1113,1163,2276,烏日,簡易
2020-10-04,3330,1107,1105,2212,烏日,簡易
2020-10-05,3330,695,609,1304,烏日,簡易
2020-10-06,3330,599,589,1188,烏日,簡易
2020-10-07,3330,618,590,1208,烏日,簡易
2020-10-08,3330,709,835,1544,烏日,簡易
2020-10-09,3330,900,869,1769,烏日,簡易
2020-10-10,3330,1052,1011,2063,烏日,簡易
2020-10-11,3330,1274,1322,2596,烏日,簡易
2020-10-12,3330,679,660,1339,烏日,簡易
2020-10-13,3330,641,633,1274,烏日,簡易
2020-10-14,3330,605,659,1264,烏日,簡易
2020-10-15,3330,638,654,1292,烏日,簡易
2020-10-16,3330,723,834,1557,烏日,簡易
2020-10-17,3330,1114,1157,2271,烏日,簡易
2020-10-18,3330,1430,1354,2784,烏日,簡易
2020-10-19,3330,653,626,1279,烏日,簡易
2020-10-20,3330,584,607,1191,烏日,簡易
2020-10-21,3330,613,616,1229,烏日,簡易
2020-10-22,3330,619,603,1222,烏日,簡易
2020-10-23,3330,711,811,1522,烏日,簡易
2020-10-24,3330,924,960,1884,烏日,簡易
2020-10-25,3330,1097,1096,2193,烏日,簡易
2020-10-26,3330,652,634,1286,烏日,簡易
2020-10-27,3330,582,580,1162,烏日,簡易
2020-10-28,3330,600,581,1181,烏日,簡易
2020-10-29,3330,595,607,1202,烏日,簡易
2020-10-30,3330,708,822,1530,烏日,簡易
2020-10-31,3330,881,910,1791,烏日,簡易
2020-11-01,3330,1072,1012,2084,烏日,簡易
2020-11-02,3330,632,614,1246,烏日,簡易
2020-11-03,3330,581,584,1165,烏日,簡易
2020-11-04,3330,580,576,1156,烏日,簡易
2020-11-05,3330,569,586,1155,烏日,簡易
2020-11-06,3330,651,728,1379,烏日,簡易
2020-11-07,3330,883,901,1784,烏日,簡易
2020-11-08,3330,1174,1125,2299,烏日,簡易
2020-11-09,3330,649,595,1244,烏日,簡易
2020-11-10,3330,603,597,1200,烏日,簡易
2020-11-11,3330,634,628,1262,烏日,簡易
2020-11-12,3330,639,614,1253,烏日,簡易
2020-11-13,3330,655,843,1498,烏日,簡易
2020-11-14,3330,1133,1126,2259,烏日,簡易
2020-11-15,3330,1455,1412,2867,烏日,簡易
2020-11-16,3330,646,624,1270,烏日,簡易
2020-11-17,3330,572,564,1136,烏日,簡易
2020-11-18,3330,583,591,1174,烏日,簡易
2020-11-19,3330,605,664,1269,烏日,簡易
2020-11-20,3330,657,794,1451,烏日,簡易
2020-11-21,3330,997,1075,2072,烏日,簡易
2020-11-22,3330,1327,1310,2637,烏日,簡易
2020-11-23,3330,641,646,1287,烏日,簡易
2020-11-24,3330,660,660,1320,烏日,簡易
2020-11-25,3330,605,616,1221,烏日,簡易
2020-11-26,3330,642,680,1322,烏日,簡易
2020-11-27,3330,736,831,1567,烏日,簡易
2020-11-28,3330,1031,992,2023,烏日,簡易
2020-11-29,3330,1115,1141,2256,烏日,簡易
2020-11-30,3330,598,595,1193,烏日,簡易
2020-12-01,3330,616,610,1226,烏日,簡易
2020-12-02,3330,618,615,1233,烏日,簡易
2020-12-03,3330,575,591,1166,烏日,簡易
2020-12-04,3330,713,835,1548,烏日,簡易
2020-12-05,3330,927,940,1867,烏日,簡易
2020-12-06,3330,1109,1094,2203,烏日,簡易
2020-12-07,3330,660,619,1279,烏日,簡易
2020-12-08,3330,602,597,1199,烏日,簡易
2020-12-09,3330,558,533,1091,烏日,簡易
2020-12-10,3330,640,630,1270,烏日,簡易
2020-12-11,3330,843,924,1767,烏日,簡易
2020-12-12,3330,1113,1120,2233,烏日,簡易
2020-12-13,3330,1374,1380,2754,烏日,簡易
2020-12-14,3330,669,643,1312,烏日,簡易
2020-12-15,3330,597,617,1214,烏日,簡易
2020-12-16,3330,616,650,1266,烏日,簡易
2020-12-17,3330,622,616,1238,烏日,簡易
2020-12-18,3330,725,833,1558,烏日,簡易
2020-12-19,3330,1080,1071,2151,烏日,簡易
2020-12-20,3330,1154,1180,2334,烏日,簡易
2020-12-21,3330,576,549,1125,烏日,簡易
2020-12-22,3330,581,610,1191,烏日,簡易
2020-12-23,3330,517,522,1039,烏日,簡易
2020-12-24,3330,590,626,1216,烏日,簡易
2020-12-25,3330,768,834,1602,烏日,簡易
2020-12-26,3330,903,951,1854,烏日,簡易
2020-12-27,3330,1034,1078,2112,烏日,簡易
2020-12-28,3330,635,603,1238,烏日,簡易
2020-12-29,3330,602,595,1197,烏日,簡易
2020-12-30,3330,592,629,1221,烏日,簡易
2020-12-31,3330,807,901,1708,烏日,簡易
2020-01-01,3340,9416,8204,17620,新烏日,二等
2020-01-02,3340,5832,5761,11593,新烏日,二等
2020-01-03,3340,9246,6620,15866,新烏日,二等
2020-01-04,3340,7969,6824,14793,新烏日,二等
2020-01-05,3340,8167,8965,17132,新烏日,二等
2020-01-06,3340,5194,5550,10744,新烏日,二等
2020-01-07,3340,4863,4763,9626,新烏日,二等
2020-01-08,3340,4926,4827,9753,新烏日,二等
2020-01-09,3340,6856,5389,12245,新烏日,二等
2020-01-10,3340,17543,8648,26191,新烏日,二等
2020-01-11,3340,13184,10031,23215,新烏日,二等
2020-01-12,3340,9518,13885,23403,新烏日,二等
2020-01-13,3340,5790,7993,13783,新烏日,二等
2020-01-14,3340,5334,5383,10717,新烏日,二等
2020-01-15,3340,5478,5116,10594,新烏日,二等
2020-01-16,3340,6027,5590,11617,新烏日,二等
2020-01-17,3340,8743,6654,15397,新烏日,二等
2020-01-18,3340,8649,7091,15740,新烏日,二等
2020-01-19,3340,8047,8357,16404,新烏日,二等
2020-01-20,3340,6609,6067,12676,新烏日,二等
2020-01-21,3340,6870,5454,12324,新烏日,二等
2020-01-22,3340,12006,6103,18109,新烏日,二等
2020-01-23,3340,12442,6032,18474,新烏日,二等
2020-01-24,3340,8618,5245,13863,新烏日,二等
2020-01-25,3340,7812,7150,14962,新烏日,二等
2020-01-26,3340,9956,8401,18357,新烏日,二等
2020-01-27,3340,10129,11063,21192,新烏日,二等
2020-01-28,3340,8950,10499,19449,新烏日,二等
2020-01-29,3340,7703,10410,18113,新烏日,二等
2020-01-30,3340,4704,6190,10894,新烏日,二等
2020-01-31,3340,6194,5361,11555,新烏日,二等
2020-02-01,3340,6336,5347,11683,新烏日,二等
2020-02-02,3340,5779,6511,12290,新烏日,二等
2020-02-03,3340,4593,5341,9934,新烏日,二等
2020-02-04,3340,4240,3998,8238,新烏日,二等
2020-02-05,3340,4341,3963,8304,新烏日,二等
2020-02-06,3340,4884,4385,9269,新烏日,二等
2020-02-07,3340,8093,5607,13700,新烏日,二等
2020-02-08,3340,7552,5892,13444,新烏日,二等
2020-02-09,3340,7428,8662,16090,新烏日,二等
2020-02-10,3340,5114,5969,11083,新烏日,二等
2020-02-11,3340,4698,4585,9283,新烏日,二等
2020-02-12,3340,4797,4646,9443,新烏日,二等
2020-02-13,3340,4643,4423,9066,新烏日,二等
2020-02-14,3340,6694,5578,12272,新烏日,二等
2020-02-15,3340,7304,5918,13222,新烏日,二等
2020-02-16,3340,6905,6765,13670,新烏日,二等
2020-02-17,3340,4614,5043,9657,新烏日,二等
2020-02-18,3340,4212,4159,8371,新烏日,二等
2020-02-19,3340,4292,4710,9002,新烏日,二等
2020-02-20,3340,4692,4423,9115,新烏日,二等
2020-02-21,3340,7626,5561,13187,新烏日,二等
2020-02-22,3340,7410,6149,13559,新烏日,二等
2020-02-23,3340,6465,7687,14152,新烏日,二等
2020-02-24,3340,4257,4891,9148,新烏日,二等
2020-02-25,3340,3934,3802,7736,新烏日,二等
2020-02-26,3340,4210,3912,8122,新烏日,二等
2020-02-27,3340,9024,5613,14637,新烏日,二等
2020-02-28,3340,8148,5471,13619,新烏日,二等
2020-02-29,3340,5210,4820,10030,新烏日,二等
2020-03-01,3340,7143,9879,17022,新烏日,二等
2020-03-02,3340,3982,4848,8830,新烏日,二等
2020-03-03,3340,3399,3312,6711,新烏日,二等
2020-03-04,3340,3509,3198,6707,新烏日,二等
2020-03-05,3340,3721,3265,6986,新烏日,二等
2020-03-06,3340,7966,5005,12971,新烏日,二等
2020-03-07,3340,5711,4102,9813,新烏日,二等
2020-03-08,3340,5446,6876,12322,新烏日,二等
2020-03-09,3340,4088,4567,8655,新烏日,二等
2020-03-10,3340,3392,3310,6702,新烏日,二等
2020-03-11,3340,3715,3510,7225,新烏日,二等
2020-03-12,3340,4089,3656,7745,新烏日,二等
2020-03-13,3340,8577,5227,13804,新烏日,二等
2020-03-14,3340,6051,4218,10269,新烏日,二等
2020-03-15,3340,6121,7591,13712,新烏日,二等
2020-03-16,3340,4138,4638,8776,新烏日,二等
2020-03-17,3340,3506,3534,7040,新烏日,二等
2020-03-18,3340,3524,3258,6782,新烏日,二等
2020-03-19,3340,3637,3193,6830,新烏日,二等
2020-03-20,3340,7631,4718,12349,新烏日,二等
2020-03-21,3340,5067,3609,8676,新烏日,二等
2020-03-22,3340,4782,6139,10921,新烏日,二等
2020-03-23,3340,3425,4103,7528,新烏日,二等
2020-03-24,3340,2930,3136,6066,新烏日,二等
2020-03-25,3340,3159,2969,6128,新烏日,二等
2020-03-26,3340,3367,3087,6454,新烏日,二等
2020-03-27,3340,6405,4146,10551,新烏日,二等
2020-03-28,3340,4494,3201,7695,新烏日,二等
2020-03-29,3340,4134,5071,9205,新烏日,二等
2020-03-30,3340,3435,3929,7364,新烏日,二等
2020-03-31,3340,3849,3366,7215,新烏日,二等
2020-04-01,3340,8679,4859,13538,新烏日,二等
2020-04-02,3340,7289,3543,10832,新烏日,二等
2020-04-03,3340,4266,3133,7399,新烏日,二等
2020-04-04,3340,3280,3787,7067,新烏日,二等
2020-04-05,3340,5465,8399,13864,新烏日,二等
2020-04-06,3340,3625,4754,8379,新烏日,二等
2020-04-07,3340,2782,2800,5582,新烏日,二等
2020-04-08,3340,2745,2690,5435,新烏日,二等
2020-04-09,3340,2977,2730,5707,新烏日,二等
2020-04-10,3340,6099,3896,9995,新烏日,二等
2020-04-11,3340,3891,2959,6850,新烏日,二等
2020-04-12,3340,3759,4776,8535,新烏日,二等
2020-04-13,3340,3159,3588,6747,新烏日,二等
2020-04-14,3340,2813,2723,5536,新烏日,二等
2020-04-15,3340,2945,2747,5692,新烏日,二等
2020-04-16,3340,3350,2925,6275,新烏日,二等
2020-04-17,3340,7558,4610,12168,新烏日,二等
2020-04-18,3340,4655,3533,8188,新烏日,二等
2020-04-19,3340,4456,6001,10457,新烏日,二等
2020-04-20,3340,3358,3940,7298,新烏日,二等
2020-04-21,3340,2662,2624,5286,新烏日,二等
2020-04-22,3340,2851,2629,5480,新烏日,二等
2020-04-23,3340,3001,2659,5660,新烏日,二等
2020-04-24,3340,6178,3792,9970,新烏日,二等
2020-04-25,3340,3903,2953,6856,新烏日,二等
2020-04-26,3340,3586,4546,8132,新烏日,二等
2020-04-27,3340,3104,3656,6760,新烏日,二等
2020-04-28,3340,2831,2898,5729,新烏日,二等
2020-04-29,3340,3082,2830,5912,新烏日,二等
2020-04-30,3340,5065,3559,8624,新烏日,二等
2020-05-01,3340,7815,4398,12213,新烏日,二等
2020-05-02,3340,4091,3313,7404,新烏日,二等
2020-05-03,3340,4850,6990,11840,新烏日,二等
2020-05-04,3340,3500,4397,7897,新烏日,二等
2020-05-05,3340,3104,2993,6097,新烏日,二等
2020-05-06,3340,3247,3042,6289,新烏日,二等
2020-05-07,3340,3941,3294,7235,新烏日,二等
2020-05-08,3340,9840,5497,15337,新烏日,二等
2020-05-09,3340,6771,4168,10939,新烏日,二等
2020-05-10,3340,6222,7982,14204,新烏日,二等
2020-05-11,3340,4016,5160,9176,新烏日,二等
2020-05-12,3340,3250,3358,6608,新烏日,二等
2020-05-13,3340,3422,3295,6717,新烏日,二等
2020-05-14,3340,3721,3468,7189,新烏日,二等
2020-05-15,3340,7960,4947,12907,新烏日,二等
2020-05-16,3340,5404,4246,9650,新烏日,二等
2020-05-17,3340,5302,6393,11695,新烏日,二等
2020-05-18,3340,3837,4462,8299,新烏日,二等
2020-05-19,3340,3191,3131,6322,新烏日,二等
2020-05-20,3340,3437,3214,6651,新烏日,二等
2020-05-21,3340,3700,3294,6994,新烏日,二等
2020-05-22,3340,7336,4575,11911,新烏日,二等
2020-05-23,3340,5066,3610,8676,新烏日,二等
2020-05-24,3340,5594,6991,12585,新烏日,二等
2020-05-25,3340,3846,4457,8303,新烏日,二等
2020-05-26,3340,3424,3371,6795,新烏日,二等
2020-05-27,3340,3405,3169,6574,新烏日,二等
2020-05-28,3340,3907,3357,7264,新烏日,二等
2020-05-29,3340,8459,5250,13709,新烏日,二等
2020-05-30,3340,6104,4773,10877,新烏日,二等
2020-05-31,3340,6003,7369,13372,新烏日,二等
2020-06-01,3340,4000,4704,8704,新烏日,二等
2020-06-02,3340,3454,3345,6799,新烏日,二等
2020-06-03,3340,3544,3420,6964,新烏日,二等
2020-06-04,3340,4138,3770,7908,新烏日,二等
2020-06-05,3340,8317,5765,14082,新烏日,二等
2020-06-06,3340,6955,5867,12822,新烏日,二等
2020-06-07,3340,6713,6939,13652,新烏日,二等
2020-06-08,3340,4302,4860,9162,新烏日,二等
2020-06-09,3340,3641,3578,7219,新烏日,二等
2020-06-10,3340,4020,3681,7701,新烏日,二等
2020-06-11,3340,4493,4057,8550,新烏日,二等
2020-06-12,3340,8618,6077,14695,新烏日,二等
2020-06-13,3340,7212,6053,13265,新烏日,二等
2020-06-14,3340,7282,7652,14934,新烏日,二等
2020-06-15,3340,4473,5085,9558,新烏日,二等
2020-06-16,3340,4067,3977,8044,新烏日,二等
2020-06-17,3340,4146,4018,8164,新烏日,二等
2020-06-18,3340,4354,4099,8453,新烏日,二等
2020-06-19,3340,6345,4946,11291,新烏日,二等
2020-06-20,3340,6369,5270,11639,新烏日,二等
2020-06-21,3340,6517,6503,13020,新烏日,二等
2020-06-22,3340,4596,4903,9499,新烏日,二等
2020-06-23,3340,4953,4197,9150,新烏日,二等
2020-06-24,3340,9988,6319,16307,新烏日,二等
2020-06-25,3340,10284,7012,17296,新烏日,二等
2020-06-26,3340,8073,7034,15107,新烏日,二等
2020-06-27,3340,8804,7966,16770,新烏日,二等
2020-06-28,3340,8700,10465,19165,新烏日,二等
2020-06-29,3340,4990,6430,11420,新烏日,二等
2020-06-30,3340,4626,4405,9031,新烏日,二等
2020-07-01,3340,4126,4060,8186,新烏日,二等
2020-07-02,3340,4248,4136,8384,新烏日,二等
2020-07-03,3340,7120,5452,12572,新烏日,二等
2020-07-04,3340,6681,5513,12194,新烏日,二等
2020-07-05,3340,6286,6667,12953,新烏日,二等
2020-07-06,3340,4902,5228,10130,新烏日,二等
2020-07-07,3340,4514,4399,8913,新烏日,二等
2020-07-08,3340,4729,4372,9101,新烏日,二等
2020-07-09,3340,4745,4483,9228,新烏日,二等
2020-07-10,3340,7722,6412,14134,新烏日,二等
2020-07-11,3340,7987,6477,14464,新烏日,二等
2020-07-12,3340,7605,8159,15764,新烏日,二等
2020-07-13,3340,4958,5519,10477,新烏日,二等
2020-07-14,3340,5054,4684,9738,新烏日,二等
2020-07-15,3340,5205,5083,10288,新烏日,二等
2020-07-16,3340,5639,5148,10787,新烏日,二等
2020-07-17,3340,9529,7082,16611,新烏日,二等
2020-07-18,3340,9233,7489,16722,新烏日,二等
2020-07-19,3340,8796,9163,17959,新烏日,二等
2020-07-20,3340,5973,6468,12441,新烏日,二等
2020-07-21,3340,4920,4753,9673,新烏日,二等
2020-07-22,3340,5360,5050,10410,新烏日,二等
2020-07-23,3340,5452,5089,10541,新烏日,二等
2020-07-24,3340,9190,6675,15865,新烏日,二等
2020-07-25,3340,8099,6808,14907,新烏日,二等
2020-07-26,3340,7881,8626,16507,新烏日,二等
2020-07-27,3340,5340,5793,11133,新烏日,二等
2020-07-28,3340,4749,4581,9330,新烏日,二等
2020-07-29,3340,4980,4863,9843,新烏日,二等
2020-07-30,3340,5336,5153,10489,新烏日,二等
2020-07-31,3340,9452,7029,16481,新烏日,二等
2020-08-01,3340,8745,7186,15931,新烏日,二等
2020-08-02,3340,8093,8665,16758,新烏日,二等
2020-08-03,3340,4835,5250,10085,新烏日,二等
2020-08-04,3340,4341,4348,8689,新烏日,二等
2020-08-05,3340,4729,4505,9234,新烏日,二等
2020-08-06,3340,5199,4706,9905,新烏日,二等
2020-08-07,3340,10635,6565,17200,新烏日,二等
2020-08-08,3340,8672,6120,14792,新烏日,二等
2020-08-09,3340,8212,10032,18244,新烏日,二等
2020-08-10,3340,5398,6417,11815,新烏日,二等
2020-08-11,3340,4582,4691,9273,新烏日,二等
2020-08-12,3340,5043,4879,9922,新烏日,二等
2020-08-13,3340,5660,5150,10810,新烏日,二等
2020-08-14,3340,9452,7304,16756,新烏日,二等
2020-08-15,3340,9334,7645,16979,新烏日,二等
2020-08-16,3340,9718,10111,19829,新烏日,二等
2020-08-17,3340,6013,6401,12414,新烏日,二等
2020-08-18,3340,5333,5085,10418,新烏日,二等
2020-08-19,3340,5143,5023,10166,新烏日,二等
2020-08-20,3340,5883,5245,11128,新烏日,二等
2020-08-21,3340,9310,6987,16297,新烏日,二等
2020-08-22,3340,8212,7518,15730,新烏日,二等
2020-08-23,3340,8538,8827,17365,新烏日,二等
2020-08-24,3340,5719,6150,11869,新烏日,二等
2020-08-25,3340,5459,5336,10795,新烏日,二等
2020-08-26,3340,5249,4866,10115,新烏日,二等
2020-08-27,3340,5097,4792,9889,新烏日,二等
2020-08-28,3340,8488,6060,14548,新烏日,二等
2020-08-29,3340,7746,6320,14066,新烏日,二等
2020-08-30,3340,7268,8004,15272,新烏日,二等
2020-08-31,3340,4790,5294,10084,新烏日,二等
2020-09-01,3340,4361,4047,8408,新烏日,二等
2020-09-02,3340,4541,3816,8357,新烏日,二等
2020-09-03,3340,4752,4665,9417,新烏日,二等
2020-09-04,3340,8298,6418,14716,新烏日,二等
2020-09-05,3340,7389,6437,13826,新烏日,二等
2020-09-06,3340,7689,8381,16070,新烏日,二等
2020-09-07,3340,4985,5521,10506,新烏日,二等
2020-09-08,3340,4729,4696,9425,新烏日,二等
2020-09-09,3340,4872,4635,9507,新烏日,二等
2020-09-10,3340,5160,4680,9840,新烏日,二等
2020-09-11,3340,9735,6684,16419,新烏日,二等
2020-09-12,3340,8259,6828,15087,新烏日,二等
2020-09-13,3340,9025,10118,19143,新烏日,二等
2020-09-14,3340,4987,5518,10505,新烏日,二等
2020-09-15,3340,4268,3999,8267,新烏日,二等
2020-09-16,3340,4486,4240,8726,新烏日,二等
2020-09-17,3340,4858,4691,9549,新烏日,二等
2020-09-18,3340,10704,6880,17584,新烏日,二等
2020-09-19,3340,9264,7898,17162,新烏日,二等
2020-09-20,3340,9910,10744,20654,新烏日,二等
2020-09-21,3340,5295,5869,11164,新烏日,二等
2020-09-22,3340,4357,4328,8685,新烏日,二等
2020-09-23,3340,4568,4314,8882,新烏日,二等
2020-09-24,3340,4939,4578,9517,新烏日,二等
2020-09-25,3340,6800,5332,12132,新烏日,二等
2020-09-26,3340,7255,5650,12905,新烏日,二等
2020-09-27,3340,6939,7344,14283,新烏日,二等
2020-09-28,3340,4671,4898,9569,新烏日,二等
2020-09-29,3340,5146,4342,9488,新烏日,二等
2020-09-30,3340,14168,7471,21639,新烏日,二等
2020-10-01,3340,13604,7395,20999,新烏日,二等
2020-10-02,3340,8375,7049,15424,新烏日,二等
2020-10-03,3340,7723,9035,16758,新烏日,二等
2020-10-04,3340,10678,14103,24781,新烏日,二等
2020-10-05,3340,4962,6642,11604,新烏日,二等
2020-10-06,3340,4445,4905,9350,新烏日,二等
2020-10-07,3340,4702,4299,9001,新烏日,二等
2020-10-08,3340,9777,6829,16606,新烏日,二等
2020-10-09,3340,10286,7570,17856,新烏日,二等
2020-10-10,3340,7984,7091,15075,新烏日,二等
2020-10-11,3340,10086,11234,21320,新烏日,二等
2020-10-12,3340,4979,5847,10826,新烏日,二等
2020-10-13,3340,4564,4668,9232,新烏日,二等
2020-10-14,3340,4816,4685,9501,新烏日,二等
2020-10-15,3340,5062,4790,9852,新烏日,二等
2020-10-16,3340,9801,6670,16471,新烏日,二等
2020-10-17,3340,9304,7735,17039,新烏日,二等
2020-10-18,3340,9479,10226,19705,新烏日,二等
2020-10-19,3340,4959,6131,11090,新烏日,二等
2020-10-20,3340,4663,4432,9095,新烏日,二等
2020-10-21,3340,4676,4608,9284,新烏日,二等
2020-10-22,3340,4991,4640,9631,新烏日,二等
2020-10-23,3340,10878,7597,18475,新烏日,二等
2020-10-24,3340,9728,7728,17456,新烏日,二等
2020-10-25,3340,9567,10796,20363,新烏日,二等
2020-10-26,3340,5305,6139,11444,新烏日,二等
2020-10-27,3340,4494,4541,9035,新烏日,二等
2020-10-28,3340,4520,4317,8837,新烏日,二等
2020-10-29,3340,5049,4645,9694,新烏日,二等
2020-10-30,3340,10362,6971,17333,新烏日,二等
2020-10-31,3340,8682,7013,15695,新烏日,二等
2020-11-01,3340,8691,9648,18339,新烏日,二等
2020-11-02,3340,4736,5409,10145,新烏日,二等
2020-11-03,3340,4014,3843,7857,新烏日,二等
2020-11-04,3340,4169,4091,8260,新烏日,二等
2020-11-05,3340,4683,4383,9066,新烏日,二等
2020-11-06,3340,10500,6865,17365,新烏日,二等
2020-11-07,3340,8973,6947,15920,新烏日,二等
2020-11-08,3340,8989,9980,18969,新烏日,二等
2020-11-09,3340,4866,5882,10748,新烏日,二等
2020-11-10,3340,4453,4323,8776,新烏日,二等
2020-11-11,3340,4548,4226,8774,新烏日,二等
2020-11-12,3340,5416,4866,10282,新烏日,二等
2020-11-13,3340,11082,7281,18363,新烏日,二等
2020-11-14,3340,9876,7768,17644,新烏日,二等
2020-11-15,3340,10123,11252,21375,新烏日,二等
2020-11-16,3340,6013,7212,13225,新烏日,二等
2020-11-17,3340,5466,5463,10929,新烏日,二等
2020-11-18,3340,5965,5596,11561,新烏日,二等
2020-11-19,3340,6191,5803,11994,新烏日,二等
2020-11-20,3340,11847,8642,20489,新烏日,二等
2020-11-21,3340,12829,10746,23575,新烏日,二等
2020-11-22,3340,11242,12226,23468,新烏日,二等
2020-11-23,3340,5769,6415,12184,新烏日,二等
2020-11-24,3340,4923,4878,9801,新烏日,二等
2020-11-25,3340,5131,4708,9839,新烏日,二等
2020-11-26,3340,5475,5003,10478,新烏日,二等
2020-11-27,3340,10922,7549,18471,新烏日,二等
2020-11-28,3340,9617,7807,17424,新烏日,二等
2020-11-29,3340,9483,10720,20203,新烏日,二等
2020-11-30,3340,5453,5761,11214,新烏日,二等
2020-12-01,3340,4512,4362,8874,新烏日,二等
2020-12-02,3340,4600,4450,9050,新烏日,二等
2020-12-03,3340,5086,4585,9671,新烏日,二等
2020-12-04,3340,11198,7084,18282,新烏日,二等
2020-12-05,3340,9843,8004,17847,新烏日,二等
2020-12-06,3340,10240,11162,21402,新烏日,二等
2020-12-07,3340,5590,6075,11665,新烏日,二等
2020-12-08,3340,4707,4549,9256,新烏日,二等
2020-12-09,3340,4528,4049,8577,新烏日,二等
2020-12-10,3340,5062,4816,9878,新烏日,二等
2020-12-11,3340,11451,7880,19331,新烏日,二等
2020-12-12,3340,10783,9021,19804,新烏日,二等
2020-12-13,3340,11550,12202,23752,新烏日,二等
2020-12-14,3340,5740,6561,12301,新烏日,二等
2020-12-15,3340,4822,4489,9311,新烏日,二等
2020-12-16,3340,4767,4446,9213,新烏日,二等
2020-12-17,3340,5670,4995,10665,新烏日,二等
2020-12-18,3340,11553,7878,19431,新烏日,二等
2020-12-19,3340,10526,8999,19525,新烏日,二等
2020-12-20,3340,11265,11664,22929,新烏日,二等
2020-12-21,3340,5617,6033,11650,新烏日,二等
2020-12-22,3340,4786,4680,9466,新烏日,二等
2020-12-23,3340,4178,3977,8155,新烏日,二等
2020-12-24,3340,5266,4719,9985,新烏日,二等
2020-12-25,3340,10216,7277,17493,新烏日,二等
2020-12-26,3340,8829,7133,15962,新烏日,二等
2020-12-27,3340,9287,9760,19047,新烏日,二等
2020-12-28,3340,5173,5733,10906,新烏日,二等
2020-12-29,3340,4562,4231,8793,新烏日,二等
2020-12-30,3340,5610,4776,10386,新烏日,二等
2020-12-31,3340,12338,9330,21668,新烏日,二等
2020-01-01,3350,1013,4543,5556,成功,三等
2020-01-02,3350,503,772,1275,成功,三等
2020-01-03,3350,2660,1806,4466,成功,三等
2020-01-04,3350,501,1331,1832,成功,三等
2020-01-05,3350,576,2367,2943,成功,三等
2020-01-06,3350,570,983,1553,成功,三等
2020-01-07,3350,489,913,1402,成功,三等
2020-01-08,3350,610,1343,1953,成功,三等
2020-01-09,3350,757,839,1596,成功,三等
2020-01-10,3350,867,1629,2496,成功,三等
2020-01-11,3350,777,1151,1928,成功,三等
2020-01-12,3350,836,1480,2316,成功,三等
2020-01-13,3350,614,958,1572,成功,三等
2020-01-14,3350,523,937,1460,成功,三等
2020-01-15,3350,558,993,1551,成功,三等
2020-01-16,3350,557,1177,1734,成功,三等
2020-01-17,3350,781,1256,2037,成功,三等
2020-01-18,3350,829,1319,2148,成功,三等
2020-01-19,3350,613,1149,1762,成功,三等
2020-01-20,3350,551,675,1226,成功,三等
2020-01-21,3350,537,695,1232,成功,三等
2020-01-22,3350,887,1031,1918,成功,三等
2020-01-23,3350,538,841,1379,成功,三等
2020-01-24,3350,492,622,1114,成功,三等
2020-01-25,3350,724,846,1570,成功,三等
2020-01-26,3350,487,788,1275,成功,三等
2020-01-27,3350,675,1154,1829,成功,三等
2020-01-28,3350,642,1093,1735,成功,三等
2020-01-29,3350,483,941,1424,成功,三等
2020-01-30,3350,484,1022,1506,成功,三等
2020-01-31,3350,674,1158,1832,成功,三等
2020-02-01,3350,510,569,1079,成功,三等
2020-02-02,3350,496,1392,1888,成功,三等
2020-02-03,3350,519,720,1239,成功,三等
2020-02-04,3350,418,647,1065,成功,三等
2020-02-05,3350,423,493,916,成功,三等
2020-02-06,3350,460,602,1062,成功,三等
2020-02-07,3350,682,710,1392,成功,三等
2020-02-08,3350,602,781,1383,成功,三等
2020-02-09,3350,530,965,1495,成功,三等
2020-02-10,3350,540,672,1212,成功,三等
2020-02-11,3350,508,586,1094,成功,三等
2020-02-12,3350,507,804,1311,成功,三等
2020-02-13,3350,455,573,1028,成功,三等
2020-02-14,3350,858,732,1590,成功,三等
2020-02-15,3350,772,936,1708,成功,三等
2020-02-16,3350,608,961,1569,成功,三等
2020-02-17,3350,471,1066,1537,成功,三等
2020-02-18,3350,462,668,1130,成功,三等
2020-02-19,3350,501,704,1205,成功,三等
2020-02-20,3350,515,698,1213,成功,三等
2020-02-21,3350,764,752,1516,成功,三等
2020-02-22,3350,595,677,1272,成功,三等
2020-02-23,3350,640,1099,1739,成功,三等
2020-02-24,3350,455,1115,1570,成功,三等
2020-02-25,3350,447,541,988,成功,三等
2020-02-26,3350,466,508,974,成功,三等
2020-02-27,3350,722,838,1560,成功,三等
2020-02-28,3350,539,1036,1575,成功,三等
2020-02-29,3350,500,1113,1613,成功,三等
2020-03-01,3350,526,970,1496,成功,三等
2020-03-02,3350,501,631,1132,成功,三等
2020-03-03,3350,512,557,1069,成功,三等
2020-03-04,3350,463,596,1059,成功,三等
2020-03-05,3350,440,475,915,成功,三等
2020-03-06,3350,651,838,1489,成功,三等
2020-03-07,3350,511,773,1284,成功,三等
2020-03-08,3350,546,819,1365,成功,三等
2020-03-09,3350,450,646,1096,成功,三等
2020-03-10,3350,469,808,1277,成功,三等
2020-03-11,3350,481,616,1097,成功,三等
2020-03-12,3350,481,802,1283,成功,三等
2020-03-13,3350,529,666,1195,成功,三等
2020-03-14,3350,495,1763,2258,成功,三等
2020-03-15,3350,601,1206,1807,成功,三等
2020-03-16,3350,440,552,992,成功,三等
2020-03-17,3350,458,800,1258,成功,三等
2020-03-18,3350,415,642,1057,成功,三等
2020-03-19,3350,404,459,863,成功,三等
2020-03-20,3350,745,1093,1838,成功,三等
2020-03-21,3350,420,1792,2212,成功,三等
2020-03-22,3350,452,752,1204,成功,三等
2020-03-23,3350,452,858,1310,成功,三等
2020-03-24,3350,414,1098,1512,成功,三等
2020-03-25,3350,403,466,869,成功,三等
2020-03-26,3350,456,1242,1698,成功,三等
2020-03-27,3350,495,544,1039,成功,三等
2020-03-28,3350,356,821,1177,成功,三等
2020-03-29,3350,410,1034,1444,成功,三等
2020-03-30,3350,396,673,1069,成功,三等
2020-03-31,3350,407,588,995,成功,三等
2020-04-01,3350,460,905,1365,成功,三等
2020-04-02,3350,475,1089,1564,成功,三等
2020-04-03,3350,310,1378,1688,成功,三等
2020-04-04,3350,337,1070,1407,成功,三等
2020-04-05,3350,360,1225,1585,成功,三等
2020-04-06,3350,398,868,1266,成功,三等
2020-04-07,3350,360,600,960,成功,三等
2020-04-08,3350,380,1252,1632,成功,三等
2020-04-09,3350,399,1926,2325,成功,三等
2020-04-10,3350,536,846,1382,成功,三等
2020-04-11,3350,621,2768,3389,成功,三等
2020-04-12,3350,410,2944,3354,成功,三等
2020-04-13,3350,429,1108,1537,成功,三等
2020-04-14,3350,403,1127,1530,成功,三等
2020-04-15,3350,354,823,1177,成功,三等
2020-04-16,3350,386,1729,2115,成功,三等
2020-04-17,3350,821,1156,1977,成功,三等
2020-04-18,3350,426,2649,3075,成功,三等
2020-04-19,3350,474,2765,3239,成功,三等
2020-04-20,3350,430,1243,1673,成功,三等
2020-04-21,3350,389,1535,1924,成功,三等
2020-04-22,3350,414,1898,2312,成功,三等
2020-04-23,3350,366,1021,1387,成功,三等
2020-04-24,3350,721,2513,3234,成功,三等
2020-04-25,3350,369,1889,2258,成功,三等
2020-04-26,3350,339,2988,3327,成功,三等
2020-04-27,3350,403,490,893,成功,三等
2020-04-28,3350,473,721,1194,成功,三等
2020-04-29,3350,382,3222,3604,成功,三等
2020-04-30,3350,391,1694,2085,成功,三等
2020-05-01,3350,546,1456,2002,成功,三等
2020-05-02,3350,492,2520,3012,成功,三等
2020-05-03,3350,374,2755,3129,成功,三等
2020-05-04,3350,404,1490,1894,成功,三等
2020-05-05,3350,406,1200,1606,成功,三等
2020-05-06,3350,432,1954,2386,成功,三等
2020-05-07,3350,503,1311,1814,成功,三等
2020-05-08,3350,658,2089,2747,成功,三等
2020-05-09,3350,587,2191,2778,成功,三等
2020-05-10,3350,446,1607,2053,成功,三等
2020-05-11,3350,458,645,1103,成功,三等
2020-05-12,3350,426,1013,1439,成功,三等
2020-05-13,3350,433,661,1094,成功,三等
2020-05-14,3350,425,607,1032,成功,三等
2020-05-15,3350,761,927,1688,成功,三等
2020-05-16,3350,531,878,1409,成功,三等
2020-05-17,3350,483,904,1387,成功,三等
2020-05-18,3350,448,518,966,成功,三等
2020-05-19,3350,372,519,891,成功,三等
2020-05-20,3350,450,1414,1864,成功,三等
2020-05-21,3350,389,880,1269,成功,三等
2020-05-22,3350,654,491,1145,成功,三等
2020-05-23,3350,520,712,1232,成功,三等
2020-05-24,3350,486,889,1375,成功,三等
2020-05-25,3350,424,591,1015,成功,三等
2020-05-26,3350,398,505,903,成功,三等
2020-05-27,3350,379,455,834,成功,三等
2020-05-28,3350,453,459,912,成功,三等
2020-05-29,3350,658,627,1285,成功,三等
2020-05-30,3350,560,782,1342,成功,三等
2020-05-31,3350,495,874,1369,成功,三等
2020-06-01,3350,435,500,935,成功,三等
2020-06-02,3350,426,548,974,成功,三等
2020-06-03,3350,421,503,924,成功,三等
2020-06-04,3350,415,719,1134,成功,三等
2020-06-05,3350,608,658,1266,成功,三等
2020-06-06,3350,547,830,1377,成功,三等
2020-06-07,3350,496,1553,2049,成功,三等
2020-06-08,3350,402,482,884,成功,三等
2020-06-09,3350,403,496,899,成功,三等
2020-06-10,3350,466,666,1132,成功,三等
2020-06-11,3350,463,547,1010,成功,三等
2020-06-12,3350,705,752,1457,成功,三等
2020-06-13,3350,638,801,1439,成功,三等
2020-06-14,3350,560,843,1403,成功,三等
2020-06-15,3350,430,518,948,成功,三等
2020-06-16,3350,431,676,1107,成功,三等
2020-06-17,3350,400,596,996,成功,三等
2020-06-18,3350,451,565,1016,成功,三等
2020-06-19,3350,501,966,1467,成功,三等
2020-06-20,3350,597,1068,1665,成功,三等
2020-06-21,3350,544,821,1365,成功,三等
2020-06-22,3350,430,500,930,成功,三等
2020-06-23,3350,427,566,993,成功,三等
2020-06-24,3350,634,588,1222,成功,三等
2020-06-25,3350,487,954,1441,成功,三等
2020-06-26,3350,495,651,1146,成功,三等
2020-06-27,3350,550,655,1205,成功,三等
2020-06-28,3350,542,981,1523,成功,三等
2020-06-29,3350,420,532,952,成功,三等
2020-06-30,3350,395,430,825,成功,三等
2020-07-01,3350,475,1212,1687,成功,三等
2020-07-02,3350,376,407,783,成功,三等
2020-07-03,3350,521,481,1002,成功,三等
2020-07-04,3350,595,604,1199,成功,三等
2020-07-05,3350,499,756,1255,成功,三等
2020-07-06,3350,502,1168,1670,成功,三等
2020-07-07,3350,467,524,991,成功,三等
2020-07-08,3350,497,466,963,成功,三等
2020-07-09,3350,484,500,984,成功,三等
2020-07-10,3350,993,720,1713,成功,三等
2020-07-11,3350,725,1076,1801,成功,三等
2020-07-12,3350,631,1307,1938,成功,三等
2020-07-13,3350,511,645,1156,成功,三等
2020-07-14,3350,437,555,992,成功,三等
2020-07-15,3350,430,515,945,成功,三等
2020-07-16,3350,436,543,979,成功,三等
2020-07-17,3350,1212,628,1840,成功,三等
2020-07-18,3350,583,678,1261,成功,三等
2020-07-19,3350,623,1064,1687,成功,三等
2020-07-20,3350,444,973,1417,成功,三等
2020-07-21,3350,408,521,929,成功,三等
2020-07-22,3350,462,507,969,成功,三等
2020-07-23,3350,529,662,1191,成功,三等
2020-07-24,3350,1043,1135,2178,成功,三等
2020-07-25,3350,602,629,1231,成功,三等
2020-07-26,3350,595,1044,1639,成功,三等
2020-07-27,3350,454,550,1004,成功,三等
2020-07-28,3350,439,552,991,成功,三等
2020-07-29,3350,465,670,1135,成功,三等
2020-07-30,3350,465,482,947,成功,三等
2020-07-31,3350,1046,606,1652,成功,三等
2020-08-01,3350,510,568,1078,成功,三等
2020-08-02,3350,526,1179,1705,成功,三等
2020-08-03,3350,400,588,988,成功,三等
2020-08-04,3350,404,1036,1440,成功,三等
2020-08-05,3350,476,714,1190,成功,三等
2020-08-06,3350,457,517,974,成功,三等
2020-08-07,3350,1215,667,1882,成功,三等
2020-08-08,3350,711,692,1403,成功,三等
2020-08-09,3350,605,1128,1733,成功,三等
2020-08-10,3350,468,1007,1475,成功,三等
2020-08-11,3350,432,481,913,成功,三等
2020-08-12,3350,448,480,928,成功,三等
2020-08-13,3350,466,480,946,成功,三等
2020-08-14,3350,1128,571,1699,成功,三等
2020-08-15,3350,731,575,1306,成功,三等
2020-08-16,3350,642,1311,1953,成功,三等
2020-08-17,3350,479,749,1228,成功,三等
2020-08-18,3350,456,586,1042,成功,三等
2020-08-19,3350,470,495,965,成功,三等
2020-08-20,3350,755,476,1231,成功,三等
2020-08-21,3350,667,640,1307,成功,三等
2020-08-22,3350,643,694,1337,成功,三等
2020-08-23,3350,508,1211,1719,成功,三等
2020-08-24,3350,464,698,1162,成功,三等
2020-08-25,3350,431,855,1286,成功,三等
2020-08-26,3350,509,485,994,成功,三等
2020-08-27,3350,459,494,953,成功,三等
2020-08-28,3350,690,559,1249,成功,三等
2020-08-29,3350,546,541,1087,成功,三等
2020-08-30,3350,458,790,1248,成功,三等
2020-08-31,3350,476,488,964,成功,三等
2020-09-01,3350,396,436,832,成功,三等
2020-09-02,3350,500,423,923,成功,三等
2020-09-03,3350,464,500,964,成功,三等
2020-09-04,3350,556,555,1111,成功,三等
2020-09-05,3350,534,1957,2491,成功,三等
2020-09-06,3350,561,712,1273,成功,三等
2020-09-07,3350,451,562,1013,成功,三等
2020-09-08,3350,487,511,998,成功,三等
2020-09-09,3350,532,836,1368,成功,三等
2020-09-10,3350,497,542,1039,成功,三等
2020-09-11,3350,785,577,1362,成功,三等
2020-09-12,3350,642,1218,1860,成功,三等
2020-09-13,3350,680,912,1592,成功,三等
2020-09-14,3350,461,633,1094,成功,三等
2020-09-15,3350,432,664,1096,成功,三等
2020-09-16,3350,473,556,1029,成功,三等
2020-09-17,3350,473,537,1010,成功,三等
2020-09-18,3350,659,593,1252,成功,三等
2020-09-19,3350,645,812,1457,成功,三等
2020-09-20,3350,713,810,1523,成功,三等
2020-09-21,3350,477,633,1110,成功,三等
2020-09-22,3350,443,472,915,成功,三等
2020-09-23,3350,471,547,1018,成功,三等
2020-09-24,3350,515,733,1248,成功,三等
2020-09-25,3350,593,577,1170,成功,三等
2020-09-26,3350,666,566,1232,成功,三等
2020-09-27,3350,751,894,1645,成功,三等
2020-09-28,3350,455,578,1033,成功,三等
2020-09-29,3350,465,599,1064,成功,三等
2020-09-30,3350,990,711,1701,成功,三等
2020-10-01,3350,522,819,1341,成功,三等
2020-10-02,3350,650,1079,1729,成功,三等
2020-10-03,3350,620,752,1372,成功,三等
2020-10-04,3350,661,965,1626,成功,三等
2020-10-05,3350,486,1118,1604,成功,三等
2020-10-06,3350,461,1617,2078,成功,三等
2020-10-07,3350,484,616,1100,成功,三等
2020-10-08,3350,881,730,1611,成功,三等
2020-10-09,3350,593,923,1516,成功,三等
2020-10-10,3350,670,1250,1920,成功,三等
2020-10-11,3350,571,1041,1612,成功,三等
2020-10-12,3350,497,530,1027,成功,三等
2020-10-13,3350,455,579,1034,成功,三等
2020-10-14,3350,496,968,1464,成功,三等
2020-10-15,3350,493,531,1024,成功,三等
2020-10-16,3350,872,614,1486,成功,三等
2020-10-17,3350,655,1258,1913,成功,三等
2020-10-18,3350,716,1138,1854,成功,三等
2020-10-19,3350,526,564,1090,成功,三等
2020-10-20,3350,475,2354,2829,成功,三等
2020-10-21,3350,451,696,1147,成功,三等
2020-10-22,3350,500,1085,1585,成功,三等
2020-10-23,3350,899,597,1496,成功,三等
2020-10-24,3350,709,777,1486,成功,三等
2020-10-25,3350,591,963,1554,成功,三等
2020-10-26,3350,493,787,1280,成功,三等
2020-10-27,3350,473,483,956,成功,三等
2020-10-28,3350,467,483,950,成功,三等
2020-10-29,3350,454,708,1162,成功,三等
2020-10-30,3350,1062,640,1702,成功,三等
2020-10-31,3350,624,701,1325,成功,三等
2020-11-01,3350,578,1538,2116,成功,三等
2020-11-02,3350,481,491,972,成功,三等
2020-11-03,3350,431,442,873,成功,三等
2020-11-04,3350,439,485,924,成功,三等
2020-11-05,3350,487,1315,1802,成功,三等
2020-11-06,3350,1223,644,1867,成功,三等
2020-11-07,3350,587,1086,1673,成功,三等
2020-11-08,3350,698,1020,1718,成功,三等
2020-11-09,3350,471,968,1439,成功,三等
2020-11-10,3350,541,518,1059,成功,三等
2020-11-11,3350,510,625,1135,成功,三等
2020-11-12,3350,626,666,1292,成功,三等
2020-11-13,3350,599,1096,1695,成功,三等
2020-11-14,3350,759,833,1592,成功,三等
2020-11-15,3350,763,1082,1845,成功,三等
2020-11-16,3350,538,526,1064,成功,三等
2020-11-17,3350,501,632,1133,成功,三等
2020-11-18,3350,588,550,1138,成功,三等
2020-11-19,3350,492,780,1272,成功,三等
2020-11-20,3350,688,788,1476,成功,三等
2020-11-21,3350,596,1232,1828,成功,三等
2020-11-22,3350,701,1188,1889,成功,三等
2020-11-23,3350,496,552,1048,成功,三等
2020-11-24,3350,508,522,1030,成功,三等
2020-11-25,3350,524,538,1062,成功,三等
2020-11-26,3350,480,981,1461,成功,三等
2020-11-27,3350,854,735,1589,成功,三等
2020-11-28,3350,712,1337,2049,成功,三等
2020-11-29,3350,637,1242,1879,成功,三等
2020-11-30,3350,525,1043,1568,成功,三等
2020-12-01,3350,472,1366,1838,成功,三等
2020-12-02,3350,479,696,1175,成功,三等
2020-12-03,3350,429,741,1170,成功,三等
2020-12-04,3350,716,772,1488,成功,三等
2020-12-05,3350,783,1166,1949,成功,三等
2020-12-06,3350,693,1437,2130,成功,三等
2020-12-07,3350,542,891,1433,成功,三等
2020-12-08,3350,544,1085,1629,成功,三等
2020-12-09,3350,450,967,1417,成功,三等
2020-12-10,3350,509,1021,1530,成功,三等
2020-12-11,3350,732,1202,1934,成功,三等
2020-12-12,3350,770,1292,2062,成功,三等
2020-12-13,3350,772,1197,1969,成功,三等
2020-12-14,3350,517,1572,2089,成功,三等
2020-12-15,3350,532,651,1183,成功,三等
2020-12-16,3350,495,871,1366,成功,三等
2020-12-17,3350,445,533,978,成功,三等
2020-12-18,3350,772,1019,1791,成功,三等
2020-12-19,3350,906,1510,2416,成功,三等
2020-12-20,3350,672,2342,3014,成功,三等
2020-12-21,3350,481,1083,1564,成功,三等
2020-12-22,3350,452,1205,1657,成功,三等
2020-12-23,3350,423,982,1405,成功,三等
2020-12-24,3350,568,1058,1626,成功,三等
2020-12-25,3350,1146,1459,2605,成功,三等
2020-12-26,3350,703,1349,2052,成功,三等
2020-12-27,3350,634,1574,2208,成功,三等
2020-12-28,3350,604,1139,1743,成功,三等
2020-12-29,3350,495,1277,1772,成功,三等
2020-12-30,3350,503,1265,1768,成功,三等
2020-12-31,3350,858,1737,2595,成功,三等
2020-01-01,3360,15478,17570,33048,彰化,一等
2020-01-02,3360,11876,12236,24112,彰化,一等
2020-01-03,3360,13694,15454,29148,彰化,一等
2020-01-04,3360,14629,14626,29255,彰化,一等
2020-01-05,3360,16623,16116,32739,彰化,一等
2020-01-06,3360,12202,11920,24122,彰化,一等
2020-01-07,3360,11354,11254,22608,彰化,一等
2020-01-08,3360,11503,11378,22881,彰化,一等
2020-01-09,3360,11696,12995,24691,彰化,一等
2020-01-10,3360,16353,22347,38700,彰化,一等
2020-01-11,3360,18654,19564,38218,彰化,一等
2020-01-12,3360,22541,19768,42309,彰化,一等
2020-01-13,3360,14047,12879,26926,彰化,一等
2020-01-14,3360,12172,12058,24230,彰化,一等
2020-01-15,3360,12354,12453,24807,彰化,一等
2020-01-16,3360,14574,14705,29279,彰化,一等
2020-01-17,3360,14564,15758,30322,彰化,一等
2020-01-18,3360,14588,14855,29443,彰化,一等
2020-01-19,3360,16479,16087,32566,彰化,一等
2020-01-20,3360,13222,13790,27012,彰化,一等
2020-01-21,3360,13300,14504,27804,彰化,一等
2020-01-22,3360,14457,18194,32651,彰化,一等
2020-01-23,3360,14866,19356,34222,彰化,一等
2020-01-24,3360,14199,16850,31049,彰化,一等
2020-01-25,3360,21481,20419,41900,彰化,一等
2020-01-26,3360,18072,18808,36880,彰化,一等
2020-01-27,3360,23639,22462,46101,彰化,一等
2020-01-28,3360,19298,18605,37903,彰化,一等
2020-01-29,3360,16196,14695,30891,彰化,一等
2020-01-30,3360,12115,11114,23229,彰化,一等
2020-01-31,3360,12265,12627,24892,彰化,一等
2020-02-01,3360,11012,11162,22174,彰化,一等
2020-02-02,3360,12584,12336,24920,彰化,一等
2020-02-03,3360,11390,11339,22729,彰化,一等
2020-02-04,3360,9965,9924,19889,彰化,一等
2020-02-05,3360,10333,10506,20839,彰化,一等
2020-02-06,3360,10799,11100,21899,彰化,一等
2020-02-07,3360,12176,13766,25942,彰化,一等
2020-02-08,3360,12052,12546,24598,彰化,一等
2020-02-09,3360,15291,14548,29839,彰化,一等
2020-02-10,3360,11737,11525,23262,彰化,一等
2020-02-11,3360,10680,10985,21665,彰化,一等
2020-02-12,3360,11146,11186,22332,彰化,一等
2020-02-13,3360,10196,10433,20629,彰化,一等
2020-02-14,3360,12329,13214,25543,彰化,一等
2020-02-15,3360,13677,13707,27384,彰化,一等
2020-02-16,3360,15131,15303,30434,彰化,一等
2020-02-17,3360,10224,10371,20595,彰化,一等
2020-02-18,3360,9256,9131,18387,彰化,一等
2020-02-19,3360,9693,9698,19391,彰化,一等
2020-02-20,3360,9747,9926,19673,彰化,一等
2020-02-21,3360,11464,12819,24283,彰化,一等
2020-02-22,3360,12013,11972,23985,彰化,一等
2020-02-23,3360,13658,13191,26849,彰化,一等
2020-02-24,3360,10812,10201,21013,彰化,一等
2020-02-25,3360,10064,9854,19918,彰化,一等
2020-02-26,3360,10100,10214,20314,彰化,一等
2020-02-27,3360,12847,15140,27987,彰化,一等
2020-02-28,3360,12509,14037,26546,彰化,一等
2020-02-29,3360,11487,11469,22956,彰化,一等
2020-03-01,3360,15285,13206,28491,彰化,一等
2020-03-02,3360,10998,10201,21199,彰化,一等
2020-03-03,3360,9594,9485,19079,彰化,一等
2020-03-04,3360,9417,9307,18724,彰化,一等
2020-03-05,3360,9115,9492,18607,彰化,一等
2020-03-06,3360,12831,15322,28153,彰化,一等
2020-03-07,3360,10925,11348,22273,彰化,一等
2020-03-08,3360,14210,12350,26560,彰化,一等
2020-03-09,3360,10833,10625,21458,彰化,一等
2020-03-10,3360,9040,8830,17870,彰化,一等
2020-03-11,3360,9862,9764,19626,彰化,一等
2020-03-12,3360,9944,10404,20348,彰化,一等
2020-03-13,3360,13373,16193,29566,彰化,一等
2020-03-14,3360,11011,11455,22466,彰化,一等
2020-03-15,3360,16670,15029,31699,彰化,一等
2020-03-16,3360,10912,10435,21347,彰化,一等
2020-03-17,3360,9715,9627,19342,彰化,一等
2020-03-18,3360,9439,9482,18921,彰化,一等
2020-03-19,3360,9061,9398,18459,彰化,一等
2020-03-20,3360,12737,15446,28183,彰化,一等
2020-03-21,3360,10097,10672,20769,彰化,一等
2020-03-22,3360,12971,11125,24096,彰化,一等
2020-03-23,3360,10125,9636,19761,彰化,一等
2020-03-24,3360,8861,8849,17710,彰化,一等
2020-03-25,3360,9004,9015,18019,彰化,一等
2020-03-26,3360,9217,9420,18637,彰化,一等
2020-03-27,3360,11510,13464,24974,彰化,一等
2020-03-28,3360,8548,8982,17530,彰化,一等
2020-03-29,3360,9889,9171,19060,彰化,一等
2020-03-30,3360,9589,9459,19048,彰化,一等
2020-03-31,3360,9129,9920,19049,彰化,一等
2020-04-01,3360,11944,15044,26988,彰化,一等
2020-04-02,3360,8762,11607,20369,彰化,一等
2020-04-03,3360,8762,9994,18756,彰化,一等
2020-04-04,3360,8123,7331,15454,彰化,一等
2020-04-05,3360,13426,9376,22802,彰化,一等
2020-04-06,3360,10749,9020,19769,彰化,一等
2020-04-07,3360,8575,8974,17549,彰化,一等
2020-04-08,3360,8501,8613,17114,彰化,一等
2020-04-09,3360,8367,8655,17022,彰化,一等
2020-04-10,3360,10844,12695,23539,彰化,一等
2020-04-11,3360,8781,9066,17847,彰化,一等
2020-04-12,3360,11366,10569,21935,彰化,一等
2020-04-13,3360,9526,9210,18736,彰化,一等
2020-04-14,3360,8707,8555,17262,彰化,一等
2020-04-15,3360,8841,8998,17839,彰化,一等
2020-04-16,3360,8857,9138,17995,彰化,一等
2020-04-17,3360,11841,13984,25825,彰化,一等
2020-04-18,3360,9594,10097,19691,彰化,一等
2020-04-19,3360,12204,11087,23291,彰化,一等
2020-04-20,3360,9864,9402,19266,彰化,一等
2020-04-21,3360,8520,8465,16985,彰化,一等
2020-04-22,3360,8441,8446,16887,彰化,一等
2020-04-23,3360,8136,8532,16668,彰化,一等
2020-04-24,3360,10592,12432,23024,彰化,一等
2020-04-25,3360,8186,8513,16699,彰化,一等
2020-04-26,3360,9991,8797,18788,彰化,一等
2020-04-27,3360,9544,9009,18553,彰化,一等
2020-04-28,3360,8725,8709,17434,彰化,一等
2020-04-29,3360,8614,8822,17436,彰化,一等
2020-04-30,3360,9639,11390,21029,彰化,一等
2020-05-01,3360,12014,14883,26897,彰化,一等
2020-05-02,3360,9309,9500,18809,彰化,一等
2020-05-03,3360,12961,10764,23725,彰化,一等
2020-05-04,3360,10288,9441,19729,彰化,一等
2020-05-05,3360,8853,8800,17653,彰化,一等
2020-05-06,3360,9040,9010,18050,彰化,一等
2020-05-07,3360,9238,9787,19025,彰化,一等
2020-05-08,3360,13213,17582,30795,彰化,一等
2020-05-09,3360,11294,12857,24151,彰化,一等
2020-05-10,3360,15323,12412,27735,彰化,一等
2020-05-11,3360,11452,10276,21728,彰化,一等
2020-05-12,3360,9375,9150,18525,彰化,一等
2020-05-13,3360,9474,9425,18899,彰化,一等
2020-05-14,3360,9688,9859,19547,彰化,一等
2020-05-15,3360,13762,16040,29802,彰化,一等
2020-05-16,3360,11063,11380,22443,彰化,一等
2020-05-17,3360,13991,12942,26933,彰化,一等
2020-05-18,3360,10239,9681,19920,彰化,一等
2020-05-19,3360,8306,8209,16515,彰化,一等
2020-05-20,3360,9146,9114,18260,彰化,一等
2020-05-21,3360,8922,9245,18167,彰化,一等
2020-05-22,3360,10968,13694,24662,彰化,一等
2020-05-23,3360,10599,11172,21771,彰化,一等
2020-05-24,3360,16729,15068,31797,彰化,一等
2020-05-25,3360,10695,10475,21170,彰化,一等
2020-05-26,3360,9226,9054,18280,彰化,一等
2020-05-27,3360,8878,8877,17755,彰化,一等
2020-05-28,3360,8963,9377,18340,彰化,一等
2020-05-29,3360,13085,15723,28808,彰化,一等
2020-05-30,3360,12584,13182,25766,彰化,一等
2020-05-31,3360,15426,13828,29254,彰化,一等
2020-06-01,3360,10863,10333,21196,彰化,一等
2020-06-02,3360,9594,9548,19142,彰化,一等
2020-06-03,3360,9787,9768,19555,彰化,一等
2020-06-04,3360,9780,10082,19862,彰化,一等
2020-06-05,3360,13465,16010,29475,彰化,一等
2020-06-06,3360,13608,14144,27752,彰化,一等
2020-06-07,3360,15130,13744,28874,彰化,一等
2020-06-08,3360,10456,10195,20651,彰化,一等
2020-06-09,3360,9589,9453,19042,彰化,一等
2020-06-10,3360,10283,10221,20504,彰化,一等
2020-06-11,3360,11364,11225,22589,彰化,一等
2020-06-12,3360,15375,17876,33251,彰化,一等
2020-06-13,3360,15336,15528,30864,彰化,一等
2020-06-14,3360,18003,17269,35272,彰化,一等
2020-06-15,3360,12631,12709,25340,彰化,一等
2020-06-16,3360,11569,11905,23474,彰化,一等
2020-06-17,3360,10342,10330,20672,彰化,一等
2020-06-18,3360,11785,11662,23447,彰化,一等
2020-06-19,3360,11978,13576,25554,彰化,一等
2020-06-20,3360,13994,13880,27874,彰化,一等
2020-06-21,3360,15092,15093,30185,彰化,一等
2020-06-22,3360,11453,11279,22732,彰化,一等
2020-06-23,3360,10787,10998,21785,彰化,一等
2020-06-24,3360,13995,17853,31848,彰化,一等
2020-06-25,3360,14110,17010,31120,彰化,一等
2020-06-26,3360,16458,16735,33193,彰化,一等
2020-06-27,3360,17025,16481,33506,彰化,一等
2020-06-28,3360,18937,17122,36059,彰化,一等
2020-06-29,3360,12653,11592,24245,彰化,一等
2020-06-30,3360,10718,10601,21319,彰化,一等
2020-07-01,3360,10505,10459,20964,彰化,一等
2020-07-02,3360,10022,10251,20273,彰化,一等
2020-07-03,3360,12458,13559,26017,彰化,一等
2020-07-04,3360,13943,13401,27344,彰化,一等
2020-07-05,3360,13922,14753,28675,彰化,一等
2020-07-06,3360,12410,13254,25664,彰化,一等
2020-07-07,3360,10840,10746,21586,彰化,一等
2020-07-08,3360,10934,11104,22038,彰化,一等
2020-07-09,3360,10988,11163,22151,彰化,一等
2020-07-10,3360,14321,15880,30201,彰化,一等
2020-07-11,3360,15707,16555,32262,彰化,一等
2020-07-12,3360,17942,17850,35792,彰化,一等
2020-07-13,3360,13254,13038,26292,彰化,一等
2020-07-14,3360,12560,12830,25390,彰化,一等
2020-07-15,3360,12207,12640,24847,彰化,一等
2020-07-16,3360,11854,12177,24031,彰化,一等
2020-07-17,3360,14328,15722,30050,彰化,一等
2020-07-18,3360,15235,15664,30899,彰化,一等
2020-07-19,3360,17854,17351,35205,彰化,一等
2020-07-20,3360,12240,12434,24674,彰化,一等
2020-07-21,3360,11274,11278,22552,彰化,一等
2020-07-22,3360,11822,11984,23806,彰化,一等
2020-07-23,3360,11605,11933,23538,彰化,一等
2020-07-24,3360,13855,15279,29134,彰化,一等
2020-07-25,3360,14548,15264,29812,彰化,一等
2020-07-26,3360,16259,15600,31859,彰化,一等
2020-07-27,3360,11245,12361,23606,彰化,一等
2020-07-28,3360,11221,11355,22576,彰化,一等
2020-07-29,3360,11449,11572,23021,彰化,一等
2020-07-30,3360,11131,11659,22790,彰化,一等
2020-07-31,3360,13726,15338,29064,彰化,一等
2020-08-01,3360,14675,15382,30057,彰化,一等
2020-08-02,3360,14906,14472,29378,彰化,一等
2020-08-03,3360,10651,10398,21049,彰化,一等
2020-08-04,3360,10119,10118,20237,彰化,一等
2020-08-05,3360,10641,10821,21462,彰化,一等
2020-08-06,3360,11062,11528,22590,彰化,一等
2020-08-07,3360,13988,16563,30551,彰化,一等
2020-08-08,3360,13017,14199,27216,彰化,一等
2020-08-09,3360,17776,15999,33775,彰化,一等
2020-08-10,3360,12549,12107,24656,彰化,一等
2020-08-11,3360,10488,10362,20850,彰化,一等
2020-08-12,3360,11373,11133,22506,彰化,一等
2020-08-13,3360,11695,11862,23557,彰化,一等
2020-08-14,3360,14662,15713,30375,彰化,一等
2020-08-15,3360,16656,16804,33460,彰化,一等
2020-08-16,3360,20288,20437,40725,彰化,一等
2020-08-17,3360,13126,13023,26149,彰化,一等
2020-08-18,3360,11958,12103,24061,彰化,一等
2020-08-19,3360,11796,11855,23651,彰化,一等
2020-08-20,3360,11990,12147,24137,彰化,一等
2020-08-21,3360,14578,15594,30172,彰化,一等
2020-08-22,3360,14697,14888,29585,彰化,一等
2020-08-23,3360,16049,16195,32244,彰化,一等
2020-08-24,3360,12523,12531,25054,彰化,一等
2020-08-25,3360,11665,11569,23234,彰化,一等
2020-08-26,3360,11183,11456,22639,彰化,一等
2020-08-27,3360,10708,10969,21677,彰化,一等
2020-08-28,3360,13027,14083,27110,彰化,一等
2020-08-29,3360,13128,13598,26726,彰化,一等
2020-08-30,3360,14430,13860,28290,彰化,一等
2020-08-31,3360,11198,11120,22318,彰化,一等
2020-09-01,3360,10188,10452,20640,彰化,一等
2020-09-02,3360,9617,9572,19189,彰化,一等
2020-09-03,3360,11034,10817,21851,彰化,一等
2020-09-04,3360,13196,14101,27297,彰化,一等
2020-09-05,3360,13314,13762,27076,彰化,一等
2020-09-06,3360,14915,14219,29134,彰化,一等
2020-09-07,3360,11575,11303,22878,彰化,一等
2020-09-08,3360,10430,10351,20781,彰化,一等
2020-09-09,3360,10615,10824,21439,彰化,一等
2020-09-10,3360,10414,11083,21497,彰化,一等
2020-09-11,3360,14151,15465,29616,彰化,一等
2020-09-12,3360,15471,15514,30985,彰化,一等
2020-09-13,3360,19893,18377,38270,彰化,一等
2020-09-14,3360,11096,11104,22200,彰化,一等
2020-09-15,3360,10109,10131,20240,彰化,一等
2020-09-16,3360,10236,10240,20476,彰化,一等
2020-09-17,3360,10546,10622,21168,彰化,一等
2020-09-18,3360,14120,17534,31654,彰化,一等
2020-09-19,3360,15578,15785,31363,彰化,一等
2020-09-20,3360,19134,17983,37117,彰化,一等
2020-09-21,3360,11527,11176,22703,彰化,一等
2020-09-22,3360,10210,10153,20363,彰化,一等
2020-09-23,3360,10435,10483,20918,彰化,一等
2020-09-24,3360,10470,10563,21033,彰化,一等
2020-09-25,3360,11732,12857,24589,彰化,一等
2020-09-26,3360,12803,13439,26242,彰化,一等
2020-09-27,3360,14850,14473,29323,彰化,一等
2020-09-28,3360,10965,10751,21716,彰化,一等
2020-09-29,3360,10384,10905,21289,彰化,一等
2020-09-30,3360,15501,21581,37082,彰化,一等
2020-10-01,3360,14926,19974,34900,彰化,一等
2020-10-02,3360,17194,17660,34854,彰化,一等
2020-10-03,3360,18056,16768,34824,彰化,一等
2020-10-04,3360,22342,18433,40775,彰化,一等
2020-10-05,3360,12894,11328,24222,彰化,一等
2020-10-06,3360,10555,10317,20872,彰化,一等
2020-10-07,3360,10511,10682,21193,彰化,一等
2020-10-08,3360,14169,17480,31649,彰化,一等
2020-10-09,3360,16362,17566,33928,彰化,一等
2020-10-10,3360,15958,15797,31755,彰化,一等
2020-10-11,3360,20393,19012,39405,彰化,一等
2020-10-12,3360,11999,11186,23185,彰化,一等
2020-10-13,3360,10486,10331,20817,彰化,一等
2020-10-14,3360,10503,10509,21012,彰化,一等
2020-10-15,3360,10805,11196,22001,彰化,一等
2020-10-16,3360,14239,17108,31347,彰化,一等
2020-10-17,3360,16135,16508,32643,彰化,一等
2020-10-18,3360,20047,19064,39111,彰化,一等
2020-10-19,3360,11839,11589,23428,彰化,一等
2020-10-20,3360,10575,10521,21096,彰化,一等
2020-10-21,3360,10591,10761,21352,彰化,一等
2020-10-22,3360,10735,10945,21680,彰化,一等
2020-10-23,3360,14160,16740,30900,彰化,一等
2020-10-24,3360,14930,16285,31215,彰化,一等
2020-10-25,3360,18083,16895,34978,彰化,一等
2020-10-26,3360,12195,11263,23458,彰化,一等
2020-10-27,3360,10236,10416,20652,彰化,一等
2020-10-28,3360,10556,10577,21133,彰化,一等
2020-10-29,3360,10602,10983,21585,彰化,一等
2020-10-30,3360,13996,17286,31282,彰化,一等
2020-10-31,3360,15070,16060,31130,彰化,一等
2020-11-01,3360,18333,16323,34656,彰化,一等
2020-11-02,3360,11677,10992,22669,彰化,一等
2020-11-03,3360,10236,10104,20340,彰化,一等
2020-11-04,3360,10211,10267,20478,彰化,一等
2020-11-05,3360,10518,11128,21646,彰化,一等
2020-11-06,3360,14483,17344,31827,彰化,一等
2020-11-07,3360,15111,15569,30680,彰化,一等
2020-11-08,3360,18801,17521,36322,彰化,一等
2020-11-09,3360,11596,11030,22626,彰化,一等
2020-11-10,3360,10417,10106,20523,彰化,一等
2020-11-11,3360,10877,10977,21854,彰化,一等
2020-11-12,3360,10793,11273,22066,彰化,一等
2020-11-13,3360,14933,18582,33515,彰化,一等
2020-11-14,3360,17536,17849,35385,彰化,一等
2020-11-15,3360,23343,21705,45048,彰化,一等
2020-11-16,3360,12737,12231,24968,彰化,一等
2020-11-17,3360,11330,11214,22544,彰化,一等
2020-11-18,3360,11185,11438,22623,彰化,一等
2020-11-19,3360,11586,11900,23486,彰化,一等
2020-11-20,3360,15185,18499,33684,彰化,一等
2020-11-21,3360,16691,17046,33737,彰化,一等
2020-11-22,3360,20071,18626,38697,彰化,一等
2020-11-23,3360,12524,11993,24517,彰化,一等
2020-11-24,3360,11099,10813,21912,彰化,一等
2020-11-25,3360,11165,11105,22270,彰化,一等
2020-11-26,3360,11349,11670,23019,彰化,一等
2020-11-27,3360,14703,17947,32650,彰化,一等
2020-11-28,3360,14969,15749,30718,彰化,一等
2020-11-29,3360,18132,16348,34480,彰化,一等
2020-11-30,3360,12081,11423,23504,彰化,一等
2020-12-01,3360,10329,10190,20519,彰化,一等
2020-12-02,3360,10629,10501,21130,彰化,一等
2020-12-03,3360,10503,11062,21565,彰化,一等
2020-12-04,3360,14253,17957,32210,彰化,一等
2020-12-05,3360,16085,16331,32416,彰化,一等
2020-12-06,3360,18520,17490,36010,彰化,一等
2020-12-07,3360,12226,11604,23830,彰化,一等
2020-12-08,3360,10487,10440,20927,彰化,一等
2020-12-09,3360,9627,9543,19170,彰化,一等
2020-12-10,3360,10642,10987,21629,彰化,一等
2020-12-11,3360,14640,18058,32698,彰化,一等
2020-12-12,3360,17264,17776,35040,彰化,一等
2020-12-13,3360,22260,21032,43292,彰化,一等
2020-12-14,3360,12460,12082,24542,彰化,一等
2020-12-15,3360,10599,10589,21188,彰化,一等
2020-12-16,3360,10677,10550,21227,彰化,一等
2020-12-17,3360,10827,11244,22071,彰化,一等
2020-12-18,3360,14813,18120,32933,彰化,一等
2020-12-19,3360,17692,18161,35853,彰化,一等
2020-12-20,3360,20244,19065,39309,彰化,一等
2020-12-21,3360,11715,11401,23116,彰化,一等
2020-12-22,3360,10624,10578,21202,彰化,一等
2020-12-23,3360,9758,10012,19770,彰化,一等
2020-12-24,3360,10938,11401,22339,彰化,一等
2020-12-25,3360,15280,17567,32847,彰化,一等
2020-12-26,3360,15179,15720,30899,彰化,一等
2020-12-27,3360,17634,16591,34225,彰化,一等
2020-12-28,3360,11822,11508,23330,彰化,一等
2020-12-29,3360,10621,10569,21190,彰化,一等
2020-12-30,3360,10809,11305,22114,彰化,一等
2020-12-31,3360,16343,18105,34448,彰化,一等
2020-01-01,3370,1321,1462,2783,花壇,乙簡
2020-01-02,3370,902,1082,1984,花壇,乙簡
2020-01-03,3370,1076,1419,2495,花壇,乙簡
2020-01-04,3370,1091,1410,2501,花壇,乙簡
2020-01-05,3370,1422,1340,2762,花壇,乙簡
2020-01-06,3370,979,1048,2027,花壇,乙簡
2020-01-07,3370,919,1072,1991,花壇,乙簡
2020-01-08,3370,907,1039,1946,花壇,乙簡
2020-01-09,3370,844,1122,1966,花壇,乙簡
2020-01-10,3370,1031,1956,2987,花壇,乙簡
2020-01-11,3370,1474,1786,3260,花壇,乙簡
2020-01-12,3370,1935,1579,3514,花壇,乙簡
2020-01-13,3370,1289,1176,2465,花壇,乙簡
2020-01-14,3370,990,1059,2049,花壇,乙簡
2020-01-15,3370,1006,1043,2049,花壇,乙簡
2020-01-16,3370,1039,1345,2384,花壇,乙簡
2020-01-17,3370,1142,1378,2520,花壇,乙簡
2020-01-18,3370,1277,1318,2595,花壇,乙簡
2020-01-19,3370,1440,1392,2832,花壇,乙簡
2020-01-20,3370,1139,1132,2271,花壇,乙簡
2020-01-21,3370,1128,1224,2352,花壇,乙簡
2020-01-22,3370,1161,1517,2678,花壇,乙簡
2020-01-23,3370,1044,1607,2651,花壇,乙簡
2020-01-24,3370,1064,1339,2403,花壇,乙簡
2020-01-25,3370,1536,1365,2901,花壇,乙簡
2020-01-26,3370,1214,1285,2499,花壇,乙簡
2020-01-27,3370,1686,1583,3269,花壇,乙簡
2020-01-28,3370,1538,1303,2841,花壇,乙簡
2020-01-29,3370,1365,1038,2403,花壇,乙簡
2020-01-30,3370,1053,896,1949,花壇,乙簡
2020-01-31,3370,992,1017,2009,花壇,乙簡
2020-02-01,3370,929,973,1902,花壇,乙簡
2020-02-02,3370,1025,982,2007,花壇,乙簡
2020-02-03,3370,926,839,1765,花壇,乙簡
2020-02-04,3370,872,866,1738,花壇,乙簡
2020-02-05,3370,860,864,1724,花壇,乙簡
2020-02-06,3370,910,950,1860,花壇,乙簡
2020-02-07,3370,965,1173,2138,花壇,乙簡
2020-02-08,3370,1079,1147,2226,花壇,乙簡
2020-02-09,3370,1315,1198,2513,花壇,乙簡
2020-02-10,3370,935,908,1843,花壇,乙簡
2020-02-11,3370,962,889,1851,花壇,乙簡
2020-02-12,3370,918,937,1855,花壇,乙簡
2020-02-13,3370,854,857,1711,花壇,乙簡
2020-02-14,3370,1010,1035,2045,花壇,乙簡
2020-02-15,3370,1153,1148,2301,花壇,乙簡
2020-02-16,3370,1357,1289,2646,花壇,乙簡
2020-02-17,3370,903,869,1772,花壇,乙簡
2020-02-18,3370,810,804,1614,花壇,乙簡
2020-02-19,3370,878,829,1707,花壇,乙簡
2020-02-20,3370,853,853,1706,花壇,乙簡
2020-02-21,3370,982,1117,2099,花壇,乙簡
2020-02-22,3370,1097,1164,2261,花壇,乙簡
2020-02-23,3370,1179,1015,2194,花壇,乙簡
2020-02-24,3370,925,898,1823,花壇,乙簡
2020-02-25,3370,847,958,1805,花壇,乙簡
2020-02-26,3370,852,957,1809,花壇,乙簡
2020-02-27,3370,922,1380,2302,花壇,乙簡
2020-02-28,3370,1006,1207,2213,花壇,乙簡
2020-02-29,3370,973,984,1957,花壇,乙簡
2020-03-01,3370,1364,981,2345,花壇,乙簡
2020-03-02,3370,902,907,1809,花壇,乙簡
2020-03-03,3370,826,913,1739,花壇,乙簡
2020-03-04,3370,847,907,1754,花壇,乙簡
2020-03-05,3370,730,896,1626,花壇,乙簡
2020-03-06,3370,951,1430,2381,花壇,乙簡
2020-03-07,3370,916,1044,1960,花壇,乙簡
2020-03-08,3370,1255,985,2240,花壇,乙簡
2020-03-09,3370,950,938,1888,花壇,乙簡
2020-03-10,3370,755,858,1613,花壇,乙簡
2020-03-11,3370,825,930,1755,花壇,乙簡
2020-03-12,3370,812,966,1778,花壇,乙簡
2020-03-13,3370,965,1498,2463,花壇,乙簡
2020-03-14,3370,1009,1100,2109,花壇,乙簡
2020-03-15,3370,1501,1166,2667,花壇,乙簡
2020-03-16,3370,973,928,1901,花壇,乙簡
2020-03-17,3370,827,908,1735,花壇,乙簡
2020-03-18,3370,841,909,1750,花壇,乙簡
2020-03-19,3370,729,885,1614,花壇,乙簡
2020-03-20,3370,899,1391,2290,花壇,乙簡
2020-03-21,3370,848,965,1813,花壇,乙簡
2020-03-22,3370,1173,859,2032,花壇,乙簡
2020-03-23,3370,936,872,1808,花壇,乙簡
2020-03-24,3370,750,858,1608,花壇,乙簡
2020-03-25,3370,750,877,1627,花壇,乙簡
2020-03-26,3370,761,904,1665,花壇,乙簡
2020-03-27,3370,855,1256,2111,花壇,乙簡
2020-03-28,3370,712,856,1568,花壇,乙簡
2020-03-29,3370,948,772,1720,花壇,乙簡
2020-03-30,3370,860,908,1768,花壇,乙簡
2020-03-31,3370,759,952,1711,花壇,乙簡
2020-04-01,3370,831,1389,2220,花壇,乙簡
2020-04-02,3370,646,970,1616,花壇,乙簡
2020-04-03,3370,715,880,1595,花壇,乙簡
2020-04-04,3370,721,689,1410,花壇,乙簡
2020-04-05,3370,1165,659,1824,花壇,乙簡
2020-04-06,3370,969,778,1747,花壇,乙簡
2020-04-07,3370,720,806,1526,花壇,乙簡
2020-04-08,3370,747,811,1558,花壇,乙簡
2020-04-09,3370,729,846,1575,花壇,乙簡
2020-04-10,3370,833,1240,2073,花壇,乙簡
2020-04-11,3370,742,847,1589,花壇,乙簡
2020-04-12,3370,1025,875,1900,花壇,乙簡
2020-04-13,3370,865,877,1742,花壇,乙簡
2020-04-14,3370,736,837,1573,花壇,乙簡
2020-04-15,3370,781,833,1614,花壇,乙簡
2020-04-16,3370,758,840,1598,花壇,乙簡
2020-04-17,3370,842,1254,2096,花壇,乙簡
2020-04-18,3370,841,928,1769,花壇,乙簡
2020-04-19,3370,1049,864,1913,花壇,乙簡
2020-04-20,3370,911,813,1724,花壇,乙簡
2020-04-21,3370,729,833,1562,花壇,乙簡
2020-04-22,3370,704,840,1544,花壇,乙簡
2020-04-23,3370,710,826,1536,花壇,乙簡
2020-04-24,3370,795,1197,1992,花壇,乙簡
2020-04-25,3370,686,831,1517,花壇,乙簡
2020-04-26,3370,973,771,1744,花壇,乙簡
2020-04-27,3370,884,856,1740,花壇,乙簡
2020-04-28,3370,727,864,1591,花壇,乙簡
2020-04-29,3370,760,860,1620,花壇,乙簡
2020-04-30,3370,815,1025,1840,花壇,乙簡
2020-05-01,3370,858,1383,2241,花壇,乙簡
2020-05-02,3370,804,899,1703,花壇,乙簡
2020-05-03,3370,1154,886,2040,花壇,乙簡
2020-05-04,3370,900,865,1765,花壇,乙簡
2020-05-05,3370,802,892,1694,花壇,乙簡
2020-05-06,3370,782,890,1672,花壇,乙簡
2020-05-07,3370,778,946,1724,花壇,乙簡
2020-05-08,3370,902,1577,2479,花壇,乙簡
2020-05-09,3370,894,1142,2036,花壇,乙簡
2020-05-10,3370,1358,913,2271,花壇,乙簡
2020-05-11,3370,1052,916,1968,花壇,乙簡
2020-05-12,3370,817,868,1685,花壇,乙簡
2020-05-13,3370,794,893,1687,花壇,乙簡
2020-05-14,3370,796,872,1668,花壇,乙簡
2020-05-15,3370,943,1466,2409,花壇,乙簡
2020-05-16,3370,887,990,1877,花壇,乙簡
2020-05-17,3370,1145,1035,2180,花壇,乙簡
2020-05-18,3370,893,857,1750,花壇,乙簡
2020-05-19,3370,727,790,1517,花壇,乙簡
2020-05-20,3370,781,860,1641,花壇,乙簡
2020-05-21,3370,757,851,1608,花壇,乙簡
2020-05-22,3370,800,1185,1985,花壇,乙簡
2020-05-23,3370,883,1011,1894,花壇,乙簡
2020-05-24,3370,1296,1145,2441,花壇,乙簡
2020-05-25,3370,951,913,1864,花壇,乙簡
2020-05-26,3370,786,842,1628,花壇,乙簡
2020-05-27,3370,727,843,1570,花壇,乙簡
2020-05-28,3370,766,883,1649,花壇,乙簡
2020-05-29,3370,949,1417,2366,花壇,乙簡
2020-05-30,3370,1098,1184,2282,花壇,乙簡
2020-05-31,3370,1279,1041,2320,花壇,乙簡
2020-06-01,3370,959,895,1854,花壇,乙簡
2020-06-02,3370,791,867,1658,花壇,乙簡
2020-06-03,3370,821,954,1775,花壇,乙簡
2020-06-04,3370,816,901,1717,花壇,乙簡
2020-06-05,3370,950,1417,2367,花壇,乙簡
2020-06-06,3370,1050,1163,2213,花壇,乙簡
2020-06-07,3370,1323,1141,2464,花壇,乙簡
2020-06-08,3370,928,871,1799,花壇,乙簡
2020-06-09,3370,823,881,1704,花壇,乙簡
2020-06-10,3370,876,969,1845,花壇,乙簡
2020-06-11,3370,906,1028,1934,花壇,乙簡
2020-06-12,3370,1080,1511,2591,花壇,乙簡
2020-06-13,3370,1343,1296,2639,花壇,乙簡
2020-06-14,3370,1383,1319,2702,花壇,乙簡
2020-06-15,3370,1021,1096,2117,花壇,乙簡
2020-06-16,3370,858,953,1811,花壇,乙簡
2020-06-17,3370,802,861,1663,花壇,乙簡
2020-06-18,3370,1064,1169,2233,花壇,乙簡
2020-06-19,3370,882,1093,1975,花壇,乙簡
2020-06-20,3370,974,1153,2127,花壇,乙簡
2020-06-21,3370,1159,1058,2217,花壇,乙簡
2020-06-22,3370,993,1005,1998,花壇,乙簡
2020-06-23,3370,903,1027,1930,花壇,乙簡
2020-06-24,3370,992,1475,2467,花壇,乙簡
2020-06-25,3370,1084,1422,2506,花壇,乙簡
2020-06-26,3370,1364,1356,2720,花壇,乙簡
2020-06-27,3370,1351,1270,2621,花壇,乙簡
2020-06-28,3370,1632,1207,2839,花壇,乙簡
2020-06-29,3370,1060,992,2052,花壇,乙簡
2020-06-30,3370,874,941,1815,花壇,乙簡
2020-07-01,3370,877,900,1777,花壇,乙簡
2020-07-02,3370,857,919,1776,花壇,乙簡
2020-07-03,3370,940,1243,2183,花壇,乙簡
2020-07-04,3370,1060,1059,2119,花壇,乙簡
2020-07-05,3370,1169,1088,2257,花壇,乙簡
2020-07-06,3370,1254,1151,2405,花壇,乙簡
2020-07-07,3370,933,961,1894,花壇,乙簡
2020-07-08,3370,930,958,1888,花壇,乙簡
2020-07-09,3370,850,936,1786,花壇,乙簡
2020-07-10,3370,1052,1203,2255,花壇,乙簡
2020-07-11,3370,1183,1217,2400,花壇,乙簡
2020-07-12,3370,1588,1464,3052,花壇,乙簡
2020-07-13,3370,1095,1081,2176,花壇,乙簡
2020-07-14,3370,988,1100,2088,花壇,乙簡
2020-07-15,3370,999,1003,2002,花壇,乙簡
2020-07-16,3370,1001,1039,2040,花壇,乙簡
2020-07-17,3370,1105,1262,2367,花壇,乙簡
2020-07-18,3370,1201,1314,2515,花壇,乙簡
2020-07-19,3370,1594,1378,2972,花壇,乙簡
2020-07-20,3370,976,989,1965,花壇,乙簡
2020-07-21,3370,927,919,1846,花壇,乙簡
2020-07-22,3370,1012,966,1978,花壇,乙簡
2020-07-23,3370,935,1026,1961,花壇,乙簡
2020-07-24,3370,1145,1289,2434,花壇,乙簡
2020-07-25,3370,1283,1272,2555,花壇,乙簡
2020-07-26,3370,1372,1279,2651,花壇,乙簡
2020-07-27,3370,1050,1043,2093,花壇,乙簡
2020-07-28,3370,984,1057,2041,花壇,乙簡
2020-07-29,3370,1031,972,2003,花壇,乙簡
2020-07-30,3370,951,1002,1953,花壇,乙簡
2020-07-31,3370,1132,1270,2402,花壇,乙簡
2020-08-01,3370,1210,1309,2519,花壇,乙簡
2020-08-02,3370,1184,1124,2308,花壇,乙簡
2020-08-03,3370,966,928,1894,花壇,乙簡
2020-08-04,3370,803,862,1665,花壇,乙簡
2020-08-05,3370,884,990,1874,花壇,乙簡
2020-08-06,3370,928,1007,1935,花壇,乙簡
2020-08-07,3370,967,1399,2366,花壇,乙簡
2020-08-08,3370,1154,1386,2540,花壇,乙簡
2020-08-09,3370,1382,1102,2484,花壇,乙簡
2020-08-10,3370,1087,1003,2090,花壇,乙簡
2020-08-11,3370,852,870,1722,花壇,乙簡
2020-08-12,3370,951,960,1911,花壇,乙簡
2020-08-13,3370,959,1037,1996,花壇,乙簡
2020-08-14,3370,1185,1320,2505,花壇,乙簡
2020-08-15,3370,1365,1392,2757,花壇,乙簡
2020-08-16,3370,1558,1571,3129,花壇,乙簡
2020-08-17,3370,1089,1085,2174,花壇,乙簡
2020-08-18,3370,1074,1060,2134,花壇,乙簡
2020-08-19,3370,980,1000,1980,花壇,乙簡
2020-08-20,3370,1044,1040,2084,花壇,乙簡
2020-08-21,3370,1151,1356,2507,花壇,乙簡
2020-08-22,3370,1288,1338,2626,花壇,乙簡
2020-08-23,3370,1332,1199,2531,花壇,乙簡
2020-08-24,3370,1017,990,2007,花壇,乙簡
2020-08-25,3370,986,1002,1988,花壇,乙簡
2020-08-26,3370,933,958,1891,花壇,乙簡
2020-08-27,3370,920,906,1826,花壇,乙簡
2020-08-28,3370,1015,1158,2173,花壇,乙簡
2020-08-29,3370,1064,1179,2243,花壇,乙簡
2020-08-30,3370,1205,1104,2309,花壇,乙簡
2020-08-31,3370,991,1020,2011,花壇,乙簡
2020-09-01,3370,905,977,1882,花壇,乙簡
2020-09-02,3370,825,911,1736,花壇,乙簡
2020-09-03,3370,890,991,1881,花壇,乙簡
2020-09-04,3370,1012,1298,2310,花壇,乙簡
2020-09-05,3370,1144,1178,2322,花壇,乙簡
2020-09-06,3370,1290,1187,2477,花壇,乙簡
2020-09-07,3370,959,996,1955,花壇,乙簡
2020-09-08,3370,894,961,1855,花壇,乙簡
2020-09-09,3370,922,1010,1932,花壇,乙簡
2020-09-10,3370,872,1011,1883,花壇,乙簡
2020-09-11,3370,1029,1424,2453,花壇,乙簡
2020-09-12,3370,1316,1366,2682,花壇,乙簡
2020-09-13,3370,1610,1392,3002,花壇,乙簡
2020-09-14,3370,1017,1016,2033,花壇,乙簡
2020-09-15,3370,831,918,1749,花壇,乙簡
2020-09-16,3370,859,929,1788,花壇,乙簡
2020-09-17,3370,874,957,1831,花壇,乙簡
2020-09-18,3370,997,1590,2587,花壇,乙簡
2020-09-19,3370,1306,1395,2701,花壇,乙簡
2020-09-20,3370,1572,1323,2895,花壇,乙簡
2020-09-21,3370,983,938,1921,花壇,乙簡
2020-09-22,3370,818,901,1719,花壇,乙簡
2020-09-23,3370,813,961,1774,花壇,乙簡
2020-09-24,3370,810,947,1757,花壇,乙簡
2020-09-25,3370,889,1148,2037,花壇,乙簡
2020-09-26,3370,1024,1236,2260,花壇,乙簡
2020-09-27,3370,1235,1134,2369,花壇,乙簡
2020-09-28,3370,876,931,1807,花壇,乙簡
2020-09-29,3370,822,1013,1835,花壇,乙簡
2020-09-30,3370,950,1840,2790,花壇,乙簡
2020-10-01,3370,1185,1830,3015,花壇,乙簡
2020-10-02,3370,1476,1564,3040,花壇,乙簡
2020-10-03,3370,1655,1499,3154,花壇,乙簡
2020-10-04,3370,1891,1158,3049,花壇,乙簡
2020-10-05,3370,1061,945,2006,花壇,乙簡
2020-10-06,3370,876,920,1796,花壇,乙簡
2020-10-07,3370,864,996,1860,花壇,乙簡
2020-10-08,3370,942,1575,2517,花壇,乙簡
2020-10-09,3370,1233,1450,2683,花壇,乙簡
2020-10-10,3370,1367,1393,2760,花壇,乙簡
2020-10-11,3370,1716,1362,3078,花壇,乙簡
2020-10-12,3370,1038,960,1998,花壇,乙簡
2020-10-13,3370,896,960,1856,花壇,乙簡
2020-10-14,3370,912,968,1880,花壇,乙簡
2020-10-15,3370,829,1006,1835,花壇,乙簡
2020-10-16,3370,1015,1486,2501,花壇,乙簡
2020-10-17,3370,1287,1436,2723,花壇,乙簡
2020-10-18,3370,1679,1556,3235,花壇,乙簡
2020-10-19,3370,1035,934,1969,花壇,乙簡
2020-10-20,3370,916,1033,1949,花壇,乙簡
2020-10-21,3370,858,964,1822,花壇,乙簡
2020-10-22,3370,883,1005,1888,花壇,乙簡
2020-10-23,3370,950,1466,2416,花壇,乙簡
2020-10-24,3370,1249,1454,2703,花壇,乙簡
2020-10-25,3370,1480,1269,2749,花壇,乙簡
2020-10-26,3370,1060,975,2035,花壇,乙簡
2020-10-27,3370,878,953,1831,花壇,乙簡
2020-10-28,3370,865,986,1851,花壇,乙簡
2020-10-29,3370,882,1039,1921,花壇,乙簡
2020-10-30,3370,1022,1546,2568,花壇,乙簡
2020-10-31,3370,1335,1427,2762,花壇,乙簡
2020-11-01,3370,1639,1364,3003,花壇,乙簡
2020-11-02,3370,999,947,1946,花壇,乙簡
2020-11-03,3370,844,943,1787,花壇,乙簡
2020-11-04,3370,892,962,1854,花壇,乙簡
2020-11-05,3370,855,1009,1864,花壇,乙簡
2020-11-06,3370,1018,1527,2545,花壇,乙簡
2020-11-07,3370,1288,1433,2721,花壇,乙簡
2020-11-08,3370,1704,1433,3137,花壇,乙簡
2020-11-09,3370,965,976,1941,花壇,乙簡
2020-11-10,3370,967,1040,2007,花壇,乙簡
2020-11-11,3370,915,990,1905,花壇,乙簡
2020-11-12,3370,911,1095,2006,花壇,乙簡
2020-11-13,3370,992,1603,2595,花壇,乙簡
2020-11-14,3370,1468,1539,3007,花壇,乙簡
2020-11-15,3370,1849,1457,3306,花壇,乙簡
2020-11-16,3370,1090,1052,2142,花壇,乙簡
2020-11-17,3370,931,1027,1958,花壇,乙簡
2020-11-18,3370,988,1113,2101,花壇,乙簡
2020-11-19,3370,921,1068,1989,花壇,乙簡
2020-11-20,3370,1149,1594,2743,花壇,乙簡
2020-11-21,3370,1477,1598,3075,花壇,乙簡
2020-11-22,3370,1738,1422,3160,花壇,乙簡
2020-11-23,3370,1058,1020,2078,花壇,乙簡
2020-11-24,3370,925,1003,1928,花壇,乙簡
2020-11-25,3370,904,1014,1918,花壇,乙簡
2020-11-26,3370,905,1011,1916,花壇,乙簡
2020-11-27,3370,1066,1569,2635,花壇,乙簡
2020-11-28,3370,1286,1407,2693,花壇,乙簡
2020-11-29,3370,1544,1283,2827,花壇,乙簡
2020-11-30,3370,1050,966,2016,花壇,乙簡
2020-12-01,3370,850,914,1764,花壇,乙簡
2020-12-02,3370,860,1002,1862,花壇,乙簡
2020-12-03,3370,823,993,1816,花壇,乙簡
2020-12-04,3370,994,1554,2548,花壇,乙簡
2020-12-05,3370,1274,1427,2701,花壇,乙簡
2020-12-06,3370,1629,1293,2922,花壇,乙簡
2020-12-07,3370,996,934,1930,花壇,乙簡
2020-12-08,3370,934,1022,1956,花壇,乙簡
2020-12-09,3370,792,884,1676,花壇,乙簡
2020-12-10,3370,806,947,1753,花壇,乙簡
2020-12-11,3370,1032,1567,2599,花壇,乙簡
2020-12-12,3370,1465,1652,3117,花壇,乙簡
2020-12-13,3370,1841,1485,3326,花壇,乙簡
2020-12-14,3370,1093,1037,2130,花壇,乙簡
2020-12-15,3370,832,954,1786,花壇,乙簡
2020-12-16,3370,867,939,1806,花壇,乙簡
2020-12-17,3370,818,979,1797,花壇,乙簡
2020-12-18,3370,1050,1571,2621,花壇,乙簡
2020-12-19,3370,1395,1500,2895,花壇,乙簡
2020-12-20,3370,1665,1412,3077,花壇,乙簡
2020-12-21,3370,947,926,1873,花壇,乙簡
2020-12-22,3370,863,967,1830,花壇,乙簡
2020-12-23,3370,800,944,1744,花壇,乙簡
2020-12-24,3370,864,1024,1888,花壇,乙簡
2020-12-25,3370,1053,1562,2615,花壇,乙簡
2020-12-26,3370,1253,1408,2661,花壇,乙簡
2020-12-27,3370,1494,1242,2736,花壇,乙簡
2020-12-28,3370,1039,990,2029,花壇,乙簡
2020-12-29,3370,973,1112,2085,花壇,乙簡
2020-12-30,3370,858,1003,1861,花壇,乙簡
2020-12-31,3370,1138,1585,2723,花壇,乙簡
2020-01-01,3380,992,1093,2085,大村,簡易
2020-01-02,3380,800,859,1659,大村,簡易
2020-01-03,3380,944,973,1917,大村,簡易
2020-01-04,3380,874,959,1833,大村,簡易
2020-01-05,3380,1125,1046,2171,大村,簡易
2020-01-06,3380,759,831,1590,大村,簡易
2020-01-07,3380,744,796,1540,大村,簡易
2020-01-08,3380,784,777,1561,大村,簡易
2020-01-09,3380,787,867,1654,大村,簡易
2020-01-10,3380,1070,1339,2409,大村,簡易
2020-01-11,3380,1147,1314,2461,大村,簡易
2020-01-12,3380,1439,1130,2569,大村,簡易
2020-01-13,3380,894,859,1753,大村,簡易
2020-01-14,3380,705,751,1456,大村,簡易
2020-01-15,3380,693,741,1434,大村,簡易
2020-01-16,3380,912,1007,1919,大村,簡易
2020-01-17,3380,859,972,1831,大村,簡易
2020-01-18,3380,874,918,1792,大村,簡易
2020-01-19,3380,1067,996,2063,大村,簡易
2020-01-20,3380,720,796,1516,大村,簡易
2020-01-21,3380,741,804,1545,大村,簡易
2020-01-22,3380,772,987,1759,大村,簡易
2020-01-23,3380,853,1123,1976,大村,簡易
2020-01-24,3380,997,965,1962,大村,簡易
2020-01-25,3380,1124,1051,2175,大村,簡易
2020-01-26,3380,960,998,1958,大村,簡易
2020-01-27,3380,1215,1165,2380,大村,簡易
2020-01-28,3380,1086,976,2062,大村,簡易
2020-01-29,3380,875,732,1607,大村,簡易
2020-01-30,3380,699,607,1306,大村,簡易
2020-01-31,3380,654,694,1348,大村,簡易
2020-02-01,3380,580,575,1155,大村,簡易
2020-02-02,3380,721,696,1417,大村,簡易
2020-02-03,3380,676,632,1308,大村,簡易
2020-02-04,3380,575,582,1157,大村,簡易
2020-02-05,3380,614,578,1192,大村,簡易
2020-02-06,3380,608,646,1254,大村,簡易
2020-02-07,3380,705,780,1485,大村,簡易
2020-02-08,3380,747,723,1470,大村,簡易
2020-02-09,3380,890,910,1800,大村,簡易
2020-02-10,3380,735,717,1452,大村,簡易
2020-02-11,3380,668,667,1335,大村,簡易
2020-02-12,3380,669,637,1306,大村,簡易
2020-02-13,3380,595,587,1182,大村,簡易
2020-02-14,3380,659,737,1396,大村,簡易
2020-02-15,3380,856,844,1700,大村,簡易
2020-02-16,3380,1011,999,2010,大村,簡易
2020-02-17,3380,685,674,1359,大村,簡易
2020-02-18,3380,572,585,1157,大村,簡易
2020-02-19,3380,597,611,1208,大村,簡易
2020-02-20,3380,632,612,1244,大村,簡易
2020-02-21,3380,679,742,1421,大村,簡易
2020-02-22,3380,749,732,1481,大村,簡易
2020-02-23,3380,936,920,1856,大村,簡易
2020-02-24,3380,711,690,1401,大村,簡易
2020-02-25,3380,575,642,1217,大村,簡易
2020-02-26,3380,602,678,1280,大村,簡易
2020-02-27,3380,653,895,1548,大村,簡易
2020-02-28,3380,703,748,1451,大村,簡易
2020-02-29,3380,707,721,1428,大村,簡易
2020-03-01,3380,963,871,1834,大村,簡易
2020-03-02,3380,712,686,1398,大村,簡易
2020-03-03,3380,637,682,1319,大村,簡易
2020-03-04,3380,647,691,1338,大村,簡易
2020-03-05,3380,602,660,1262,大村,簡易
2020-03-06,3380,917,948,1865,大村,簡易
2020-03-07,3380,679,746,1425,大村,簡易
2020-03-08,3380,958,871,1829,大村,簡易
2020-03-09,3380,687,682,1369,大村,簡易
2020-03-10,3380,566,655,1221,大村,簡易
2020-03-11,3380,685,729,1414,大村,簡易
2020-03-12,3380,666,659,1325,大村,簡易
2020-03-13,3380,879,921,1800,大村,簡易
2020-03-14,3380,728,781,1509,大村,簡易
2020-03-15,3380,1175,1137,2312,大村,簡易
2020-03-16,3380,693,725,1418,大村,簡易
2020-03-17,3380,640,622,1262,大村,簡易
2020-03-18,3380,606,651,1257,大村,簡易
2020-03-19,3380,585,608,1193,大村,簡易
2020-03-20,3380,877,896,1773,大村,簡易
2020-03-21,3380,664,687,1351,大村,簡易
2020-03-22,3380,810,754,1564,大村,簡易
2020-03-23,3380,677,680,1357,大村,簡易
2020-03-24,3380,570,594,1164,大村,簡易
2020-03-25,3380,583,657,1240,大村,簡易
2020-03-26,3380,610,623,1233,大村,簡易
2020-03-27,3380,767,835,1602,大村,簡易
2020-03-28,3380,559,599,1158,大村,簡易
2020-03-29,3380,673,615,1288,大村,簡易
2020-03-30,3380,644,685,1329,大村,簡易
2020-03-31,3380,761,633,1394,大村,簡易
2020-04-01,3380,644,876,1520,大村,簡易
2020-04-02,3380,443,622,1065,大村,簡易
2020-04-03,3380,565,558,1123,大村,簡易
2020-04-04,3380,553,467,1020,大村,簡易
2020-04-05,3380,733,651,1384,大村,簡易
2020-04-06,3380,691,653,1344,大村,簡易
2020-04-07,3380,563,573,1136,大村,簡易
2020-04-08,3380,593,595,1188,大村,簡易
2020-04-09,3380,586,624,1210,大村,簡易
2020-04-10,3380,848,825,1673,大村,簡易
2020-04-11,3380,599,624,1223,大村,簡易
2020-04-12,3380,718,703,1421,大村,簡易
2020-04-13,3380,633,660,1293,大村,簡易
2020-04-14,3380,566,622,1188,大村,簡易
2020-04-15,3380,629,643,1272,大村,簡易
2020-04-16,3380,590,623,1213,大村,簡易
2020-04-17,3380,765,873,1638,大村,簡易
2020-04-18,3380,691,734,1425,大村,簡易
2020-04-19,3380,768,760,1528,大村,簡易
2020-04-20,3380,665,697,1362,大村,簡易
2020-04-21,3380,611,605,1216,大村,簡易
2020-04-22,3380,577,621,1198,大村,簡易
2020-04-23,3380,531,584,1115,大村,簡易
2020-04-24,3380,710,774,1484,大村,簡易
2020-04-25,3380,551,580,1131,大村,簡易
2020-04-26,3380,707,652,1359,大村,簡易
2020-04-27,3380,646,663,1309,大村,簡易
2020-04-28,3380,592,581,1173,大村,簡易
2020-04-29,3380,562,623,1185,大村,簡易
2020-04-30,3380,689,791,1480,大村,簡易
2020-05-01,3380,882,912,1794,大村,簡易
2020-05-02,3380,723,772,1495,大村,簡易
2020-05-03,3380,867,802,1669,大村,簡易
2020-05-04,3380,712,718,1430,大村,簡易
2020-05-05,3380,597,607,1204,大村,簡易
2020-05-06,3380,587,648,1235,大村,簡易
2020-05-07,3380,646,672,1318,大村,簡易
2020-05-08,3380,1032,1050,2082,大村,簡易
2020-05-09,3380,737,870,1607,大村,簡易
2020-05-10,3380,1019,894,1913,大村,簡易
2020-05-11,3380,777,783,1560,大村,簡易
2020-05-12,3380,668,664,1332,大村,簡易
2020-05-13,3380,627,680,1307,大村,簡易
2020-05-14,3380,682,661,1343,大村,簡易
2020-05-15,3380,918,986,1904,大村,簡易
2020-05-16,3380,706,708,1414,大村,簡易
2020-05-17,3380,888,907,1795,大村,簡易
2020-05-18,3380,701,735,1436,大村,簡易
2020-05-19,3380,534,587,1121,大村,簡易
2020-05-20,3380,578,626,1204,大村,簡易
2020-05-21,3380,592,608,1200,大村,簡易
2020-05-22,3380,826,866,1692,大村,簡易
2020-05-23,3380,712,738,1450,大村,簡易
2020-05-24,3380,1115,1048,2163,大村,簡易
2020-05-25,3380,678,727,1405,大村,簡易
2020-05-26,3380,627,648,1275,大村,簡易
2020-05-27,3380,567,638,1205,大村,簡易
2020-05-28,3380,615,627,1242,大村,簡易
2020-05-29,3380,948,930,1878,大村,簡易
2020-05-30,3380,866,828,1694,大村,簡易
2020-05-31,3380,982,972,1954,大村,簡易
2020-06-01,3380,725,753,1478,大村,簡易
2020-06-02,3380,656,661,1317,大村,簡易
2020-06-03,3380,651,682,1333,大村,簡易
2020-06-04,3380,641,638,1279,大村,簡易
2020-06-05,3380,906,949,1855,大村,簡易
2020-06-06,3380,852,852,1704,大村,簡易
2020-06-07,3380,917,923,1840,大村,簡易
2020-06-08,3380,673,700,1373,大村,簡易
2020-06-09,3380,615,633,1248,大村,簡易
2020-06-10,3380,700,744,1444,大村,簡易
2020-06-11,3380,764,681,1445,大村,簡易
2020-06-12,3380,987,1001,1988,大村,簡易
2020-06-13,3380,1011,1010,2021,大村,簡易
2020-06-14,3380,1100,1086,2186,大村,簡易
2020-06-15,3380,750,795,1545,大村,簡易
2020-06-16,3380,674,749,1423,大村,簡易
2020-06-17,3380,663,673,1336,大村,簡易
2020-06-18,3380,748,794,1542,大村,簡易
2020-06-19,3380,788,749,1537,大村,簡易
2020-06-20,3380,791,814,1605,大村,簡易
2020-06-21,3380,899,929,1828,大村,簡易
2020-06-22,3380,761,792,1553,大村,簡易
2020-06-23,3380,672,697,1369,大村,簡易
2020-06-24,3380,775,948,1723,大村,簡易
2020-06-25,3380,768,870,1638,大村,簡易
2020-06-26,3380,863,851,1714,大村,簡易
2020-06-27,3380,1041,842,1883,大村,簡易
2020-06-28,3380,1120,990,2110,大村,簡易
2020-06-29,3380,754,694,1448,大村,簡易
2020-06-30,3380,619,628,1247,大村,簡易
2020-07-01,3380,606,628,1234,大村,簡易
2020-07-02,3380,623,630,1253,大村,簡易
2020-07-03,3380,735,813,1548,大村,簡易
2020-07-04,3380,756,705,1461,大村,簡易
2020-07-05,3380,825,854,1679,大村,簡易
2020-07-06,3380,918,778,1696,大村,簡易
2020-07-07,3380,661,652,1313,大村,簡易
2020-07-08,3380,680,681,1361,大村,簡易
2020-07-09,3380,674,686,1360,大村,簡易
2020-07-10,3380,767,805,1572,大村,簡易
2020-07-11,3380,1017,920,1937,大村,簡易
2020-07-12,3380,1013,1016,2029,大村,簡易
2020-07-13,3380,750,755,1505,大村,簡易
2020-07-14,3380,725,794,1519,大村,簡易
2020-07-15,3380,760,742,1502,大村,簡易
2020-07-16,3380,704,689,1393,大村,簡易
2020-07-17,3380,813,837,1650,大村,簡易
2020-07-18,3380,903,848,1751,大村,簡易
2020-07-19,3380,1149,1081,2230,大村,簡易
2020-07-20,3380,737,737,1474,大村,簡易
2020-07-21,3380,668,640,1308,大村,簡易
2020-07-22,3380,653,647,1300,大村,簡易
2020-07-23,3380,700,695,1395,大村,簡易
2020-07-24,3380,756,840,1596,大村,簡易
2020-07-25,3380,880,853,1733,大村,簡易
2020-07-26,3380,975,905,1880,大村,簡易
2020-07-27,3380,734,700,1434,大村,簡易
2020-07-28,3380,608,616,1224,大村,簡易
2020-07-29,3380,657,668,1325,大村,簡易
2020-07-30,3380,712,755,1467,大村,簡易
2020-07-31,3380,760,869,1629,大村,簡易
2020-08-01,3380,819,810,1629,大村,簡易
2020-08-02,3380,916,809,1725,大村,簡易
2020-08-03,3380,619,645,1264,大村,簡易
2020-08-04,3380,629,648,1277,大村,簡易
2020-08-05,3380,677,695,1372,大村,簡易
2020-08-06,3380,679,695,1374,大村,簡易
2020-08-07,3380,750,951,1701,大村,簡易
2020-08-08,3380,713,802,1515,大村,簡易
2020-08-09,3380,1092,933,2025,大村,簡易
2020-08-10,3380,771,755,1526,大村,簡易
2020-08-11,3380,614,611,1225,大村,簡易
2020-08-12,3380,655,657,1312,大村,簡易
2020-08-13,3380,749,748,1497,大村,簡易
2020-08-14,3380,828,940,1768,大村,簡易
2020-08-15,3380,896,842,1738,大村,簡易
2020-08-16,3380,1095,993,2088,大村,簡易
2020-08-17,3380,789,775,1564,大村,簡易
2020-08-18,3380,687,726,1413,大村,簡易
2020-08-19,3380,692,676,1368,大村,簡易
2020-08-20,3380,696,687,1383,大村,簡易
2020-08-21,3380,792,888,1680,大村,簡易
2020-08-22,3380,801,805,1606,大村,簡易
2020-08-23,3380,922,877,1799,大村,簡易
2020-08-24,3380,736,745,1481,大村,簡易
2020-08-25,3380,700,690,1390,大村,簡易
2020-08-26,3380,673,660,1333,大村,簡易
2020-08-27,3380,659,697,1356,大村,簡易
2020-08-28,3380,673,825,1498,大村,簡易
2020-08-29,3380,778,778,1556,大村,簡易
2020-08-30,3380,823,766,1589,大村,簡易
2020-08-31,3380,728,751,1479,大村,簡易
2020-09-01,3380,612,675,1287,大村,簡易
2020-09-02,3380,645,643,1288,大村,簡易
2020-09-03,3380,651,696,1347,大村,簡易
2020-09-04,3380,764,913,1677,大村,簡易
2020-09-05,3380,805,821,1626,大村,簡易
2020-09-06,3380,1041,935,1976,大村,簡易
2020-09-07,3380,757,749,1506,大村,簡易
2020-09-08,3380,716,733,1449,大村,簡易
2020-09-09,3380,791,782,1573,大村,簡易
2020-09-10,3380,735,728,1463,大村,簡易
2020-09-11,3380,1058,1037,2095,大村,簡易
2020-09-12,3380,942,873,1815,大村,簡易
2020-09-13,3380,1155,1113,2268,大村,簡易
2020-09-14,3380,758,790,1548,大村,簡易
2020-09-15,3380,683,682,1365,大村,簡易
2020-09-16,3380,691,726,1417,大村,簡易
2020-09-17,3380,791,776,1567,大村,簡易
2020-09-18,3380,1056,1088,2144,大村,簡易
2020-09-19,3380,947,919,1866,大村,簡易
2020-09-20,3380,1154,1105,2259,大村,簡易
2020-09-21,3380,769,755,1524,大村,簡易
2020-09-22,3380,697,740,1437,大村,簡易
2020-09-23,3380,703,726,1429,大村,簡易
2020-09-24,3380,747,740,1487,大村,簡易
2020-09-25,3380,797,872,1669,大村,簡易
2020-09-26,3380,850,863,1713,大村,簡易
2020-09-27,3380,967,962,1929,大村,簡易
2020-09-28,3380,750,760,1510,大村,簡易
2020-09-29,3380,760,765,1525,大村,簡易
2020-09-30,3380,1102,1207,2309,大村,簡易
2020-10-01,3380,943,1153,2096,大村,簡易
2020-10-02,3380,1070,1084,2154,大村,簡易
2020-10-03,3380,1101,925,2026,大村,簡易
2020-10-04,3380,1334,1080,2414,大村,簡易
2020-10-05,3380,807,772,1579,大村,簡易
2020-10-06,3380,740,739,1479,大村,簡易
2020-10-07,3380,703,723,1426,大村,簡易
2020-10-08,3380,1023,1036,2059,大村,簡易
2020-10-09,3380,969,1024,1993,大村,簡易
2020-10-10,3380,935,780,1715,大村,簡易
2020-10-11,3380,1164,1055,2219,大村,簡易
2020-10-12,3380,824,826,1650,大村,簡易
2020-10-13,3380,745,751,1496,大村,簡易
2020-10-14,3380,716,771,1487,大村,簡易
2020-10-15,3380,790,817,1607,大村,簡易
2020-10-16,3380,1024,1037,2061,大村,簡易
2020-10-17,3380,973,972,1945,大村,簡易
2020-10-18,3380,1143,1125,2268,大村,簡易
2020-10-19,3380,817,805,1622,大村,簡易
2020-10-20,3380,738,763,1501,大村,簡易
2020-10-21,3380,723,723,1446,大村,簡易
2020-10-22,3380,753,750,1503,大村,簡易
2020-10-23,3380,1017,1033,2050,大村,簡易
2020-10-24,3380,966,1024,1990,大村,簡易
2020-10-25,3380,1095,1030,2125,大村,簡易
2020-10-26,3380,850,830,1680,大村,簡易
2020-10-27,3380,698,761,1459,大村,簡易
2020-10-28,3380,774,744,1518,大村,簡易
2020-10-29,3380,764,787,1551,大村,簡易
2020-10-30,3380,974,1012,1986,大村,簡易
2020-10-31,3380,977,994,1971,大村,簡易
2020-11-01,3380,1200,1065,2265,大村,簡易
2020-11-02,3380,766,776,1542,大村,簡易
2020-11-03,3380,714,730,1444,大村,簡易
2020-11-04,3380,768,729,1497,大村,簡易
2020-11-05,3380,754,796,1550,大村,簡易
2020-11-06,3380,1020,1043,2063,大村,簡易
2020-11-07,3380,959,902,1861,大村,簡易
2020-11-08,3380,1151,1072,2223,大村,簡易
2020-11-09,3380,730,770,1500,大村,簡易
2020-11-10,3380,741,755,1496,大村,簡易
2020-11-11,3380,775,780,1555,大村,簡易
2020-11-12,3380,814,810,1624,大村,簡易
2020-11-13,3380,1040,1086,2126,大村,簡易
2020-11-14,3380,1100,1128,2228,大村,簡易
2020-11-15,3380,1289,1222,2511,大村,簡易
2020-11-16,3380,817,817,1634,大村,簡易
2020-11-17,3380,747,757,1504,大村,簡易
2020-11-18,3380,744,799,1543,大村,簡易
2020-11-19,3380,834,842,1676,大村,簡易
2020-11-20,3380,1072,1097,2169,大村,簡易
2020-11-21,3380,984,1010,1994,大村,簡易
2020-11-22,3380,1273,1204,2477,大村,簡易
2020-11-23,3380,811,797,1608,大村,簡易
2020-11-24,3380,716,717,1433,大村,簡易
2020-11-25,3380,733,766,1499,大村,簡易
2020-11-26,3380,777,782,1559,大村,簡易
2020-11-27,3380,1000,1073,2073,大村,簡易
2020-11-28,3380,984,918,1902,大村,簡易
2020-11-29,3380,1058,1062,2120,大村,簡易
2020-11-30,3380,805,821,1626,大村,簡易
2020-12-01,3380,739,755,1494,大村,簡易
2020-12-02,3380,742,759,1501,大村,簡易
2020-12-03,3380,740,774,1514,大村,簡易
2020-12-04,3380,1069,1060,2129,大村,簡易
2020-12-05,3380,958,964,1922,大村,簡易
2020-12-06,3380,1204,1098,2302,大村,簡易
2020-12-07,3380,750,778,1528,大村,簡易
2020-12-08,3380,730,758,1488,大村,簡易
2020-12-09,3380,671,716,1387,大村,簡易
2020-12-10,3380,753,786,1539,大村,簡易
2020-12-11,3380,1145,1120,2265,大村,簡易
2020-12-12,3380,1105,1032,2137,大村,簡易
2020-12-13,3380,1327,1353,2680,大村,簡易
2020-12-14,3380,887,888,1775,大村,簡易
2020-12-15,3380,709,751,1460,大村,簡易
2020-12-16,3380,795,849,1644,大村,簡易
2020-12-17,3380,790,792,1582,大村,簡易
2020-12-18,3380,976,1138,2114,大村,簡易
2020-12-19,3380,1142,1111,2253,大村,簡易
2020-12-20,3380,1276,1103,2379,大村,簡易
2020-12-21,3380,729,772,1501,大村,簡易
2020-12-22,3380,720,762,1482,大村,簡易
2020-12-23,3380,705,732,1437,大村,簡易
2020-12-24,3380,759,774,1533,大村,簡易
2020-12-25,3380,1099,1085,2184,大村,簡易
2020-12-26,3380,963,953,1916,大村,簡易
2020-12-27,3380,1110,1063,2173,大村,簡易
2020-12-28,3380,770,764,1534,大村,簡易
2020-12-29,3380,685,698,1383,大村,簡易
2020-12-30,3380,710,771,1481,大村,簡易
2020-12-31,3380,1188,1166,2354,大村,簡易
2020-01-01,3390,8396,9287,17683,員林,一等
2020-01-02,3390,7211,7241,14452,員林,一等
2020-01-03,3390,8481,9440,17921,員林,一等
2020-01-04,3390,8309,8799,17108,員林,一等
2020-01-05,3390,9237,8238,17475,員林,一等
2020-01-06,3390,7589,7352,14941,員林,一等
2020-01-07,3390,7203,6977,14180,員林,一等
2020-01-08,3390,7147,7210,14357,員林,一等
2020-01-09,3390,7129,7857,14986,員林,一等
2020-01-10,3390,9649,13694,23343,員林,一等
2020-01-11,3390,10263,10973,21236,員林,一等
2020-01-12,3390,12265,8930,21195,員林,一等
2020-01-13,3390,8679,7736,16415,員林,一等
2020-01-14,3390,7676,7630,15306,員林,一等
2020-01-15,3390,7591,7756,15347,員林,一等
2020-01-16,3390,9629,9418,19047,員林,一等
2020-01-17,3390,8873,9615,18488,員林,一等
2020-01-18,3390,8491,8598,17089,員林,一等
2020-01-19,3390,8527,7855,16382,員林,一等
2020-01-20,3390,8105,8392,16497,員林,一等
2020-01-21,3390,7962,8792,16754,員林,一等
2020-01-22,3390,8675,10857,19532,員林,一等
2020-01-23,3390,7748,11132,18880,員林,一等
2020-01-24,3390,6119,7969,14088,員林,一等
2020-01-25,3390,8556,8127,16683,員林,一等
2020-01-26,3390,8377,8297,16674,員林,一等
2020-01-27,3390,10818,9569,20387,員林,一等
2020-01-28,3390,9982,8759,18741,員林,一等
2020-01-29,3390,9146,7326,16472,員林,一等
2020-01-30,3390,7456,6595,14051,員林,一等
2020-01-31,3390,7082,7424,14506,員林,一等
2020-02-01,3390,5878,6094,11972,員林,一等
2020-02-02,3390,6740,5940,12680,員林,一等
2020-02-03,3390,6758,6536,13294,員林,一等
2020-02-04,3390,6118,6168,12286,員林,一等
2020-02-05,3390,6204,6254,12458,員林,一等
2020-02-06,3390,6621,6555,13176,員林,一等
2020-02-07,3390,7056,8244,15300,員林,一等
2020-02-08,3390,6240,6942,13182,員林,一等
2020-02-09,3390,7976,6973,14949,員林,一等
2020-02-10,3390,7000,6859,13859,員林,一等
2020-02-11,3390,6435,6479,12914,員林,一等
2020-02-12,3390,6498,6531,13029,員林,一等
2020-02-13,3390,6136,6225,12361,員林,一等
2020-02-14,3390,7218,7761,14979,員林,一等
2020-02-15,3390,6963,7567,14530,員林,一等
2020-02-16,3390,7371,6771,14142,員林,一等
2020-02-17,3390,6401,6217,12618,員林,一等
2020-02-18,3390,5815,5759,11574,員林,一等
2020-02-19,3390,5749,5820,11569,員林,一等
2020-02-20,3390,6214,6176,12390,員林,一等
2020-02-21,3390,6466,7664,14130,員林,一等
2020-02-22,3390,6165,6676,12841,員林,一等
2020-02-23,3390,7472,6440,13912,員林,一等
2020-02-24,3390,6826,6123,12949,員林,一等
2020-02-25,3390,6578,6361,12939,員林,一等
2020-02-26,3390,6703,6685,13388,員林,一等
2020-02-27,3390,7857,9827,17684,員林,一等
2020-02-28,3390,6830,7931,14761,員林,一等
2020-02-29,3390,6123,6157,12280,員林,一等
2020-03-01,3390,9267,6475,15742,員林,一等
2020-03-02,3390,6923,6546,13469,員林,一等
2020-03-03,3390,6111,6033,12144,員林,一等
2020-03-04,3390,6091,6050,12141,員林,一等
2020-03-05,3390,5953,5963,11916,員林,一等
2020-03-06,3390,7797,9821,17618,員林,一等
2020-03-07,3390,5933,6661,12594,員林,一等
2020-03-08,3390,8287,6524,14811,員林,一等
2020-03-09,3390,6815,6299,13114,員林,一等
2020-03-10,3390,5847,5646,11493,員林,一等
2020-03-11,3390,6364,6321,12685,員林,一等
2020-03-12,3390,6558,6519,13077,員林,一等
2020-03-13,3390,7956,10370,18326,員林,一等
2020-03-14,3390,5938,6700,12638,員林,一等
2020-03-15,3390,9547,7523,17070,員林,一等
2020-03-16,3390,7034,6685,13719,員林,一等
2020-03-17,3390,6321,6226,12547,員林,一等
2020-03-18,3390,6274,6162,12436,員林,一等
2020-03-19,3390,6042,6067,12109,員林,一等
2020-03-20,3390,7481,9735,17216,員林,一等
2020-03-21,3390,5504,6302,11806,員林,一等
2020-03-22,3390,7540,5837,13377,員林,一等
2020-03-23,3390,6572,6050,12622,員林,一等
2020-03-24,3390,5946,5778,11724,員林,一等
2020-03-25,3390,5963,5809,11772,員林,一等
2020-03-26,3390,5895,5959,11854,員林,一等
2020-03-27,3390,7435,9005,16440,員林,一等
2020-03-28,3390,4674,5444,10118,員林,一等
2020-03-29,3390,6238,5297,11535,員林,一等
2020-03-30,3390,6516,6005,12521,員林,一等
2020-03-31,3390,6834,6632,13466,員林,一等
2020-04-01,3390,7265,9945,17210,員林,一等
2020-04-02,3390,4896,7202,12098,員林,一等
2020-04-03,3390,5304,6101,11405,員林,一等
2020-04-04,3390,4758,3994,8752,員林,一等
2020-04-05,3390,8458,5466,13924,員林,一等
2020-04-06,3390,7058,5574,12632,員林,一等
2020-04-07,3390,5636,5259,10895,員林,一等
2020-04-08,3390,5550,5420,10970,員林,一等
2020-04-09,3390,5526,5536,11062,員林,一等
2020-04-10,3390,7221,8104,15325,員林,一等
2020-04-11,3390,4702,5273,9975,員林,一等
2020-04-12,3390,6820,5564,12384,員林,一等
2020-04-13,3390,6212,6156,12368,員林,一等
2020-04-14,3390,5842,5586,11428,員林,一等
2020-04-15,3390,5777,5632,11409,員林,一等
2020-04-16,3390,5943,5965,11908,員林,一等
2020-04-17,3390,7425,9093,16518,員林,一等
2020-04-18,3390,5563,6208,11771,員林,一等
2020-04-19,3390,7266,5853,13119,員林,一等
2020-04-20,3390,6351,5957,12308,員林,一等
2020-04-21,3390,5523,5479,11002,員林,一等
2020-04-22,3390,5447,5307,10754,員林,一等
2020-04-23,3390,5470,5697,11167,員林,一等
2020-04-24,3390,6467,8075,14542,員林,一等
2020-04-25,3390,4591,5265,9856,員林,一等
2020-04-26,3390,6190,4775,10965,員林,一等
2020-04-27,3390,6077,5671,11748,員林,一等
2020-04-28,3390,5618,5536,11154,員林,一等
2020-04-29,3390,5599,5568,11167,員林,一等
2020-04-30,3390,6183,7126,13309,員林,一等
2020-05-01,3390,7269,9350,16619,員林,一等
2020-05-02,3390,5372,5817,11189,員林,一等
2020-05-03,3390,8301,5971,14272,員林,一等
2020-05-04,3390,6801,6089,12890,員林,一等
2020-05-05,3390,5824,5654,11478,員林,一等
2020-05-06,3390,5855,5841,11696,員林,一等
2020-05-07,3390,6147,6493,12640,員林,一等
2020-05-08,3390,7968,11350,19318,員林,一等
2020-05-09,3390,6045,7627,13672,員林,一等
2020-05-10,3390,9573,6554,16127,員林,一等
2020-05-11,3390,7472,6432,13904,員林,一等
2020-05-12,3390,6142,5903,12045,員林,一等
2020-05-13,3390,6174,6044,12218,員林,一等
2020-05-14,3390,6067,6291,12358,員林,一等
2020-05-15,3390,8660,10322,18982,員林,一等
2020-05-16,3390,5959,6480,12439,員林,一等
2020-05-17,3390,7959,6582,14541,員林,一等
2020-05-18,3390,6661,6120,12781,員林,一等
2020-05-19,3390,5495,5422,10917,員林,一等
2020-05-20,3390,5994,5971,11965,員林,一等
2020-05-21,3390,5797,5979,11776,員林,一等
2020-05-22,3390,6672,8711,15383,員林,一等
2020-05-23,3390,5822,5436,11258,員林,一等
2020-05-24,3390,8554,7130,15684,員林,一等
2020-05-25,3390,6933,6459,13392,員林,一等
2020-05-26,3390,5917,5674,11591,員林,一等
2020-05-27,3390,5686,5654,11340,員林,一等
2020-05-28,3390,5864,6008,11872,員林,一等
2020-05-29,3390,7825,10014,17839,員林,一等
2020-05-30,3390,6896,7761,14657,員林,一等
2020-05-31,3390,9175,7292,16467,員林,一等
2020-06-01,3390,6904,6361,13265,員林,一等
2020-06-02,3390,6195,6077,12272,員林,一等
2020-06-03,3390,6170,6188,12358,員林,一等
2020-06-04,3390,6336,6414,12750,員林,一等
2020-06-05,3390,7879,10003,17882,員林,一等
2020-06-06,3390,7234,7929,15163,員林,一等
2020-06-07,3390,8640,7156,15796,員林,一等
2020-06-08,3390,6629,6188,12817,員林,一等
2020-06-09,3390,6054,6049,12103,員林,一等
2020-06-10,3390,6591,6448,13039,員林,一等
2020-06-11,3390,6808,6802,13610,員林,一等
2020-06-12,3390,8386,10163,18549,員林,一等
2020-06-13,3390,8636,8881,17517,員林,一等
2020-06-14,3390,9510,8201,17711,員林,一等
2020-06-15,3390,8688,7845,16533,員林,一等
2020-06-16,3390,7123,7164,14287,員林,一等
2020-06-17,3390,6545,6561,13106,員林,一等
2020-06-18,3390,6645,7334,13979,員林,一等
2020-06-19,3390,6896,7623,14519,員林,一等
2020-06-20,3390,7140,7641,14781,員林,一等
2020-06-21,3390,7719,7369,15088,員林,一等
2020-06-22,3390,7216,6813,14029,員林,一等
2020-06-23,3390,6791,7008,13799,員林,一等
2020-06-24,3390,8190,10884,19074,員林,一等
2020-06-25,3390,7453,9851,17304,員林,一等
2020-06-26,3390,8592,8835,17427,員林,一等
2020-06-27,3390,8589,7818,16407,員林,一等
2020-06-28,3390,10592,7714,18306,員林,一等
2020-06-29,3390,7761,6639,14400,員林,一等
2020-06-30,3390,6705,6500,13205,員林,一等
2020-07-01,3390,6440,6407,12847,員林,一等
2020-07-02,3390,6282,6388,12670,員林,一等
2020-07-03,3390,7085,8164,15249,員林,一等
2020-07-04,3390,6992,7211,14203,員林,一等
2020-07-05,3390,7750,7155,14905,員林,一等
2020-07-06,3390,8468,7204,15672,員林,一等
2020-07-07,3390,6638,6628,13266,員林,一等
2020-07-08,3390,6636,6630,13266,員林,一等
2020-07-09,3390,6785,6786,13571,員林,一等
2020-07-10,3390,8160,9672,17832,員林,一等
2020-07-11,3390,7759,8238,15997,員林,一等
2020-07-12,3390,8975,8011,16986,員林,一等
2020-07-13,3390,7585,7293,14878,員林,一等
2020-07-14,3390,7937,7205,15142,員林,一等
2020-07-15,3390,7257,7383,14640,員林,一等
2020-07-16,3390,6967,7078,14045,員林,一等
2020-07-17,3390,7716,8948,16664,員林,一等
2020-07-18,3390,8062,8633,16695,員林,一等
2020-07-19,3390,9156,8128,17284,員林,一等
2020-07-20,3390,7451,6662,14113,員林,一等
2020-07-21,3390,6665,6775,13440,員林,一等
2020-07-22,3390,7007,7008,14015,員林,一等
2020-07-23,3390,6744,6986,13730,員林,一等
2020-07-24,3390,7613,8777,16390,員林,一等
2020-07-25,3390,7851,8441,16292,員林,一等
2020-07-26,3390,8746,7650,16396,員林,一等
2020-07-27,3390,7562,6822,14384,員林,一等
2020-07-28,3390,6867,6598,13465,員林,一等
2020-07-29,3390,6665,6565,13230,員林,一等
2020-07-30,3390,6693,6879,13572,員林,一等
2020-07-31,3390,7713,8872,16585,員林,一等
2020-08-01,3390,7193,7867,15060,員林,一等
2020-08-02,3390,8415,7043,15458,員林,一等
2020-08-03,3390,6600,6236,12836,員林,一等
2020-08-04,3390,6353,6119,12472,員林,一等
2020-08-05,3390,6819,6169,12988,員林,一等
2020-08-06,3390,6848,7152,14000,員林,一等
2020-08-07,3390,7847,10407,18254,員林,一等
2020-08-08,3390,7021,8334,15355,員林,一等
2020-08-09,3390,9950,7659,17609,員林,一等
2020-08-10,3390,7810,7049,14859,員林,一等
2020-08-11,3390,6716,6440,13156,員林,一等
2020-08-12,3390,6737,6826,13563,員林,一等
2020-08-13,3390,7188,7382,14570,員林,一等
2020-08-14,3390,8533,9742,18275,員林,一等
2020-08-15,3390,7941,8446,16387,員林,一等
2020-08-16,3390,9809,8834,18643,員林,一等
2020-08-17,3390,8028,7583,15611,員林,一等
2020-08-18,3390,7340,7376,14716,員林,一等
2020-08-19,3390,7143,7239,14382,員林,一等
2020-08-20,3390,7292,7390,14682,員林,一等
2020-08-21,3390,8261,9326,17587,員林,一等
2020-08-22,3390,7657,8108,15765,員林,一等
2020-08-23,3390,8582,7609,16191,員林,一等
2020-08-24,3390,7786,7542,15328,員林,一等
2020-08-25,3390,7295,7242,14537,員林,一等
2020-08-26,3390,6771,6945,13716,員林,一等
2020-08-27,3390,6307,6665,12972,員林,一等
2020-08-28,3390,7215,8872,16087,員林,一等
2020-08-29,3390,7054,7526,14580,員林,一等
2020-08-30,3390,7936,6889,14825,員林,一等
2020-08-31,3390,7182,6996,14178,員林,一等
2020-09-01,3390,6523,6679,13202,員林,一等
2020-09-02,3390,6100,6158,12258,員林,一等
2020-09-03,3390,6955,6952,13907,員林,一等
2020-09-04,3390,7694,9093,16787,員林,一等
2020-09-05,3390,7264,7792,15056,員林,一等
2020-09-06,3390,8739,7224,15963,員林,一等
2020-09-07,3390,7305,6916,14221,員林,一等
2020-09-08,3390,6695,6884,13579,員林,一等
2020-09-09,3390,6517,6701,13218,員林,一等
2020-09-10,3390,6704,6976,13680,員林,一等
2020-09-11,3390,8457,9583,18040,員林,一等
2020-09-12,3390,7807,8489,16296,員林,一等
2020-09-13,3390,10104,8393,18497,員林,一等
2020-09-14,3390,7000,6368,13368,員林,一等
2020-09-15,3390,6307,6286,12593,員林,一等
2020-09-16,3390,6462,6458,12920,員林,一等
2020-09-17,3390,6643,6730,13373,員林,一等
2020-09-18,3390,8371,10757,19128,員林,一等
2020-09-19,3390,7987,8754,16741,員林,一等
2020-09-20,3390,10256,8592,18848,員林,一等
2020-09-21,3390,7232,6714,13946,員林,一等
2020-09-22,3390,6333,5870,12203,員林,一等
2020-09-23,3390,6592,6793,13385,員林,一等
2020-09-24,3390,6597,6609,13206,員林,一等
2020-09-25,3390,7004,7952,14956,員林,一等
2020-09-26,3390,7496,8055,15551,員林,一等
2020-09-27,3390,7887,7056,14943,員林,一等
2020-09-28,3390,6800,6566,13366,員林,一等
2020-09-29,3390,6451,6900,13351,員林,一等
2020-09-30,3390,8816,13166,21982,員林,一等
2020-10-01,3390,8015,11447,19462,員林,一等
2020-10-02,3390,9466,9738,19204,員林,一等
2020-10-03,3390,9819,8698,18517,員林,一等
2020-10-04,3390,12649,8456,21105,員林,一等
2020-10-05,3390,8382,6866,15248,員林,一等
2020-10-06,3390,6458,6378,12836,員林,一等
2020-10-07,3390,6519,6607,13126,員林,一等
2020-10-08,3390,8307,10928,19235,員林,一等
2020-10-09,3390,8303,9701,18004,員林,一等
2020-10-10,3390,7719,7633,15352,員林,一等
2020-10-11,3390,10997,8703,19700,員林,一等
2020-10-12,3390,7398,6735,14133,員林,一等
2020-10-13,3390,6619,6479,13098,員林,一等
2020-10-14,3390,6520,6495,13015,員林,一等
2020-10-15,3390,6636,6880,13516,員林,一等
2020-10-16,3390,8132,10403,18535,員林,一等
2020-10-17,3390,8311,9096,17407,員林,一等
2020-10-18,3390,10810,9173,19983,員林,一等
2020-10-19,3390,7434,6878,14312,員林,一等
2020-10-20,3390,6572,6643,13215,員林,一等
2020-10-21,3390,6538,6496,13034,員林,一等
2020-10-22,3390,6462,6640,13102,員林,一等
2020-10-23,3390,8209,10773,18982,員林,一等
2020-10-24,3390,8263,9649,17912,員林,一等
2020-10-25,3390,10346,8265,18611,員林,一等
2020-10-26,3390,7727,6917,14644,員林,一等
2020-10-27,3390,6640,5966,12606,員林,一等
2020-10-28,3390,6565,6525,13090,員林,一等
2020-10-29,3390,6483,6742,13225,員林,一等
2020-10-30,3390,8066,10558,18624,員林,一等
2020-10-31,3390,7876,8510,16386,員林,一等
2020-11-01,3390,10113,8284,18397,員林,一等
2020-11-02,3390,7103,6592,13695,員林,一等
2020-11-03,3390,6328,6324,12652,員林,一等
2020-11-04,3390,6306,6276,12582,員林,一等
2020-11-05,3390,6541,6509,13050,員林,一等
2020-11-06,3390,8377,10514,18891,員林,一等
2020-11-07,3390,7780,8869,16649,員林,一等
2020-11-08,3390,10614,8856,19470,員林,一等
2020-11-09,3390,7294,6169,13463,員林,一等
2020-11-10,3390,6381,6389,12770,員林,一等
2020-11-11,3390,6633,6684,13317,員林,一等
2020-11-12,3390,6781,6996,13777,員林,一等
2020-11-13,3390,8558,11553,20111,員林,一等
2020-11-14,3390,8903,9656,18559,員林,一等
2020-11-15,3390,11861,9439,21300,員林,一等
2020-11-16,3390,7736,7071,14807,員林,一等
2020-11-17,3390,6752,6649,13401,員林,一等
2020-11-18,3390,6842,6825,13667,員林,一等
2020-11-19,3390,6957,7190,14147,員林,一等
2020-11-20,3390,8700,11229,19929,員林,一等
2020-11-21,3390,8701,9491,18192,員林,一等
2020-11-22,3390,10706,8671,19377,員林,一等
2020-11-23,3390,7747,7093,14840,員林,一等
2020-11-24,3390,6633,6639,13272,員林,一等
2020-11-25,3390,6699,6691,13390,員林,一等
2020-11-26,3390,6935,7017,13952,員林,一等
2020-11-27,3390,8572,10813,19385,員林,一等
2020-11-28,3390,7852,8510,16362,員林,一等
2020-11-29,3390,9803,7779,17582,員林,一等
2020-11-30,3390,7488,6868,14356,員林,一等
2020-12-01,3390,6364,6350,12714,員林,一等
2020-12-02,3390,6446,6426,12872,員林,一等
2020-12-03,3390,6548,6550,13098,員林,一等
2020-12-04,3390,8573,11065,19638,員林,一等
2020-12-05,3390,8545,9394,17939,員林,一等
2020-12-06,3390,10634,8943,19577,員林,一等
2020-12-07,3390,7676,6899,14575,員林,一等
2020-12-08,3390,6633,6714,13347,員林,一等
2020-12-09,3390,6121,6072,12193,員林,一等
2020-12-10,3390,6528,6676,13204,員林,一等
2020-12-11,3390,8793,11571,20364,員林,一等
2020-12-12,3390,9186,9956,19142,員林,一等
2020-12-13,3390,11685,9381,21066,員林,一等
2020-12-14,3390,7813,7214,15027,員林,一等
2020-12-15,3390,6585,6504,13089,員林,一等
2020-12-16,3390,6669,6621,13290,員林,一等
2020-12-17,3390,6634,6893,13527,員林,一等
2020-12-18,3390,8377,11140,19517,員林,一等
2020-12-19,3390,9328,9918,19246,員林,一等
2020-12-20,3390,10813,8818,19631,員林,一等
2020-12-21,3390,7264,6184,13448,員林,一等
2020-12-22,3390,6740,6202,12942,員林,一等
2020-12-23,3390,6295,6342,12637,員林,一等
2020-12-24,3390,6848,7207,14055,員林,一等
2020-12-25,3390,8823,10789,19612,員林,一等
2020-12-26,3390,8059,8633,16692,員林,一等
2020-12-27,3390,9630,8206,17836,員林,一等
2020-12-28,3390,7378,6849,14227,員林,一等
2020-12-29,3390,6518,6575,13093,員林,一等
2020-12-30,3390,6635,6947,13582,員林,一等
2020-12-31,3390,9142,11073,20215,員林,一等
2020-01-01,3400,533,569,1102,永靖,招呼
2020-01-02,3400,465,463,928,永靖,招呼
2020-01-03,3400,431,637,1068,永靖,招呼
2020-01-04,3400,410,655,1065,永靖,招呼
2020-01-05,3400,576,395,971,永靖,招呼
2020-01-06,3400,494,491,985,永靖,招呼
2020-01-07,3400,424,459,883,永靖,招呼
2020-01-08,3400,423,462,885,永靖,招呼
2020-01-09,3400,425,510,935,永靖,招呼
2020-01-10,3400,434,963,1397,永靖,招呼
2020-01-11,3400,551,682,1233,永靖,招呼
2020-01-12,3400,757,473,1230,永靖,招呼
2020-01-13,3400,532,523,1055,永靖,招呼
2020-01-14,3400,449,492,941,永靖,招呼
2020-01-15,3400,431,473,904,永靖,招呼
2020-01-16,3400,533,671,1204,永靖,招呼
2020-01-17,3400,668,785,1453,永靖,招呼
2020-01-18,3400,428,541,969,永靖,招呼
2020-01-19,3400,501,453,954,永靖,招呼
2020-01-20,3400,500,526,1026,永靖,招呼
2020-01-21,3400,538,583,1121,永靖,招呼
2020-01-22,3400,455,628,1083,永靖,招呼
2020-01-23,3400,374,617,991,永靖,招呼
2020-01-24,3400,248,465,713,永靖,招呼
2020-01-25,3400,355,356,711,永靖,招呼
2020-01-26,3400,316,356,672,永靖,招呼
2020-01-27,3400,526,524,1050,永靖,招呼
2020-01-28,3400,473,454,927,永靖,招呼
2020-01-29,3400,493,427,920,永靖,招呼
2020-01-30,3400,462,411,873,永靖,招呼
2020-01-31,3400,427,488,915,永靖,招呼
2020-02-01,3400,305,406,711,永靖,招呼
2020-02-02,3400,397,335,732,永靖,招呼
2020-02-03,3400,454,448,902,永靖,招呼
2020-02-04,3400,409,413,822,永靖,招呼
2020-02-05,3400,415,439,854,永靖,招呼
2020-02-06,3400,387,423,810,永靖,招呼
2020-02-07,3400,466,557,1023,永靖,招呼
2020-02-08,3400,356,473,829,永靖,招呼
2020-02-09,3400,497,393,890,永靖,招呼
2020-02-10,3400,451,452,903,永靖,招呼
2020-02-11,3400,431,402,833,永靖,招呼
2020-02-12,3400,393,428,821,永靖,招呼
2020-02-13,3400,422,428,850,永靖,招呼
2020-02-14,3400,432,497,929,永靖,招呼
2020-02-15,3400,397,490,887,永靖,招呼
2020-02-16,3400,421,374,795,永靖,招呼
2020-02-17,3400,442,451,893,永靖,招呼
2020-02-18,3400,375,404,779,永靖,招呼
2020-02-19,3400,403,410,813,永靖,招呼
2020-02-20,3400,398,460,858,永靖,招呼
2020-02-21,3400,433,532,965,永靖,招呼
2020-02-22,3400,360,461,821,永靖,招呼
2020-02-23,3400,473,393,866,永靖,招呼
2020-02-24,3400,466,485,951,永靖,招呼
2020-02-25,3400,432,467,899,永靖,招呼
2020-02-26,3400,407,478,885,永靖,招呼
2020-02-27,3400,431,730,1161,永靖,招呼
2020-02-28,3400,430,569,999,永靖,招呼
2020-02-29,3400,337,405,742,永靖,招呼
2020-03-01,3400,581,321,902,永靖,招呼
2020-03-02,3400,449,450,899,永靖,招呼
2020-03-03,3400,377,442,819,永靖,招呼
2020-03-04,3400,386,449,835,永靖,招呼
2020-03-05,3400,375,440,815,永靖,招呼
2020-03-06,3400,405,773,1178,永靖,招呼
2020-03-07,3400,314,468,782,永靖,招呼
2020-03-08,3400,587,320,907,永靖,招呼
2020-03-09,3400,482,482,964,永靖,招呼
2020-03-10,3400,339,415,754,永靖,招呼
2020-03-11,3400,425,457,882,永靖,招呼
2020-03-12,3400,415,438,853,永靖,招呼
2020-03-13,3400,444,774,1218,永靖,招呼
2020-03-14,3400,322,451,773,永靖,招呼
2020-03-15,3400,632,386,1018,永靖,招呼
2020-03-16,3400,477,473,950,永靖,招呼
2020-03-17,3400,401,441,842,永靖,招呼
2020-03-18,3400,381,431,812,永靖,招呼
2020-03-19,3400,377,429,806,永靖,招呼
2020-03-20,3400,414,743,1157,永靖,招呼
2020-03-21,3400,345,456,801,永靖,招呼
2020-03-22,3400,529,287,816,永靖,招呼
2020-03-23,3400,465,451,916,永靖,招呼
2020-03-24,3400,378,432,810,永靖,招呼
2020-03-25,3400,388,427,815,永靖,招呼
2020-03-26,3400,387,462,849,永靖,招呼
2020-03-27,3400,387,673,1060,永靖,招呼
2020-03-28,3400,255,363,618,永靖,招呼
2020-03-29,3400,426,275,701,永靖,招呼
2020-03-30,3400,467,463,930,永靖,招呼
2020-03-31,3400,364,439,803,永靖,招呼
2020-04-01,3400,381,714,1095,永靖,招呼
2020-04-02,3400,288,495,783,永靖,招呼
2020-04-03,3400,326,432,758,永靖,招呼
2020-04-04,3400,277,305,582,永靖,招呼
2020-04-05,3400,510,233,743,永靖,招呼
2020-04-06,3400,489,408,897,永靖,招呼
2020-04-07,3400,367,406,773,永靖,招呼
2020-04-08,3400,364,414,778,永靖,招呼
2020-04-09,3400,361,439,800,永靖,招呼
2020-04-10,3400,412,689,1101,永靖,招呼
2020-04-11,3400,268,363,631,永靖,招呼
2020-04-12,3400,444,287,731,永靖,招呼
2020-04-13,3400,445,444,889,永靖,招呼
2020-04-14,3400,381,415,796,永靖,招呼
2020-04-15,3400,392,445,837,永靖,招呼
2020-04-16,3400,376,461,837,永靖,招呼
2020-04-17,3400,400,701,1101,永靖,招呼
2020-04-18,3400,329,492,821,永靖,招呼
2020-04-19,3400,506,312,818,永靖,招呼
2020-04-20,3400,451,433,884,永靖,招呼
2020-04-21,3400,367,410,777,永靖,招呼
2020-04-22,3400,393,431,824,永靖,招呼
2020-04-23,3400,357,414,771,永靖,招呼
2020-04-24,3400,387,654,1041,永靖,招呼
2020-04-25,3400,310,390,700,永靖,招呼
2020-04-26,3400,427,297,724,永靖,招呼
2020-04-27,3400,446,433,879,永靖,招呼
2020-04-28,3400,371,438,809,永靖,招呼
2020-04-29,3400,385,434,819,永靖,招呼
2020-04-30,3400,370,553,923,永靖,招呼
2020-05-01,3400,389,729,1118,永靖,招呼
2020-05-02,3400,365,478,843,永靖,招呼
2020-05-03,3400,546,347,893,永靖,招呼
2020-05-04,3400,459,455,914,永靖,招呼
2020-05-05,3400,384,430,814,永靖,招呼
2020-05-06,3400,411,449,860,永靖,招呼
2020-05-07,3400,369,474,843,永靖,招呼
2020-05-08,3400,383,774,1157,永靖,招呼
2020-05-09,3400,368,603,971,永靖,招呼
2020-05-10,3400,611,316,927,永靖,招呼
2020-05-11,3400,491,447,938,永靖,招呼
2020-05-12,3400,373,411,784,永靖,招呼
2020-05-13,3400,385,446,831,永靖,招呼
2020-05-14,3400,382,450,832,永靖,招呼
2020-05-15,3400,438,792,1230,永靖,招呼
2020-05-16,3400,317,444,761,永靖,招呼
2020-05-17,3400,521,270,791,永靖,招呼
2020-05-18,3400,454,445,899,永靖,招呼
2020-05-19,3400,334,396,730,永靖,招呼
2020-05-20,3400,371,436,807,永靖,招呼
2020-05-21,3400,349,428,777,永靖,招呼
2020-05-22,3400,343,615,958,永靖,招呼
2020-05-23,3400,275,357,632,永靖,招呼
2020-05-24,3400,525,327,852,永靖,招呼
2020-05-25,3400,454,374,828,永靖,招呼
2020-05-26,3400,372,404,776,永靖,招呼
2020-05-27,3400,342,404,746,永靖,招呼
2020-05-28,3400,348,425,773,永靖,招呼
2020-05-29,3400,421,715,1136,永靖,招呼
2020-05-30,3400,458,610,1068,永靖,招呼
2020-05-31,3400,583,384,967,永靖,招呼
2020-06-01,3400,481,449,930,永靖,招呼
2020-06-02,3400,418,479,897,永靖,招呼
2020-06-03,3400,405,457,862,永靖,招呼
2020-06-04,3400,371,427,798,永靖,招呼
2020-06-05,3400,442,725,1167,永靖,招呼
2020-06-06,3400,450,608,1058,永靖,招呼
2020-06-07,3400,515,337,852,永靖,招呼
2020-06-08,3400,469,433,902,永靖,招呼
2020-06-09,3400,399,413,812,永靖,招呼
2020-06-10,3400,424,484,908,永靖,招呼
2020-06-11,3400,423,488,911,永靖,招呼
2020-06-12,3400,479,749,1228,永靖,招呼
2020-06-13,3400,507,643,1150,永靖,招呼
2020-06-14,3400,579,450,1029,永靖,招呼
2020-06-15,3400,536,609,1145,永靖,招呼
2020-06-16,3400,470,526,996,永靖,招呼
2020-06-17,3400,416,484,900,永靖,招呼
2020-06-18,3400,373,427,800,永靖,招呼
2020-06-19,3400,429,563,992,永靖,招呼
2020-06-20,3400,456,603,1059,永靖,招呼
2020-06-21,3400,494,385,879,永靖,招呼
2020-06-22,3400,530,540,1070,永靖,招呼
2020-06-23,3400,409,477,886,永靖,招呼
2020-06-24,3400,440,774,1214,永靖,招呼
2020-06-25,3400,414,670,1084,永靖,招呼
2020-06-26,3400,528,573,1101,永靖,招呼
2020-06-27,3400,436,483,919,永靖,招呼
2020-06-28,3400,649,412,1061,永靖,招呼
2020-06-29,3400,501,475,976,永靖,招呼
2020-06-30,3400,423,481,904,永靖,招呼
2020-07-01,3400,427,457,884,永靖,招呼
2020-07-02,3400,417,466,883,永靖,招呼
2020-07-03,3400,465,655,1120,永靖,招呼
2020-07-04,3400,412,470,882,永靖,招呼
2020-07-05,3400,464,414,878,永靖,招呼
2020-07-06,3400,469,491,960,永靖,招呼
2020-07-07,3400,442,484,926,永靖,招呼
2020-07-08,3400,451,524,975,永靖,招呼
2020-07-09,3400,474,526,1000,永靖,招呼
2020-07-10,3400,506,683,1189,永靖,招呼
2020-07-11,3400,465,568,1033,永靖,招呼
2020-07-12,3400,556,490,1046,永靖,招呼
2020-07-13,3400,506,508,1014,永靖,招呼
2020-07-14,3400,449,511,960,永靖,招呼
2020-07-15,3400,469,525,994,永靖,招呼
2020-07-16,3400,475,521,996,永靖,招呼
2020-07-17,3400,506,579,1085,永靖,招呼
2020-07-18,3400,462,540,1002,永靖,招呼
2020-07-19,3400,538,538,1076,永靖,招呼
2020-07-20,3400,448,397,845,永靖,招呼
2020-07-21,3400,422,419,841,永靖,招呼
2020-07-22,3400,469,469,938,永靖,招呼
2020-07-23,3400,474,493,967,永靖,招呼
2020-07-24,3400,472,613,1085,永靖,招呼
2020-07-25,3400,448,580,1028,永靖,招呼
2020-07-26,3400,577,468,1045,永靖,招呼
2020-07-27,3400,513,495,1008,永靖,招呼
2020-07-28,3400,423,483,906,永靖,招呼
2020-07-29,3400,478,501,979,永靖,招呼
2020-07-30,3400,468,490,958,永靖,招呼
2020-07-31,3400,503,657,1160,永靖,招呼
2020-08-01,3400,486,626,1112,永靖,招呼
2020-08-02,3400,499,421,920,永靖,招呼
2020-08-03,3400,432,431,863,永靖,招呼
2020-08-04,3400,437,487,924,永靖,招呼
2020-08-05,3400,422,444,866,永靖,招呼
2020-08-06,3400,421,466,887,永靖,招呼
2020-08-07,3400,448,696,1144,永靖,招呼
2020-08-08,3400,386,539,925,永靖,招呼
2020-08-09,3400,595,462,1057,永靖,招呼
2020-08-10,3400,429,453,882,永靖,招呼
2020-08-11,3400,442,447,889,永靖,招呼
2020-08-12,3400,472,481,953,永靖,招呼
2020-08-13,3400,440,494,934,永靖,招呼
2020-08-14,3400,492,671,1163,永靖,招呼
2020-08-15,3400,436,542,978,永靖,招呼
2020-08-16,3400,592,522,1114,永靖,招呼
2020-08-17,3400,522,575,1097,永靖,招呼
2020-08-18,3400,479,494,973,永靖,招呼
2020-08-19,3400,467,502,969,永靖,招呼
2020-08-20,3400,440,499,939,永靖,招呼
2020-08-21,3400,508,736,1244,永靖,招呼
2020-08-22,3400,463,537,1000,永靖,招呼
2020-08-23,3400,538,501,1039,永靖,招呼
2020-08-24,3400,501,463,964,永靖,招呼
2020-08-25,3400,515,490,1005,永靖,招呼
2020-08-26,3400,414,419,833,永靖,招呼
2020-08-27,3400,426,451,877,永靖,招呼
2020-08-28,3400,438,633,1071,永靖,招呼
2020-08-29,3400,420,536,956,永靖,招呼
2020-08-30,3400,487,390,877,永靖,招呼
2020-08-31,3400,498,521,1019,永靖,招呼
2020-09-01,3400,449,523,972,永靖,招呼
2020-09-02,3400,428,466,894,永靖,招呼
2020-09-03,3400,464,496,960,永靖,招呼
2020-09-04,3400,487,696,1183,永靖,招呼
2020-09-05,3400,449,542,991,永靖,招呼
2020-09-06,3400,562,414,976,永靖,招呼
2020-09-07,3400,495,503,998,永靖,招呼
2020-09-08,3400,411,429,840,永靖,招呼
2020-09-09,3400,443,509,952,永靖,招呼
2020-09-10,3400,429,499,928,永靖,招呼
2020-09-11,3400,433,639,1072,永靖,招呼
2020-09-12,3400,420,551,971,永靖,招呼
2020-09-13,3400,605,418,1023,永靖,招呼
2020-09-14,3400,447,409,856,永靖,招呼
2020-09-15,3400,434,458,892,永靖,招呼
2020-09-16,3400,408,443,851,永靖,招呼
2020-09-17,3400,409,478,887,永靖,招呼
2020-09-18,3400,437,840,1277,永靖,招呼
2020-09-19,3400,495,680,1175,永靖,招呼
2020-09-20,3400,686,466,1152,永靖,招呼
2020-09-21,3400,487,484,971,永靖,招呼
2020-09-22,3400,397,434,831,永靖,招呼
2020-09-23,3400,406,455,861,永靖,招呼
2020-09-24,3400,426,486,912,永靖,招呼
2020-09-25,3400,425,587,1012,永靖,招呼
2020-09-26,3400,423,673,1096,永靖,招呼
2020-09-27,3400,539,412,951,永靖,招呼
2020-09-28,3400,452,477,929,永靖,招呼
2020-09-29,3400,410,485,895,永靖,招呼
2020-09-30,3400,431,960,1391,永靖,招呼
2020-10-01,3400,496,825,1321,永靖,招呼
2020-10-02,3400,589,718,1307,永靖,招呼
2020-10-03,3400,599,618,1217,永靖,招呼
2020-10-04,3400,839,426,1265,永靖,招呼
2020-10-05,3400,502,434,936,永靖,招呼
2020-10-06,3400,400,429,829,永靖,招呼
2020-10-07,3400,431,456,887,永靖,招呼
2020-10-08,3400,412,810,1222,永靖,招呼
2020-10-09,3400,470,661,1131,永靖,招呼
2020-10-10,3400,419,501,920,永靖,招呼
2020-10-11,3400,664,398,1062,永靖,招呼
2020-10-12,3400,491,469,960,永靖,招呼
2020-10-13,3400,406,456,862,永靖,招呼
2020-10-14,3400,407,471,878,永靖,招呼
2020-10-15,3400,410,506,916,永靖,招呼
2020-10-16,3400,440,766,1206,永靖,招呼
2020-10-17,3400,484,686,1170,永靖,招呼
2020-10-18,3400,690,499,1189,永靖,招呼
2020-10-19,3400,521,521,1042,永靖,招呼
2020-10-20,3400,482,505,987,永靖,招呼
2020-10-21,3400,418,466,884,永靖,招呼
2020-10-22,3400,429,525,954,永靖,招呼
2020-10-23,3400,483,831,1314,永靖,招呼
2020-10-24,3400,480,733,1213,永靖,招呼
2020-10-25,3400,620,456,1076,永靖,招呼
2020-10-26,3400,541,482,1023,永靖,招呼
2020-10-27,3400,402,402,804,永靖,招呼
2020-10-28,3400,413,471,884,永靖,招呼
2020-10-29,3400,417,490,907,永靖,招呼
2020-10-30,3400,429,793,1222,永靖,招呼
2020-10-31,3400,449,620,1069,永靖,招呼
2020-11-01,3400,734,523,1257,永靖,招呼
2020-11-02,3400,495,489,984,永靖,招呼
2020-11-03,3400,407,452,859,永靖,招呼
2020-11-04,3400,440,486,926,永靖,招呼
2020-11-05,3400,419,513,932,永靖,招呼
2020-11-06,3400,435,799,1234,永靖,招呼
2020-11-07,3400,452,612,1064,永靖,招呼
2020-11-08,3400,717,531,1248,永靖,招呼
2020-11-09,3400,463,452,915,永靖,招呼
2020-11-10,3400,422,446,868,永靖,招呼
2020-11-11,3400,437,480,917,永靖,招呼
2020-11-12,3400,442,529,971,永靖,招呼
2020-11-13,3400,444,798,1242,永靖,招呼
2020-11-14,3400,481,680,1161,永靖,招呼
2020-11-15,3400,717,523,1240,永靖,招呼
2020-11-16,3400,515,486,1001,永靖,招呼
2020-11-17,3400,444,500,944,永靖,招呼
2020-11-18,3400,453,499,952,永靖,招呼
2020-11-19,3400,445,533,978,永靖,招呼
2020-11-20,3400,480,805,1285,永靖,招呼
2020-11-21,3400,522,725,1247,永靖,招呼
2020-11-22,3400,675,492,1167,永靖,招呼
2020-11-23,3400,509,456,965,永靖,招呼
2020-11-24,3400,423,452,875,永靖,招呼
2020-11-25,3400,412,469,881,永靖,招呼
2020-11-26,3400,400,466,866,永靖,招呼
2020-11-27,3400,466,839,1305,永靖,招呼
2020-11-28,3400,439,596,1035,永靖,招呼
2020-11-29,3400,704,456,1160,永靖,招呼
2020-11-30,3400,465,452,917,永靖,招呼
2020-12-01,3400,412,479,891,永靖,招呼
2020-12-02,3400,411,453,864,永靖,招呼
2020-12-03,3400,400,483,883,永靖,招呼
2020-12-04,3400,424,809,1233,永靖,招呼
2020-12-05,3400,506,669,1175,永靖,招呼
2020-12-06,3400,677,459,1136,永靖,招呼
2020-12-07,3400,486,485,971,永靖,招呼
2020-12-08,3400,397,432,829,永靖,招呼
2020-12-09,3400,364,417,781,永靖,招呼
2020-12-10,3400,406,454,860,永靖,招呼
2020-12-11,3400,469,833,1302,永靖,招呼
2020-12-12,3400,483,710,1193,永靖,招呼
2020-12-13,3400,737,499,1236,永靖,招呼
2020-12-14,3400,516,494,1010,永靖,招呼
2020-12-15,3400,403,426,829,永靖,招呼
2020-12-16,3400,456,510,966,永靖,招呼
2020-12-17,3400,446,514,960,永靖,招呼
2020-12-18,3400,475,831,1306,永靖,招呼
2020-12-19,3400,580,778,1358,永靖,招呼
2020-12-20,3400,714,513,1227,永靖,招呼
2020-12-21,3400,461,408,869,永靖,招呼
2020-12-22,3400,429,438,867,永靖,招呼
2020-12-23,3400,388,421,809,永靖,招呼
2020-12-24,3400,435,514,949,永靖,招呼
2020-12-25,3400,477,824,1301,永靖,招呼
2020-12-26,3400,450,623,1073,永靖,招呼
2020-12-27,3400,688,453,1141,永靖,招呼
2020-12-28,3400,498,483,981,永靖,招呼
2020-12-29,3400,408,467,875,永靖,招呼
2020-12-30,3400,393,484,877,永靖,招呼
2020-12-31,3400,438,789,1227,永靖,招呼
2020-01-01,3410,1258,1207,2465,社頭,三等
2020-01-02,3410,1087,1090,2177,社頭,三等
2020-01-03,3410,1077,1405,2482,社頭,三等
2020-01-04,3410,1106,1350,2456,社頭,三等
2020-01-05,3410,1375,988,2363,社頭,三等
2020-01-06,3410,1166,1164,2330,社頭,三等
2020-01-07,3410,1097,1098,2195,社頭,三等
2020-01-08,3410,1103,1124,2227,社頭,三等
2020-01-09,3410,1027,1107,2134,社頭,三等
2020-01-10,3410,1112,1830,2942,社頭,三等
2020-01-11,3410,1281,1391,2672,社頭,三等
2020-01-12,3410,1525,1048,2573,社頭,三等
2020-01-13,3410,1279,1253,2532,社頭,三等
2020-01-14,3410,1181,1188,2369,社頭,三等
2020-01-15,3410,1122,1136,2258,社頭,三等
2020-01-16,3410,1351,1473,2824,社頭,三等
2020-01-17,3410,1126,1315,2441,社頭,三等
2020-01-18,3410,1062,1215,2277,社頭,三等
2020-01-19,3410,1154,974,2128,社頭,三等
2020-01-20,3410,1161,1180,2341,社頭,三等
2020-01-21,3410,1101,1150,2251,社頭,三等
2020-01-22,3410,1170,1372,2542,社頭,三等
2020-01-23,3410,1007,1365,2372,社頭,三等
2020-01-24,3410,760,1078,1838,社頭,三等
2020-01-25,3410,1136,1043,2179,社頭,三等
2020-01-26,3410,996,927,1923,社頭,三等
2020-01-27,3410,1411,1255,2666,社頭,三等
2020-01-28,3410,1258,1081,2339,社頭,三等
2020-01-29,3410,1133,876,2009,社頭,三等
2020-01-30,3410,985,930,1915,社頭,三等
2020-01-31,3410,915,958,1873,社頭,三等
2020-02-01,3410,816,879,1695,社頭,三等
2020-02-02,3410,977,786,1763,社頭,三等
2020-02-03,3410,951,912,1863,社頭,三等
2020-02-04,3410,912,888,1800,社頭,三等
2020-02-05,3410,931,957,1888,社頭,三等
2020-02-06,3410,908,876,1784,社頭,三等
2020-02-07,3410,982,1122,2104,社頭,三等
2020-02-08,3410,836,1017,1853,社頭,三等
2020-02-09,3410,1036,878,1914,社頭,三等
2020-02-10,3410,1029,925,1954,社頭,三等
2020-02-11,3410,943,949,1892,社頭,三等
2020-02-12,3410,987,958,1945,社頭,三等
2020-02-13,3410,902,892,1794,社頭,三等
2020-02-14,3410,926,986,1912,社頭,三等
2020-02-15,3410,981,1067,2048,社頭,三等
2020-02-16,3410,987,882,1869,社頭,三等
2020-02-17,3410,963,920,1883,社頭,三等
2020-02-18,3410,886,862,1748,社頭,三等
2020-02-19,3410,889,887,1776,社頭,三等
2020-02-20,3410,890,887,1777,社頭,三等
2020-02-21,3410,891,1029,1920,社頭,三等
2020-02-22,3410,873,970,1843,社頭,三等
2020-02-23,3410,1041,840,1881,社頭,三等
2020-02-24,3410,1028,946,1974,社頭,三等
2020-02-25,3410,981,992,1973,社頭,三等
2020-02-26,3410,981,1044,2025,社頭,三等
2020-02-27,3410,1043,1454,2497,社頭,三等
2020-02-28,3410,841,1110,1951,社頭,三等
2020-02-29,3410,846,882,1728,社頭,三等
2020-03-01,3410,1221,760,1981,社頭,三等
2020-03-02,3410,1104,1031,2135,社頭,三等
2020-03-03,3410,942,991,1933,社頭,三等
2020-03-04,3410,957,1021,1978,社頭,三等
2020-03-05,3410,930,1007,1937,社頭,三等
2020-03-06,3410,1018,1506,2524,社頭,三等
2020-03-07,3410,820,978,1798,社頭,三等
2020-03-08,3410,1178,785,1963,社頭,三等
2020-03-09,3410,1064,1036,2100,社頭,三等
2020-03-10,3410,862,939,1801,社頭,三等
2020-03-11,3410,945,1020,1965,社頭,三等
2020-03-12,3410,962,1047,2009,社頭,三等
2020-03-13,3410,986,1524,2510,社頭,三等
2020-03-14,3410,780,911,1691,社頭,三等
2020-03-15,3410,1241,837,2078,社頭,三等
2020-03-16,3410,1056,1024,2080,社頭,三等
2020-03-17,3410,976,1008,1984,社頭,三等
2020-03-18,3410,986,1016,2002,社頭,三等
2020-03-19,3410,900,989,1889,社頭,三等
2020-03-20,3410,988,1465,2453,社頭,三等
2020-03-21,3410,723,927,1650,社頭,三等
2020-03-22,3410,1121,680,1801,社頭,三等
2020-03-23,3410,1008,975,1983,社頭,三等
2020-03-24,3410,916,945,1861,社頭,三等
2020-03-25,3410,899,940,1839,社頭,三等
2020-03-26,3410,902,967,1869,社頭,三等
2020-03-27,3410,920,1316,2236,社頭,三等
2020-03-28,3410,609,780,1389,社頭,三等
2020-03-29,3410,875,578,1453,社頭,三等
2020-03-30,3410,1014,962,1976,社頭,三等
2020-03-31,3410,903,976,1879,社頭,三等
2020-04-01,3410,910,1363,2273,社頭,三等
2020-04-02,3410,667,943,1610,社頭,三等
2020-04-03,3410,713,826,1539,社頭,三等
2020-04-04,3410,623,573,1196,社頭,三等
2020-04-05,3410,1043,510,1553,社頭,三等
2020-04-06,3410,996,889,1885,社頭,三等
2020-04-07,3410,862,910,1772,社頭,三等
2020-04-08,3410,914,972,1886,社頭,三等
2020-04-09,3410,887,967,1854,社頭,三等
2020-04-10,3410,912,1286,2198,社頭,三等
2020-04-11,3410,651,786,1437,社頭,三等
2020-04-12,3410,835,584,1419,社頭,三等
2020-04-13,3410,987,953,1940,社頭,三等
2020-04-14,3410,942,991,1933,社頭,三等
2020-04-15,3410,932,969,1901,社頭,三等
2020-04-16,3410,892,989,1881,社頭,三等
2020-04-17,3410,932,1372,2304,社頭,三等
2020-04-18,3410,723,948,1671,社頭,三等
2020-04-19,3410,1047,672,1719,社頭,三等
2020-04-20,3410,1024,963,1987,社頭,三等
2020-04-21,3410,911,908,1819,社頭,三等
2020-04-22,3410,858,923,1781,社頭,三等
2020-04-23,3410,870,949,1819,社頭,三等
2020-04-24,3410,887,1325,2212,社頭,三等
2020-04-25,3410,594,739,1333,社頭,三等
2020-04-26,3410,880,584,1464,社頭,三等
2020-04-27,3410,975,902,1877,社頭,三等
2020-04-28,3410,919,937,1856,社頭,三等
2020-04-29,3410,876,947,1823,社頭,三等
2020-04-30,3410,918,1061,1979,社頭,三等
2020-05-01,3410,917,1439,2356,社頭,三等
2020-05-02,3410,787,931,1718,社頭,三等
2020-05-03,3410,1115,733,1848,社頭,三等
2020-05-04,3410,1021,947,1968,社頭,三等
2020-05-05,3410,919,938,1857,社頭,三等
2020-05-06,3410,950,1002,1952,社頭,三等
2020-05-07,3410,939,1009,1948,社頭,三等
2020-05-08,3410,953,1543,2496,社頭,三等
2020-05-09,3410,789,1091,1880,社頭,三等
2020-05-10,3410,1262,744,2006,社頭,三等
2020-05-11,3410,1128,1022,2150,社頭,三等
2020-05-12,3410,984,1005,1989,社頭,三等
2020-05-13,3410,961,1008,1969,社頭,三等
2020-05-14,3410,932,1028,1960,社頭,三等
2020-05-15,3410,1076,1511,2587,社頭,三等
2020-05-16,3410,785,902,1687,社頭,三等
2020-05-17,3410,1084,799,1883,社頭,三等
2020-05-18,3410,1011,972,1983,社頭,三等
2020-05-19,3410,859,885,1744,社頭,三等
2020-05-20,3410,921,940,1861,社頭,三等
2020-05-21,3410,884,945,1829,社頭,三等
2020-05-22,3410,901,1250,2151,社頭,三等
2020-05-23,3410,721,901,1622,社頭,三等
2020-05-24,3410,1177,800,1977,社頭,三等
2020-05-25,3410,1101,1072,2173,社頭,三等
2020-05-26,3410,928,975,1903,社頭,三等
2020-05-27,3410,891,916,1807,社頭,三等
2020-05-28,3410,876,950,1826,社頭,三等
2020-05-29,3410,980,1450,2430,社頭,三等
2020-05-30,3410,950,1129,2079,社頭,三等
2020-05-31,3410,1291,882,2173,社頭,三等
2020-06-01,3410,1043,1021,2064,社頭,三等
2020-06-02,3410,952,992,1944,社頭,三等
2020-06-03,3410,958,963,1921,社頭,三等
2020-06-04,3410,905,999,1904,社頭,三等
2020-06-05,3410,997,1426,2423,社頭,三等
2020-06-06,3410,995,1197,2192,社頭,三等
2020-06-07,3410,1167,738,1905,社頭,三等
2020-06-08,3410,1065,1036,2101,社頭,三等
2020-06-09,3410,936,935,1871,社頭,三等
2020-06-10,3410,1019,1106,2125,社頭,三等
2020-06-11,3410,997,1035,2032,社頭,三等
2020-06-12,3410,1125,1479,2604,社頭,三等
2020-06-13,3410,1061,1186,2247,社頭,三等
2020-06-14,3410,1246,973,2219,社頭,三等
2020-06-15,3410,1167,1167,2334,社頭,三等
2020-06-16,3410,1041,1147,2188,社頭,三等
2020-06-17,3410,990,1007,1997,社頭,三等
2020-06-18,3410,1006,1038,2044,社頭,三等
2020-06-19,3410,974,1148,2122,社頭,三等
2020-06-20,3410,993,1195,2188,社頭,三等
2020-06-21,3410,1113,917,2030,社頭,三等
2020-06-22,3410,1141,1088,2229,社頭,三等
2020-06-23,3410,1034,1058,2092,社頭,三等
2020-06-24,3410,1011,1510,2521,社頭,三等
2020-06-25,3410,933,1223,2156,社頭,三等
2020-06-26,3410,1246,1236,2482,社頭,三等
2020-06-27,3410,1153,1032,2185,社頭,三等
2020-06-28,3410,1376,962,2338,社頭,三等
2020-06-29,3410,1097,1019,2116,社頭,三等
2020-06-30,3410,1036,1052,2088,社頭,三等
2020-07-01,3410,959,946,1905,社頭,三等
2020-07-02,3410,960,1013,1973,社頭,三等
2020-07-03,3410,960,1192,2152,社頭,三等
2020-07-04,3410,939,966,1905,社頭,三等
2020-07-05,3410,1067,867,1934,社頭,三等
2020-07-06,3410,1093,1047,2140,社頭,三等
2020-07-07,3410,934,970,1904,社頭,三等
2020-07-08,3410,992,1034,2026,社頭,三等
2020-07-09,3410,984,1045,2029,社頭,三等
2020-07-10,3410,1128,1287,2415,社頭,三等
2020-07-11,3410,1029,1129,2158,社頭,三等
2020-07-12,3410,1230,1000,2230,社頭,三等
2020-07-13,3410,1109,1143,2252,社頭,三等
2020-07-14,3410,1091,1224,2315,社頭,三等
2020-07-15,3410,1159,1122,2281,社頭,三等
2020-07-16,3410,1044,1099,2143,社頭,三等
2020-07-17,3410,1117,1252,2369,社頭,三等
2020-07-18,3410,979,1084,2063,社頭,三等
2020-07-19,3410,1216,998,2214,社頭,三等
2020-07-20,3410,1064,1090,2154,社頭,三等
2020-07-21,3410,1057,1023,2080,社頭,三等
2020-07-22,3410,1048,992,2040,社頭,三等
2020-07-23,3410,1021,1054,2075,社頭,三等
2020-07-24,3410,1029,1182,2211,社頭,三等
2020-07-25,3410,1081,1158,2239,社頭,三等
2020-07-26,3410,1255,986,2241,社頭,三等
2020-07-27,3410,1093,1061,2154,社頭,三等
2020-07-28,3410,1021,1002,2023,社頭,三等
2020-07-29,3410,1047,1049,2096,社頭,三等
2020-07-30,3410,968,1012,1980,社頭,三等
2020-07-31,3410,1074,1268,2342,社頭,三等
2020-08-01,3410,956,1076,2032,社頭,三等
2020-08-02,3410,1036,812,1848,社頭,三等
2020-08-03,3410,956,911,1867,社頭,三等
2020-08-04,3410,955,1011,1966,社頭,三等
2020-08-05,3410,1020,1042,2062,社頭,三等
2020-08-06,3410,1011,1054,2065,社頭,三等
2020-08-07,3410,1087,1449,2536,社頭,三等
2020-08-08,3410,899,1135,2034,社頭,三等
2020-08-09,3410,1264,924,2188,社頭,三等
2020-08-10,3410,1137,1082,2219,社頭,三等
2020-08-11,3410,977,949,1926,社頭,三等
2020-08-12,3410,965,964,1929,社頭,三等
2020-08-13,3410,1026,1042,2068,社頭,三等
2020-08-14,3410,1124,1293,2417,社頭,三等
2020-08-15,3410,1003,1089,2092,社頭,三等
2020-08-16,3410,1240,1018,2258,社頭,三等
2020-08-17,3410,1088,1065,2153,社頭,三等
2020-08-18,3410,1033,1026,2059,社頭,三等
2020-08-19,3410,1007,1014,2021,社頭,三等
2020-08-20,3410,1017,1027,2044,社頭,三等
2020-08-21,3410,1152,1421,2573,社頭,三等
2020-08-22,3410,931,1040,1971,社頭,三等
2020-08-23,3410,1127,910,2037,社頭,三等
2020-08-24,3410,1066,1017,2083,社頭,三等
2020-08-25,3410,1072,1218,2290,社頭,三等
2020-08-26,3410,1010,1020,2030,社頭,三等
2020-08-27,3410,930,980,1910,社頭,三等
2020-08-28,3410,1024,1263,2287,社頭,三等
2020-08-29,3410,929,1061,1990,社頭,三等
2020-08-30,3410,1069,848,1917,社頭,三等
2020-08-31,3410,1079,1119,2198,社頭,三等
2020-09-01,3410,984,1041,2025,社頭,三等
2020-09-02,3410,986,980,1966,社頭,三等
2020-09-03,3410,994,1027,2021,社頭,三等
2020-09-04,3410,1058,1369,2427,社頭,三等
2020-09-05,3410,909,1069,1978,社頭,三等
2020-09-06,3410,1080,809,1889,社頭,三等
2020-09-07,3410,1056,1055,2111,社頭,三等
2020-09-08,3410,1055,1070,2125,社頭,三等
2020-09-09,3410,1013,1051,2064,社頭,三等
2020-09-10,3410,988,1110,2098,社頭,三等
2020-09-11,3410,1078,1400,2478,社頭,三等
2020-09-12,3410,1074,1205,2279,社頭,三等
2020-09-13,3410,1392,1002,2394,社頭,三等
2020-09-14,3410,1043,1067,2110,社頭,三等
2020-09-15,3410,974,1044,2018,社頭,三等
2020-09-16,3410,943,1004,1947,社頭,三等
2020-09-17,3410,937,999,1936,社頭,三等
2020-09-18,3410,1054,1539,2593,社頭,三等
2020-09-19,3410,1084,1260,2344,社頭,三等
2020-09-20,3410,1441,1004,2445,社頭,三等
2020-09-21,3410,1059,996,2055,社頭,三等
2020-09-22,3410,946,1025,1971,社頭,三等
2020-09-23,3410,1011,1042,2053,社頭,三等
2020-09-24,3410,990,1059,2049,社頭,三等
2020-09-25,3410,1019,1268,2287,社頭,三等
2020-09-26,3410,933,1263,2196,社頭,三等
2020-09-27,3410,1145,931,2076,社頭,三等
2020-09-28,3410,1058,1057,2115,社頭,三等
2020-09-29,3410,990,1055,2045,社頭,三等
2020-09-30,3410,1293,2075,3368,社頭,三等
2020-10-01,3410,1072,1570,2642,社頭,三等
2020-10-02,3410,1401,1405,2806,社頭,三等
2020-10-03,3410,1336,1280,2616,社頭,三等
2020-10-04,3410,1571,894,2465,社頭,三等
2020-10-05,3410,1121,1015,2136,社頭,三等
2020-10-06,3410,1008,1019,2027,社頭,三等
2020-10-07,3410,1021,1063,2084,社頭,三等
2020-10-08,3410,1037,1569,2606,社頭,三等
2020-10-09,3410,1098,1322,2420,社頭,三等
2020-10-10,3410,1001,964,1965,社頭,三等
2020-10-11,3410,1347,913,2260,社頭,三等
2020-10-12,3410,1109,1054,2163,社頭,三等
2020-10-13,3410,1004,1029,2033,社頭,三等
2020-10-14,3410,985,1044,2029,社頭,三等
2020-10-15,3410,981,1053,2034,社頭,三等
2020-10-16,3410,1038,1512,2550,社頭,三等
2020-10-17,3410,1127,1262,2389,社頭,三等
2020-10-18,3410,1385,1036,2421,社頭,三等
2020-10-19,3410,1146,1076,2222,社頭,三等
2020-10-20,3410,1000,1029,2029,社頭,三等
2020-10-21,3410,962,1010,1972,社頭,三等
2020-10-22,3410,966,1092,2058,社頭,三等
2020-10-23,3410,1070,1553,2623,社頭,三等
2020-10-24,3410,1078,1360,2438,社頭,三等
2020-10-25,3410,1282,880,2162,社頭,三等
2020-10-26,3410,1135,1057,2192,社頭,三等
2020-10-27,3410,994,1036,2030,社頭,三等
2020-10-28,3410,1047,1098,2145,社頭,三等
2020-10-29,3410,1028,1104,2132,社頭,三等
2020-10-30,3410,1040,1539,2579,社頭,三等
2020-10-31,3410,1053,1211,2264,社頭,三等
2020-11-01,3410,1398,1011,2409,社頭,三等
2020-11-02,3410,1111,1053,2164,社頭,三等
2020-11-03,3410,989,1028,2017,社頭,三等
2020-11-04,3410,990,1010,2000,社頭,三等
2020-11-05,3410,945,1037,1982,社頭,三等
2020-11-06,3410,1039,1499,2538,社頭,三等
2020-11-07,3410,1054,1246,2300,社頭,三等
2020-11-08,3410,1462,1060,2522,社頭,三等
2020-11-09,3410,1073,1025,2098,社頭,三等
2020-11-10,3410,982,1026,2008,社頭,三等
2020-11-11,3410,996,1079,2075,社頭,三等
2020-11-12,3410,1008,1095,2103,社頭,三等
2020-11-13,3410,1047,1596,2643,社頭,三等
2020-11-14,3410,1152,1364,2516,社頭,三等
2020-11-15,3410,1614,1188,2802,社頭,三等
2020-11-16,3410,1095,1005,2100,社頭,三等
2020-11-17,3410,1007,1066,2073,社頭,三等
2020-11-18,3410,1078,1116,2194,社頭,三等
2020-11-19,3410,1024,1121,2145,社頭,三等
2020-11-20,3410,1081,1545,2626,社頭,三等
2020-11-21,3410,1115,1293,2408,社頭,三等
2020-11-22,3410,1404,965,2369,社頭,三等
2020-11-23,3410,1100,1069,2169,社頭,三等
2020-11-24,3410,1012,1048,2060,社頭,三等
2020-11-25,3410,1012,1026,2038,社頭,三等
2020-11-26,3410,1033,1080,2113,社頭,三等
2020-11-27,3410,1028,1527,2555,社頭,三等
2020-11-28,3410,1012,1198,2210,社頭,三等
2020-11-29,3410,1391,923,2314,社頭,三等
2020-11-30,3410,1068,1021,2089,社頭,三等
2020-12-01,3410,1006,1042,2048,社頭,三等
2020-12-02,3410,989,1028,2017,社頭,三等
2020-12-03,3410,937,1033,1970,社頭,三等
2020-12-04,3410,1078,1622,2700,社頭,三等
2020-12-05,3410,1096,1262,2358,社頭,三等
2020-12-06,3410,1684,1264,2948,社頭,三等
2020-12-07,3410,1087,1027,2114,社頭,三等
2020-12-08,3410,924,1007,1931,社頭,三等
2020-12-09,3410,899,955,1854,社頭,三等
2020-12-10,3410,928,1018,1946,社頭,三等
2020-12-11,3410,1174,1705,2879,社頭,三等
2020-12-12,3410,1535,1813,3348,社頭,三等
2020-12-13,3410,2022,1574,3596,社頭,三等
2020-12-14,3410,1197,1057,2254,社頭,三等
2020-12-15,3410,1028,1074,2102,社頭,三等
2020-12-16,3410,987,1029,2016,社頭,三等
2020-12-17,3410,974,1067,2041,社頭,三等
2020-12-18,3410,1072,1593,2665,社頭,三等
2020-12-19,3410,1125,1342,2467,社頭,三等
2020-12-20,3410,1385,977,2362,社頭,三等
2020-12-21,3410,1030,1000,2030,社頭,三等
2020-12-22,3410,1024,1024,2048,社頭,三等
2020-12-23,3410,919,1003,1922,社頭,三等
2020-12-24,3410,980,1106,2086,社頭,三等
2020-12-25,3410,1102,1561,2663,社頭,三等
2020-12-26,3410,1063,1206,2269,社頭,三等
2020-12-27,3410,1278,892,2170,社頭,三等
2020-12-28,3410,1102,1056,2158,社頭,三等
2020-12-29,3410,1003,1033,2036,社頭,三等
2020-12-30,3410,984,1039,2023,社頭,三等
2020-12-31,3410,1132,1567,2699,社頭,三等
2020-01-01,3420,2796,2655,5451,田中,二等
2020-01-02,3420,2447,2446,4893,田中,二等
2020-01-03,3420,2729,3473,6202,田中,二等
2020-01-04,3420,2588,3152,5740,田中,二等
2020-01-05,3420,3457,2511,5968,田中,二等
2020-01-06,3420,2800,2494,5294,田中,二等
2020-01-07,3420,2422,2356,4778,田中,二等
2020-01-08,3420,2451,2359,4810,田中,二等
2020-01-09,3420,2301,2577,4878,田中,二等
2020-01-10,3420,2693,4747,7440,田中,二等
2020-01-11,3420,3331,3708,7039,田中,二等
2020-01-12,3420,4353,2585,6938,田中,二等
2020-01-13,3420,3111,2694,5805,田中,二等
2020-01-14,3420,2535,2531,5066,田中,二等
2020-01-15,3420,2639,2597,5236,田中,二等
2020-01-16,3420,3146,3015,6161,田中,二等
2020-01-17,3420,2946,3263,6209,田中,二等
2020-01-18,3420,2664,2826,5490,田中,二等
2020-01-19,3420,2934,2557,5491,田中,二等
2020-01-20,3420,2683,2791,5474,田中,二等
2020-01-21,3420,2593,2903,5496,田中,二等
2020-01-22,3420,2678,3565,6243,田中,二等
2020-01-23,3420,2547,3709,6256,田中,二等
2020-01-24,3420,2039,3110,5149,田中,二等
2020-01-25,3420,3194,3035,6229,田中,二等
2020-01-26,3420,3199,2992,6191,田中,二等
2020-01-27,3420,3989,3210,7199,田中,二等
2020-01-28,3420,3609,2924,6533,田中,二等
2020-01-29,3420,3203,2318,5521,田中,二等
2020-01-30,3420,2471,2171,4642,田中,二等
2020-01-31,3420,2457,2516,4973,田中,二等
2020-02-01,3420,1962,1959,3921,田中,二等
2020-02-02,3420,2459,1941,4400,田中,二等
2020-02-03,3420,2403,2210,4613,田中,二等
2020-02-04,3420,2164,2110,4274,田中,二等
2020-02-05,3420,2116,2140,4256,田中,二等
2020-02-06,3420,2206,2135,4341,田中,二等
2020-02-07,3420,2357,2824,5181,田中,二等
2020-02-08,3420,1984,2304,4288,田中,二等
2020-02-09,3420,2826,2221,5047,田中,二等
2020-02-10,3420,2522,2318,4840,田中,二等
2020-02-11,3420,2154,2123,4277,田中,二等
2020-02-12,3420,2214,2185,4399,田中,二等
2020-02-13,3420,2086,1987,4073,田中,二等
2020-02-14,3420,2246,2512,4758,田中,二等
2020-02-15,3420,2200,2446,4646,田中,二等
2020-02-16,3420,2612,2350,4962,田中,二等
2020-02-17,3420,2202,2061,4263,田中,二等
2020-02-18,3420,1998,1836,3834,田中,二等
2020-02-19,3420,2004,1883,3887,田中,二等
2020-02-20,3420,2052,1939,3991,田中,二等
2020-02-21,3420,2176,2581,4757,田中,二等
2020-02-22,3420,1982,2228,4210,田中,二等
2020-02-23,3420,2585,2023,4608,田中,二等
2020-02-24,3420,2478,2121,4599,田中,二等
2020-02-25,3420,2218,2147,4365,田中,二等
2020-02-26,3420,2232,2312,4544,田中,二等
2020-02-27,3420,2448,3561,6009,田中,二等
2020-02-28,3420,2221,2737,4958,田中,二等
2020-02-29,3420,2044,1991,4035,田中,二等
2020-03-01,3420,3462,1824,5286,田中,二等
2020-03-02,3420,2435,2153,4588,田中,二等
2020-03-03,3420,2169,2128,4297,田中,二等
2020-03-04,3420,2154,2051,4205,田中,二等
2020-03-05,3420,1885,2012,3897,田中,二等
2020-03-06,3420,2385,3616,6001,田中,二等
2020-03-07,3420,1961,2224,4185,田中,二等
2020-03-08,3420,3164,1948,5112,田中,二等
2020-03-09,3420,2430,2101,4531,田中,二等
2020-03-10,3420,1963,1869,3832,田中,二等
2020-03-11,3420,2162,2150,4312,田中,二等
2020-03-12,3420,2139,2237,4376,田中,二等
2020-03-13,3420,2310,3786,6096,田中,二等
2020-03-14,3420,1846,2208,4054,田中,二等
2020-03-15,3420,3586,2159,5745,田中,二等
2020-03-16,3420,2530,2235,4765,田中,二等
2020-03-17,3420,2175,2036,4211,田中,二等
2020-03-18,3420,2077,2078,4155,田中,二等
2020-03-19,3420,1930,2048,3978,田中,二等
2020-03-20,3420,2286,3566,5852,田中,二等
2020-03-21,3420,1729,2161,3890,田中,二等
2020-03-22,3420,2999,1702,4701,田中,二等
2020-03-23,3420,2343,2000,4343,田中,二等
2020-03-24,3420,2006,1936,3942,田中,二等
2020-03-25,3420,1968,1944,3912,田中,二等
2020-03-26,3420,1914,2016,3930,田中,二等
2020-03-27,3420,2186,3347,5533,田中,二等
2020-03-28,3420,1542,1950,3492,田中,二等
2020-03-29,3420,2511,1508,4019,田中,二等
2020-03-30,3420,2253,2023,4276,田中,二等
2020-03-31,3420,1932,2094,4026,田中,二等
2020-04-01,3420,2095,3555,5650,田中,二等
2020-04-02,3420,1567,2513,4080,田中,二等
2020-04-03,3420,1740,2252,3992,田中,二等
2020-04-04,3420,1701,1436,3137,田中,二等
2020-04-05,3420,3424,1435,4859,田中,二等
2020-04-06,3420,2388,1816,4204,田中,二等
2020-04-07,3420,1930,1796,3726,田中,二等
2020-04-08,3420,1857,1851,3708,田中,二等
2020-04-09,3420,1828,1899,3727,田中,二等
2020-04-10,3420,2088,2994,5082,田中,二等
2020-04-11,3420,1509,1747,3256,田中,二等
2020-04-12,3420,2628,1566,4194,田中,二等
2020-04-13,3420,2224,1970,4194,田中,二等
2020-04-14,3420,2057,1899,3956,田中,二等
2020-04-15,3420,1923,1932,3855,田中,二等
2020-04-16,3420,1918,2011,3929,田中,二等
2020-04-17,3420,2183,3250,5433,田中,二等
2020-04-18,3420,1708,2023,3731,田中,二等
2020-04-19,3420,2835,1676,4511,田中,二等
2020-04-20,3420,2268,1929,4197,田中,二等
2020-04-21,3420,1923,1818,3741,田中,二等
2020-04-22,3420,1960,1856,3816,田中,二等
2020-04-23,3420,1804,1897,3701,田中,二等
2020-04-24,3420,2062,3062,5124,田中,二等
2020-04-25,3420,1493,1731,3224,田中,二等
2020-04-26,3420,2343,1504,3847,田中,二等
2020-04-27,3420,2237,1953,4190,田中,二等
2020-04-28,3420,1906,1885,3791,田中,二等
2020-04-29,3420,2118,1900,4018,田中,二等
2020-04-30,3420,2009,2473,4482,田中,二等
2020-05-01,3420,2235,3451,5686,田中,二等
2020-05-02,3420,1796,2137,3933,田中,二等
2020-05-03,3420,3131,1687,4818,田中,二等
2020-05-04,3420,2449,2042,4491,田中,二等
2020-05-05,3420,2080,1914,3994,田中,二等
2020-05-06,3420,1936,1997,3933,田中,二等
2020-05-07,3420,2005,2147,4152,田中,二等
2020-05-08,3420,2363,4081,6444,田中,二等
2020-05-09,3420,1971,2728,4699,田中,二等
2020-05-10,3420,3721,1875,5596,田中,二等
2020-05-11,3420,2555,2074,4629,田中,二等
2020-05-12,3420,2084,1984,4068,田中,二等
2020-05-13,3420,2035,1972,4007,田中,二等
2020-05-14,3420,1990,2149,4139,田中,二等
2020-05-15,3420,2509,3498,6007,田中,二等
2020-05-16,3420,1854,2165,4019,田中,二等
2020-05-17,3420,2931,1968,4899,田中,二等
2020-05-18,3420,2412,2024,4436,田中,二等
2020-05-19,3420,1861,1785,3646,田中,二等
2020-05-20,3420,1949,1950,3899,田中,二等
2020-05-21,3420,1911,1979,3890,田中,二等
2020-05-22,3420,2064,3177,5241,田中,二等
2020-05-23,3420,1683,2065,3748,田中,二等
2020-05-24,3420,3189,2024,5213,田中,二等
2020-05-25,3420,2439,2121,4560,田中,二等
2020-05-26,3420,1957,1926,3883,田中,二等
2020-05-27,3420,1919,1945,3864,田中,二等
2020-05-28,3420,1909,1975,3884,田中,二等
2020-05-29,3420,2417,3596,6013,田中,二等
2020-05-30,3420,2161,2434,4595,田中,二等
2020-05-31,3420,3340,2067,5407,田中,二等
2020-06-01,3420,2381,2137,4518,田中,二等
2020-06-02,3420,2139,2080,4219,田中,二等
2020-06-03,3420,2159,2118,4277,田中,二等
2020-06-04,3420,1957,2026,3983,田中,二等
2020-06-05,3420,2411,3639,6050,田中,二等
2020-06-06,3420,2224,2536,4760,田中,二等
2020-06-07,3420,3364,2093,5457,田中,二等
2020-06-08,3420,2382,2088,4470,田中,二等
2020-06-09,3420,2149,2071,4220,田中,二等
2020-06-10,3420,2188,2175,4363,田中,二等
2020-06-11,3420,2217,2256,4473,田中,二等
2020-06-12,3420,2599,3562,6161,田中,二等
2020-06-13,3420,2554,2931,5485,田中,二等
2020-06-14,3420,3385,2418,5803,田中,二等
2020-06-15,3420,2640,2502,5142,田中,二等
2020-06-16,3420,2843,2389,5232,田中,二等
2020-06-17,3420,2228,2331,4559,田中,二等
2020-06-18,3420,2142,2186,4328,田中,二等
2020-06-19,3420,2228,2669,4897,田中,二等
2020-06-20,3420,2199,2623,4822,田中,二等
2020-06-21,3420,2682,2139,4821,田中,二等
2020-06-22,3420,2385,2266,4651,田中,二等
2020-06-23,3420,2369,2415,4784,田中,二等
2020-06-24,3420,2496,3984,6480,田中,二等
2020-06-25,3420,2389,3525,5914,田中,二等
2020-06-26,3420,3073,3173,6246,田中,二等
2020-06-27,3420,2998,2544,5542,田中,二等
2020-06-28,3420,4085,2385,6470,田中,二等
2020-06-29,3420,2717,2289,5006,田中,二等
2020-06-30,3420,2243,2176,4419,田中,二等
2020-07-01,3420,2110,2061,4171,田中,二等
2020-07-02,3420,2044,2167,4211,田中,二等
2020-07-03,3420,2407,2869,5276,田中,二等
2020-07-04,3420,2260,2377,4637,田中,二等
2020-07-05,3420,2699,2240,4939,田中,二等
2020-07-06,3420,2529,2349,4878,田中,二等
2020-07-07,3420,2230,2268,4498,田中,二等
2020-07-08,3420,2242,2235,4477,田中,二等
2020-07-09,3420,2245,2249,4494,田中,二等
2020-07-10,3420,2534,3157,5691,田中,二等
2020-07-11,3420,2566,2720,5286,田中,二等
2020-07-12,3420,3148,2512,5660,田中,二等
2020-07-13,3420,2591,2430,5021,田中,二等
2020-07-14,3420,2590,2529,5119,田中,二等
2020-07-15,3420,2380,2362,4742,田中,二等
2020-07-16,3420,2284,2336,4620,田中,二等
2020-07-17,3420,2462,2995,5457,田中,二等
2020-07-18,3420,2549,2779,5328,田中,二等
2020-07-19,3420,3303,2690,5993,田中,二等
2020-07-20,3420,2545,2449,4994,田中,二等
2020-07-21,3420,2224,2085,4309,田中,二等
2020-07-22,3420,2267,2317,4584,田中,二等
2020-07-23,3420,2299,2316,4615,田中,二等
2020-07-24,3420,2583,2993,5576,田中,二等
2020-07-25,3420,2626,2883,5509,田中,二等
2020-07-26,3420,3137,2480,5617,田中,二等
2020-07-27,3420,2514,2402,4916,田中,二等
2020-07-28,3420,2329,2239,4568,田中,二等
2020-07-29,3420,2309,2326,4635,田中,二等
2020-07-30,3420,2261,2248,4509,田中,二等
2020-07-31,3420,2494,2972,5466,田中,二等
2020-08-01,3420,2263,2548,4811,田中,二等
2020-08-02,3420,2914,2265,5179,田中,二等
2020-08-03,3420,2277,2079,4356,田中,二等
2020-08-04,3420,2081,2039,4120,田中,二等
2020-08-05,3420,2293,2309,4602,田中,二等
2020-08-06,3420,2281,2341,4622,田中,二等
2020-08-07,3420,2466,3380,5846,田中,二等
2020-08-08,3420,2321,2779,5100,田中,二等
2020-08-09,3420,3457,2432,5889,田中,二等
2020-08-10,3420,2667,2391,5058,田中,二等
2020-08-11,3420,2239,2086,4325,田中,二等
2020-08-12,3420,2214,2197,4411,田中,二等
2020-08-13,3420,2273,2291,4564,田中,二等
2020-08-14,3420,2680,3181,5861,田中,二等
2020-08-15,3420,2624,2722,5346,田中,二等
2020-08-16,3420,3323,2766,6089,田中,二等
2020-08-17,3420,2576,2444,5020,田中,二等
2020-08-18,3420,2375,2327,4702,田中,二等
2020-08-19,3420,2385,2333,4718,田中,二等
2020-08-20,3420,2310,2330,4640,田中,二等
2020-08-21,3420,2615,3167,5782,田中,二等
2020-08-22,3420,2566,2634,5200,田中,二等
2020-08-23,3420,2949,2440,5389,田中,二等
2020-08-24,3420,2523,2405,4928,田中,二等
2020-08-25,3420,2411,2315,4726,田中,二等
2020-08-26,3420,2344,2322,4666,田中,二等
2020-08-27,3420,2146,2124,4270,田中,二等
2020-08-28,3420,2507,3014,5521,田中,二等
2020-08-29,3420,2277,2506,4783,田中,二等
2020-08-30,3420,2794,2239,5033,田中,二等
2020-08-31,3420,2391,2302,4693,田中,二等
2020-09-01,3420,2200,2288,4488,田中,二等
2020-09-02,3420,2193,2208,4401,田中,二等
2020-09-03,3420,2378,2249,4627,田中,二等
2020-09-04,3420,2502,3148,5650,田中,二等
2020-09-05,3420,2357,2570,4927,田中,二等
2020-09-06,3420,3113,2323,5436,田中,二等
2020-09-07,3420,2635,2339,4974,田中,二等
2020-09-08,3420,2286,2249,4535,田中,二等
2020-09-09,3420,2279,2308,4587,田中,二等
2020-09-10,3420,2309,2452,4761,田中,二等
2020-09-11,3420,2568,3351,5919,田中,二等
2020-09-12,3420,2591,2817,5408,田中,二等
2020-09-13,3420,3761,2596,6357,田中,二等
2020-09-14,3420,2449,2256,4705,田中,二等
2020-09-15,3420,2125,2123,4248,田中,二等
2020-09-16,3420,2160,2133,4293,田中,二等
2020-09-17,3420,2166,2247,4413,田中,二等
2020-09-18,3420,2457,3859,6316,田中,二等
2020-09-19,3420,2477,2822,5299,田中,二等
2020-09-20,3420,3777,2456,6233,田中,二等
2020-09-21,3420,2532,2276,4808,田中,二等
2020-09-22,3420,2144,2142,4286,田中,二等
2020-09-23,3420,2192,2197,4389,田中,二等
2020-09-24,3420,2239,2192,4431,田中,二等
2020-09-25,3420,2293,2668,4961,田中,二等
2020-09-26,3420,2205,2763,4968,田中,二等
2020-09-27,3420,2823,2311,5134,田中,二等
2020-09-28,3420,2447,2139,4586,田中,二等
2020-09-29,3420,2286,2335,4621,田中,二等
2020-09-30,3420,2515,4632,7147,田中,二等
2020-10-01,3420,2496,4171,6667,田中,二等
2020-10-02,3420,3465,3391,6856,田中,二等
2020-10-03,3420,3387,3080,6467,田中,二等
2020-10-04,3420,4977,2389,7366,田中,二等
2020-10-05,3420,2825,2233,5058,田中,二等
2020-10-06,3420,2212,2109,4321,田中,二等
2020-10-07,3420,2199,2221,4420,田中,二等
2020-10-08,3420,2479,4004,6483,田中,二等
2020-10-09,3420,2704,3406,6110,田中,二等
2020-10-10,3420,2704,2560,5264,田中,二等
2020-10-11,3420,4295,2581,6876,田中,二等
2020-10-12,3420,2666,2285,4951,田中,二等
2020-10-13,3420,2337,2253,4590,田中,二等
2020-10-14,3420,2289,2119,4408,田中,二等
2020-10-15,3420,2263,2123,4386,田中,二等
2020-10-16,3420,2535,3525,6060,田中,二等
2020-10-17,3420,2730,2803,5533,田中,二等
2020-10-18,3420,3788,2493,6281,田中,二等
2020-10-19,3420,2484,2062,4546,田中,二等
2020-10-20,3420,2320,1998,4318,田中,二等
2020-10-21,3420,2272,2077,4349,田中,二等
2020-10-22,3420,2183,2029,4212,田中,二等
2020-10-23,3420,2565,3536,6101,田中,二等
2020-10-24,3420,2654,3101,5755,田中,二等
2020-10-25,3420,3618,2254,5872,田中,二等
2020-10-26,3420,2785,2080,4865,田中,二等
2020-10-27,3420,2145,1961,4106,田中,二等
2020-10-28,3420,2197,2045,4242,田中,二等
2020-10-29,3420,2124,2021,4145,田中,二等
2020-10-30,3420,2518,3577,6095,田中,二等
2020-10-31,3420,2632,2672,5304,田中,二等
2020-11-01,3420,3771,2320,6091,田中,二等
2020-11-02,3420,2597,2114,4711,田中,二等
2020-11-03,3420,2183,1985,4168,田中,二等
2020-11-04,3420,2192,2210,4402,田中,二等
2020-11-05,3420,2168,2257,4425,田中,二等
2020-11-06,3420,2530,3806,6336,田中,二等
2020-11-07,3420,2764,3765,6529,田中,二等
2020-11-08,3420,6754,5237,11991,田中,二等
2020-11-09,3420,2535,2214,4749,田中,二等
2020-11-10,3420,2206,2151,4357,田中,二等
2020-11-11,3420,2350,2312,4662,田中,二等
2020-11-12,3420,2215,2368,4583,田中,二等
2020-11-13,3420,2669,4135,6804,田中,二等
2020-11-14,3420,2767,3132,5899,田中,二等
2020-11-15,3420,4385,2888,7273,田中,二等
2020-11-16,3420,2601,2324,4925,田中,二等
2020-11-17,3420,2391,2317,4708,田中,二等
2020-11-18,3420,2374,2359,4733,田中,二等
2020-11-19,3420,2278,2333,4611,田中,二等
2020-11-20,3420,2582,3816,6398,田中,二等
2020-11-21,3420,2659,3030,5689,田中,二等
2020-11-22,3420,3865,2591,6456,田中,二等
2020-11-23,3420,2649,2257,4906,田中,二等
2020-11-24,3420,2268,2224,4492,田中,二等
2020-11-25,3420,2290,2250,4540,田中,二等
2020-11-26,3420,2264,2406,4670,田中,二等
2020-11-27,3420,2626,3987,6613,田中,二等
2020-11-28,3420,2504,2897,5401,田中,二等
2020-11-29,3420,3715,2281,5996,田中,二等
2020-11-30,3420,2613,2267,4880,田中,二等
2020-12-01,3420,2222,2159,4381,田中,二等
2020-12-02,3420,2207,2181,4388,田中,二等
2020-12-03,3420,2185,2337,4522,田中,二等
2020-12-04,3420,2696,3955,6651,田中,二等
2020-12-05,3420,2757,3131,5888,田中,二等
2020-12-06,3420,4263,2848,7111,田中,二等
2020-12-07,3420,2671,2330,5001,田中,二等
2020-12-08,3420,2458,2327,4785,田中,二等
2020-12-09,3420,2025,2024,4049,田中,二等
2020-12-10,3420,2087,2184,4271,田中,二等
2020-12-11,3420,2596,4047,6643,田中,二等
2020-12-12,3420,2832,3132,5964,田中,二等
2020-12-13,3420,3944,2780,6724,田中,二等
2020-12-14,3420,2703,2449,5152,田中,二等
2020-12-15,3420,2297,2245,4542,田中,二等
2020-12-16,3420,2223,2264,4487,田中,二等
2020-12-17,3420,2219,2331,4550,田中,二等
2020-12-18,3420,2900,3951,6851,田中,二等
2020-12-19,3420,3136,3502,6638,田中,二等
2020-12-20,3420,3912,2535,6447,田中,二等
2020-12-21,3420,2490,2237,4727,田中,二等
2020-12-22,3420,2165,2176,4341,田中,二等
2020-12-23,3420,2068,2063,4131,田中,二等
2020-12-24,3420,2135,2339,4474,田中,二等
2020-12-25,3420,2736,3848,6584,田中,二等
2020-12-26,3420,2456,2791,5247,田中,二等
2020-12-27,3420,3575,2349,5924,田中,二等
2020-12-28,3420,2675,2334,5009,田中,二等
2020-12-29,3420,2248,2197,4445,田中,二等
2020-12-30,3420,2141,2367,4508,田中,二等
2020-12-31,3420,2548,3877,6425,田中,二等
2020-01-01,3430,1343,1219,2562,二水,二等
2020-01-02,3430,961,938,1899,二水,二等
2020-01-03,3430,1089,1286,2375,二水,二等
2020-01-04,3430,1103,1195,2298,二水,二等
2020-01-05,3430,1254,1005,2259,二水,二等
2020-01-06,3430,927,904,1831,二水,二等
2020-01-07,3430,885,883,1768,二水,二等
2020-01-08,3430,933,934,1867,二水,二等
2020-01-09,3430,876,938,1814,二水,二等
2020-01-10,3430,1097,1618,2715,二水,二等
2020-01-11,3430,1345,1410,2755,二水,二等
2020-01-12,3430,1457,1045,2502,二水,二等
2020-01-13,3430,1069,966,2035,二水,二等
2020-01-14,3430,956,979,1935,二水,二等
2020-01-15,3430,1027,1029,2056,二水,二等
2020-01-16,3430,1207,1263,2470,二水,二等
2020-01-17,3430,1179,1328,2507,二水,二等
2020-01-18,3430,1084,1171,2255,二水,二等
2020-01-19,3430,1194,980,2174,二水,二等
2020-01-20,3430,1062,1104,2166,二水,二等
2020-01-21,3430,1185,1218,2403,二水,二等
2020-01-22,3430,1212,1447,2659,二水,二等
2020-01-23,3430,1101,1547,2648,二水,二等
2020-01-24,3430,874,1327,2201,二水,二等
2020-01-25,3430,1748,1505,3253,二水,二等
2020-01-26,3430,1440,1337,2777,二水,二等
2020-01-27,3430,2077,1802,3879,二水,二等
2020-01-28,3430,1851,1575,3426,二水,二等
2020-01-29,3430,1383,1083,2466,二水,二等
2020-01-30,3430,1129,1044,2173,二水,二等
2020-01-31,3430,964,1057,2021,二水,二等
2020-02-01,3430,825,916,1741,二水,二等
2020-02-02,3430,946,822,1768,二水,二等
2020-02-03,3430,908,878,1786,二水,二等
2020-02-04,3430,854,847,1701,二水,二等
2020-02-05,3430,843,836,1679,二水,二等
2020-02-06,3430,845,863,1708,二水,二等
2020-02-07,3430,953,1085,2038,二水,二等
2020-02-08,3430,778,869,1647,二水,二等
2020-02-09,3430,1036,782,1818,二水,二等
2020-02-10,3430,879,849,1728,二水,二等
2020-02-11,3430,840,846,1686,二水,二等
2020-02-12,3430,851,856,1707,二水,二等
2020-02-13,3430,796,780,1576,二水,二等
2020-02-14,3430,919,943,1862,二水,二等
2020-02-15,3430,848,927,1775,二水,二等
2020-02-16,3430,943,875,1818,二水,二等
2020-02-17,3430,825,790,1615,二水,二等
2020-02-18,3430,729,697,1426,二水,二等
2020-02-19,3430,750,737,1487,二水,二等
2020-02-20,3430,748,754,1502,二水,二等
2020-02-21,3430,891,930,1821,二水,二等
2020-02-22,3430,762,855,1617,二水,二等
2020-02-23,3430,918,813,1731,二水,二等
2020-02-24,3430,868,810,1678,二水,二等
2020-02-25,3430,795,798,1593,二水,二等
2020-02-26,3430,847,861,1708,二水,二等
2020-02-27,3430,923,1168,2091,二水,二等
2020-02-28,3430,1011,1183,2194,二水,二等
2020-02-29,3430,994,1013,2007,二水,二等
2020-03-01,3430,1212,751,1963,二水,二等
2020-03-02,3430,838,773,1611,二水,二等
2020-03-03,3430,730,774,1504,二水,二等
2020-03-04,3430,703,727,1430,二水,二等
2020-03-05,3430,618,686,1304,二水,二等
2020-03-06,3430,901,1226,2127,二水,二等
2020-03-07,3430,698,799,1497,二水,二等
2020-03-08,3430,1050,765,1815,二水,二等
2020-03-09,3430,870,782,1652,二水,二等
2020-03-10,3430,667,704,1371,二水,二等
2020-03-11,3430,752,781,1533,二水,二等
2020-03-12,3430,767,824,1591,二水,二等
2020-03-13,3430,897,1215,2112,二水,二等
2020-03-14,3430,605,820,1425,二水,二等
2020-03-15,3430,1128,787,1915,二水,二等
2020-03-16,3430,860,833,1693,二水,二等
2020-03-17,3430,748,752,1500,二水,二等
2020-03-18,3430,738,749,1487,二水,二等
2020-03-19,3430,695,756,1451,二水,二等
2020-03-20,3430,2541,1274,3815,二水,二等
2020-03-21,3430,898,832,1730,二水,二等
2020-03-22,3430,1260,855,2115,二水,二等
2020-03-23,3430,791,696,1487,二水,二等
2020-03-24,3430,726,742,1468,二水,二等
2020-03-25,3430,704,727,1431,二水,二等
2020-03-26,3430,686,701,1387,二水,二等
2020-03-27,3430,845,1139,1984,二水,二等
2020-03-28,3430,581,701,1282,二水,二等
2020-03-29,3430,947,605,1552,二水,二等
2020-03-30,3430,784,736,1520,二水,二等
2020-03-31,3430,650,719,1369,二水,二等
2020-04-01,3430,791,1096,1887,二水,二等
2020-04-02,3430,724,1009,1733,二水,二等
2020-04-03,3430,799,914,1713,二水,二等
2020-04-04,3430,711,616,1327,二水,二等
2020-04-05,3430,1123,587,1710,二水,二等
2020-04-06,3430,794,693,1487,二水,二等
2020-04-07,3430,635,622,1257,二水,二等
2020-04-08,3430,643,685,1328,二水,二等
2020-04-09,3430,629,647,1276,二水,二等
2020-04-10,3430,736,971,1707,二水,二等
2020-04-11,3430,531,655,1186,二水,二等
2020-04-12,3430,785,570,1355,二水,二等
2020-04-13,3430,750,728,1478,二水,二等
2020-04-14,3430,674,667,1341,二水,二等
2020-04-15,3430,726,774,1500,二水,二等
2020-04-16,3430,692,715,1407,二水,二等
2020-04-17,3430,808,1085,1893,二水,二等
2020-04-18,3430,650,569,1219,二水,二等
2020-04-19,3430,884,631,1515,二水,二等
2020-04-20,3430,745,729,1474,二水,二等
2020-04-21,3430,672,687,1359,二水,二等
2020-04-22,3430,654,685,1339,二水,二等
2020-04-23,3430,670,626,1296,二水,二等
2020-04-24,3430,738,972,1710,二水,二等
2020-04-25,3430,543,598,1141,二水,二等
2020-04-26,3430,819,560,1379,二水,二等
2020-04-27,3430,759,722,1481,二水,二等
2020-04-28,3430,649,675,1324,二水,二等
2020-04-29,3430,709,736,1445,二水,二等
2020-04-30,3430,718,817,1535,二水,二等
2020-05-01,3430,843,1093,1936,二水,二等
2020-05-02,3430,736,799,1535,二水,二等
2020-05-03,3430,995,631,1626,二水,二等
2020-05-04,3430,823,736,1559,二水,二等
2020-05-05,3430,679,702,1381,二水,二等
2020-05-06,3430,705,518,1223,二水,二等
2020-05-07,3430,717,647,1364,二水,二等
2020-05-08,3430,874,1263,2137,二水,二等
2020-05-09,3430,777,1000,1777,二水,二等
2020-05-10,3430,1264,748,2012,二水,二等
2020-05-11,3430,850,781,1631,二水,二等
2020-05-12,3430,753,744,1497,二水,二等
2020-05-13,3430,816,826,1642,二水,二等
2020-05-14,3430,823,767,1590,二水,二等
2020-05-15,3430,918,1163,2081,二水,二等
2020-05-16,3430,746,812,1558,二水,二等
2020-05-17,3430,1063,777,1840,二水,二等
2020-05-18,3430,835,757,1592,二水,二等
2020-05-19,3430,672,626,1298,二水,二等
2020-05-20,3430,732,743,1475,二水,二等
2020-05-21,3430,663,681,1344,二水,二等
2020-05-22,3430,715,990,1705,二水,二等
2020-05-23,3430,584,663,1247,二水,二等
2020-05-24,3430,1095,794,1889,二水,二等
2020-05-25,3430,798,771,1569,二水,二等
2020-05-26,3430,703,703,1406,二水,二等
2020-05-27,3430,672,691,1363,二水,二等
2020-05-28,3430,612,682,1294,二水,二等
2020-05-29,3430,815,1129,1944,二水,二等
2020-05-30,3430,873,932,1805,二水,二等
2020-05-31,3430,1257,856,2113,二水,二等
2020-06-01,3430,850,828,1678,二水,二等
2020-06-02,3430,812,762,1574,二水,二等
2020-06-03,3430,782,671,1453,二水,二等
2020-06-04,3430,793,786,1579,二水,二等
2020-06-05,3430,889,1160,2049,二水,二等
2020-06-06,3430,873,1006,1879,二水,二等
2020-06-07,3430,1230,1020,2250,二水,二等
2020-06-08,3430,790,743,1533,二水,二等
2020-06-09,3430,754,763,1517,二水,二等
2020-06-10,3430,848,847,1695,二水,二等
2020-06-11,3430,822,812,1634,二水,二等
2020-06-12,3430,945,1181,2126,二水,二等
2020-06-13,3430,918,1049,1967,二水,二等
2020-06-14,3430,1251,1009,2260,二水,二等
2020-06-15,3430,1104,1072,2176,二水,二等
2020-06-16,3430,857,818,1675,二水,二等
2020-06-17,3430,792,783,1575,二水,二等
2020-06-18,3430,931,988,1919,二水,二等
2020-06-19,3430,884,955,1839,二水,二等
2020-06-20,3430,1058,1172,2230,二水,二等
2020-06-21,3430,1002,910,1912,二水,二等
2020-06-22,3430,1048,979,2027,二水,二等
2020-06-23,3430,832,872,1704,二水,二等
2020-06-24,3430,913,1321,2234,二水,二等
2020-06-25,3430,1067,1413,2480,二水,二等
2020-06-26,3430,1632,1513,3145,二水,二等
2020-06-27,3430,1522,1394,2916,二水,二等
2020-06-28,3430,1464,1056,2520,二水,二等
2020-06-29,3430,1002,883,1885,二水,二等
2020-06-30,3430,802,791,1593,二水,二等
2020-07-01,3430,895,836,1731,二水,二等
2020-07-02,3430,811,848,1659,二水,二等
2020-07-03,3430,844,1024,1868,二水,二等
2020-07-04,3430,1079,1033,2112,二水,二等
2020-07-05,3430,1139,952,2091,二水,二等
2020-07-06,3430,868,851,1719,二水,二等
2020-07-07,3430,800,825,1625,二水,二等
2020-07-08,3430,780,818,1598,二水,二等
2020-07-09,3430,847,844,1691,二水,二等
2020-07-10,3430,1087,1252,2339,二水,二等
2020-07-11,3430,1007,1050,2057,二水,二等
2020-07-12,3430,1250,1107,2357,二水,二等
2020-07-13,3430,1078,1028,2106,二水,二等
2020-07-14,3430,892,927,1819,二水,二等
2020-07-15,3430,923,942,1865,二水,二等
2020-07-16,3430,995,996,1991,二水,二等
2020-07-17,3430,1109,1186,2295,二水,二等
2020-07-18,3430,1082,1148,2230,二水,二等
2020-07-19,3430,1223,1021,2244,二水,二等
2020-07-20,3430,957,957,1914,二水,二等
2020-07-21,3430,942,930,1872,二水,二等
2020-07-22,3430,917,936,1853,二水,二等
2020-07-23,3430,911,870,1781,二水,二等
2020-07-24,3430,1058,1151,2209,二水,二等
2020-07-25,3430,1151,1165,2316,二水,二等
2020-07-26,3430,1212,982,2194,二水,二等
2020-07-27,3430,976,966,1942,二水,二等
2020-07-28,3430,883,912,1795,二水,二等
2020-07-29,3430,936,954,1890,二水,二等
2020-07-30,3430,898,907,1805,二水,二等
2020-07-31,3430,1112,1208,2320,二水,二等
2020-08-01,3430,1140,1118,2258,二水,二等
2020-08-02,3430,1124,882,2006,二水,二等
2020-08-03,3430,838,635,1473,二水,二等
2020-08-04,3430,795,795,1590,二水,二等
2020-08-05,3430,834,900,1734,二水,二等
2020-08-06,3430,883,888,1771,二水,二等
2020-08-07,3430,1128,1358,2486,二水,二等
2020-08-08,3430,991,1087,2078,二水,二等
2020-08-09,3430,1393,1059,2452,二水,二等
2020-08-10,3430,960,1035,1995,二水,二等
2020-08-11,3430,728,741,1469,二水,二等
2020-08-12,3430,788,828,1616,二水,二等
2020-08-13,3430,962,901,1863,二水,二等
2020-08-14,3430,1027,1124,2151,二水,二等
2020-08-15,3430,993,1093,2086,二水,二等
2020-08-16,3430,1224,1052,2276,二水,二等
2020-08-17,3430,1000,977,1977,二水,二等
2020-08-18,3430,1079,1113,2192,二水,二等
2020-08-19,3430,867,892,1759,二水,二等
2020-08-20,3430,882,921,1803,二水,二等
2020-08-21,3430,1084,1192,2276,二水,二等
2020-08-22,3430,986,1136,2122,二水,二等
2020-08-23,3430,1184,901,2085,二水,二等
2020-08-24,3430,1032,906,1938,二水,二等
2020-08-25,3430,902,897,1799,二水,二等
2020-08-26,3430,1048,1065,2113,二水,二等
2020-08-27,3430,843,853,1696,二水,二等
2020-08-28,3430,1056,1070,2126,二水,二等
2020-08-29,3430,834,929,1763,二水,二等
2020-08-30,3430,1080,886,1966,二水,二等
2020-08-31,3430,894,895,1789,二水,二等
2020-09-01,3430,814,829,1643,二水,二等
2020-09-02,3430,818,808,1626,二水,二等
2020-09-03,3430,868,841,1709,二水,二等
2020-09-04,3430,880,1040,1920,二水,二等
2020-09-05,3430,927,1005,1932,二水,二等
2020-09-06,3430,1174,970,2144,二水,二等
2020-09-07,3430,901,874,1775,二水,二等
2020-09-08,3430,904,883,1787,二水,二等
2020-09-09,3430,898,958,1856,二水,二等
2020-09-10,3430,856,886,1742,二水,二等
2020-09-11,3430,958,1159,2117,二水,二等
2020-09-12,3430,1001,1029,2030,二水,二等
2020-09-13,3430,1354,1033,2387,二水,二等
2020-09-14,3430,852,870,1722,二水,二等
2020-09-15,3430,782,775,1557,二水,二等
2020-09-16,3430,784,799,1583,二水,二等
2020-09-17,3430,813,845,1658,二水,二等
2020-09-18,3430,876,1217,2093,二水,二等
2020-09-19,3430,865,1061,1926,二水,二等
2020-09-20,3430,1383,1049,2432,二水,二等
2020-09-21,3430,940,893,1833,二水,二等
2020-09-22,3430,851,909,1760,二水,二等
2020-09-23,3430,898,874,1772,二水,二等
2020-09-24,3430,832,879,1711,二水,二等
2020-09-25,3430,834,953,1787,二水,二等
2020-09-26,3430,1005,1038,2043,二水,二等
2020-09-27,3430,1103,915,2018,二水,二等
2020-09-28,3430,875,862,1737,二水,二等
2020-09-29,3430,818,849,1667,二水,二等
2020-09-30,3430,1050,1544,2594,二水,二等
2020-10-01,3430,1180,1604,2784,二水,二等
2020-10-02,3430,1614,1640,3254,二水,二等
2020-10-03,3430,1714,1455,3169,二水,二等
2020-10-04,3430,1732,1115,2847,二水,二等
2020-10-05,3430,1021,906,1927,二水,二等
2020-10-06,3430,935,925,1860,二水,二等
2020-10-07,3430,843,888,1731,二水,二等
2020-10-08,3430,987,1290,2277,二水,二等
2020-10-09,3430,1305,1459,2764,二水,二等
2020-10-10,3430,1306,1400,2706,二水,二等
2020-10-11,3430,1540,1130,2670,二水,二等
2020-10-12,3430,984,929,1913,二水,二等
2020-10-13,3430,910,894,1804,二水,二等
2020-10-14,3430,903,922,1825,二水,二等
2020-10-15,3430,886,886,1772,二水,二等
2020-10-16,3430,1081,1394,2475,二水,二等
2020-10-17,3430,1028,1170,2198,二水,二等
2020-10-18,3430,1523,1169,2692,二水,二等
2020-10-19,3430,970,1005,1975,二水,二等
2020-10-20,3430,937,937,1874,二水,二等
2020-10-21,3430,930,988,1918,二水,二等
2020-10-22,3430,841,858,1699,二水,二等
2020-10-23,3430,1028,1352,2380,二水,二等
2020-10-24,3430,1162,946,2108,二水,二等
2020-10-25,3430,1448,1065,2513,二水,二等
2020-10-26,3430,1029,940,1969,二水,二等
2020-10-27,3430,1056,1088,2144,二水,二等
2020-10-28,3430,881,924,1805,二水,二等
2020-10-29,3430,921,961,1882,二水,二等
2020-10-30,3430,1567,2023,3590,二水,二等
2020-10-31,3430,1947,2159,4106,二水,二等
2020-11-01,3430,2131,1663,3794,二水,二等
2020-11-02,3430,945,830,1775,二水,二等
2020-11-03,3430,819,823,1642,二水,二等
2020-11-04,3430,855,899,1754,二水,二等
2020-11-05,3430,780,800,1580,二水,二等
2020-11-06,3430,1145,1488,2633,二水,二等
2020-11-07,3430,1020,1141,2161,二水,二等
2020-11-08,3430,1414,1145,2559,二水,二等
2020-11-09,3430,944,931,1875,二水,二等
2020-11-10,3430,980,1034,2014,二水,二等
2020-11-11,3430,885,890,1775,二水,二等
2020-11-12,3430,870,896,1766,二水,二等
2020-11-13,3430,947,1301,2248,二水,二等
2020-11-14,3430,989,1101,2090,二水,二等
2020-11-15,3430,1538,1115,2653,二水,二等
2020-11-16,3430,961,907,1868,二水,二等
2020-11-17,3430,913,906,1819,二水,二等
2020-11-18,3430,981,997,1978,二水,二等
2020-11-19,3430,926,901,1827,二水,二等
2020-11-20,3430,1078,1369,2447,二水,二等
2020-11-21,3430,1143,1160,2303,二水,二等
2020-11-22,3430,1543,1205,2748,二水,二等
2020-11-23,3430,1044,928,1972,二水,二等
2020-11-24,3430,915,887,1802,二水,二等
2020-11-25,3430,910,944,1854,二水,二等
2020-11-26,3430,890,911,1801,二水,二等
2020-11-27,3430,1014,1338,2352,二水,二等
2020-11-28,3430,1150,1215,2365,二水,二等
2020-11-29,3430,1395,1053,2448,二水,二等
2020-11-30,3430,1042,995,2037,二水,二等
2020-12-01,3430,905,966,1871,二水,二等
2020-12-02,3430,851,897,1748,二水,二等
2020-12-03,3430,830,866,1696,二水,二等
2020-12-04,3430,956,1272,2228,二水,二等
2020-12-05,3430,1088,1157,2245,二水,二等
2020-12-06,3430,1594,1180,2774,二水,二等
2020-12-07,3430,946,885,1831,二水,二等
2020-12-08,3430,1018,977,1995,二水,二等
2020-12-09,3430,825,838,1663,二水,二等
2020-12-10,3430,841,866,1707,二水,二等
2020-12-11,3430,1009,1340,2349,二水,二等
2020-12-12,3430,1156,1264,2420,二水,二等
2020-12-13,3430,1468,1078,2546,二水,二等
2020-12-14,3430,1003,926,1929,二水,二等
2020-12-15,3430,859,889,1748,二水,二等
2020-12-16,3430,918,921,1839,二水,二等
2020-12-17,3430,940,932,1872,二水,二等
2020-12-18,3430,956,1333,2289,二水,二等
2020-12-19,3430,1053,1179,2232,二水,二等
2020-12-20,3430,1353,964,2317,二水,二等
2020-12-21,3430,890,860,1750,二水,二等
2020-12-22,3430,878,887,1765,二水,二等
2020-12-23,3430,792,815,1607,二水,二等
2020-12-24,3430,857,911,1768,二水,二等
2020-12-25,3430,985,1254,2239,二水,二等
2020-12-26,3430,976,1045,2021,二水,二等
2020-12-27,3430,1276,1017,2293,二水,二等
2020-12-28,3430,937,894,1831,二水,二等
2020-12-29,3430,846,856,1702,二水,二等
2020-12-30,3430,809,878,1687,二水,二等
2020-12-31,3430,999,1316,2315,二水,二等
2020-01-01,3431,19,17,36,源泉,招呼
2020-01-02,3431,17,18,35,源泉,招呼
2020-01-03,3431,14,25,39,源泉,招呼
2020-01-04,3431,25,24,49,源泉,招呼
2020-01-05,3431,21,23,44,源泉,招呼
2020-01-06,3431,22,11,33,源泉,招呼
2020-01-07,3431,17,21,38,源泉,招呼
2020-01-08,3431,19,17,36,源泉,招呼
2020-01-09,3431,16,21,37,源泉,招呼
2020-01-10,3431,23,34,57,源泉,招呼
2020-01-11,3431,37,35,72,源泉,招呼
2020-01-12,3431,26,16,42,源泉,招呼
2020-01-13,3431,24,23,47,源泉,招呼
2020-01-14,3431,24,19,43,源泉,招呼
2020-01-15,3431,28,26,54,源泉,招呼
2020-01-16,3431,15,16,31,源泉,招呼
2020-01-17,3431,39,30,69,源泉,招呼
2020-01-18,3431,30,42,72,源泉,招呼
2020-01-19,3431,36,18,54,源泉,招呼
2020-01-20,3431,33,25,58,源泉,招呼
2020-01-21,3431,20,25,45,源泉,招呼
2020-01-22,3431,47,33,80,源泉,招呼
2020-01-23,3431,13,23,36,源泉,招呼
2020-01-24,3431,16,22,38,源泉,招呼
2020-01-25,3431,49,50,99,源泉,招呼
2020-01-26,3431,46,60,106,源泉,招呼
2020-01-27,3431,69,49,118,源泉,招呼
2020-01-28,3431,60,64,124,源泉,招呼
2020-01-29,3431,24,23,47,源泉,招呼
2020-01-30,3431,25,25,50,源泉,招呼
2020-01-31,3431,32,36,68,源泉,招呼
2020-02-01,3431,55,32,87,源泉,招呼
2020-02-02,3431,23,14,37,源泉,招呼
2020-02-03,3431,15,17,32,源泉,招呼
2020-02-04,3431,19,18,37,源泉,招呼
2020-02-05,3431,23,21,44,源泉,招呼
2020-02-06,3431,24,14,38,源泉,招呼
2020-02-07,3431,19,27,46,源泉,招呼
2020-02-08,3431,12,19,31,源泉,招呼
2020-02-09,3431,19,16,35,源泉,招呼
2020-02-10,3431,14,12,26,源泉,招呼
2020-02-11,3431,23,23,46,源泉,招呼
2020-02-12,3431,29,28,57,源泉,招呼
2020-02-13,3431,14,13,27,源泉,招呼
2020-02-14,3431,30,33,63,源泉,招呼
2020-02-15,3431,26,26,52,源泉,招呼
2020-02-16,3431,23,14,37,源泉,招呼
2020-02-17,3431,25,19,44,源泉,招呼
2020-02-18,3431,21,19,40,源泉,招呼
2020-02-19,3431,33,24,57,源泉,招呼
2020-02-20,3431,14,22,36,源泉,招呼
2020-02-21,3431,15,25,40,源泉,招呼
2020-02-22,3431,29,34,63,源泉,招呼
2020-02-23,3431,19,21,40,源泉,招呼
2020-02-24,3431,26,18,44,源泉,招呼
2020-02-25,3431,21,18,39,源泉,招呼
2020-02-26,3431,25,27,52,源泉,招呼
2020-02-27,3431,22,26,48,源泉,招呼
2020-02-28,3431,27,31,58,源泉,招呼
2020-02-29,3431,24,17,41,源泉,招呼
2020-03-01,3431,22,13,35,源泉,招呼
2020-03-02,3431,15,21,36,源泉,招呼
2020-03-03,3431,21,20,41,源泉,招呼
2020-03-04,3431,18,18,36,源泉,招呼
2020-03-05,3431,16,21,37,源泉,招呼
2020-03-06,3431,17,27,44,源泉,招呼
2020-03-07,3431,19,26,45,源泉,招呼
2020-03-08,3431,20,18,38,源泉,招呼
2020-03-09,3431,23,28,51,源泉,招呼
2020-03-10,3431,21,20,41,源泉,招呼
2020-03-11,3431,26,18,44,源泉,招呼
2020-03-12,3431,21,20,41,源泉,招呼
2020-03-13,3431,22,34,56,源泉,招呼
2020-03-14,3431,21,30,51,源泉,招呼
2020-03-15,3431,29,22,51,源泉,招呼
2020-03-16,3431,21,17,38,源泉,招呼
2020-03-17,3431,19,13,32,源泉,招呼
2020-03-18,3431,16,19,35,源泉,招呼
2020-03-19,3431,18,10,28,源泉,招呼
2020-03-20,3431,21,32,53,源泉,招呼
2020-03-21,3431,28,28,56,源泉,招呼
2020-03-22,3431,32,54,86,源泉,招呼
2020-03-23,3431,16,20,36,源泉,招呼
2020-03-24,3431,17,12,29,源泉,招呼
2020-03-25,3431,19,17,36,源泉,招呼
2020-03-26,3431,15,19,34,源泉,招呼
2020-03-27,3431,18,23,41,源泉,招呼
2020-03-28,3431,22,25,47,源泉,招呼
2020-03-29,3431,23,22,45,源泉,招呼
2020-03-30,3431,18,22,40,源泉,招呼
2020-03-31,3431,20,20,40,源泉,招呼
2020-04-01,3431,21,23,44,源泉,招呼
2020-04-02,3431,19,28,47,源泉,招呼
2020-04-03,3431,31,37,68,源泉,招呼
2020-04-04,3431,26,31,57,源泉,招呼
2020-04-05,3431,18,9,27,源泉,招呼
2020-04-06,3431,29,23,52,源泉,招呼
2020-04-07,3431,20,18,38,源泉,招呼
2020-04-08,3431,37,24,61,源泉,招呼
2020-04-09,3431,21,15,36,源泉,招呼
2020-04-10,3431,33,25,58,源泉,招呼
2020-04-11,3431,33,34,67,源泉,招呼
2020-04-12,3431,25,23,48,源泉,招呼
2020-04-13,3431,42,42,84,源泉,招呼
2020-04-14,3431,22,18,40,源泉,招呼
2020-04-15,3431,27,19,46,源泉,招呼
2020-04-16,3431,27,20,47,源泉,招呼
2020-04-17,3431,20,24,44,源泉,招呼
2020-04-18,3431,27,25,52,源泉,招呼
2020-04-19,3431,24,14,38,源泉,招呼
2020-04-20,3431,22,19,41,源泉,招呼
2020-04-21,3431,15,13,28,源泉,招呼
2020-04-22,3431,33,23,56,源泉,招呼
2020-04-23,3431,17,18,35,源泉,招呼
2020-04-24,3431,23,25,48,源泉,招呼
2020-04-25,3431,16,26,42,源泉,招呼
2020-04-26,3431,22,20,42,源泉,招呼
2020-04-27,3431,16,21,37,源泉,招呼
2020-04-28,3431,23,22,45,源泉,招呼
2020-04-29,3431,26,39,65,源泉,招呼
2020-04-30,3431,17,19,36,源泉,招呼
2020-05-01,3431,17,20,37,源泉,招呼
2020-05-02,3431,26,27,53,源泉,招呼
2020-05-03,3431,11,13,24,源泉,招呼
2020-05-04,3431,23,25,48,源泉,招呼
2020-05-05,3431,20,21,41,源泉,招呼
2020-05-06,3431,16,9,25,源泉,招呼
2020-05-07,3431,22,17,39,源泉,招呼
2020-05-08,3431,17,33,50,源泉,招呼
2020-05-09,3431,16,20,36,源泉,招呼
2020-05-10,3431,24,18,42,源泉,招呼
2020-05-11,3431,20,25,45,源泉,招呼
2020-05-12,3431,14,19,33,源泉,招呼
2020-05-13,3431,22,21,43,源泉,招呼
2020-05-14,3431,21,25,46,源泉,招呼
2020-05-15,3431,25,27,52,源泉,招呼
2020-05-16,3431,24,21,45,源泉,招呼
2020-05-17,3431,34,18,52,源泉,招呼
2020-05-18,3431,23,21,44,源泉,招呼
2020-05-19,3431,11,19,30,源泉,招呼
2020-05-20,3431,26,16,42,源泉,招呼
2020-05-21,3431,19,12,31,源泉,招呼
2020-05-22,3431,14,16,30,源泉,招呼
2020-05-23,3431,14,12,26,源泉,招呼
2020-05-24,3431,19,13,32,源泉,招呼
2020-05-25,3431,13,17,30,源泉,招呼
2020-05-26,3431,16,19,35,源泉,招呼
2020-05-27,3431,18,13,31,源泉,招呼
2020-05-28,3431,19,17,36,源泉,招呼
2020-05-29,3431,20,21,41,源泉,招呼
2020-05-30,3431,18,23,41,源泉,招呼
2020-05-31,3431,27,31,58,源泉,招呼
2020-06-01,3431,18,14,32,源泉,招呼
2020-06-02,3431,18,21,39,源泉,招呼
2020-06-03,3431,25,15,40,源泉,招呼
2020-06-04,3431,18,18,36,源泉,招呼
2020-06-05,3431,26,26,52,源泉,招呼
2020-06-06,3431,33,21,54,源泉,招呼
2020-06-07,3431,23,18,41,源泉,招呼
2020-06-08,3431,15,14,29,源泉,招呼
2020-06-09,3431,38,30,68,源泉,招呼
2020-06-10,3431,19,23,42,源泉,招呼
2020-06-11,3431,20,17,37,源泉,招呼
2020-06-12,3431,33,30,63,源泉,招呼
2020-06-13,3431,15,37,52,源泉,招呼
2020-06-14,3431,29,38,67,源泉,招呼
2020-06-15,3431,25,22,47,源泉,招呼
2020-06-16,3431,22,15,37,源泉,招呼
2020-06-17,3431,23,27,50,源泉,招呼
2020-06-18,3431,18,23,41,源泉,招呼
2020-06-19,3431,19,16,35,源泉,招呼
2020-06-20,3431,46,38,84,源泉,招呼
2020-06-21,3431,27,24,51,源泉,招呼
2020-06-22,3431,18,22,40,源泉,招呼
2020-06-23,3431,17,21,38,源泉,招呼
2020-06-24,3431,19,22,41,源泉,招呼
2020-06-25,3431,19,20,39,源泉,招呼
2020-06-26,3431,55,42,97,源泉,招呼
2020-06-27,3431,35,34,69,源泉,招呼
2020-06-28,3431,17,18,35,源泉,招呼
2020-06-29,3431,21,19,40,源泉,招呼
2020-06-30,3431,17,17,34,源泉,招呼
2020-07-01,3431,17,25,42,源泉,招呼
2020-07-02,3431,18,20,38,源泉,招呼
2020-07-03,3431,19,20,39,源泉,招呼
2020-07-04,3431,23,27,50,源泉,招呼
2020-07-05,3431,25,27,52,源泉,招呼
2020-07-06,3431,23,27,50,源泉,招呼
2020-07-07,3431,21,20,41,源泉,招呼
2020-07-08,3431,21,29,50,源泉,招呼
2020-07-09,3431,14,15,29,源泉,招呼
2020-07-10,3431,20,23,43,源泉,招呼
2020-07-11,3431,26,23,49,源泉,招呼
2020-07-12,3431,25,12,37,源泉,招呼
2020-07-13,3431,21,16,37,源泉,招呼
2020-07-14,3431,17,22,39,源泉,招呼
2020-07-15,3431,21,17,38,源泉,招呼
2020-07-16,3431,19,18,37,源泉,招呼
2020-07-17,3431,39,31,70,源泉,招呼
2020-07-18,3431,33,18,51,源泉,招呼
2020-07-19,3431,21,17,38,源泉,招呼
2020-07-20,3431,20,26,46,源泉,招呼
2020-07-21,3431,28,28,56,源泉,招呼
2020-07-22,3431,21,7,28,源泉,招呼
2020-07-23,3431,23,17,40,源泉,招呼
2020-07-24,3431,20,19,39,源泉,招呼
2020-07-25,3431,31,21,52,源泉,招呼
2020-07-26,3431,22,25,47,源泉,招呼
2020-07-27,3431,24,19,43,源泉,招呼
2020-07-28,3431,26,18,44,源泉,招呼
2020-07-29,3431,20,18,38,源泉,招呼
2020-07-30,3431,29,18,47,源泉,招呼
2020-07-31,3431,17,24,41,源泉,招呼
2020-08-01,3431,22,32,54,源泉,招呼
2020-08-02,3431,20,13,33,源泉,招呼
2020-08-03,3431,18,19,37,源泉,招呼
2020-08-04,3431,20,19,39,源泉,招呼
2020-08-05,3431,18,18,36,源泉,招呼
2020-08-06,3431,24,21,45,源泉,招呼
2020-08-07,3431,20,20,40,源泉,招呼
2020-08-08,3431,15,24,39,源泉,招呼
2020-08-09,3431,32,15,47,源泉,招呼
2020-08-10,3431,31,30,61,源泉,招呼
2020-08-11,3431,16,12,28,源泉,招呼
2020-08-12,3431,11,16,27,源泉,招呼
2020-08-13,3431,19,15,34,源泉,招呼
2020-08-14,3431,25,25,50,源泉,招呼
2020-08-15,3431,28,28,56,源泉,招呼
2020-08-16,3431,26,31,57,源泉,招呼
2020-08-17,3431,23,15,38,源泉,招呼
2020-08-18,3431,22,32,54,源泉,招呼
2020-08-19,3431,22,17,39,源泉,招呼
2020-08-20,3431,26,26,52,源泉,招呼
2020-08-21,3431,20,22,42,源泉,招呼
2020-08-22,3431,16,14,30,源泉,招呼
2020-08-23,3431,30,25,55,源泉,招呼
2020-08-24,3431,19,19,38,源泉,招呼
2020-08-25,3431,22,17,39,源泉,招呼
2020-08-26,3431,118,109,227,源泉,招呼
2020-08-27,3431,19,15,34,源泉,招呼
2020-08-28,3431,13,16,29,源泉,招呼
2020-08-29,3431,26,21,47,源泉,招呼
2020-08-30,3431,25,14,39,源泉,招呼
2020-08-31,3431,19,14,33,源泉,招呼
2020-09-01,3431,17,23,40,源泉,招呼
2020-09-02,3431,17,15,32,源泉,招呼
2020-09-03,3431,16,16,32,源泉,招呼
2020-09-04,3431,29,14,43,源泉,招呼
2020-09-05,3431,19,17,36,源泉,招呼
2020-09-06,3431,18,17,35,源泉,招呼
2020-09-07,3431,22,21,43,源泉,招呼
2020-09-08,3431,20,19,39,源泉,招呼
2020-09-09,3431,21,13,34,源泉,招呼
2020-09-10,3431,14,16,30,源泉,招呼
2020-09-11,3431,16,16,32,源泉,招呼
2020-09-12,3431,21,19,40,源泉,招呼
2020-09-13,3431,37,18,55,源泉,招呼
2020-09-14,3431,18,15,33,源泉,招呼
2020-09-15,3431,17,15,32,源泉,招呼
2020-09-16,3431,11,8,19,源泉,招呼
2020-09-17,3431,14,17,31,源泉,招呼
2020-09-18,3431,18,18,36,源泉,招呼
2020-09-19,3431,17,16,33,源泉,招呼
2020-09-20,3431,14,8,22,源泉,招呼
2020-09-21,3431,24,21,45,源泉,招呼
2020-09-22,3431,18,20,38,源泉,招呼
2020-09-23,3431,14,11,25,源泉,招呼
2020-09-24,3431,16,20,36,源泉,招呼
2020-09-25,3431,15,26,41,源泉,招呼
2020-09-26,3431,26,25,51,源泉,招呼
2020-09-27,3431,38,20,58,源泉,招呼
2020-09-28,3431,22,17,39,源泉,招呼
2020-09-29,3431,23,25,48,源泉,招呼
2020-09-30,3431,14,23,37,源泉,招呼
2020-10-01,3431,31,32,63,源泉,招呼
2020-10-02,3431,37,37,74,源泉,招呼
2020-10-03,3431,52,40,92,源泉,招呼
2020-10-04,3431,25,11,36,源泉,招呼
2020-10-05,3431,19,15,34,源泉,招呼
2020-10-06,3431,29,27,56,源泉,招呼
2020-10-07,3431,21,18,39,源泉,招呼
2020-10-08,3431,18,19,37,源泉,招呼
2020-10-09,3431,15,28,43,源泉,招呼
2020-10-10,3431,14,14,28,源泉,招呼
2020-10-11,3431,12,12,24,源泉,招呼
2020-10-12,3431,23,22,45,源泉,招呼
2020-10-13,3431,27,25,52,源泉,招呼
2020-10-14,3431,22,19,41,源泉,招呼
2020-10-15,3431,15,12,27,源泉,招呼
2020-10-16,3431,63,67,130,源泉,招呼
2020-10-17,3431,30,31,61,源泉,招呼
2020-10-18,3431,23,22,45,源泉,招呼
2020-10-19,3431,9,13,22,源泉,招呼
2020-10-20,3431,23,18,41,源泉,招呼
2020-10-21,3431,21,16,37,源泉,招呼
2020-10-22,3431,18,19,37,源泉,招呼
2020-10-23,3431,23,25,48,源泉,招呼
2020-10-24,3431,19,32,51,源泉,招呼
2020-10-25,3431,26,26,52,源泉,招呼
2020-10-26,3431,24,11,35,源泉,招呼
2020-10-27,3431,24,26,50,源泉,招呼
2020-10-28,3431,18,22,40,源泉,招呼
2020-10-29,3431,19,17,36,源泉,招呼
2020-10-30,3431,44,51,95,源泉,招呼
2020-10-31,3431,289,212,501,源泉,招呼
2020-11-01,3431,92,94,186,源泉,招呼
2020-11-02,3431,25,17,42,源泉,招呼
2020-11-03,3431,15,20,35,源泉,招呼
2020-11-04,3431,18,22,40,源泉,招呼
2020-11-05,3431,18,15,33,源泉,招呼
2020-11-06,3431,5,17,22,源泉,招呼
2020-11-07,3431,24,25,49,源泉,招呼
2020-11-08,3431,38,38,76,源泉,招呼
2020-11-09,3431,14,14,28,源泉,招呼
2020-11-10,3431,16,10,26,源泉,招呼
2020-11-11,3431,17,13,30,源泉,招呼
2020-11-12,3431,18,13,31,源泉,招呼
2020-11-13,3431,16,19,35,源泉,招呼
2020-11-14,3431,25,37,62,源泉,招呼
2020-11-15,3431,25,19,44,源泉,招呼
2020-11-16,3431,15,10,25,源泉,招呼
2020-11-17,3431,21,17,38,源泉,招呼
2020-11-18,3431,27,30,57,源泉,招呼
2020-11-19,3431,21,21,42,源泉,招呼
2020-11-20,3431,19,21,40,源泉,招呼
2020-11-21,3431,23,43,66,源泉,招呼
2020-11-22,3431,29,38,67,源泉,招呼
2020-11-23,3431,14,15,29,源泉,招呼
2020-11-24,3431,24,25,49,源泉,招呼
2020-11-25,3431,11,18,29,源泉,招呼
2020-11-26,3431,13,16,29,源泉,招呼
2020-11-27,3431,18,22,40,源泉,招呼
2020-11-28,3431,24,27,51,源泉,招呼
2020-11-29,3431,36,27,63,源泉,招呼
2020-11-30,3431,16,16,32,源泉,招呼
2020-12-01,3431,24,20,44,源泉,招呼
2020-12-02,3431,22,20,42,源泉,招呼
2020-12-03,3431,20,14,34,源泉,招呼
2020-12-04,3431,21,29,50,源泉,招呼
2020-12-05,3431,19,21,40,源泉,招呼
2020-12-06,3431,20,19,39,源泉,招呼
2020-12-07,3431,12,11,23,源泉,招呼
2020-12-08,3431,18,18,36,源泉,招呼
2020-12-09,3431,11,8,19,源泉,招呼
2020-12-10,3431,19,19,38,源泉,招呼
2020-12-11,3431,21,21,42,源泉,招呼
2020-12-12,3431,22,28,50,源泉,招呼
2020-12-13,3431,21,18,39,源泉,招呼
2020-12-14,3431,10,16,26,源泉,招呼
2020-12-15,3431,15,15,30,源泉,招呼
2020-12-16,3431,16,17,33,源泉,招呼
2020-12-17,3431,29,30,59,源泉,招呼
2020-12-18,3431,14,21,35,源泉,招呼
2020-12-19,3431,25,28,53,源泉,招呼
2020-12-20,3431,22,14,36,源泉,招呼
2020-12-21,3431,15,15,30,源泉,招呼
2020-12-22,3431,44,21,65,源泉,招呼
2020-12-23,3431,13,14,27,源泉,招呼
2020-12-24,3431,21,21,42,源泉,招呼
2020-12-25,3431,20,27,47,源泉,招呼
2020-12-26,3431,20,21,41,源泉,招呼
2020-12-27,3431,17,19,36,源泉,招呼
2020-12-28,3431,26,25,51,源泉,招呼
2020-12-29,3431,12,9,21,源泉,招呼
2020-12-30,3431,11,11,22,源泉,招呼
2020-12-31,3431,17,16,33,源泉,招呼
2020-01-01,3432,206,191,397,濁水,丙簡
2020-01-02,3432,78,89,167,濁水,丙簡
2020-01-03,3432,76,94,170,濁水,丙簡
2020-01-04,3432,200,236,436,濁水,丙簡
2020-01-05,3432,265,149,414,濁水,丙簡
2020-01-06,3432,80,68,148,濁水,丙簡
2020-01-07,3432,130,56,186,濁水,丙簡
2020-01-08,3432,71,63,134,濁水,丙簡
2020-01-09,3432,75,63,138,濁水,丙簡
2020-01-10,3432,116,131,247,濁水,丙簡
2020-01-11,3432,161,155,316,濁水,丙簡
2020-01-12,3432,191,142,333,濁水,丙簡
2020-01-13,3432,140,136,276,濁水,丙簡
2020-01-14,3432,60,61,121,濁水,丙簡
2020-01-15,3432,81,74,155,濁水,丙簡
2020-01-16,3432,134,87,221,濁水,丙簡
2020-01-17,3432,98,112,210,濁水,丙簡
2020-01-18,3432,131,118,249,濁水,丙簡
2020-01-19,3432,153,158,311,濁水,丙簡
2020-01-20,3432,108,111,219,濁水,丙簡
2020-01-21,3432,116,108,224,濁水,丙簡
2020-01-22,3432,101,107,208,濁水,丙簡
2020-01-23,3432,112,139,251,濁水,丙簡
2020-01-24,3432,76,134,210,濁水,丙簡
2020-01-25,3432,338,299,637,濁水,丙簡
2020-01-26,3432,209,183,392,濁水,丙簡
2020-01-27,3432,401,379,780,濁水,丙簡
2020-01-28,3432,231,224,455,濁水,丙簡
2020-01-29,3432,192,150,342,濁水,丙簡
2020-01-30,3432,167,176,343,濁水,丙簡
2020-01-31,3432,89,94,183,濁水,丙簡
2020-02-01,3432,117,120,237,濁水,丙簡
2020-02-02,3432,127,100,227,濁水,丙簡
2020-02-03,3432,83,81,164,濁水,丙簡
2020-02-04,3432,77,86,163,濁水,丙簡
2020-02-05,3432,105,97,202,濁水,丙簡
2020-02-06,3432,170,169,339,濁水,丙簡
2020-02-07,3432,126,114,240,濁水,丙簡
2020-02-08,3432,90,96,186,濁水,丙簡
2020-02-09,3432,113,126,239,濁水,丙簡
2020-02-10,3432,96,82,178,濁水,丙簡
2020-02-11,3432,88,76,164,濁水,丙簡
2020-02-12,3432,81,70,151,濁水,丙簡
2020-02-13,3432,72,55,127,濁水,丙簡
2020-02-14,3432,101,97,198,濁水,丙簡
2020-02-15,3432,92,86,178,濁水,丙簡
2020-02-16,3432,109,119,228,濁水,丙簡
2020-02-17,3432,84,82,166,濁水,丙簡
2020-02-18,3432,63,64,127,濁水,丙簡
2020-02-19,3432,113,115,228,濁水,丙簡
2020-02-20,3432,68,63,131,濁水,丙簡
2020-02-21,3432,104,103,207,濁水,丙簡
2020-02-22,3432,114,94,208,濁水,丙簡
2020-02-23,3432,145,136,281,濁水,丙簡
2020-02-24,3432,89,94,183,濁水,丙簡
2020-02-25,3432,55,55,110,濁水,丙簡
2020-02-26,3432,65,54,119,濁水,丙簡
2020-02-27,3432,75,85,160,濁水,丙簡
2020-02-28,3432,121,129,250,濁水,丙簡
2020-02-29,3432,162,109,271,濁水,丙簡
2020-03-01,3432,162,176,338,濁水,丙簡
2020-03-02,3432,57,60,117,濁水,丙簡
2020-03-03,3432,50,47,97,濁水,丙簡
2020-03-04,3432,48,44,92,濁水,丙簡
2020-03-05,3432,43,54,97,濁水,丙簡
2020-03-06,3432,61,103,164,濁水,丙簡
2020-03-07,3432,97,97,194,濁水,丙簡
2020-03-08,3432,153,116,269,濁水,丙簡
2020-03-09,3432,51,59,110,濁水,丙簡
2020-03-10,3432,36,30,66,濁水,丙簡
2020-03-11,3432,40,52,92,濁水,丙簡
2020-03-12,3432,34,36,70,濁水,丙簡
2020-03-13,3432,67,82,149,濁水,丙簡
2020-03-14,3432,91,111,202,濁水,丙簡
2020-03-15,3432,121,100,221,濁水,丙簡
2020-03-16,3432,54,51,105,濁水,丙簡
2020-03-17,3432,48,56,104,濁水,丙簡
2020-03-18,3432,36,45,81,濁水,丙簡
2020-03-19,3432,33,35,68,濁水,丙簡
2020-03-20,3432,62,98,160,濁水,丙簡
2020-03-21,3432,82,90,172,濁水,丙簡
2020-03-22,3432,131,93,224,濁水,丙簡
2020-03-23,3432,46,46,92,濁水,丙簡
2020-03-24,3432,50,44,94,濁水,丙簡
2020-03-25,3432,45,61,106,濁水,丙簡
2020-03-26,3432,48,43,91,濁水,丙簡
2020-03-27,3432,48,74,122,濁水,丙簡
2020-03-28,3432,63,81,144,濁水,丙簡
2020-03-29,3432,112,105,217,濁水,丙簡
2020-03-30,3432,37,37,74,濁水,丙簡
2020-03-31,3432,51,54,105,濁水,丙簡
2020-04-01,3432,59,81,140,濁水,丙簡
2020-04-02,3432,51,64,115,濁水,丙簡
2020-04-03,3432,96,89,185,濁水,丙簡
2020-04-04,3432,73,65,138,濁水,丙簡
2020-04-05,3432,123,81,204,濁水,丙簡
2020-04-06,3432,50,30,80,濁水,丙簡
2020-04-07,3432,32,23,55,濁水,丙簡
2020-04-08,3432,24,29,53,濁水,丙簡
2020-04-09,3432,32,31,63,濁水,丙簡
2020-04-10,3432,47,79,126,濁水,丙簡
2020-04-11,3432,83,81,164,濁水,丙簡
2020-04-12,3432,90,51,141,濁水,丙簡
2020-04-13,3432,69,65,134,濁水,丙簡
2020-04-14,3432,33,35,68,濁水,丙簡
2020-04-15,3432,46,47,93,濁水,丙簡
2020-04-16,3432,42,35,77,濁水,丙簡
2020-04-17,3432,51,78,129,濁水,丙簡
2020-04-18,3432,72,78,150,濁水,丙簡
2020-04-19,3432,118,109,227,濁水,丙簡
2020-04-20,3432,53,45,98,濁水,丙簡
2020-04-21,3432,34,29,63,濁水,丙簡
2020-04-22,3432,36,48,84,濁水,丙簡
2020-04-23,3432,42,30,72,濁水,丙簡
2020-04-24,3432,41,81,122,濁水,丙簡
2020-04-25,3432,71,60,131,濁水,丙簡
2020-04-26,3432,94,81,175,濁水,丙簡
2020-04-27,3432,54,41,95,濁水,丙簡
2020-04-28,3432,43,49,92,濁水,丙簡
2020-04-29,3432,42,41,83,濁水,丙簡
2020-04-30,3432,50,57,107,濁水,丙簡
2020-05-01,3432,65,117,182,濁水,丙簡
2020-05-02,3432,135,108,243,濁水,丙簡
2020-05-03,3432,128,117,245,濁水,丙簡
2020-05-04,3432,51,64,115,濁水,丙簡
2020-05-05,3432,50,48,98,濁水,丙簡
2020-05-06,3432,42,50,92,濁水,丙簡
2020-05-07,3432,43,56,99,濁水,丙簡
2020-05-08,3432,80,102,182,濁水,丙簡
2020-05-09,3432,87,103,190,濁水,丙簡
2020-05-10,3432,151,172,323,濁水,丙簡
2020-05-11,3432,51,49,100,濁水,丙簡
2020-05-12,3432,39,37,76,濁水,丙簡
2020-05-13,3432,43,54,97,濁水,丙簡
2020-05-14,3432,59,50,109,濁水,丙簡
2020-05-15,3432,74,104,178,濁水,丙簡
2020-05-16,3432,113,91,204,濁水,丙簡
2020-05-17,3432,150,133,283,濁水,丙簡
2020-05-18,3432,66,67,133,濁水,丙簡
2020-05-19,3432,37,32,69,濁水,丙簡
2020-05-20,3432,45,44,89,濁水,丙簡
2020-05-21,3432,35,39,74,濁水,丙簡
2020-05-22,3432,45,76,121,濁水,丙簡
2020-05-23,3432,83,81,164,濁水,丙簡
2020-05-24,3432,175,144,319,濁水,丙簡
2020-05-25,3432,88,80,168,濁水,丙簡
2020-05-26,3432,44,41,85,濁水,丙簡
2020-05-27,3432,46,38,84,濁水,丙簡
2020-05-28,3432,30,48,78,濁水,丙簡
2020-05-29,3432,47,80,127,濁水,丙簡
2020-05-30,3432,163,159,322,濁水,丙簡
2020-05-31,3432,252,196,448,濁水,丙簡
2020-06-01,3432,48,50,98,濁水,丙簡
2020-06-02,3432,46,56,102,濁水,丙簡
2020-06-03,3432,55,49,104,濁水,丙簡
2020-06-04,3432,86,76,162,濁水,丙簡
2020-06-05,3432,61,100,161,濁水,丙簡
2020-06-06,3432,127,114,241,濁水,丙簡
2020-06-07,3432,192,140,332,濁水,丙簡
2020-06-08,3432,69,73,142,濁水,丙簡
2020-06-09,3432,50,44,94,濁水,丙簡
2020-06-10,3432,60,96,156,濁水,丙簡
2020-06-11,3432,82,60,142,濁水,丙簡
2020-06-12,3432,77,89,166,濁水,丙簡
2020-06-13,3432,146,100,246,濁水,丙簡
2020-06-14,3432,209,201,410,濁水,丙簡
2020-06-15,3432,116,97,213,濁水,丙簡
2020-06-16,3432,53,54,107,濁水,丙簡
2020-06-17,3432,107,54,161,濁水,丙簡
2020-06-18,3432,118,69,187,濁水,丙簡
2020-06-19,3432,91,73,164,濁水,丙簡
2020-06-20,3432,105,99,204,濁水,丙簡
2020-06-21,3432,195,180,375,濁水,丙簡
2020-06-22,3432,92,73,165,濁水,丙簡
2020-06-23,3432,61,60,121,濁水,丙簡
2020-06-24,3432,82,114,196,濁水,丙簡
2020-06-25,3432,160,152,312,濁水,丙簡
2020-06-26,3432,233,272,505,濁水,丙簡
2020-06-27,3432,300,260,560,濁水,丙簡
2020-06-28,3432,195,169,364,濁水,丙簡
2020-06-29,3432,92,58,150,濁水,丙簡
2020-06-30,3432,64,70,134,濁水,丙簡
2020-07-01,3432,82,60,142,濁水,丙簡
2020-07-02,3432,85,86,171,濁水,丙簡
2020-07-03,3432,103,89,192,濁水,丙簡
2020-07-04,3432,108,81,189,濁水,丙簡
2020-07-05,3432,195,139,334,濁水,丙簡
2020-07-06,3432,92,79,171,濁水,丙簡
2020-07-07,3432,69,69,138,濁水,丙簡
2020-07-08,3432,72,74,146,濁水,丙簡
2020-07-09,3432,99,80,179,濁水,丙簡
2020-07-10,3432,79,76,155,濁水,丙簡
2020-07-11,3432,208,177,385,濁水,丙簡
2020-07-12,3432,231,175,406,濁水,丙簡
2020-07-13,3432,95,102,197,濁水,丙簡
2020-07-14,3432,73,76,149,濁水,丙簡
2020-07-15,3432,180,75,255,濁水,丙簡
2020-07-16,3432,95,112,207,濁水,丙簡
2020-07-17,3432,133,166,299,濁水,丙簡
2020-07-18,3432,205,201,406,濁水,丙簡
2020-07-19,3432,399,177,576,濁水,丙簡
2020-07-20,3432,127,117,244,濁水,丙簡
2020-07-21,3432,98,109,207,濁水,丙簡
2020-07-22,3432,95,95,190,濁水,丙簡
2020-07-23,3432,98,102,200,濁水,丙簡
2020-07-24,3432,124,103,227,濁水,丙簡
2020-07-25,3432,190,180,370,濁水,丙簡
2020-07-26,3432,192,182,374,濁水,丙簡
2020-07-27,3432,181,140,321,濁水,丙簡
2020-07-28,3432,142,202,344,濁水,丙簡
2020-07-29,3432,196,122,318,濁水,丙簡
2020-07-30,3432,121,186,307,濁水,丙簡
2020-07-31,3432,134,150,284,濁水,丙簡
2020-08-01,3432,296,183,479,濁水,丙簡
2020-08-02,3432,159,168,327,濁水,丙簡
2020-08-03,3432,83,65,148,濁水,丙簡
2020-08-04,3432,70,83,153,濁水,丙簡
2020-08-05,3432,86,69,155,濁水,丙簡
2020-08-06,3432,110,105,215,濁水,丙簡
2020-08-07,3432,106,108,214,濁水,丙簡
2020-08-08,3432,146,268,414,濁水,丙簡
2020-08-09,3432,215,178,393,濁水,丙簡
2020-08-10,3432,115,163,278,濁水,丙簡
2020-08-11,3432,76,70,146,濁水,丙簡
2020-08-12,3432,99,96,195,濁水,丙簡
2020-08-13,3432,101,139,240,濁水,丙簡
2020-08-14,3432,189,123,312,濁水,丙簡
2020-08-15,3432,219,250,469,濁水,丙簡
2020-08-16,3432,209,162,371,濁水,丙簡
2020-08-17,3432,130,90,220,濁水,丙簡
2020-08-18,3432,120,86,206,濁水,丙簡
2020-08-19,3432,65,61,126,濁水,丙簡
2020-08-20,3432,94,82,176,濁水,丙簡
2020-08-21,3432,105,107,212,濁水,丙簡
2020-08-22,3432,158,127,285,濁水,丙簡
2020-08-23,3432,216,156,372,濁水,丙簡
2020-08-24,3432,85,252,337,濁水,丙簡
2020-08-25,3432,68,118,186,濁水,丙簡
2020-08-26,3432,122,113,235,濁水,丙簡
2020-08-27,3432,103,67,170,濁水,丙簡
2020-08-28,3432,83,129,212,濁水,丙簡
2020-08-29,3432,160,157,317,濁水,丙簡
2020-08-30,3432,155,134,289,濁水,丙簡
2020-08-31,3432,68,55,123,濁水,丙簡
2020-09-01,3432,68,52,120,濁水,丙簡
2020-09-02,3432,50,50,100,濁水,丙簡
2020-09-03,3432,73,75,148,濁水,丙簡
2020-09-04,3432,81,83,164,濁水,丙簡
2020-09-05,3432,154,166,320,濁水,丙簡
2020-09-06,3432,172,194,366,濁水,丙簡
2020-09-07,3432,99,119,218,濁水,丙簡
2020-09-08,3432,67,50,117,濁水,丙簡
2020-09-09,3432,64,64,128,濁水,丙簡
2020-09-10,3432,58,52,110,濁水,丙簡
2020-09-11,3432,97,60,157,濁水,丙簡
2020-09-12,3432,136,125,261,濁水,丙簡
2020-09-13,3432,175,164,339,濁水,丙簡
2020-09-14,3432,85,74,159,濁水,丙簡
2020-09-15,3432,52,45,97,濁水,丙簡
2020-09-16,3432,40,34,74,濁水,丙簡
2020-09-17,3432,148,76,224,濁水,丙簡
2020-09-18,3432,86,115,201,濁水,丙簡
2020-09-19,3432,145,143,288,濁水,丙簡
2020-09-20,3432,249,202,451,濁水,丙簡
2020-09-21,3432,62,204,266,濁水,丙簡
2020-09-22,3432,75,72,147,濁水,丙簡
2020-09-23,3432,68,135,203,濁水,丙簡
2020-09-24,3432,124,92,216,濁水,丙簡
2020-09-25,3432,88,106,194,濁水,丙簡
2020-09-26,3432,183,136,319,濁水,丙簡
2020-09-27,3432,233,118,351,濁水,丙簡
2020-09-28,3432,83,68,151,濁水,丙簡
2020-09-29,3432,84,79,163,濁水,丙簡
2020-09-30,3432,75,89,164,濁水,丙簡
2020-10-01,3432,91,157,248,濁水,丙簡
2020-10-02,3432,313,225,538,濁水,丙簡
2020-10-03,3432,320,258,578,濁水,丙簡
2020-10-04,3432,343,224,567,濁水,丙簡
2020-10-05,3432,71,51,122,濁水,丙簡
2020-10-06,3432,303,69,372,濁水,丙簡
2020-10-07,3432,102,66,168,濁水,丙簡
2020-10-08,3432,69,142,211,濁水,丙簡
2020-10-09,3432,206,160,366,濁水,丙簡
2020-10-10,3432,218,187,405,濁水,丙簡
2020-10-11,3432,224,149,373,濁水,丙簡
2020-10-12,3432,122,112,234,濁水,丙簡
2020-10-13,3432,62,77,139,濁水,丙簡
2020-10-14,3432,161,68,229,濁水,丙簡
2020-10-15,3432,44,51,95,濁水,丙簡
2020-10-16,3432,91,105,196,濁水,丙簡
2020-10-17,3432,290,157,447,濁水,丙簡
2020-10-18,3432,211,220,431,濁水,丙簡
2020-10-19,3432,70,61,131,濁水,丙簡
2020-10-20,3432,250,73,323,濁水,丙簡
2020-10-21,3432,70,65,135,濁水,丙簡
2020-10-22,3432,172,84,256,濁水,丙簡
2020-10-23,3432,89,121,210,濁水,丙簡
2020-10-24,3432,234,111,345,濁水,丙簡
2020-10-25,3432,194,186,380,濁水,丙簡
2020-10-26,3432,90,157,247,濁水,丙簡
2020-10-27,3432,194,81,275,濁水,丙簡
2020-10-28,3432,118,90,208,濁水,丙簡
2020-10-29,3432,218,60,278,濁水,丙簡
2020-10-30,3432,63,94,157,濁水,丙簡
2020-10-31,3432,142,263,405,濁水,丙簡
2020-11-01,3432,214,172,386,濁水,丙簡
2020-11-02,3432,93,92,185,濁水,丙簡
2020-11-03,3432,61,59,120,濁水,丙簡
2020-11-04,3432,53,88,141,濁水,丙簡
2020-11-05,3432,64,47,111,濁水,丙簡
2020-11-06,3432,86,87,173,濁水,丙簡
2020-11-07,3432,202,126,328,濁水,丙簡
2020-11-08,3432,180,148,328,濁水,丙簡
2020-11-09,3432,103,70,173,濁水,丙簡
2020-11-10,3432,137,60,197,濁水,丙簡
2020-11-11,3432,75,65,140,濁水,丙簡
2020-11-12,3432,97,123,220,濁水,丙簡
2020-11-13,3432,73,88,161,濁水,丙簡
2020-11-14,3432,188,154,342,濁水,丙簡
2020-11-15,3432,285,164,449,濁水,丙簡
2020-11-16,3432,83,85,168,濁水,丙簡
2020-11-17,3432,82,91,173,濁水,丙簡
2020-11-18,3432,109,69,178,濁水,丙簡
2020-11-19,3432,99,84,183,濁水,丙簡
2020-11-20,3432,99,166,265,濁水,丙簡
2020-11-21,3432,205,179,384,濁水,丙簡
2020-11-22,3432,401,225,626,濁水,丙簡
2020-11-23,3432,94,106,200,濁水,丙簡
2020-11-24,3432,78,57,135,濁水,丙簡
2020-11-25,3432,102,79,181,濁水,丙簡
2020-11-26,3432,63,57,120,濁水,丙簡
2020-11-27,3432,121,163,284,濁水,丙簡
2020-11-28,3432,134,163,297,濁水,丙簡
2020-11-29,3432,219,178,397,濁水,丙簡
2020-11-30,3432,76,85,161,濁水,丙簡
2020-12-01,3432,78,82,160,濁水,丙簡
2020-12-02,3432,70,69,139,濁水,丙簡
2020-12-03,3432,70,68,138,濁水,丙簡
2020-12-04,3432,131,130,261,濁水,丙簡
2020-12-05,3432,136,148,284,濁水,丙簡
2020-12-06,3432,180,156,336,濁水,丙簡
2020-12-07,3432,59,48,107,濁水,丙簡
2020-12-08,3432,167,96,263,濁水,丙簡
2020-12-09,3432,72,75,147,濁水,丙簡
2020-12-10,3432,68,62,130,濁水,丙簡
2020-12-11,3432,75,97,172,濁水,丙簡
2020-12-12,3432,140,122,262,濁水,丙簡
2020-12-13,3432,453,190,643,濁水,丙簡
2020-12-14,3432,106,96,202,濁水,丙簡
2020-12-15,3432,57,55,112,濁水,丙簡
2020-12-16,3432,87,50,137,濁水,丙簡
2020-12-17,3432,69,81,150,濁水,丙簡
2020-12-18,3432,69,94,163,濁水,丙簡
2020-12-19,3432,187,148,335,濁水,丙簡
2020-12-20,3432,316,177,493,濁水,丙簡
2020-12-21,3432,66,59,125,濁水,丙簡
2020-12-22,3432,71,77,148,濁水,丙簡
2020-12-23,3432,57,54,111,濁水,丙簡
2020-12-24,3432,55,43,98,濁水,丙簡
2020-12-25,3432,87,78,165,濁水,丙簡
2020-12-26,3432,119,121,240,濁水,丙簡
2020-12-27,3432,156,134,290,濁水,丙簡
2020-12-28,3432,75,55,130,濁水,丙簡
2020-12-29,3432,64,54,118,濁水,丙簡
2020-12-30,3432,57,136,193,濁水,丙簡
2020-12-31,3432,78,95,173,濁水,丙簡
2020-01-01,3433,14,37,51,龍泉,招呼
2020-01-02,3433,16,25,41,龍泉,招呼
2020-01-03,3433,22,17,39,龍泉,招呼
2020-01-04,3433,15,14,29,龍泉,招呼
2020-01-05,3433,15,27,42,龍泉,招呼
2020-01-06,3433,7,16,23,龍泉,招呼
2020-01-07,3433,4,10,14,龍泉,招呼
2020-01-08,3433,8,9,17,龍泉,招呼
2020-01-09,3433,7,5,12,龍泉,招呼
2020-01-10,3433,18,27,45,龍泉,招呼
2020-01-11,3433,12,30,42,龍泉,招呼
2020-01-12,3433,46,21,67,龍泉,招呼
2020-01-13,3433,30,27,57,龍泉,招呼
2020-01-14,3433,10,15,25,龍泉,招呼
2020-01-15,3433,13,21,34,龍泉,招呼
2020-01-16,3433,15,12,27,龍泉,招呼
2020-01-17,3433,22,11,33,龍泉,招呼
2020-01-18,3433,4,12,16,龍泉,招呼
2020-01-19,3433,8,24,32,龍泉,招呼
2020-01-20,3433,8,9,17,龍泉,招呼
2020-01-21,3433,11,11,22,龍泉,招呼
2020-01-22,3433,10,20,30,龍泉,招呼
2020-01-23,3433,8,6,14,龍泉,招呼
2020-01-24,3433,9,22,31,龍泉,招呼
2020-01-25,3433,43,44,87,龍泉,招呼
2020-01-26,3433,20,43,63,龍泉,招呼
2020-01-27,3433,63,59,122,龍泉,招呼
2020-01-28,3433,18,22,40,龍泉,招呼
2020-01-29,3433,11,10,21,龍泉,招呼
2020-01-30,3433,16,21,37,龍泉,招呼
2020-01-31,3433,13,11,24,龍泉,招呼
2020-02-01,3433,12,17,29,龍泉,招呼
2020-02-02,3433,47,63,110,龍泉,招呼
2020-02-03,3433,10,8,18,龍泉,招呼
2020-02-04,3433,12,23,35,龍泉,招呼
2020-02-05,3433,7,9,16,龍泉,招呼
2020-02-06,3433,13,19,32,龍泉,招呼
2020-02-07,3433,29,17,46,龍泉,招呼
2020-02-08,3433,12,26,38,龍泉,招呼
2020-02-09,3433,9,37,46,龍泉,招呼
2020-02-10,3433,19,27,46,龍泉,招呼
2020-02-11,3433,12,8,20,龍泉,招呼
2020-02-12,3433,9,7,16,龍泉,招呼
2020-02-13,3433,13,13,26,龍泉,招呼
2020-02-14,3433,6,9,15,龍泉,招呼
2020-02-15,3433,21,22,43,龍泉,招呼
2020-02-16,3433,26,35,61,龍泉,招呼
2020-02-17,3433,10,13,23,龍泉,招呼
2020-02-18,3433,20,16,36,龍泉,招呼
2020-02-19,3433,12,7,19,龍泉,招呼
2020-02-20,3433,33,36,69,龍泉,招呼
2020-02-21,3433,32,24,56,龍泉,招呼
2020-02-22,3433,11,16,27,龍泉,招呼
2020-02-23,3433,7,24,31,龍泉,招呼
2020-02-24,3433,12,5,17,龍泉,招呼
2020-02-25,3433,7,11,18,龍泉,招呼
2020-02-26,3433,8,8,16,龍泉,招呼
2020-02-27,3433,21,14,35,龍泉,招呼
2020-02-28,3433,12,20,32,龍泉,招呼
2020-02-29,3433,19,26,45,龍泉,招呼
2020-03-01,3433,17,17,34,龍泉,招呼
2020-03-02,3433,10,18,28,龍泉,招呼
2020-03-03,3433,6,9,15,龍泉,招呼
2020-03-04,3433,16,17,33,龍泉,招呼
2020-03-05,3433,7,3,10,龍泉,招呼
2020-03-06,3433,23,17,40,龍泉,招呼
2020-03-07,3433,6,6,12,龍泉,招呼
2020-03-08,3433,11,18,29,龍泉,招呼
2020-03-09,3433,13,15,28,龍泉,招呼
2020-03-10,3433,5,6,11,龍泉,招呼
2020-03-11,3433,9,5,14,龍泉,招呼
2020-03-12,3433,13,10,23,龍泉,招呼
2020-03-13,3433,24,17,41,龍泉,招呼
2020-03-14,3433,3,5,8,龍泉,招呼
2020-03-15,3433,3,16,19,龍泉,招呼
2020-03-16,3433,16,12,28,龍泉,招呼
2020-03-17,3433,24,11,35,龍泉,招呼
2020-03-18,3433,11,8,19,龍泉,招呼
2020-03-19,3433,9,7,16,龍泉,招呼
2020-03-20,3433,19,22,41,龍泉,招呼
2020-03-21,3433,10,14,24,龍泉,招呼
2020-03-22,3433,23,28,51,龍泉,招呼
2020-03-23,3433,10,19,29,龍泉,招呼
2020-03-24,3433,9,13,22,龍泉,招呼
2020-03-25,3433,8,10,18,龍泉,招呼
2020-03-26,3433,7,3,10,龍泉,招呼
2020-03-27,3433,26,11,37,龍泉,招呼
2020-03-28,3433,11,11,22,龍泉,招呼
2020-03-29,3433,8,25,33,龍泉,招呼
2020-03-30,3433,11,12,23,龍泉,招呼
2020-03-31,3433,20,20,40,龍泉,招呼
2020-04-01,3433,17,8,25,龍泉,招呼
2020-04-02,3433,4,4,8,龍泉,招呼
2020-04-03,3433,14,16,30,龍泉,招呼
2020-04-04,3433,12,15,27,龍泉,招呼
2020-04-05,3433,3,17,20,龍泉,招呼
2020-04-06,3433,16,11,27,龍泉,招呼
2020-04-07,3433,11,8,19,龍泉,招呼
2020-04-08,3433,7,7,14,龍泉,招呼
2020-04-09,3433,14,6,20,龍泉,招呼
2020-04-10,3433,26,12,38,龍泉,招呼
2020-04-11,3433,5,11,16,龍泉,招呼
2020-04-12,3433,13,27,40,龍泉,招呼
2020-04-13,3433,10,11,21,龍泉,招呼
2020-04-14,3433,25,9,34,龍泉,招呼
2020-04-15,3433,20,28,48,龍泉,招呼
2020-04-16,3433,10,7,17,龍泉,招呼
2020-04-17,3433,23,15,38,龍泉,招呼
2020-04-18,3433,13,16,29,龍泉,招呼
2020-04-19,3433,15,23,38,龍泉,招呼
2020-04-20,3433,16,14,30,龍泉,招呼
2020-04-21,3433,12,9,21,龍泉,招呼
2020-04-22,3433,18,12,30,龍泉,招呼
2020-04-23,3433,11,4,15,龍泉,招呼
2020-04-24,3433,20,11,31,龍泉,招呼
2020-04-25,3433,8,12,20,龍泉,招呼
2020-04-26,3433,46,17,63,龍泉,招呼
2020-04-27,3433,17,13,30,龍泉,招呼
2020-04-28,3433,8,6,14,龍泉,招呼
2020-04-29,3433,5,1,6,龍泉,招呼
2020-04-30,3433,9,4,13,龍泉,招呼
2020-05-01,3433,14,11,25,龍泉,招呼
2020-05-02,3433,10,14,24,龍泉,招呼
2020-05-03,3433,9,23,32,龍泉,招呼
2020-05-04,3433,23,25,48,龍泉,招呼
2020-05-05,3433,11,10,21,龍泉,招呼
2020-05-06,3433,21,16,37,龍泉,招呼
2020-05-07,3433,8,10,18,龍泉,招呼
2020-05-08,3433,12,18,30,龍泉,招呼
2020-05-09,3433,11,12,23,龍泉,招呼
2020-05-10,3433,16,20,36,龍泉,招呼
2020-05-11,3433,10,11,21,龍泉,招呼
2020-05-12,3433,13,8,21,龍泉,招呼
2020-05-13,3433,16,11,27,龍泉,招呼
2020-05-14,3433,10,14,24,龍泉,招呼
2020-05-15,3433,13,11,24,龍泉,招呼
2020-05-16,3433,10,12,22,龍泉,招呼
2020-05-17,3433,16,19,35,龍泉,招呼
2020-05-18,3433,13,13,26,龍泉,招呼
2020-05-19,3433,13,11,24,龍泉,招呼
2020-05-20,3433,4,11,15,龍泉,招呼
2020-05-21,3433,4,7,11,龍泉,招呼
2020-05-22,3433,10,6,16,龍泉,招呼
2020-05-23,3433,13,14,27,龍泉,招呼
2020-05-24,3433,22,34,56,龍泉,招呼
2020-05-25,3433,9,18,27,龍泉,招呼
2020-05-26,3433,8,5,13,龍泉,招呼
2020-05-27,3433,10,11,21,龍泉,招呼
2020-05-28,3433,6,8,14,龍泉,招呼
2020-05-29,3433,15,11,26,龍泉,招呼
2020-05-30,3433,6,13,19,龍泉,招呼
2020-05-31,3433,12,16,28,龍泉,招呼
2020-06-01,3433,23,17,40,龍泉,招呼
2020-06-02,3433,12,13,25,龍泉,招呼
2020-06-03,3433,7,12,19,龍泉,招呼
2020-06-04,3433,4,8,12,龍泉,招呼
2020-06-05,3433,16,16,32,龍泉,招呼
2020-06-06,3433,20,21,41,龍泉,招呼
2020-06-07,3433,9,12,21,龍泉,招呼
2020-06-08,3433,19,14,33,龍泉,招呼
2020-06-09,3433,18,15,33,龍泉,招呼
2020-06-10,3433,16,17,33,龍泉,招呼
2020-06-11,3433,12,9,21,龍泉,招呼
2020-06-12,3433,7,12,19,龍泉,招呼
2020-06-13,3433,20,14,34,龍泉,招呼
2020-06-14,3433,12,27,39,龍泉,招呼
2020-06-15,3433,11,14,25,龍泉,招呼
2020-06-16,3433,10,14,24,龍泉,招呼
2020-06-17,3433,7,9,16,龍泉,招呼
2020-06-18,3433,10,9,19,龍泉,招呼
2020-06-19,3433,7,11,18,龍泉,招呼
2020-06-20,3433,13,10,23,龍泉,招呼
2020-06-21,3433,24,29,53,龍泉,招呼
2020-06-22,3433,21,18,39,龍泉,招呼
2020-06-23,3433,5,6,11,龍泉,招呼
2020-06-24,3433,15,15,30,龍泉,招呼
2020-06-25,3433,13,16,29,龍泉,招呼
2020-06-26,3433,27,16,43,龍泉,招呼
2020-06-27,3433,18,17,35,龍泉,招呼
2020-06-28,3433,8,14,22,龍泉,招呼
2020-06-29,3433,14,10,24,龍泉,招呼
2020-06-30,3433,9,11,20,龍泉,招呼
2020-07-01,3433,7,10,17,龍泉,招呼
2020-07-02,3433,10,8,18,龍泉,招呼
2020-07-03,3433,16,7,23,龍泉,招呼
2020-07-04,3433,14,8,22,龍泉,招呼
2020-07-05,3433,14,15,29,龍泉,招呼
2020-07-06,3433,16,21,37,龍泉,招呼
2020-07-07,3433,21,23,44,龍泉,招呼
2020-07-08,3433,27,18,45,龍泉,招呼
2020-07-09,3433,10,11,21,龍泉,招呼
2020-07-10,3433,12,7,19,龍泉,招呼
2020-07-11,3433,10,11,21,龍泉,招呼
2020-07-12,3433,10,19,29,龍泉,招呼
2020-07-13,3433,14,15,29,龍泉,招呼
2020-07-14,3433,10,8,18,龍泉,招呼
2020-07-15,3433,12,10,22,龍泉,招呼
2020-07-16,3433,7,11,18,龍泉,招呼
2020-07-17,3433,8,15,23,龍泉,招呼
2020-07-18,3433,12,3,15,龍泉,招呼
2020-07-19,3433,36,39,75,龍泉,招呼
2020-07-20,3433,8,15,23,龍泉,招呼
2020-07-21,3433,16,44,60,龍泉,招呼
2020-07-22,3433,13,14,27,龍泉,招呼
2020-07-23,3433,34,14,48,龍泉,招呼
2020-07-24,3433,23,21,44,龍泉,招呼
2020-07-25,3433,18,21,39,龍泉,招呼
2020-07-26,3433,14,18,32,龍泉,招呼
2020-07-27,3433,15,24,39,龍泉,招呼
2020-07-28,3433,18,12,30,龍泉,招呼
2020-07-29,3433,11,11,22,龍泉,招呼
2020-07-30,3433,14,12,26,龍泉,招呼
2020-07-31,3433,13,12,25,龍泉,招呼
2020-08-01,3433,14,15,29,龍泉,招呼
2020-08-02,3433,17,24,41,龍泉,招呼
2020-08-03,3433,11,10,21,龍泉,招呼
2020-08-04,3433,12,15,27,龍泉,招呼
2020-08-05,3433,18,14,32,龍泉,招呼
2020-08-06,3433,12,10,22,龍泉,招呼
2020-08-07,3433,10,13,23,龍泉,招呼
2020-08-08,3433,25,27,52,龍泉,招呼
2020-08-09,3433,18,18,36,龍泉,招呼
2020-08-10,3433,17,12,29,龍泉,招呼
2020-08-11,3433,10,6,16,龍泉,招呼
2020-08-12,3433,6,13,19,龍泉,招呼
2020-08-13,3433,15,18,33,龍泉,招呼
2020-08-14,3433,18,8,26,龍泉,招呼
2020-08-15,3433,9,27,36,龍泉,招呼
2020-08-16,3433,40,68,108,龍泉,招呼
2020-08-17,3433,12,74,86,龍泉,招呼
2020-08-18,3433,8,16,24,龍泉,招呼
2020-08-19,3433,14,12,26,龍泉,招呼
2020-08-20,3433,9,11,20,龍泉,招呼
2020-08-21,3433,74,19,93,龍泉,招呼
2020-08-22,3433,19,20,39,龍泉,招呼
2020-08-23,3433,7,14,21,龍泉,招呼
2020-08-24,3433,15,14,29,龍泉,招呼
2020-08-25,3433,15,20,35,龍泉,招呼
2020-08-26,3433,13,15,28,龍泉,招呼
2020-08-27,3433,6,5,11,龍泉,招呼
2020-08-28,3433,33,17,50,龍泉,招呼
2020-08-29,3433,19,16,35,龍泉,招呼
2020-08-30,3433,6,22,28,龍泉,招呼
2020-08-31,3433,10,5,15,龍泉,招呼
2020-09-01,3433,9,274,283,龍泉,招呼
2020-09-02,3433,20,9,29,龍泉,招呼
2020-09-03,3433,25,25,50,龍泉,招呼
2020-09-04,3433,11,12,23,龍泉,招呼
2020-09-05,3433,22,13,35,龍泉,招呼
2020-09-06,3433,23,35,58,龍泉,招呼
2020-09-07,3433,4,7,11,龍泉,招呼
2020-09-08,3433,11,12,23,龍泉,招呼
2020-09-09,3433,16,11,27,龍泉,招呼
2020-09-10,3433,10,7,17,龍泉,招呼
2020-09-11,3433,22,15,37,龍泉,招呼
2020-09-12,3433,10,27,37,龍泉,招呼
2020-09-13,3433,22,51,73,龍泉,招呼
2020-09-14,3433,18,29,47,龍泉,招呼
2020-09-15,3433,9,5,14,龍泉,招呼
2020-09-16,3433,4,9,13,龍泉,招呼
2020-09-17,3433,18,10,28,龍泉,招呼
2020-09-18,3433,44,10,54,龍泉,招呼
2020-09-19,3433,12,17,29,龍泉,招呼
2020-09-20,3433,17,23,40,龍泉,招呼
2020-09-21,3433,12,24,36,龍泉,招呼
2020-09-22,3433,7,15,22,龍泉,招呼
2020-09-23,3433,8,7,15,龍泉,招呼
2020-09-24,3433,13,11,24,龍泉,招呼
2020-09-25,3433,20,20,40,龍泉,招呼
2020-09-26,3433,28,19,47,龍泉,招呼
2020-09-27,3433,14,47,61,龍泉,招呼
2020-09-28,3433,11,8,19,龍泉,招呼
2020-09-29,3433,11,12,23,龍泉,招呼
2020-09-30,3433,19,9,28,龍泉,招呼
2020-10-01,3433,5,13,18,龍泉,招呼
2020-10-02,3433,10,20,30,龍泉,招呼
2020-10-03,3433,20,47,67,龍泉,招呼
2020-10-04,3433,23,35,58,龍泉,招呼
2020-10-05,3433,14,42,56,龍泉,招呼
2020-10-06,3433,53,57,110,龍泉,招呼
2020-10-07,3433,16,12,28,龍泉,招呼
2020-10-08,3433,17,15,32,龍泉,招呼
2020-10-09,3433,29,25,54,龍泉,招呼
2020-10-10,3433,60,52,112,龍泉,招呼
2020-10-11,3433,22,38,60,龍泉,招呼
2020-10-12,3433,14,16,30,龍泉,招呼
2020-10-13,3433,8,20,28,龍泉,招呼
2020-10-14,3433,13,10,23,龍泉,招呼
2020-10-15,3433,15,12,27,龍泉,招呼
2020-10-16,3433,31,17,48,龍泉,招呼
2020-10-17,3433,10,16,26,龍泉,招呼
2020-10-18,3433,62,108,170,龍泉,招呼
2020-10-19,3433,10,65,75,龍泉,招呼
2020-10-20,3433,17,16,33,龍泉,招呼
2020-10-21,3433,4,5,9,龍泉,招呼
2020-10-22,3433,21,15,36,龍泉,招呼
2020-10-23,3433,84,32,116,龍泉,招呼
2020-10-24,3433,14,12,26,龍泉,招呼
2020-10-25,3433,7,31,38,龍泉,招呼
2020-10-26,3433,13,7,20,龍泉,招呼
2020-10-27,3433,15,20,35,龍泉,招呼
2020-10-28,3433,24,16,40,龍泉,招呼
2020-10-29,3433,27,11,38,龍泉,招呼
2020-10-30,3433,28,7,35,龍泉,招呼
2020-10-31,3433,12,21,33,龍泉,招呼
2020-11-01,3433,29,41,70,龍泉,招呼
2020-11-02,3433,8,9,17,龍泉,招呼
2020-11-03,3433,12,10,22,龍泉,招呼
2020-11-04,3433,13,14,27,龍泉,招呼
2020-11-05,3433,12,17,29,龍泉,招呼
2020-11-06,3433,16,9,25,龍泉,招呼
2020-11-07,3433,19,22,41,龍泉,招呼
2020-11-08,3433,12,37,49,龍泉,招呼
2020-11-09,3433,18,20,38,龍泉,招呼
2020-11-10,3433,9,14,23,龍泉,招呼
2020-11-11,3433,14,10,24,龍泉,招呼
2020-11-12,3433,8,10,18,龍泉,招呼
2020-11-13,3433,48,20,68,龍泉,招呼
2020-11-14,3433,22,42,64,龍泉,招呼
2020-11-15,3433,36,34,70,龍泉,招呼
2020-11-16,3433,37,28,65,龍泉,招呼
2020-11-17,3433,23,21,44,龍泉,招呼
2020-11-18,3433,11,31,42,龍泉,招呼
2020-11-19,3433,15,12,27,龍泉,招呼
2020-11-20,3433,44,14,58,龍泉,招呼
2020-11-21,3433,10,12,22,龍泉,招呼
2020-11-22,3433,7,51,58,龍泉,招呼
2020-11-23,3433,7,13,20,龍泉,招呼
2020-11-24,3433,20,16,36,龍泉,招呼
2020-11-25,3433,13,19,32,龍泉,招呼
2020-11-26,3433,11,6,17,龍泉,招呼
2020-11-27,3433,17,8,25,龍泉,招呼
2020-11-28,3433,8,19,27,龍泉,招呼
2020-11-29,3433,54,124,178,龍泉,招呼
2020-11-30,3433,49,31,80,龍泉,招呼
2020-12-01,3433,16,12,28,龍泉,招呼
2020-12-02,3433,9,12,21,龍泉,招呼
2020-12-03,3433,8,7,15,龍泉,招呼
2020-12-04,3433,21,12,33,龍泉,招呼
2020-12-05,3433,6,13,19,龍泉,招呼
2020-12-06,3433,29,49,78,龍泉,招呼
2020-12-07,3433,19,21,40,龍泉,招呼
2020-12-08,3433,12,20,32,龍泉,招呼
2020-12-09,3433,16,10,26,龍泉,招呼
2020-12-10,3433,10,9,19,龍泉,招呼
2020-12-11,3433,24,13,37,龍泉,招呼
2020-12-12,3433,21,19,40,龍泉,招呼
2020-12-13,3433,29,64,93,龍泉,招呼
2020-12-14,3433,11,14,25,龍泉,招呼
2020-12-15,3433,4,3,7,龍泉,招呼
2020-12-16,3433,8,6,14,龍泉,招呼
2020-12-17,3433,10,8,18,龍泉,招呼
2020-12-18,3433,16,9,25,龍泉,招呼
2020-12-19,3433,16,7,23,龍泉,招呼
2020-12-20,3433,34,25,59,龍泉,招呼
2020-12-21,3433,8,35,43,龍泉,招呼
2020-12-22,3433,22,27,49,龍泉,招呼
2020-12-23,3433,7,7,14,龍泉,招呼
2020-12-24,3433,27,26,53,龍泉,招呼
2020-12-25,3433,19,11,30,龍泉,招呼
2020-12-26,3433,24,15,39,龍泉,招呼
2020-12-27,3433,27,24,51,龍泉,招呼
2020-12-28,3433,27,37,64,龍泉,招呼
2020-12-29,3433,6,9,15,龍泉,招呼
2020-12-30,3433,20,17,37,龍泉,招呼
2020-12-31,3433,8,8,16,龍泉,招呼
2020-01-01,3434,780,766,1546,集集,招呼
2020-01-02,3434,362,388,750,集集,招呼
2020-01-03,3434,204,206,410,集集,招呼
2020-01-04,3434,544,540,1084,集集,招呼
2020-01-05,3434,627,643,1270,集集,招呼
2020-01-06,3434,258,291,549,集集,招呼
2020-01-07,3434,156,161,317,集集,招呼
2020-01-08,3434,189,114,303,集集,招呼
2020-01-09,3434,119,131,250,集集,招呼
2020-01-10,3434,111,185,296,集集,招呼
2020-01-11,3434,286,291,577,集集,招呼
2020-01-12,3434,531,458,989,集集,招呼
2020-01-13,3434,332,579,911,集集,招呼
2020-01-14,3434,305,172,477,集集,招呼
2020-01-15,3434,361,310,671,集集,招呼
2020-01-16,3434,539,840,1379,集集,招呼
2020-01-17,3434,916,465,1381,集集,招呼
2020-01-18,3434,480,423,903,集集,招呼
2020-01-19,3434,538,483,1021,集集,招呼
2020-01-20,3434,513,307,820,集集,招呼
2020-01-21,3434,561,413,974,集集,招呼
2020-01-22,3434,341,332,673,集集,招呼
2020-01-23,3434,451,521,972,集集,招呼
2020-01-24,3434,251,280,531,集集,招呼
2020-01-25,3434,1294,1438,2732,集集,招呼
2020-01-26,3434,1000,929,1929,集集,招呼
2020-01-27,3434,1869,1830,3699,集集,招呼
2020-01-28,3434,1476,1495,2971,集集,招呼
2020-01-29,3434,1092,770,1862,集集,招呼
2020-01-30,3434,555,591,1146,集集,招呼
2020-01-31,3434,515,413,928,集集,招呼
2020-02-01,3434,577,519,1096,集集,招呼
2020-02-02,3434,751,729,1480,集集,招呼
2020-02-03,3434,370,329,699,集集,招呼
2020-02-04,3434,238,319,557,集集,招呼
2020-02-05,3434,354,249,603,集集,招呼
2020-02-06,3434,362,387,749,集集,招呼
2020-02-07,3434,267,282,549,集集,招呼
2020-02-08,3434,344,363,707,集集,招呼
2020-02-09,3434,483,433,916,集集,招呼
2020-02-10,3434,285,256,541,集集,招呼
2020-02-11,3434,369,358,727,集集,招呼
2020-02-12,3434,284,238,522,集集,招呼
2020-02-13,3434,160,204,364,集集,招呼
2020-02-14,3434,194,196,390,集集,招呼
2020-02-15,3434,322,325,647,集集,招呼
2020-02-16,3434,455,447,902,集集,招呼
2020-02-17,3434,239,219,458,集集,招呼
2020-02-18,3434,319,233,552,集集,招呼
2020-02-19,3434,237,239,476,集集,招呼
2020-02-20,3434,193,202,395,集集,招呼
2020-02-21,3434,214,206,420,集集,招呼
2020-02-22,3434,459,342,801,集集,招呼
2020-02-23,3434,387,422,809,集集,招呼
2020-02-24,3434,295,297,592,集集,招呼
2020-02-25,3434,117,134,251,集集,招呼
2020-02-26,3434,183,123,306,集集,招呼
2020-02-27,3434,102,128,230,集集,招呼
2020-02-28,3434,571,526,1097,集集,招呼
2020-02-29,3434,931,961,1892,集集,招呼
2020-03-01,3434,665,559,1224,集集,招呼
2020-03-02,3434,200,178,378,集集,招呼
2020-03-03,3434,95,70,165,集集,招呼
2020-03-04,3434,87,122,209,集集,招呼
2020-03-05,3434,64,46,110,集集,招呼
2020-03-06,3434,184,150,334,集集,招呼
2020-03-07,3434,295,307,602,集集,招呼
2020-03-08,3434,375,285,660,集集,招呼
2020-03-09,3434,190,163,353,集集,招呼
2020-03-10,3434,86,82,168,集集,招呼
2020-03-11,3434,161,92,253,集集,招呼
2020-03-12,3434,84,84,168,集集,招呼
2020-03-13,3434,111,142,253,集集,招呼
2020-03-14,3434,185,167,352,集集,招呼
2020-03-15,3434,490,449,939,集集,招呼
2020-03-16,3434,243,194,437,集集,招呼
2020-03-17,3434,108,111,219,集集,招呼
2020-03-18,3434,110,77,187,集集,招呼
2020-03-19,3434,89,61,150,集集,招呼
2020-03-20,3434,90,103,193,集集,招呼
2020-03-21,3434,265,248,513,集集,招呼
2020-03-22,3434,397,340,737,集集,招呼
2020-03-23,3434,152,123,275,集集,招呼
2020-03-24,3434,62,54,116,集集,招呼
2020-03-25,3434,61,107,168,集集,招呼
2020-03-26,3434,111,70,181,集集,招呼
2020-03-27,3434,139,186,325,集集,招呼
2020-03-28,3434,150,160,310,集集,招呼
2020-03-29,3434,321,308,629,集集,招呼
2020-03-30,3434,150,126,276,集集,招呼
2020-03-31,3434,86,79,165,集集,招呼
2020-04-01,3434,56,84,140,集集,招呼
2020-04-02,3434,217,217,434,集集,招呼
2020-04-03,3434,386,427,813,集集,招呼
2020-04-04,3434,368,362,730,集集,招呼
2020-04-05,3434,311,278,589,集集,招呼
2020-04-06,3434,150,80,230,集集,招呼
2020-04-07,3434,53,43,96,集集,招呼
2020-04-08,3434,37,39,76,集集,招呼
2020-04-09,3434,41,43,84,集集,招呼
2020-04-10,3434,72,94,166,集集,招呼
2020-04-11,3434,177,148,325,集集,招呼
2020-04-12,3434,156,138,294,集集,招呼
2020-04-13,3434,121,115,236,集集,招呼
2020-04-14,3434,81,75,156,集集,招呼
2020-04-15,3434,63,145,208,集集,招呼
2020-04-16,3434,82,79,161,集集,招呼
2020-04-17,3434,79,87,166,集集,招呼
2020-04-18,3434,214,225,439,集集,招呼
2020-04-19,3434,350,285,635,集集,招呼
2020-04-20,3434,151,117,268,集集,招呼
2020-04-21,3434,83,90,173,集集,招呼
2020-04-22,3434,65,67,132,集集,招呼
2020-04-23,3434,40,40,80,集集,招呼
2020-04-24,3434,60,66,126,集集,招呼
2020-04-25,3434,116,116,232,集集,招呼
2020-04-26,3434,332,213,545,集集,招呼
2020-04-27,3434,124,152,276,集集,招呼
2020-04-28,3434,100,75,175,集集,招呼
2020-04-29,3434,93,108,201,集集,招呼
2020-04-30,3434,72,85,157,集集,招呼
2020-05-01,3434,217,256,473,集集,招呼
2020-05-02,3434,380,369,749,集集,招呼
2020-05-03,3434,376,346,722,集集,招呼
2020-05-04,3434,163,121,284,集集,招呼
2020-05-05,3434,61,47,108,集集,招呼
2020-05-06,3434,81,87,168,集集,招呼
2020-05-07,3434,70,68,138,集集,招呼
2020-05-08,3434,102,116,218,集集,招呼
2020-05-09,3434,245,284,529,集集,招呼
2020-05-10,3434,342,340,682,集集,招呼
2020-05-11,3434,162,93,255,集集,招呼
2020-05-12,3434,49,53,102,集集,招呼
2020-05-13,3434,102,93,195,集集,招呼
2020-05-14,3434,107,106,213,集集,招呼
2020-05-15,3434,118,145,263,集集,招呼
2020-05-16,3434,284,297,581,集集,招呼
2020-05-17,3434,357,335,692,集集,招呼
2020-05-18,3434,211,226,437,集集,招呼
2020-05-19,3434,64,74,138,集集,招呼
2020-05-20,3434,62,153,215,集集,招呼
2020-05-21,3434,66,65,131,集集,招呼
2020-05-22,3434,206,308,514,集集,招呼
2020-05-23,3434,160,155,315,集集,招呼
2020-05-24,3434,449,441,890,集集,招呼
2020-05-25,3434,208,171,379,集集,招呼
2020-05-26,3434,94,84,178,集集,招呼
2020-05-27,3434,69,49,118,集集,招呼
2020-05-28,3434,56,59,115,集集,招呼
2020-05-29,3434,103,165,268,集集,招呼
2020-05-30,3434,446,437,883,集集,招呼
2020-05-31,3434,645,653,1298,集集,招呼
2020-06-01,3434,207,189,396,集集,招呼
2020-06-02,3434,273,79,352,集集,招呼
2020-06-03,3434,390,87,477,集集,招呼
2020-06-04,3434,114,240,354,集集,招呼
2020-06-05,3434,187,229,416,集集,招呼
2020-06-06,3434,442,480,922,集集,招呼
2020-06-07,3434,735,516,1251,集集,招呼
2020-06-08,3434,264,228,492,集集,招呼
2020-06-09,3434,115,488,603,集集,招呼
2020-06-10,3434,112,102,214,集集,招呼
2020-06-11,3434,380,374,754,集集,招呼
2020-06-12,3434,156,158,314,集集,招呼
2020-06-13,3434,509,550,1059,集集,招呼
2020-06-14,3434,592,655,1247,集集,招呼
2020-06-15,3434,224,189,413,集集,招呼
2020-06-16,3434,193,446,639,集集,招呼
2020-06-17,3434,178,305,483,集集,招呼
2020-06-18,3434,265,462,727,集集,招呼
2020-06-19,3434,341,213,554,集集,招呼
2020-06-20,3434,335,421,756,集集,招呼
2020-06-21,3434,610,360,970,集集,招呼
2020-06-22,3434,530,360,890,集集,招呼
2020-06-23,3434,295,878,1173,集集,招呼
2020-06-24,3434,163,823,986,集集,招呼
2020-06-25,3434,463,519,982,集集,招呼
2020-06-26,3434,1320,1326,2646,集集,招呼
2020-06-27,3434,1167,1369,2536,集集,招呼
2020-06-28,3434,863,651,1514,集集,招呼
2020-06-29,3434,269,346,615,集集,招呼
2020-06-30,3434,234,122,356,集集,招呼
2020-07-01,3434,509,149,658,集集,招呼
2020-07-02,3434,102,109,211,集集,招呼
2020-07-03,3434,220,180,400,集集,招呼
2020-07-04,3434,423,433,856,集集,招呼
2020-07-05,3434,565,628,1193,集集,招呼
2020-07-06,3434,222,263,485,集集,招呼
2020-07-07,3434,236,172,408,集集,招呼
2020-07-08,3434,235,206,441,集集,招呼
2020-07-09,3434,318,179,497,集集,招呼
2020-07-10,3434,353,246,599,集集,招呼
2020-07-11,3434,746,588,1334,集集,招呼
2020-07-12,3434,862,681,1543,集集,招呼
2020-07-13,3434,441,329,770,集集,招呼
2020-07-14,3434,226,174,400,集集,招呼
2020-07-15,3434,228,223,451,集集,招呼
2020-07-16,3434,404,542,946,集集,招呼
2020-07-17,3434,279,275,554,集集,招呼
2020-07-18,3434,705,671,1376,集集,招呼
2020-07-19,3434,916,801,1717,集集,招呼
2020-07-20,3434,576,510,1086,集集,招呼
2020-07-21,3434,275,268,543,集集,招呼
2020-07-22,3434,301,234,535,集集,招呼
2020-07-23,3434,360,394,754,集集,招呼
2020-07-24,3434,606,438,1044,集集,招呼
2020-07-25,3434,1137,891,2028,集集,招呼
2020-07-26,3434,838,1250,2088,集集,招呼
2020-07-27,3434,586,830,1416,集集,招呼
2020-07-28,3434,464,246,710,集集,招呼
2020-07-29,3434,265,233,498,集集,招呼
2020-07-30,3434,388,357,745,集集,招呼
2020-07-31,3434,478,471,949,集集,招呼
2020-08-01,3434,1132,1011,2143,集集,招呼
2020-08-02,3434,737,603,1340,集集,招呼
2020-08-03,3434,260,612,872,集集,招呼
2020-08-04,3434,305,202,507,集集,招呼
2020-08-05,3434,281,191,472,集集,招呼
2020-08-06,3434,390,417,807,集集,招呼
2020-08-07,3434,382,236,618,集集,招呼
2020-08-08,3434,643,849,1492,集集,招呼
2020-08-09,3434,783,728,1511,集集,招呼
2020-08-10,3434,725,397,1122,集集,招呼
2020-08-11,3434,427,249,676,集集,招呼
2020-08-12,3434,222,234,456,集集,招呼
2020-08-13,3434,459,323,782,集集,招呼
2020-08-14,3434,533,965,1498,集集,招呼
2020-08-15,3434,1023,633,1656,集集,招呼
2020-08-16,3434,1263,1428,2691,集集,招呼
2020-08-17,3434,491,433,924,集集,招呼
2020-08-18,3434,468,704,1172,集集,招呼
2020-08-19,3434,263,242,505,集集,招呼
2020-08-20,3434,305,376,681,集集,招呼
2020-08-21,3434,390,440,830,集集,招呼
2020-08-22,3434,637,910,1547,集集,招呼
2020-08-23,3434,979,864,1843,集集,招呼
2020-08-24,3434,682,547,1229,集集,招呼
2020-08-25,3434,593,318,911,集集,招呼
2020-08-26,3434,298,157,455,集集,招呼
2020-08-27,3434,254,315,569,集集,招呼
2020-08-28,3434,435,350,785,集集,招呼
2020-08-29,3434,453,397,850,集集,招呼
2020-08-30,3434,734,535,1269,集集,招呼
2020-08-31,3434,168,434,602,集集,招呼
2020-09-01,3434,356,93,449,集集,招呼
2020-09-02,3434,102,79,181,集集,招呼
2020-09-03,3434,128,115,243,集集,招呼
2020-09-04,3434,384,132,516,集集,招呼
2020-09-05,3434,561,485,1046,集集,招呼
2020-09-06,3434,841,795,1636,集集,招呼
2020-09-07,3434,268,244,512,集集,招呼
2020-09-08,3434,275,595,870,集集,招呼
2020-09-09,3434,130,114,244,集集,招呼
2020-09-10,3434,187,475,662,集集,招呼
2020-09-11,3434,153,383,536,集集,招呼
2020-09-12,3434,437,433,870,集集,招呼
2020-09-13,3434,762,723,1485,集集,招呼
2020-09-14,3434,243,499,742,集集,招呼
2020-09-15,3434,138,119,257,集集,招呼
2020-09-16,3434,106,111,217,集集,招呼
2020-09-17,3434,411,422,833,集集,招呼
2020-09-18,3434,455,199,654,集集,招呼
2020-09-19,3434,463,383,846,集集,招呼
2020-09-20,3434,814,717,1531,集集,招呼
2020-09-21,3434,424,532,956,集集,招呼
2020-09-22,3434,315,225,540,集集,招呼
2020-09-23,3434,383,240,623,集集,招呼
2020-09-24,3434,310,190,500,集集,招呼
2020-09-25,3434,331,660,991,集集,招呼
2020-09-26,3434,343,356,699,集集,招呼
2020-09-27,3434,849,520,1369,集集,招呼
2020-09-28,3434,243,314,557,集集,招呼
2020-09-29,3434,239,181,420,集集,招呼
2020-09-30,3434,393,192,585,集集,招呼
2020-10-01,3434,515,576,1091,集集,招呼
2020-10-02,3434,1615,1494,3109,集集,招呼
2020-10-03,3434,1366,1391,2757,集集,招呼
2020-10-04,3434,945,775,1720,集集,招呼
2020-10-05,3434,529,380,909,集集,招呼
2020-10-06,3434,353,409,762,集集,招呼
2020-10-07,3434,726,180,906,集集,招呼
2020-10-08,3434,548,454,1002,集集,招呼
2020-10-09,3434,1070,1457,2527,集集,招呼
2020-10-10,3434,1545,1245,2790,集集,招呼
2020-10-11,3434,1050,764,1814,集集,招呼
2020-10-12,3434,657,263,920,集集,招呼
2020-10-13,3434,352,514,866,集集,招呼
2020-10-14,3434,265,187,452,集集,招呼
2020-10-15,3434,608,198,806,集集,招呼
2020-10-16,3434,658,411,1069,集集,招呼
2020-10-17,3434,859,817,1676,集集,招呼
2020-10-18,3434,1035,855,1890,集集,招呼
2020-10-19,3434,473,613,1086,集集,招呼
2020-10-20,3434,561,290,851,集集,招呼
2020-10-21,3434,356,255,611,集集,招呼
2020-10-22,3434,421,650,1071,集集,招呼
2020-10-23,3434,276,309,585,集集,招呼
2020-10-24,3434,861,595,1456,集集,招呼
2020-10-25,3434,798,649,1447,集集,招呼
2020-10-26,3434,332,425,757,集集,招呼
2020-10-27,3434,224,274,498,集集,招呼
2020-10-28,3434,322,401,723,集集,招呼
2020-10-29,3434,514,294,808,集集,招呼
2020-10-30,3434,280,311,591,集集,招呼
2020-10-31,3434,708,821,1529,集集,招呼
2020-11-01,3434,831,747,1578,集集,招呼
2020-11-02,3434,307,461,768,集集,招呼
2020-11-03,3434,304,137,441,集集,招呼
2020-11-04,3434,124,141,265,集集,招呼
2020-11-05,3434,210,112,322,集集,招呼
2020-11-06,3434,178,158,336,集集,招呼
2020-11-07,3434,801,555,1356,集集,招呼
2020-11-08,3434,907,767,1674,集集,招呼
2020-11-09,3434,342,488,830,集集,招呼
2020-11-10,3434,436,130,566,集集,招呼
2020-11-11,3434,264,117,381,集集,招呼
2020-11-12,3434,690,157,847,集集,招呼
2020-11-13,3434,248,452,700,集集,招呼
2020-11-14,3434,576,535,1111,集集,招呼
2020-11-15,3434,895,758,1653,集集,招呼
2020-11-16,3434,529,417,946,集集,招呼
2020-11-17,3434,486,308,794,集集,招呼
2020-11-18,3434,372,706,1078,集集,招呼
2020-11-19,3434,164,116,280,集集,招呼
2020-11-20,3434,271,449,720,集集,招呼
2020-11-21,3434,658,737,1395,集集,招呼
2020-11-22,3434,1360,793,2153,集集,招呼
2020-11-23,3434,543,629,1172,集集,招呼
2020-11-24,3434,482,252,734,集集,招呼
2020-11-25,3434,265,239,504,集集,招呼
2020-11-26,3434,742,165,907,集集,招呼
2020-11-27,3434,366,617,983,集集,招呼
2020-11-28,3434,509,482,991,集集,招呼
2020-11-29,3434,951,633,1584,集集,招呼
2020-11-30,3434,355,473,828,集集,招呼
2020-12-01,3434,327,134,461,集集,招呼
2020-12-02,3434,113,225,338,集集,招呼
2020-12-03,3434,521,152,673,集集,招呼
2020-12-04,3434,432,474,906,集集,招呼
2020-12-05,3434,928,373,1301,集集,招呼
2020-12-06,3434,887,635,1522,集集,招呼
2020-12-07,3434,558,219,777,集集,招呼
2020-12-08,3434,289,438,727,集集,招呼
2020-12-09,3434,83,77,160,集集,招呼
2020-12-10,3434,226,154,380,集集,招呼
2020-12-11,3434,472,177,649,集集,招呼
2020-12-12,3434,805,536,1341,集集,招呼
2020-12-13,3434,850,748,1598,集集,招呼
2020-12-14,3434,491,1349,1840,集集,招呼
2020-12-15,3434,303,115,418,集集,招呼
2020-12-16,3434,244,221,465,集集,招呼
2020-12-17,3434,326,373,699,集集,招呼
2020-12-18,3434,646,184,830,集集,招呼
2020-12-19,3434,737,428,1165,集集,招呼
2020-12-20,3434,786,639,1425,集集,招呼
2020-12-21,3434,231,210,441,集集,招呼
2020-12-22,3434,135,144,279,集集,招呼
2020-12-23,3434,160,1003,1163,集集,招呼
2020-12-24,3434,169,131,300,集集,招呼
2020-12-25,3434,249,225,474,集集,招呼
2020-12-26,3434,690,531,1221,集集,招呼
2020-12-27,3434,676,575,1251,集集,招呼
2020-12-28,3434,288,226,514,集集,招呼
2020-12-29,3434,217,122,339,集集,招呼
2020-12-30,3434,126,376,502,集集,招呼
2020-12-31,3434,197,191,388,集集,招呼
2020-01-01,3435,191,154,345,水里,簡易
2020-01-02,3435,137,155,292,水里,簡易
2020-01-03,3435,174,221,395,水里,簡易
2020-01-04,3435,159,195,354,水里,簡易
2020-01-05,3435,258,217,475,水里,簡易
2020-01-06,3435,146,162,308,水里,簡易
2020-01-07,3435,135,148,283,水里,簡易
2020-01-08,3435,123,141,264,水里,簡易
2020-01-09,3435,170,133,303,水里,簡易
2020-01-10,3435,170,256,426,水里,簡易
2020-01-11,3435,202,237,439,水里,簡易
2020-01-12,3435,308,232,540,水里,簡易
2020-01-13,3435,157,135,292,水里,簡易
2020-01-14,3435,133,168,301,水里,簡易
2020-01-15,3435,174,201,375,水里,簡易
2020-01-16,3435,313,169,482,水里,簡易
2020-01-17,3435,211,215,426,水里,簡易
2020-01-18,3435,175,162,337,水里,簡易
2020-01-19,3435,189,176,365,水里,簡易
2020-01-20,3435,140,180,320,水里,簡易
2020-01-21,3435,153,143,296,水里,簡易
2020-01-22,3435,186,233,419,水里,簡易
2020-01-23,3435,131,294,425,水里,簡易
2020-01-24,3435,97,235,332,水里,簡易
2020-01-25,3435,405,384,789,水里,簡易
2020-01-26,3435,286,342,628,水里,簡易
2020-01-27,3435,406,414,820,水里,簡易
2020-01-28,3435,365,321,686,水里,簡易
2020-01-29,3435,282,220,502,水里,簡易
2020-01-30,3435,191,229,420,水里,簡易
2020-01-31,3435,225,190,415,水里,簡易
2020-02-01,3435,204,158,362,水里,簡易
2020-02-02,3435,184,178,362,水里,簡易
2020-02-03,3435,144,166,310,水里,簡易
2020-02-04,3435,143,140,283,水里,簡易
2020-02-05,3435,109,116,225,水里,簡易
2020-02-06,3435,135,117,252,水里,簡易
2020-02-07,3435,113,141,254,水里,簡易
2020-02-08,3435,118,141,259,水里,簡易
2020-02-09,3435,173,142,315,水里,簡易
2020-02-10,3435,124,145,269,水里,簡易
2020-02-11,3435,120,115,235,水里,簡易
2020-02-12,3435,134,133,267,水里,簡易
2020-02-13,3435,99,109,208,水里,簡易
2020-02-14,3435,120,130,250,水里,簡易
2020-02-15,3435,147,151,298,水里,簡易
2020-02-16,3435,152,104,256,水里,簡易
2020-02-17,3435,125,139,264,水里,簡易
2020-02-18,3435,128,111,239,水里,簡易
2020-02-19,3435,119,106,225,水里,簡易
2020-02-20,3435,98,111,209,水里,簡易
2020-02-21,3435,111,131,242,水里,簡易
2020-02-22,3435,110,184,294,水里,簡易
2020-02-23,3435,194,152,346,水里,簡易
2020-02-24,3435,130,94,224,水里,簡易
2020-02-25,3435,97,121,218,水里,簡易
2020-02-26,3435,73,76,149,水里,簡易
2020-02-27,3435,97,175,272,水里,簡易
2020-02-28,3435,139,213,352,水里,簡易
2020-02-29,3435,178,181,359,水里,簡易
2020-03-01,3435,271,174,445,水里,簡易
2020-03-02,3435,108,65,173,水里,簡易
2020-03-03,3435,60,64,124,水里,簡易
2020-03-04,3435,61,72,133,水里,簡易
2020-03-05,3435,74,57,131,水里,簡易
2020-03-06,3435,93,185,278,水里,簡易
2020-03-07,3435,102,139,241,水里,簡易
2020-03-08,3435,190,131,321,水里,簡易
2020-03-09,3435,102,76,178,水里,簡易
2020-03-10,3435,53,65,118,水里,簡易
2020-03-11,3435,63,67,130,水里,簡易
2020-03-12,3435,96,94,190,水里,簡易
2020-03-13,3435,103,179,282,水里,簡易
2020-03-14,3435,130,140,270,水里,簡易
2020-03-15,3435,184,119,303,水里,簡易
2020-03-16,3435,80,85,165,水里,簡易
2020-03-17,3435,65,76,141,水里,簡易
2020-03-18,3435,73,75,148,水里,簡易
2020-03-19,3435,62,78,140,水里,簡易
2020-03-20,3435,98,201,299,水里,簡易
2020-03-21,3435,105,177,282,水里,簡易
2020-03-22,3435,221,104,325,水里,簡易
2020-03-23,3435,92,82,174,水里,簡易
2020-03-24,3435,55,60,115,水里,簡易
2020-03-25,3435,60,62,122,水里,簡易
2020-03-26,3435,67,78,145,水里,簡易
2020-03-27,3435,84,133,217,水里,簡易
2020-03-28,3435,80,125,205,水里,簡易
2020-03-29,3435,177,100,277,水里,簡易
2020-03-30,3435,80,74,154,水里,簡易
2020-03-31,3435,53,76,129,水里,簡易
2020-04-01,3435,90,154,244,水里,簡易
2020-04-02,3435,91,194,285,水里,簡易
2020-04-03,3435,103,146,249,水里,簡易
2020-04-04,3435,146,104,250,水里,簡易
2020-04-05,3435,245,98,343,水里,簡易
2020-04-06,3435,85,71,156,水里,簡易
2020-04-07,3435,63,40,103,水里,簡易
2020-04-08,3435,70,61,131,水里,簡易
2020-04-09,3435,43,48,91,水里,簡易
2020-04-10,3435,76,126,202,水里,簡易
2020-04-11,3435,77,95,172,水里,簡易
2020-04-12,3435,128,99,227,水里,簡易
2020-04-13,3435,76,84,160,水里,簡易
2020-04-14,3435,59,56,115,水里,簡易
2020-04-15,3435,85,81,166,水里,簡易
2020-04-16,3435,79,94,173,水里,簡易
2020-04-17,3435,88,153,241,水里,簡易
2020-04-18,3435,82,103,185,水里,簡易
2020-04-19,3435,172,126,298,水里,簡易
2020-04-20,3435,96,70,166,水里,簡易
2020-04-21,3435,71,73,144,水里,簡易
2020-04-22,3435,78,64,142,水里,簡易
2020-04-23,3435,48,64,112,水里,簡易
2020-04-24,3435,88,146,234,水里,簡易
2020-04-25,3435,117,128,245,水里,簡易
2020-04-26,3435,174,108,282,水里,簡易
2020-04-27,3435,78,75,153,水里,簡易
2020-04-28,3435,60,57,117,水里,簡易
2020-04-29,3435,76,87,163,水里,簡易
2020-04-30,3435,89,120,209,水里,簡易
2020-05-01,3435,156,228,384,水里,簡易
2020-05-02,3435,203,225,428,水里,簡易
2020-05-03,3435,219,122,341,水里,簡易
2020-05-04,3435,97,102,199,水里,簡易
2020-05-05,3435,65,77,142,水里,簡易
2020-05-06,3435,71,78,149,水里,簡易
2020-05-07,3435,82,108,190,水里,簡易
2020-05-08,3435,107,194,301,水里,簡易
2020-05-09,3435,111,168,279,水里,簡易
2020-05-10,3435,222,123,345,水里,簡易
2020-05-11,3435,107,73,180,水里,簡易
2020-05-12,3435,78,79,157,水里,簡易
2020-05-13,3435,88,97,185,水里,簡易
2020-05-14,3435,77,66,143,水里,簡易
2020-05-15,3435,149,222,371,水里,簡易
2020-05-16,3435,137,163,300,水里,簡易
2020-05-17,3435,215,145,360,水里,簡易
2020-05-18,3435,107,110,217,水里,簡易
2020-05-19,3435,65,73,138,水里,簡易
2020-05-20,3435,86,57,143,水里,簡易
2020-05-21,3435,60,71,131,水里,簡易
2020-05-22,3435,75,127,202,水里,簡易
2020-05-23,3435,72,88,160,水里,簡易
2020-05-24,3435,191,130,321,水里,簡易
2020-05-25,3435,78,93,171,水里,簡易
2020-05-26,3435,68,70,138,水里,簡易
2020-05-27,3435,56,78,134,水里,簡易
2020-05-28,3435,80,69,149,水里,簡易
2020-05-29,3435,128,143,271,水里,簡易
2020-05-30,3435,157,211,368,水里,簡易
2020-05-31,3435,217,132,349,水里,簡易
2020-06-01,3435,98,145,243,水里,簡易
2020-06-02,3435,122,96,218,水里,簡易
2020-06-03,3435,82,112,194,水里,簡易
2020-06-04,3435,76,86,162,水里,簡易
2020-06-05,3435,138,192,330,水里,簡易
2020-06-06,3435,144,164,308,水里,簡易
2020-06-07,3435,212,142,354,水里,簡易
2020-06-08,3435,104,96,200,水里,簡易
2020-06-09,3435,143,142,285,水里,簡易
2020-06-10,3435,87,109,196,水里,簡易
2020-06-11,3435,84,109,193,水里,簡易
2020-06-12,3435,123,170,293,水里,簡易
2020-06-13,3435,208,187,395,水里,簡易
2020-06-14,3435,226,159,385,水里,簡易
2020-06-15,3435,122,118,240,水里,簡易
2020-06-16,3435,95,124,219,水里,簡易
2020-06-17,3435,121,116,237,水里,簡易
2020-06-18,3435,115,82,197,水里,簡易
2020-06-19,3435,107,149,256,水里,簡易
2020-06-20,3435,206,242,448,水里,簡易
2020-06-21,3435,251,181,432,水里,簡易
2020-06-22,3435,131,146,277,水里,簡易
2020-06-23,3435,135,128,263,水里,簡易
2020-06-24,3435,136,224,360,水里,簡易
2020-06-25,3435,201,331,532,水里,簡易
2020-06-26,3435,301,350,651,水里,簡易
2020-06-27,3435,366,385,751,水里,簡易
2020-06-28,3435,356,247,603,水里,簡易
2020-06-29,3435,182,142,324,水里,簡易
2020-06-30,3435,153,124,277,水里,簡易
2020-07-01,3435,125,133,258,水里,簡易
2020-07-02,3435,128,182,310,水里,簡易
2020-07-03,3435,151,155,306,水里,簡易
2020-07-04,3435,144,182,326,水里,簡易
2020-07-05,3435,254,187,441,水里,簡易
2020-07-06,3435,141,160,301,水里,簡易
2020-07-07,3435,132,104,236,水里,簡易
2020-07-08,3435,107,127,234,水里,簡易
2020-07-09,3435,93,125,218,水里,簡易
2020-07-10,3435,233,204,437,水里,簡易
2020-07-11,3435,170,262,432,水里,簡易
2020-07-12,3435,374,277,651,水里,簡易
2020-07-13,3435,162,173,335,水里,簡易
2020-07-14,3435,142,164,306,水里,簡易
2020-07-15,3435,182,161,343,水里,簡易
2020-07-16,3435,159,173,332,水里,簡易
2020-07-17,3435,164,199,363,水里,簡易
2020-07-18,3435,206,241,447,水里,簡易
2020-07-19,3435,243,169,412,水里,簡易
2020-07-20,3435,151,142,293,水里,簡易
2020-07-21,3435,154,166,320,水里,簡易
2020-07-22,3435,165,182,347,水里,簡易
2020-07-23,3435,151,181,332,水里,簡易
2020-07-24,3435,257,239,496,水里,簡易
2020-07-25,3435,218,258,476,水里,簡易
2020-07-26,3435,269,193,462,水里,簡易
2020-07-27,3435,173,182,355,水里,簡易
2020-07-28,3435,137,152,289,水里,簡易
2020-07-29,3435,193,191,384,水里,簡易
2020-07-30,3435,192,163,355,水里,簡易
2020-07-31,3435,192,216,408,水里,簡易
2020-08-01,3435,218,290,508,水里,簡易
2020-08-02,3435,240,229,469,水里,簡易
2020-08-03,3435,113,115,228,水里,簡易
2020-08-04,3435,106,89,195,水里,簡易
2020-08-05,3435,131,144,275,水里,簡易
2020-08-06,3435,161,163,324,水里,簡易
2020-08-07,3435,171,188,359,水里,簡易
2020-08-08,3435,200,230,430,水里,簡易
2020-08-09,3435,252,184,436,水里,簡易
2020-08-10,3435,160,155,315,水里,簡易
2020-08-11,3435,133,124,257,水里,簡易
2020-08-12,3435,162,115,277,水里,簡易
2020-08-13,3435,209,274,483,水里,簡易
2020-08-14,3435,245,205,450,水里,簡易
2020-08-15,3435,188,191,379,水里,簡易
2020-08-16,3435,331,291,622,水里,簡易
2020-08-17,3435,153,215,368,水里,簡易
2020-08-18,3435,138,169,307,水里,簡易
2020-08-19,3435,141,150,291,水里,簡易
2020-08-20,3435,120,159,279,水里,簡易
2020-08-21,3435,182,204,386,水里,簡易
2020-08-22,3435,191,197,388,水里,簡易
2020-08-23,3435,199,271,470,水里,簡易
2020-08-24,3435,217,191,408,水里,簡易
2020-08-25,3435,152,132,284,水里,簡易
2020-08-26,3435,137,129,266,水里,簡易
2020-08-27,3435,116,108,224,水里,簡易
2020-08-28,3435,134,176,310,水里,簡易
2020-08-29,3435,153,191,344,水里,簡易
2020-08-30,3435,213,156,369,水里,簡易
2020-08-31,3435,135,131,266,水里,簡易
2020-09-01,3435,105,89,194,水里,簡易
2020-09-02,3435,69,79,148,水里,簡易
2020-09-03,3435,109,122,231,水里,簡易
2020-09-04,3435,118,177,295,水里,簡易
2020-09-05,3435,190,183,373,水里,簡易
2020-09-06,3435,212,156,368,水里,簡易
2020-09-07,3435,120,124,244,水里,簡易
2020-09-08,3435,104,100,204,水里,簡易
2020-09-09,3435,152,137,289,水里,簡易
2020-09-10,3435,117,139,256,水里,簡易
2020-09-11,3435,119,191,310,水里,簡易
2020-09-12,3435,140,152,292,水里,簡易
2020-09-13,3435,273,189,462,水里,簡易
2020-09-14,3435,128,137,265,水里,簡易
2020-09-15,3435,150,138,288,水里,簡易
2020-09-16,3435,104,80,184,水里,簡易
2020-09-17,3435,85,93,178,水里,簡易
2020-09-18,3435,119,188,307,水里,簡易
2020-09-19,3435,163,187,350,水里,簡易
2020-09-20,3435,262,157,419,水里,簡易
2020-09-21,3435,121,141,262,水里,簡易
2020-09-22,3435,120,122,242,水里,簡易
2020-09-23,3435,118,112,230,水里,簡易
2020-09-24,3435,133,127,260,水里,簡易
2020-09-25,3435,133,171,304,水里,簡易
2020-09-26,3435,227,305,532,水里,簡易
2020-09-27,3435,219,161,380,水里,簡易
2020-09-28,3435,138,168,306,水里,簡易
2020-09-29,3435,151,152,303,水里,簡易
2020-09-30,3435,147,257,404,水里,簡易
2020-10-01,3435,219,384,603,水里,簡易
2020-10-02,3435,349,393,742,水里,簡易
2020-10-03,3435,306,269,575,水里,簡易
2020-10-04,3435,432,195,627,水里,簡易
2020-10-05,3435,202,108,310,水里,簡易
2020-10-06,3435,119,163,282,水里,簡易
2020-10-07,3435,109,125,234,水里,簡易
2020-10-08,3435,130,185,315,水里,簡易
2020-10-09,3435,234,362,596,水里,簡易
2020-10-10,3435,305,282,587,水里,簡易
2020-10-11,3435,338,183,521,水里,簡易
2020-10-12,3435,168,159,327,水里,簡易
2020-10-13,3435,109,143,252,水里,簡易
2020-10-14,3435,180,167,347,水里,簡易
2020-10-15,3435,156,140,296,水里,簡易
2020-10-16,3435,156,211,367,水里,簡易
2020-10-17,3435,294,305,599,水里,簡易
2020-10-18,3435,351,263,614,水里,簡易
2020-10-19,3435,146,151,297,水里,簡易
2020-10-20,3435,185,218,403,水里,簡易
2020-10-21,3435,195,130,325,水里,簡易
2020-10-22,3435,168,186,354,水里,簡易
2020-10-23,3435,175,296,471,水里,簡易
2020-10-24,3435,236,243,479,水里,簡易
2020-10-25,3435,300,205,505,水里,簡易
2020-10-26,3435,146,210,356,水里,簡易
2020-10-27,3435,165,162,327,水里,簡易
2020-10-28,3435,176,196,372,水里,簡易
2020-10-29,3435,174,262,436,水里,簡易
2020-10-30,3435,135,245,380,水里,簡易
2020-10-31,3435,286,211,497,水里,簡易
2020-11-01,3435,313,243,556,水里,簡易
2020-11-02,3435,127,108,235,水里,簡易
2020-11-03,3435,115,105,220,水里,簡易
2020-11-04,3435,112,131,243,水里,簡易
2020-11-05,3435,122,102,224,水里,簡易
2020-11-06,3435,154,213,367,水里,簡易
2020-11-07,3435,146,195,341,水里,簡易
2020-11-08,3435,304,248,552,水里,簡易
2020-11-09,3435,129,133,262,水里,簡易
2020-11-10,3435,101,131,232,水里,簡易
2020-11-11,3435,117,125,242,水里,簡易
2020-11-12,3435,120,130,250,水里,簡易
2020-11-13,3435,117,162,279,水里,簡易
2020-11-14,3435,139,202,341,水里,簡易
2020-11-15,3435,363,225,588,水里,簡易
2020-11-16,3435,118,183,301,水里,簡易
2020-11-17,3435,120,141,261,水里,簡易
2020-11-18,3435,145,128,273,水里,簡易
2020-11-19,3435,93,111,204,水里,簡易
2020-11-20,3435,135,245,380,水里,簡易
2020-11-21,3435,198,254,452,水里,簡易
2020-11-22,3435,284,223,507,水里,簡易
2020-11-23,3435,144,122,266,水里,簡易
2020-11-24,3435,123,122,245,水里,簡易
2020-11-25,3435,147,169,316,水里,簡易
2020-11-26,3435,130,105,235,水里,簡易
2020-11-27,3435,158,228,386,水里,簡易
2020-11-28,3435,247,242,489,水里,簡易
2020-11-29,3435,335,225,560,水里,簡易
2020-11-30,3435,135,109,244,水里,簡易
2020-12-01,3435,108,117,225,水里,簡易
2020-12-02,3435,118,117,235,水里,簡易
2020-12-03,3435,112,126,238,水里,簡易
2020-12-04,3435,164,198,362,水里,簡易
2020-12-05,3435,230,215,445,水里,簡易
2020-12-06,3435,280,239,519,水里,簡易
2020-12-07,3435,143,137,280,水里,簡易
2020-12-08,3435,106,112,218,水里,簡易
2020-12-09,3435,91,131,222,水里,簡易
2020-12-10,3435,141,127,268,水里,簡易
2020-12-11,3435,138,211,349,水里,簡易
2020-12-12,3435,140,178,318,水里,簡易
2020-12-13,3435,346,292,638,水里,簡易
2020-12-14,3435,256,234,490,水里,簡易
2020-12-15,3435,97,131,228,水里,簡易
2020-12-16,3435,158,138,296,水里,簡易
2020-12-17,3435,104,141,245,水里,簡易
2020-12-18,3435,144,213,357,水里,簡易
2020-12-19,3435,197,239,436,水里,簡易
2020-12-20,3435,228,181,409,水里,簡易
2020-12-21,3435,123,150,273,水里,簡易
2020-12-22,3435,95,111,206,水里,簡易
2020-12-23,3435,118,141,259,水里,簡易
2020-12-24,3435,154,186,340,水里,簡易
2020-12-25,3435,280,228,508,水里,簡易
2020-12-26,3435,176,230,406,水里,簡易
2020-12-27,3435,322,175,497,水里,簡易
2020-12-28,3435,152,114,266,水里,簡易
2020-12-29,3435,84,112,196,水里,簡易
2020-12-30,3435,142,127,269,水里,簡易
2020-12-31,3435,111,212,323,水里,簡易
2020-01-01,3436,861,940,1801,車埕,招呼
2020-01-02,3436,462,347,809,車埕,招呼
2020-01-03,3436,301,331,632,車埕,招呼
2020-01-04,3436,627,645,1272,車埕,招呼
2020-01-05,3436,713,768,1481,車埕,招呼
2020-01-06,3436,361,239,600,車埕,招呼
2020-01-07,3436,168,240,408,車埕,招呼
2020-01-08,3436,114,201,315,車埕,招呼
2020-01-09,3436,137,169,306,車埕,招呼
2020-01-10,3436,148,133,281,車埕,招呼
2020-01-11,3436,250,309,559,車埕,招呼
2020-01-12,3436,525,562,1087,車埕,招呼
2020-01-13,3436,614,349,963,車埕,招呼
2020-01-14,3436,162,300,462,車埕,招呼
2020-01-15,3436,335,353,688,車埕,招呼
2020-01-16,3436,803,666,1469,車埕,招呼
2020-01-17,3436,435,899,1334,車埕,招呼
2020-01-18,3436,414,466,880,車埕,招呼
2020-01-19,3436,601,650,1251,車埕,招呼
2020-01-20,3436,294,437,731,車埕,招呼
2020-01-21,3436,422,608,1030,車埕,招呼
2020-01-22,3436,328,395,723,車埕,招呼
2020-01-23,3436,525,472,997,車埕,招呼
2020-01-24,3436,211,238,449,車埕,招呼
2020-01-25,3436,1712,1759,3471,車埕,招呼
2020-01-26,3436,895,906,1801,車埕,招呼
2020-01-27,3436,2031,2148,4179,車埕,招呼
2020-01-28,3436,1711,1548,3259,車埕,招呼
2020-01-29,3436,759,944,1703,車埕,招呼
2020-01-30,3436,636,532,1168,車埕,招呼
2020-01-31,3436,415,481,896,車埕,招呼
2020-02-01,3436,528,593,1121,車埕,招呼
2020-02-02,3436,828,822,1650,車埕,招呼
2020-02-03,3436,374,396,770,車埕,招呼
2020-02-04,3436,303,263,566,車埕,招呼
2020-02-05,3436,289,368,657,車埕,招呼
2020-02-06,3436,289,271,560,車埕,招呼
2020-02-07,3436,255,243,498,車埕,招呼
2020-02-08,3436,310,291,601,車埕,招呼
2020-02-09,3436,434,495,929,車埕,招呼
2020-02-10,3436,257,273,530,車埕,招呼
2020-02-11,3436,337,359,696,車埕,招呼
2020-02-12,3436,241,287,528,車埕,招呼
2020-02-13,3436,214,168,382,車埕,招呼
2020-02-14,3436,218,208,426,車埕,招呼
2020-02-15,3436,337,374,711,車埕,招呼
2020-02-16,3436,449,459,908,車埕,招呼
2020-02-17,3436,255,228,483,車埕,招呼
2020-02-18,3436,182,256,438,車埕,招呼
2020-02-19,3436,250,249,499,車埕,招呼
2020-02-20,3436,211,189,400,車埕,招呼
2020-02-21,3436,215,229,444,車埕,招呼
2020-02-22,3436,337,431,768,車埕,招呼
2020-02-23,3436,475,428,903,車埕,招呼
2020-02-24,3436,326,280,606,車埕,招呼
2020-02-25,3436,158,125,283,車埕,招呼
2020-02-26,3436,113,160,273,車埕,招呼
2020-02-27,3436,117,108,225,車埕,招呼
2020-02-28,3436,532,637,1169,車埕,招呼
2020-02-29,3436,965,1024,1989,車埕,招呼
2020-03-01,3436,638,646,1284,車埕,招呼
2020-03-02,3436,179,146,325,車埕,招呼
2020-03-03,3436,96,100,196,車埕,招呼
2020-03-04,3436,105,83,188,車埕,招呼
2020-03-05,3436,39,47,86,車埕,招呼
2020-03-06,3436,138,185,323,車埕,招呼
2020-03-07,3436,282,277,559,車埕,招呼
2020-03-08,3436,304,372,676,車埕,招呼
2020-03-09,3436,178,174,352,車埕,招呼
2020-03-10,3436,77,51,128,車埕,招呼
2020-03-11,3436,90,139,229,車埕,招呼
2020-03-12,3436,84,77,161,車埕,招呼
2020-03-13,3436,117,123,240,車埕,招呼
2020-03-14,3436,154,188,342,車埕,招呼
2020-03-15,3436,473,479,952,車埕,招呼
2020-03-16,3436,189,191,380,車埕,招呼
2020-03-17,3436,113,96,209,車埕,招呼
2020-03-18,3436,84,104,188,車埕,招呼
2020-03-19,3436,68,84,152,車埕,招呼
2020-03-20,3436,86,1684,1770,車埕,招呼
2020-03-21,3436,251,424,675,車埕,招呼
2020-03-22,3436,386,471,857,車埕,招呼
2020-03-23,3436,153,122,275,車埕,招呼
2020-03-24,3436,54,69,123,車埕,招呼
2020-03-25,3436,114,73,187,車埕,招呼
2020-03-26,3436,70,136,206,車埕,招呼
2020-03-27,3436,162,125,287,車埕,招呼
2020-03-28,3436,141,149,290,車埕,招呼
2020-03-29,3436,326,339,665,車埕,招呼
2020-03-30,3436,130,123,253,車埕,招呼
2020-03-31,3436,91,82,173,車埕,招呼
2020-04-01,3436,79,84,163,車埕,招呼
2020-04-02,3436,168,221,389,車埕,招呼
2020-04-03,3436,423,432,855,車埕,招呼
2020-04-04,3436,376,351,727,車埕,招呼
2020-04-05,3436,285,264,549,車埕,招呼
2020-04-06,3436,87,96,183,車埕,招呼
2020-04-07,3436,47,58,105,車埕,招呼
2020-04-08,3436,42,33,75,車埕,招呼
2020-04-09,3436,36,35,71,車埕,招呼
2020-04-10,3436,53,48,101,車埕,招呼
2020-04-11,3436,142,182,324,車埕,招呼
2020-04-12,3436,106,121,227,車埕,招呼
2020-04-13,3436,123,115,238,車埕,招呼
2020-04-14,3436,73,81,154,車埕,招呼
2020-04-15,3436,162,74,236,車埕,招呼
2020-04-16,3436,92,84,176,車埕,招呼
2020-04-17,3436,58,80,138,車埕,招呼
2020-04-18,3436,215,230,445,車埕,招呼
2020-04-19,3436,298,302,600,車埕,招呼
2020-04-20,3436,115,122,237,車埕,招呼
2020-04-21,3436,70,66,136,車埕,招呼
2020-04-22,3436,79,76,155,車埕,招呼
2020-04-23,3436,31,113,144,車埕,招呼
2020-04-24,3436,40,51,91,車埕,招呼
2020-04-25,3436,158,170,328,車埕,招呼
2020-04-26,3436,256,308,564,車埕,招呼
2020-04-27,3436,185,125,310,車埕,招呼
2020-04-28,3436,53,71,124,車埕,招呼
2020-04-29,3436,122,106,228,車埕,招呼
2020-04-30,3436,59,61,120,車埕,招呼
2020-05-01,3436,219,250,469,車埕,招呼
2020-05-02,3436,424,465,889,車埕,招呼
2020-05-03,3436,380,368,748,車埕,招呼
2020-05-04,3436,148,132,280,車埕,招呼
2020-05-05,3436,62,45,107,車埕,招呼
2020-05-06,3436,102,104,206,車埕,招呼
2020-05-07,3436,86,93,179,車埕,招呼
2020-05-08,3436,81,97,178,車埕,招呼
2020-05-09,3436,258,256,514,車埕,招呼
2020-05-10,3436,414,370,784,車埕,招呼
2020-05-11,3436,124,115,239,車埕,招呼
2020-05-12,3436,54,37,91,車埕,招呼
2020-05-13,3436,105,101,206,車埕,招呼
2020-05-14,3436,116,201,317,車埕,招呼
2020-05-15,3436,98,90,188,車埕,招呼
2020-05-16,3436,321,367,688,車埕,招呼
2020-05-17,3436,403,455,858,車埕,招呼
2020-05-18,3436,255,161,416,車埕,招呼
2020-05-19,3436,66,48,114,車埕,招呼
2020-05-20,3436,156,72,228,車埕,招呼
2020-05-21,3436,53,51,104,車埕,招呼
2020-05-22,3436,288,190,478,車埕,招呼
2020-05-23,3436,142,192,334,車埕,招呼
2020-05-24,3436,494,506,1000,車埕,招呼
2020-05-25,3436,200,166,366,車埕,招呼
2020-05-26,3436,76,87,163,車埕,招呼
2020-05-27,3436,47,46,93,車埕,招呼
2020-05-28,3436,69,66,135,車埕,招呼
2020-05-29,3436,128,113,241,車埕,招呼
2020-05-30,3436,479,545,1024,車埕,招呼
2020-05-31,3436,734,754,1488,車埕,招呼
2020-06-01,3436,240,184,424,車埕,招呼
2020-06-02,3436,99,248,347,車埕,招呼
2020-06-03,3436,112,436,548,車埕,招呼
2020-06-04,3436,323,210,533,車埕,招呼
2020-06-05,3436,140,144,284,車埕,招呼
2020-06-06,3436,527,537,1064,車埕,招呼
2020-06-07,3436,658,809,1467,車埕,招呼
2020-06-08,3436,277,214,491,車埕,招呼
2020-06-09,3436,524,171,695,車埕,招呼
2020-06-10,3436,163,148,311,車埕,招呼
2020-06-11,3436,393,421,814,車埕,招呼
2020-06-12,3436,150,170,320,車埕,招呼
2020-06-13,3436,613,672,1285,車埕,招呼
2020-06-14,3436,830,694,1524,車埕,招呼
2020-06-15,3436,293,318,611,車埕,招呼
2020-06-16,3436,429,198,627,車埕,招呼
2020-06-17,3436,335,218,553,車埕,招呼
2020-06-18,3436,469,305,774,車埕,招呼
2020-06-19,3436,243,362,605,車埕,招呼
2020-06-20,3436,613,559,1172,車埕,招呼
2020-06-21,3436,467,738,1205,車埕,招呼
2020-06-22,3436,446,572,1018,車埕,招呼
2020-06-23,3436,756,171,927,車埕,招呼
2020-06-24,3436,818,168,986,車埕,招呼
2020-06-25,3436,546,582,1128,車埕,招呼
2020-06-26,3436,1656,1689,3345,車埕,招呼
2020-06-27,3436,1845,1567,3412,車埕,招呼
2020-06-28,3436,777,949,1726,車埕,招呼
2020-06-29,3436,353,239,592,車埕,招呼
2020-06-30,3436,121,230,351,車埕,招呼
2020-07-01,3436,182,596,778,車埕,招呼
2020-07-02,3436,166,136,302,車埕,招呼
2020-07-03,3436,159,230,389,車埕,招呼
2020-07-04,3436,489,602,1091,車埕,招呼
2020-07-05,3436,650,667,1317,車埕,招呼
2020-07-06,3436,344,238,582,車埕,招呼
2020-07-07,3436,172,248,420,車埕,招呼
2020-07-08,3436,224,233,457,車埕,招呼
2020-07-09,3436,219,339,558,車埕,招呼
2020-07-10,3436,354,456,810,車埕,招呼
2020-07-11,3436,691,965,1656,車埕,招呼
2020-07-12,3436,877,1027,1904,車埕,招呼
2020-07-13,3436,648,684,1332,車埕,招呼
2020-07-14,3436,176,247,423,車埕,招呼
2020-07-15,3436,206,288,494,車埕,招呼
2020-07-16,3436,591,428,1019,車埕,招呼
2020-07-17,3436,363,360,723,車埕,招呼
2020-07-18,3436,840,964,1804,車埕,招呼
2020-07-19,3436,923,1255,2178,車埕,招呼
2020-07-20,3436,565,551,1116,車埕,招呼
2020-07-21,3436,268,254,522,車埕,招呼
2020-07-22,3436,283,335,618,車埕,招呼
2020-07-23,3436,471,433,904,車埕,招呼
2020-07-24,3436,429,737,1166,車埕,招呼
2020-07-25,3436,1037,1306,2343,車埕,招呼
2020-07-26,3436,1299,918,2217,車埕,招呼
2020-07-27,3436,944,606,1550,車埕,招呼
2020-07-28,3436,348,530,878,車埕,招呼
2020-07-29,3436,285,360,645,車埕,招呼
2020-07-30,3436,469,480,949,車埕,招呼
2020-07-31,3436,539,533,1072,車埕,招呼
2020-08-01,3436,1149,1528,2677,車埕,招呼
2020-08-02,3436,796,784,1580,車埕,招呼
2020-08-03,3436,639,276,915,車埕,招呼
2020-08-04,3436,211,283,494,車埕,招呼
2020-08-05,3436,214,289,503,車埕,招呼
2020-08-06,3436,411,396,807,車埕,招呼
2020-08-07,3436,266,458,724,車埕,招呼
2020-08-08,3436,960,656,1616,車埕,招呼
2020-08-09,3436,837,971,1808,車埕,招呼
2020-08-10,3436,502,624,1126,車埕,招呼
2020-08-11,3436,179,328,507,車埕,招呼
2020-08-12,3436,378,327,705,車埕,招呼
2020-08-13,3436,319,504,823,車埕,招呼
2020-08-14,3436,998,636,1634,車埕,招呼
2020-08-15,3436,754,1173,1927,車埕,招呼
2020-08-16,3436,1719,1572,3291,車埕,招呼
2020-08-17,3436,478,510,988,車埕,招呼
2020-08-18,3436,927,604,1531,車埕,招呼
2020-08-19,3436,325,377,702,車埕,招呼
2020-08-20,3436,462,401,863,車埕,招呼
2020-08-21,3436,427,451,878,車埕,招呼
2020-08-22,3436,950,740,1690,車埕,招呼
2020-08-23,3436,978,1112,2090,車埕,招呼
2020-08-24,3436,656,573,1229,車埕,招呼
2020-08-25,3436,420,605,1025,車埕,招呼
2020-08-26,3436,233,368,601,車埕,招呼
2020-08-27,3436,355,346,701,車埕,招呼
2020-08-28,3436,364,482,846,車埕,招呼
2020-08-29,3436,489,555,1044,車埕,招呼
2020-08-30,3436,649,839,1488,車埕,招呼
2020-08-31,3436,470,162,632,車埕,招呼
2020-09-01,3436,88,91,179,車埕,招呼
2020-09-02,3436,69,73,142,車埕,招呼
2020-09-03,3436,147,147,294,車埕,招呼
2020-09-04,3436,122,367,489,車埕,招呼
2020-09-05,3436,520,640,1160,車埕,招呼
2020-09-06,3436,937,932,1869,車埕,招呼
2020-09-07,3436,308,234,542,車埕,招呼
2020-09-08,3436,573,248,821,車埕,招呼
2020-09-09,3436,152,165,317,車埕,招呼
2020-09-10,3436,516,209,725,車埕,招呼
2020-09-11,3436,349,141,490,車埕,招呼
2020-09-12,3436,447,563,1010,車埕,招呼
2020-09-13,3436,845,864,1709,車埕,招呼
2020-09-14,3436,556,229,785,車埕,招呼
2020-09-15,3436,116,120,236,車埕,招呼
2020-09-16,3436,144,137,281,車埕,招呼
2020-09-17,3436,355,438,793,車埕,招呼
2020-09-18,3436,154,459,613,車埕,招呼
2020-09-19,3436,437,574,1011,車埕,招呼
2020-09-20,3436,794,946,1740,車埕,招呼
2020-09-21,3436,621,243,864,車埕,招呼
2020-09-22,3436,220,284,504,車埕,招呼
2020-09-23,3436,272,355,627,車埕,招呼
2020-09-24,3436,183,303,486,車埕,招呼
2020-09-25,3436,643,285,928,車埕,招呼
2020-09-26,3436,523,608,1131,車埕,招呼
2020-09-27,3436,608,1018,1626,車埕,招呼
2020-09-28,3436,341,255,596,車埕,招呼
2020-09-29,3436,242,245,487,車埕,招呼
2020-09-30,3436,138,367,505,車埕,招呼
2020-10-01,3436,554,626,1180,車埕,招呼
2020-10-02,3436,1773,2010,3783,車埕,招呼
2020-10-03,3436,1632,1643,3275,車埕,招呼
2020-10-04,3436,978,1132,2110,車埕,招呼
2020-10-05,3436,406,577,983,車埕,招呼
2020-10-06,3436,197,359,556,車埕,招呼
2020-10-07,3436,241,814,1055,車埕,招呼
2020-10-08,3436,469,531,1000,車埕,招呼
2020-10-09,3436,1452,1247,2699,車埕,招呼
2020-10-10,3436,1506,1755,3261,車埕,招呼
2020-10-11,3436,825,1124,1949,車埕,招呼
2020-10-12,3436,357,683,1040,車埕,招呼
2020-10-13,3436,514,331,845,車埕,招呼
2020-10-14,3436,228,357,585,車埕,招呼
2020-10-15,3436,216,599,815,車埕,招呼
2020-10-16,3436,325,604,929,車埕,招呼
2020-10-17,3436,817,1062,1879,車埕,招呼
2020-10-18,3436,851,1047,1898,車埕,招呼
2020-10-19,3436,705,429,1134,車埕,招呼
2020-10-20,3436,326,762,1088,車埕,招呼
2020-10-21,3436,324,340,664,車埕,招呼
2020-10-22,3436,561,464,1025,車埕,招呼
2020-10-23,3436,269,275,544,車埕,招呼
2020-10-24,3436,586,1137,1723,車埕,招呼
2020-10-25,3436,766,856,1622,車埕,招呼
2020-10-26,3436,559,304,863,車埕,招呼
2020-10-27,3436,247,362,609,車埕,招呼
2020-10-28,3436,483,407,890,車埕,招呼
2020-10-29,3436,293,655,948,車埕,招呼
2020-10-30,3436,573,573,1146,車埕,招呼
2020-10-31,3436,1015,859,1874,車埕,招呼
2020-11-01,3436,938,971,1909,車埕,招呼
2020-11-02,3436,513,320,833,車埕,招呼
2020-11-03,3436,180,347,527,車埕,招呼
2020-11-04,3436,246,180,426,車埕,招呼
2020-11-05,3436,144,233,377,車埕,招呼
2020-11-06,3436,330,334,664,車埕,招呼
2020-11-07,3436,613,1034,1647,車埕,招呼
2020-11-08,3436,922,1060,1982,車埕,招呼
2020-11-09,3436,540,342,882,車埕,招呼
2020-11-10,3436,252,619,871,車埕,招呼
2020-11-11,3436,158,332,490,車埕,招呼
2020-11-12,3436,240,738,978,車埕,招呼
2020-11-13,3436,440,294,734,車埕,招呼
2020-11-14,3436,611,698,1309,車埕,招呼
2020-11-15,3436,743,1107,1850,車埕,招呼
2020-11-16,3436,512,501,1013,車埕,招呼
2020-11-17,3436,333,503,836,車埕,招呼
2020-11-18,3436,801,511,1312,車埕,招呼
2020-11-19,3436,206,283,489,車埕,招呼
2020-11-20,3436,503,289,792,車埕,招呼
2020-11-21,3436,828,886,1714,車埕,招呼
2020-11-22,3436,1119,1738,2857,車埕,招呼
2020-11-23,3436,705,595,1300,車埕,招呼
2020-11-24,3436,286,504,790,車埕,招呼
2020-11-25,3436,277,305,582,車埕,招呼
2020-11-26,3436,218,792,1010,車埕,招呼
2020-11-27,3436,656,398,1054,車埕,招呼
2020-11-28,3436,597,731,1328,車埕,招呼
2020-11-29,3436,861,1144,2005,車埕,招呼
2020-11-30,3436,550,372,922,車埕,招呼
2020-12-01,3436,194,381,575,車埕,招呼
2020-12-02,3436,262,144,406,車埕,招呼
2020-12-03,3436,187,588,775,車埕,招呼
2020-12-04,3436,417,420,837,車埕,招呼
2020-12-05,3436,393,1102,1495,車埕,招呼
2020-12-06,3436,894,1073,1967,車埕,招呼
2020-12-07,3436,274,567,841,車埕,招呼
2020-12-08,3436,638,560,1198,車埕,招呼
2020-12-09,3436,175,152,327,車埕,招呼
2020-12-10,3436,217,271,488,車埕,招呼
2020-12-11,3436,179,469,648,車埕,招呼
2020-12-12,3436,632,950,1582,車埕,招呼
2020-12-13,3436,978,1316,2294,車埕,招呼
2020-12-14,3436,1529,619,2148,車埕,招呼
2020-12-15,3436,169,328,497,車埕,招呼
2020-12-16,3436,334,346,680,車埕,招呼
2020-12-17,3436,420,368,788,車埕,招呼
2020-12-18,3436,179,674,853,車埕,招呼
2020-12-19,3436,434,859,1293,車埕,招呼
2020-12-20,3436,621,877,1498,車埕,招呼
2020-12-21,3436,339,249,588,車埕,招呼
2020-12-22,3436,189,143,332,車埕,招呼
2020-12-23,3436,1015,207,1222,車埕,招呼
2020-12-24,3436,176,213,389,車埕,招呼
2020-12-25,3436,215,392,607,車埕,招呼
2020-12-26,3436,544,774,1318,車埕,招呼
2020-12-27,3436,727,801,1528,車埕,招呼
2020-12-28,3436,312,370,682,車埕,招呼
2020-12-29,3436,176,254,430,車埕,招呼
2020-12-30,3436,472,129,601,車埕,招呼
2020-12-31,3436,165,230,395,車埕,招呼
2020-01-01,3450,959,898,1857,林內,三等
2020-01-02,3450,647,670,1317,林內,三等
2020-01-03,3450,809,949,1758,林內,三等
2020-01-04,3450,704,820,1524,林內,三等
2020-01-05,3450,1075,819,1894,林內,三等
2020-01-06,3450,768,712,1480,林內,三等
2020-01-07,3450,656,662,1318,林內,三等
2020-01-08,3450,691,721,1412,林內,三等
2020-01-09,3450,623,697,1320,林內,三等
2020-01-10,3450,832,1361,2193,林內,三等
2020-01-11,3450,994,1125,2119,林內,三等
2020-01-12,3450,1329,807,2136,林內,三等
2020-01-13,3450,811,711,1522,林內,三等
2020-01-14,3450,717,678,1395,林內,三等
2020-01-15,3450,716,713,1429,林內,三等
2020-01-16,3450,783,804,1587,林內,三等
2020-01-17,3450,820,897,1717,林內,三等
2020-01-18,3450,854,886,1740,林內,三等
2020-01-19,3450,808,637,1445,林內,三等
2020-01-20,3450,717,720,1437,林內,三等
2020-01-21,3450,776,878,1654,林內,三等
2020-01-22,3450,845,1155,2000,林內,三等
2020-01-23,3450,647,1156,1803,林內,三等
2020-01-24,3450,555,1018,1573,林內,三等
2020-01-25,3450,980,927,1907,林內,三等
2020-01-26,3450,931,817,1748,林內,三等
2020-01-27,3450,1267,974,2241,林內,三等
2020-01-28,3450,1134,766,1900,林內,三等
2020-01-29,3450,1012,647,1659,林內,三等
2020-01-30,3450,717,621,1338,林內,三等
2020-01-31,3450,704,712,1416,林內,三等
2020-02-01,3450,644,656,1300,林內,三等
2020-02-02,3450,722,539,1261,林內,三等
2020-02-03,3450,652,624,1276,林內,三等
2020-02-04,3450,601,576,1177,林內,三等
2020-02-05,3450,680,649,1329,林內,三等
2020-02-06,3450,614,628,1242,林內,三等
2020-02-07,3450,713,805,1518,林內,三等
2020-02-08,3450,637,705,1342,林內,三等
2020-02-09,3450,887,698,1585,林內,三等
2020-02-10,3450,669,619,1288,林內,三等
2020-02-11,3450,645,632,1277,林內,三等
2020-02-12,3450,680,688,1368,林內,三等
2020-02-13,3450,579,560,1139,林內,三等
2020-02-14,3450,669,730,1399,林內,三等
2020-02-15,3450,638,687,1325,林內,三等
2020-02-16,3450,743,619,1362,林內,三等
2020-02-17,3450,595,561,1156,林內,三等
2020-02-18,3450,560,551,1111,林內,三等
2020-02-19,3450,619,581,1200,林內,三等
2020-02-20,3450,546,602,1148,林內,三等
2020-02-21,3450,691,737,1428,林內,三等
2020-02-22,3450,686,777,1463,林內,三等
2020-02-23,3450,784,613,1397,林內,三等
2020-02-24,3450,653,602,1255,林內,三等
2020-02-25,3450,623,600,1223,林內,三等
2020-02-26,3450,620,639,1259,林內,三等
2020-02-27,3450,724,1003,1727,林內,三等
2020-02-28,3450,630,834,1464,林內,三等
2020-02-29,3450,631,622,1253,林內,三等
2020-03-01,3450,1073,577,1650,林內,三等
2020-03-02,3450,667,613,1280,林內,三等
2020-03-03,3450,608,603,1211,林內,三等
2020-03-04,3450,608,588,1196,林內,三等
2020-03-05,3450,536,587,1123,林內,三等
2020-03-06,3450,727,1064,1791,林內,三等
2020-03-07,3450,584,651,1235,林內,三等
2020-03-08,3450,1002,684,1686,林內,三等
2020-03-09,3450,660,621,1281,林內,三等
2020-03-10,3450,582,547,1129,林內,三等
2020-03-11,3450,573,582,1155,林內,三等
2020-03-12,3450,564,595,1159,林內,三等
2020-03-13,3450,741,1099,1840,林內,三等
2020-03-14,3450,509,612,1121,林內,三等
2020-03-15,3450,1086,680,1766,林內,三等
2020-03-16,3450,647,616,1263,林內,三等
2020-03-17,3450,594,546,1140,林內,三等
2020-03-18,3450,591,565,1156,林內,三等
2020-03-19,3450,545,616,1161,林內,三等
2020-03-20,3450,698,1000,1698,林內,三等
2020-03-21,3450,545,650,1195,林內,三等
2020-03-22,3450,904,519,1423,林內,三等
2020-03-23,3450,624,575,1199,林內,三等
2020-03-24,3450,572,544,1116,林內,三等
2020-03-25,3450,544,544,1088,林內,三等
2020-03-26,3450,517,552,1069,林內,三等
2020-03-27,3450,618,881,1499,林內,三等
2020-03-28,3450,449,529,978,林內,三等
2020-03-29,3450,732,481,1213,林內,三等
2020-03-30,3450,589,578,1167,林內,三等
2020-03-31,3450,550,558,1108,林內,三等
2020-04-01,3450,627,986,1613,林內,三等
2020-04-02,3450,474,753,1227,林內,三等
2020-04-03,3450,477,599,1076,林內,三等
2020-04-04,3450,514,405,919,林內,三等
2020-04-05,3450,997,417,1414,林內,三等
2020-04-06,3450,666,511,1177,林內,三等
2020-04-07,3450,578,545,1123,林內,三等
2020-04-08,3450,519,512,1031,林內,三等
2020-04-09,3450,490,499,989,林內,三等
2020-04-10,3450,598,848,1446,林內,三等
2020-04-11,3450,450,573,1023,林內,三等
2020-04-12,3450,798,512,1310,林內,三等
2020-04-13,3450,575,527,1102,林內,三等
2020-04-14,3450,540,524,1064,林內,三等
2020-04-15,3450,556,541,1097,林內,三等
2020-04-16,3450,488,548,1036,林內,三等
2020-04-17,3450,643,933,1576,林內,三等
2020-04-18,3450,502,648,1150,林內,三等
2020-04-19,3450,901,511,1412,林內,三等
2020-04-20,3450,640,574,1214,林內,三等
2020-04-21,3450,524,513,1037,林內,三等
2020-04-22,3450,477,500,977,林內,三等
2020-04-23,3450,463,496,959,林內,三等
2020-04-24,3450,571,833,1404,林內,三等
2020-04-25,3450,417,503,920,林內,三等
2020-04-26,3450,723,476,1199,林內,三等
2020-04-27,3450,574,516,1090,林內,三等
2020-04-28,3450,503,512,1015,林內,三等
2020-04-29,3450,479,498,977,林內,三等
2020-04-30,3450,527,650,1177,林內,三等
2020-05-01,3450,636,967,1603,林內,三等
2020-05-02,3450,484,594,1078,林內,三等
2020-05-03,3450,910,540,1450,林內,三等
2020-05-04,3450,652,559,1211,林內,三等
2020-05-05,3450,603,567,1170,林內,三等
2020-05-06,3450,564,571,1135,林內,三等
2020-05-07,3450,528,554,1082,林內,三等
2020-05-08,3450,668,1131,1799,林內,三等
2020-05-09,3450,556,774,1330,林內,三等
2020-05-10,3450,1087,567,1654,林內,三等
2020-05-11,3450,709,594,1303,林內,三等
2020-05-12,3450,565,568,1133,林內,三等
2020-05-13,3450,591,572,1163,林內,三等
2020-05-14,3450,547,560,1107,林內,三等
2020-05-15,3450,652,940,1592,林內,三等
2020-05-16,3450,593,659,1252,林內,三等
2020-05-17,3450,859,588,1447,林內,三等
2020-05-18,3450,656,589,1245,林內,三等
2020-05-19,3450,508,504,1012,林內,三等
2020-05-20,3450,583,559,1142,林內,三等
2020-05-21,3450,533,552,1085,林內,三等
2020-05-22,3450,602,852,1454,林內,三等
2020-05-23,3450,496,594,1090,林內,三等
2020-05-24,3450,907,582,1489,林內,三等
2020-05-25,3450,624,568,1192,林內,三等
2020-05-26,3450,591,562,1153,林內,三等
2020-05-27,3450,540,555,1095,林內,三等
2020-05-28,3450,487,513,1000,林內,三等
2020-05-29,3450,684,986,1670,林內,三等
2020-05-30,3450,622,728,1350,林內,三等
2020-05-31,3450,951,585,1536,林內,三等
2020-06-01,3450,693,637,1330,林內,三等
2020-06-02,3450,615,568,1183,林內,三等
2020-06-03,3450,573,562,1135,林內,三等
2020-06-04,3450,547,581,1128,林內,三等
2020-06-05,3450,704,998,1702,林內,三等
2020-06-06,3450,631,724,1355,林內,三等
2020-06-07,3450,928,584,1512,林內,三等
2020-06-08,3450,682,614,1296,林內,三等
2020-06-09,3450,602,595,1197,林內,三等
2020-06-10,3450,628,635,1263,林內,三等
2020-06-11,3450,627,582,1209,林內,三等
2020-06-12,3450,697,1005,1702,林內,三等
2020-06-13,3450,680,762,1442,林內,三等
2020-06-14,3450,952,672,1624,林內,三等
2020-06-15,3450,784,735,1519,林內,三等
2020-06-16,3450,621,633,1254,林內,三等
2020-06-17,3450,629,602,1231,林內,三等
2020-06-18,3450,613,616,1229,林內,三等
2020-06-19,3450,638,695,1333,林內,三等
2020-06-20,3450,652,730,1382,林內,三等
2020-06-21,3450,792,631,1423,林內,三等
2020-06-22,3450,701,688,1389,林內,三等
2020-06-23,3450,778,749,1527,林內,三等
2020-06-24,3450,768,1125,1893,林內,三等
2020-06-25,3450,655,985,1640,林內,三等
2020-06-26,3450,939,961,1900,林內,三等
2020-06-27,3450,871,719,1590,林內,三等
2020-06-28,3450,1175,645,1820,林內,三等
2020-06-29,3450,751,605,1356,林內,三等
2020-06-30,3450,659,660,1319,林內,三等
2020-07-01,3450,619,595,1214,林內,三等
2020-07-02,3450,573,597,1170,林內,三等
2020-07-03,3450,728,827,1555,林內,三等
2020-07-04,3450,659,702,1361,林內,三等
2020-07-05,3450,876,674,1550,林內,三等
2020-07-06,3450,699,651,1350,林內,三等
2020-07-07,3450,642,656,1298,林內,三等
2020-07-08,3450,632,596,1228,林內,三等
2020-07-09,3450,620,623,1243,林內,三等
2020-07-10,3450,786,886,1672,林內,三等
2020-07-11,3450,661,757,1418,林內,三等
2020-07-12,3450,957,643,1600,林內,三等
2020-07-13,3450,692,662,1354,林內,三等
2020-07-14,3450,657,661,1318,林內,三等
2020-07-15,3450,676,644,1320,林內,三等
2020-07-16,3450,588,639,1227,林內,三等
2020-07-17,3450,659,785,1444,林內,三等
2020-07-18,3450,722,791,1513,林內,三等
2020-07-19,3450,940,640,1580,林內,三等
2020-07-20,3450,720,714,1434,林內,三等
2020-07-21,3450,724,691,1415,林內,三等
2020-07-22,3450,723,708,1431,林內,三等
2020-07-23,3450,654,671,1325,林內,三等
2020-07-24,3450,854,889,1743,林內,三等
2020-07-25,3450,764,850,1614,林內,三等
2020-07-26,3450,903,729,1632,林內,三等
2020-07-27,3450,715,666,1381,林內,三等
2020-07-28,3450,671,682,1353,林內,三等
2020-07-29,3450,639,640,1279,林內,三等
2020-07-30,3450,651,640,1291,林內,三等
2020-07-31,3450,759,868,1627,林內,三等
2020-08-01,3450,687,784,1471,林內,三等
2020-08-02,3450,881,689,1570,林內,三等
2020-08-03,3450,648,625,1273,林內,三等
2020-08-04,3450,612,560,1172,林內,三等
2020-08-05,3450,693,703,1396,林內,三等
2020-08-06,3450,670,675,1345,林內,三等
2020-08-07,3450,740,945,1685,林內,三等
2020-08-08,3450,673,848,1521,林內,三等
2020-08-09,3450,996,667,1663,林內,三等
2020-08-10,3450,714,620,1334,林內,三等
2020-08-11,3450,639,624,1263,林內,三等
2020-08-12,3450,653,632,1285,林內,三等
2020-08-13,3450,676,694,1370,林內,三等
2020-08-14,3450,724,858,1582,林內,三等
2020-08-15,3450,700,781,1481,林內,三等
2020-08-16,3450,898,684,1582,林內,三等
2020-08-17,3450,721,695,1416,林內,三等
2020-08-18,3450,688,644,1332,林內,三等
2020-08-19,3450,630,598,1228,林內,三等
2020-08-20,3450,701,658,1359,林內,三等
2020-08-21,3450,737,826,1563,林內,三等
2020-08-22,3450,700,796,1496,林內,三等
2020-08-23,3450,814,634,1448,林內,三等
2020-08-24,3450,731,701,1432,林內,三等
2020-08-25,3450,694,682,1376,林內,三等
2020-08-26,3450,614,629,1243,林內,三等
2020-08-27,3450,600,580,1180,林內,三等
2020-08-28,3450,691,819,1510,林內,三等
2020-08-29,3450,627,724,1351,林內,三等
2020-08-30,3450,893,601,1494,林內,三等
2020-08-31,3450,728,705,1433,林內,三等
2020-09-01,3450,667,663,1330,林內,三等
2020-09-02,3450,617,615,1232,林內,三等
2020-09-03,3450,675,650,1325,林內,三等
2020-09-04,3450,843,882,1725,林內,三等
2020-09-05,3450,707,806,1513,林內,三等
2020-09-06,3450,985,730,1715,林內,三等
2020-09-07,3450,733,712,1445,林內,三等
2020-09-08,3450,685,703,1388,林內,三等
2020-09-09,3450,690,669,1359,林內,三等
2020-09-10,3450,656,672,1328,林內,三等
2020-09-11,3450,813,970,1783,林內,三等
2020-09-12,3450,733,812,1545,林內,三等
2020-09-13,3450,1115,784,1899,林內,三等
2020-09-14,3450,773,683,1456,林內,三等
2020-09-15,3450,631,643,1274,林內,三等
2020-09-16,3450,614,594,1208,林內,三等
2020-09-17,3450,622,657,1279,林內,三等
2020-09-18,3450,799,1109,1908,林內,三等
2020-09-19,3450,725,853,1578,林內,三等
2020-09-20,3450,1109,758,1867,林內,三等
2020-09-21,3450,728,656,1384,林內,三等
2020-09-22,3450,628,613,1241,林內,三等
2020-09-23,3450,609,614,1223,林內,三等
2020-09-24,3450,593,644,1237,林內,三等
2020-09-25,3450,654,737,1391,林內,三等
2020-09-26,3450,679,761,1440,林內,三等
2020-09-27,3450,858,722,1580,林內,三等
2020-09-28,3450,707,654,1361,林內,三等
2020-09-29,3450,629,670,1299,林內,三等
2020-09-30,3450,778,1361,2139,林內,三等
2020-10-01,3450,808,1365,2173,林內,三等
2020-10-02,3450,1030,982,2012,林內,三等
2020-10-03,3450,1097,842,1939,林內,三等
2020-10-04,3450,1450,674,2124,林內,三等
2020-10-05,3450,844,724,1568,林內,三等
2020-10-06,3450,669,632,1301,林內,三等
2020-10-07,3450,652,625,1277,林內,三等
2020-10-08,3450,750,1137,1887,林內,三等
2020-10-09,3450,832,1044,1876,林內,三等
2020-10-10,3450,738,776,1514,林內,三等
2020-10-11,3450,1275,776,2051,林內,三等
2020-10-12,3450,790,717,1507,林內,三等
2020-10-13,3450,724,657,1381,林內,三等
2020-10-14,3450,637,611,1248,林內,三等
2020-10-15,3450,633,689,1322,林內,三等
2020-10-16,3450,820,1019,1839,林內,三等
2020-10-17,3450,748,864,1612,林內,三等
2020-10-18,3450,1037,756,1793,林內,三等
2020-10-19,3450,766,706,1472,林內,三等
2020-10-20,3450,650,681,1331,林內,三等
2020-10-21,3450,686,641,1327,林內,三等
2020-10-22,3450,650,693,1343,林內,三等
2020-10-23,3450,752,1061,1813,林內,三等
2020-10-24,3450,713,861,1574,林內,三等
2020-10-25,3450,1083,702,1785,林內,三等
2020-10-26,3450,782,676,1458,林內,三等
2020-10-27,3450,675,683,1358,林內,三等
2020-10-28,3450,579,576,1155,林內,三等
2020-10-29,3450,653,693,1346,林內,三等
2020-10-30,3450,800,1128,1928,林內,三等
2020-10-31,3450,790,793,1583,林內,三等
2020-11-01,3450,1137,821,1958,林內,三等
2020-11-02,3450,783,745,1528,林內,三等
2020-11-03,3450,672,642,1314,林內,三等
2020-11-04,3450,653,647,1300,林內,三等
2020-11-05,3450,661,680,1341,林內,三等
2020-11-06,3450,826,1079,1905,林內,三等
2020-11-07,3450,763,864,1627,林內,三等
2020-11-08,3450,1165,853,2018,林內,三等
2020-11-09,3450,719,671,1390,林內,三等
2020-11-10,3450,618,633,1251,林內,三等
2020-11-11,3450,737,704,1441,林內,三等
2020-11-12,3450,692,751,1443,林內,三等
2020-11-13,3450,868,1157,2025,林內,三等
2020-11-14,3450,718,809,1527,林內,三等
2020-11-15,3450,1256,871,2127,林內,三等
2020-11-16,3450,796,730,1526,林內,三等
2020-11-17,3450,741,717,1458,林內,三等
2020-11-18,3450,682,721,1403,林內,三等
2020-11-19,3450,656,684,1340,林內,三等
2020-11-20,3450,812,1127,1939,林內,三等
2020-11-21,3450,795,928,1723,林內,三等
2020-11-22,3450,1193,792,1985,林內,三等
2020-11-23,3450,783,750,1533,林內,三等
2020-11-24,3450,670,668,1338,林內,三等
2020-11-25,3450,689,678,1367,林內,三等
2020-11-26,3450,647,735,1382,林內,三等
2020-11-27,3450,871,1181,2052,林內,三等
2020-11-28,3450,673,817,1490,林內,三等
2020-11-29,3450,1232,839,2071,林內,三等
2020-11-30,3450,766,695,1461,林內,三等
2020-12-01,3450,688,698,1386,林內,三等
2020-12-02,3450,691,686,1377,林內,三等
2020-12-03,3450,642,703,1345,林內,三等
2020-12-04,3450,835,1149,1984,林內,三等
2020-12-05,3450,799,904,1703,林內,三等
2020-12-06,3450,1178,786,1964,林內,三等
2020-12-07,3450,788,718,1506,林內,三等
2020-12-08,3450,696,696,1392,林內,三等
2020-12-09,3450,644,624,1268,林內,三等
2020-12-10,3450,587,675,1262,林內,三等
2020-12-11,3450,802,1076,1878,林內,三等
2020-12-12,3450,752,912,1664,林內,三等
2020-12-13,3450,1198,801,1999,林內,三等
2020-12-14,3450,782,735,1517,林內,三等
2020-12-15,3450,704,670,1374,林內,三等
2020-12-16,3450,669,685,1354,林內,三等
2020-12-17,3450,705,707,1412,林內,三等
2020-12-18,3450,851,1163,2014,林內,三等
2020-12-19,3450,805,965,1770,林內,三等
2020-12-20,3450,1206,820,2026,林內,三等
2020-12-21,3450,738,623,1361,林內,三等
2020-12-22,3450,708,679,1387,林內,三等
2020-12-23,3450,639,619,1258,林內,三等
2020-12-24,3450,642,689,1331,林內,三等
2020-12-25,3450,859,1109,1968,林內,三等
2020-12-26,3450,634,831,1465,林內,三等
2020-12-27,3450,1067,754,1821,林內,三等
2020-12-28,3450,777,688,1465,林內,三等
2020-12-29,3450,661,664,1325,林內,三等
2020-12-30,3450,639,700,1339,林內,三等
2020-12-31,3450,795,1106,1901,林內,三等
2020-01-01,3460,219,268,487,石榴,招呼
2020-01-02,3460,158,163,321,石榴,招呼
2020-01-03,3460,182,234,416,石榴,招呼
2020-01-04,3460,181,261,442,石榴,招呼
2020-01-05,3460,274,245,519,石榴,招呼
2020-01-06,3460,193,196,389,石榴,招呼
2020-01-07,3460,141,170,311,石榴,招呼
2020-01-08,3460,161,182,343,石榴,招呼
2020-01-09,3460,155,185,340,石榴,招呼
2020-01-10,3460,161,284,445,石榴,招呼
2020-01-11,3460,276,300,576,石榴,招呼
2020-01-12,3460,351,357,708,石榴,招呼
2020-01-13,3460,176,179,355,石榴,招呼
2020-01-14,3460,173,169,342,石榴,招呼
2020-01-15,3460,162,195,357,石榴,招呼
2020-01-16,3460,166,240,406,石榴,招呼
2020-01-17,3460,168,207,375,石榴,招呼
2020-01-18,3460,205,224,429,石榴,招呼
2020-01-19,3460,246,277,523,石榴,招呼
2020-01-20,3460,179,206,385,石榴,招呼
2020-01-21,3460,147,202,349,石榴,招呼
2020-01-22,3460,190,275,465,石榴,招呼
2020-01-23,3460,217,304,521,石榴,招呼
2020-01-24,3460,223,313,536,石榴,招呼
2020-01-25,3460,239,279,518,石榴,招呼
2020-01-26,3460,224,258,482,石榴,招呼
2020-01-27,3460,252,331,583,石榴,招呼
2020-01-28,3460,273,252,525,石榴,招呼
2020-01-29,3460,205,219,424,石榴,招呼
2020-01-30,3460,160,179,339,石榴,招呼
2020-01-31,3460,143,155,298,石榴,招呼
2020-02-01,3460,118,171,289,石榴,招呼
2020-02-02,3460,176,192,368,石榴,招呼
2020-02-03,3460,154,173,327,石榴,招呼
2020-02-04,3460,136,148,284,石榴,招呼
2020-02-05,3460,126,139,265,石榴,招呼
2020-02-06,3460,139,131,270,石榴,招呼
2020-02-07,3460,180,221,401,石榴,招呼
2020-02-08,3460,160,197,357,石榴,招呼
2020-02-09,3460,222,272,494,石榴,招呼
2020-02-10,3460,165,190,355,石榴,招呼
2020-02-11,3460,148,142,290,石榴,招呼
2020-02-12,3460,156,177,333,石榴,招呼
2020-02-13,3460,132,137,269,石榴,招呼
2020-02-14,3460,173,186,359,石榴,招呼
2020-02-15,3460,149,167,316,石榴,招呼
2020-02-16,3460,221,273,494,石榴,招呼
2020-02-17,3460,161,139,300,石榴,招呼
2020-02-18,3460,132,149,281,石榴,招呼
2020-02-19,3460,146,155,301,石榴,招呼
2020-02-20,3460,127,144,271,石榴,招呼
2020-02-21,3460,167,182,349,石榴,招呼
2020-02-22,3460,148,185,333,石榴,招呼
2020-02-23,3460,213,205,418,石榴,招呼
2020-02-24,3460,167,173,340,石榴,招呼
2020-02-25,3460,146,163,309,石榴,招呼
2020-02-26,3460,153,174,327,石榴,招呼
2020-02-27,3460,155,244,399,石榴,招呼
2020-02-28,3460,188,235,423,石榴,招呼
2020-02-29,3460,152,192,344,石榴,招呼
2020-03-01,3460,261,224,485,石榴,招呼
2020-03-02,3460,173,158,331,石榴,招呼
2020-03-03,3460,127,142,269,石榴,招呼
2020-03-04,3460,144,147,291,石榴,招呼
2020-03-05,3460,126,144,270,石榴,招呼
2020-03-06,3460,153,247,400,石榴,招呼
2020-03-07,3460,166,225,391,石榴,招呼
2020-03-08,3460,224,222,446,石榴,招呼
2020-03-09,3460,169,162,331,石榴,招呼
2020-03-10,3460,115,139,254,石榴,招呼
2020-03-11,3460,141,146,287,石榴,招呼
2020-03-12,3460,146,178,324,石榴,招呼
2020-03-13,3460,175,258,433,石榴,招呼
2020-03-14,3460,159,192,351,石榴,招呼
2020-03-15,3460,255,257,512,石榴,招呼
2020-03-16,3460,150,170,320,石榴,招呼
2020-03-17,3460,140,137,277,石榴,招呼
2020-03-18,3460,133,145,278,石榴,招呼
2020-03-19,3460,117,121,238,石榴,招呼
2020-03-20,3460,170,244,414,石榴,招呼
2020-03-21,3460,123,176,299,石榴,招呼
2020-03-22,3460,225,178,403,石榴,招呼
2020-03-23,3460,159,142,301,石榴,招呼
2020-03-24,3460,116,141,257,石榴,招呼
2020-03-25,3460,122,135,257,石榴,招呼
2020-03-26,3460,120,146,266,石榴,招呼
2020-03-27,3460,148,228,376,石榴,招呼
2020-03-28,3460,93,122,215,石榴,招呼
2020-03-29,3460,131,128,259,石榴,招呼
2020-03-30,3460,126,140,266,石榴,招呼
2020-03-31,3460,106,150,256,石榴,招呼
2020-04-01,3460,131,227,358,石榴,招呼
2020-04-02,3460,119,176,295,石榴,招呼
2020-04-03,3460,114,165,279,石榴,招呼
2020-04-04,3460,115,110,225,石榴,招呼
2020-04-05,3460,212,150,362,石榴,招呼
2020-04-06,3460,138,131,269,石榴,招呼
2020-04-07,3460,114,116,230,石榴,招呼
2020-04-08,3460,118,129,247,石榴,招呼
2020-04-09,3460,117,140,257,石榴,招呼
2020-04-10,3460,139,219,358,石榴,招呼
2020-04-11,3460,131,167,298,石榴,招呼
2020-04-12,3460,209,189,398,石榴,招呼
2020-04-13,3460,139,137,276,石榴,招呼
2020-04-14,3460,115,120,235,石榴,招呼
2020-04-15,3460,119,134,253,石榴,招呼
2020-04-16,3460,117,117,234,石榴,招呼
2020-04-17,3460,151,254,405,石榴,招呼
2020-04-18,3460,129,158,287,石榴,招呼
2020-04-19,3460,212,183,395,石榴,招呼
2020-04-20,3460,137,137,274,石榴,招呼
2020-04-21,3460,119,122,241,石榴,招呼
2020-04-22,3460,102,108,210,石榴,招呼
2020-04-23,3460,115,122,237,石榴,招呼
2020-04-24,3460,138,200,338,石榴,招呼
2020-04-25,3460,114,153,267,石榴,招呼
2020-04-26,3460,157,149,306,石榴,招呼
2020-04-27,3460,133,145,278,石榴,招呼
2020-04-28,3460,116,119,235,石榴,招呼
2020-04-29,3460,123,126,249,石榴,招呼
2020-04-30,3460,127,151,278,石榴,招呼
2020-05-01,3460,133,220,353,石榴,招呼
2020-05-02,3460,132,163,295,石榴,招呼
2020-05-03,3460,188,188,376,石榴,招呼
2020-05-04,3460,155,134,289,石榴,招呼
2020-05-05,3460,114,131,245,石榴,招呼
2020-05-06,3460,133,140,273,石榴,招呼
2020-05-07,3460,122,135,257,石榴,招呼
2020-05-08,3460,151,247,398,石榴,招呼
2020-05-09,3460,164,245,409,石榴,招呼
2020-05-10,3460,252,198,450,石榴,招呼
2020-05-11,3460,163,153,316,石榴,招呼
2020-05-12,3460,119,129,248,石榴,招呼
2020-05-13,3460,116,147,263,石榴,招呼
2020-05-14,3460,110,115,225,石榴,招呼
2020-05-15,3460,157,212,369,石榴,招呼
2020-05-16,3460,152,196,348,石榴,招呼
2020-05-17,3460,218,214,432,石榴,招呼
2020-05-18,3460,145,135,280,石榴,招呼
2020-05-19,3460,90,107,197,石榴,招呼
2020-05-20,3460,102,125,227,石榴,招呼
2020-05-21,3460,116,122,238,石榴,招呼
2020-05-22,3460,137,215,352,石榴,招呼
2020-05-23,3460,156,182,338,石榴,招呼
2020-05-24,3460,275,311,586,石榴,招呼
2020-05-25,3460,155,136,291,石榴,招呼
2020-05-26,3460,74,124,198,石榴,招呼
2020-05-27,3460,92,109,201,石榴,招呼
2020-05-28,3460,100,111,211,石榴,招呼
2020-05-29,3460,141,224,365,石榴,招呼
2020-05-30,3460,174,219,393,石榴,招呼
2020-05-31,3460,223,195,418,石榴,招呼
2020-06-01,3460,159,175,334,石榴,招呼
2020-06-02,3460,131,140,271,石榴,招呼
2020-06-03,3460,122,131,253,石榴,招呼
2020-06-04,3460,122,140,262,石榴,招呼
2020-06-05,3460,146,247,393,石榴,招呼
2020-06-06,3460,147,214,361,石榴,招呼
2020-06-07,3460,226,173,399,石榴,招呼
2020-06-08,3460,160,159,319,石榴,招呼
2020-06-09,3460,109,121,230,石榴,招呼
2020-06-10,3460,114,133,247,石榴,招呼
2020-06-11,3460,134,151,285,石榴,招呼
2020-06-12,3460,172,254,426,石榴,招呼
2020-06-13,3460,184,228,412,石榴,招呼
2020-06-14,3460,267,287,554,石榴,招呼
2020-06-15,3460,232,246,478,石榴,招呼
2020-06-16,3460,120,135,255,石榴,招呼
2020-06-17,3460,112,132,244,石榴,招呼
2020-06-18,3460,129,139,268,石榴,招呼
2020-06-19,3460,141,174,315,石榴,招呼
2020-06-20,3460,143,219,362,石榴,招呼
2020-06-21,3460,221,243,464,石榴,招呼
2020-06-22,3460,143,169,312,石榴,招呼
2020-06-23,3460,118,139,257,石榴,招呼
2020-06-24,3460,135,250,385,石榴,招呼
2020-06-25,3460,175,232,407,石榴,招呼
2020-06-26,3460,212,215,427,石榴,招呼
2020-06-27,3460,237,243,480,石榴,招呼
2020-06-28,3460,300,277,577,石榴,招呼
2020-06-29,3460,183,174,357,石榴,招呼
2020-06-30,3460,136,158,294,石榴,招呼
2020-07-01,3460,138,159,297,石榴,招呼
2020-07-02,3460,141,150,291,石榴,招呼
2020-07-03,3460,148,189,337,石榴,招呼
2020-07-04,3460,157,196,353,石榴,招呼
2020-07-05,3460,204,188,392,石榴,招呼
2020-07-06,3460,155,169,324,石榴,招呼
2020-07-07,3460,140,152,292,石榴,招呼
2020-07-08,3460,135,170,305,石榴,招呼
2020-07-09,3460,145,176,321,石榴,招呼
2020-07-10,3460,154,207,361,石榴,招呼
2020-07-11,3460,262,274,536,石榴,招呼
2020-07-12,3460,259,304,563,石榴,招呼
2020-07-13,3460,177,188,365,石榴,招呼
2020-07-14,3460,149,184,333,石榴,招呼
2020-07-15,3460,116,134,250,石榴,招呼
2020-07-16,3460,131,136,267,石榴,招呼
2020-07-17,3460,161,199,360,石榴,招呼
2020-07-18,3460,219,236,455,石榴,招呼
2020-07-19,3460,267,290,557,石榴,招呼
2020-07-20,3460,179,177,356,石榴,招呼
2020-07-21,3460,114,125,239,石榴,招呼
2020-07-22,3460,127,142,269,石榴,招呼
2020-07-23,3460,137,141,278,石榴,招呼
2020-07-24,3460,164,205,369,石榴,招呼
2020-07-25,3460,294,337,631,石榴,招呼
2020-07-26,3460,227,255,482,石榴,招呼
2020-07-27,3460,163,146,309,石榴,招呼
2020-07-28,3460,130,142,272,石榴,招呼
2020-07-29,3460,142,141,283,石榴,招呼
2020-07-30,3460,167,182,349,石榴,招呼
2020-07-31,3460,185,220,405,石榴,招呼
2020-08-01,3460,197,228,425,石榴,招呼
2020-08-02,3460,236,232,468,石榴,招呼
2020-08-03,3460,158,163,321,石榴,招呼
2020-08-04,3460,121,147,268,石榴,招呼
2020-08-05,3460,149,164,313,石榴,招呼
2020-08-06,3460,147,178,325,石榴,招呼
2020-08-07,3460,178,214,392,石榴,招呼
2020-08-08,3460,181,226,407,石榴,招呼
2020-08-09,3460,301,292,593,石榴,招呼
2020-08-10,3460,185,190,375,石榴,招呼
2020-08-11,3460,153,157,310,石榴,招呼
2020-08-12,3460,146,155,301,石榴,招呼
2020-08-13,3460,146,174,320,石榴,招呼
2020-08-14,3460,177,207,384,石榴,招呼
2020-08-15,3460,202,192,394,石榴,招呼
2020-08-16,3460,218,298,516,石榴,招呼
2020-08-17,3460,159,176,335,石榴,招呼
2020-08-18,3460,134,159,293,石榴,招呼
2020-08-19,3460,128,158,286,石榴,招呼
2020-08-20,3460,141,161,302,石榴,招呼
2020-08-21,3460,171,196,367,石榴,招呼
2020-08-22,3460,196,209,405,石榴,招呼
2020-08-23,3460,207,233,440,石榴,招呼
2020-08-24,3460,148,159,307,石榴,招呼
2020-08-25,3460,128,161,289,石榴,招呼
2020-08-26,3460,131,131,262,石榴,招呼
2020-08-27,3460,104,113,217,石榴,招呼
2020-08-28,3460,159,180,339,石榴,招呼
2020-08-29,3460,149,184,333,石榴,招呼
2020-08-30,3460,196,198,394,石榴,招呼
2020-08-31,3460,182,190,372,石榴,招呼
2020-09-01,3460,131,160,291,石榴,招呼
2020-09-02,3460,121,158,279,石榴,招呼
2020-09-03,3460,152,149,301,石榴,招呼
2020-09-04,3460,161,189,350,石榴,招呼
2020-09-05,3460,186,1284,1470,石榴,招呼
2020-09-06,3460,237,210,447,石榴,招呼
2020-09-07,3460,156,162,318,石榴,招呼
2020-09-08,3460,132,147,279,石榴,招呼
2020-09-09,3460,135,682,817,石榴,招呼
2020-09-10,3460,152,155,307,石榴,招呼
2020-09-11,3460,169,233,402,石榴,招呼
2020-09-12,3460,196,244,440,石榴,招呼
2020-09-13,3460,294,292,586,石榴,招呼
2020-09-14,3460,151,168,319,石榴,招呼
2020-09-15,3460,115,131,246,石榴,招呼
2020-09-16,3460,115,147,262,石榴,招呼
2020-09-17,3460,138,148,286,石榴,招呼
2020-09-18,3460,167,214,381,石榴,招呼
2020-09-19,3460,164,185,349,石榴,招呼
2020-09-20,3460,339,291,630,石榴,招呼
2020-09-21,3460,166,153,319,石榴,招呼
2020-09-22,3460,126,136,262,石榴,招呼
2020-09-23,3460,135,171,306,石榴,招呼
2020-09-24,3460,147,146,293,石榴,招呼
2020-09-25,3460,161,186,347,石榴,招呼
2020-09-26,3460,164,219,383,石榴,招呼
2020-09-27,3460,181,233,414,石榴,招呼
2020-09-28,3460,162,159,321,石榴,招呼
2020-09-29,3460,123,157,280,石榴,招呼
2020-09-30,3460,159,296,455,石榴,招呼
2020-10-01,3460,201,296,497,石榴,招呼
2020-10-02,3460,238,254,492,石榴,招呼
2020-10-03,3460,250,259,509,石榴,招呼
2020-10-04,3460,296,252,548,石榴,招呼
2020-10-05,3460,187,152,339,石榴,招呼
2020-10-06,3460,122,156,278,石榴,招呼
2020-10-07,3460,125,154,279,石榴,招呼
2020-10-08,3460,163,227,390,石榴,招呼
2020-10-09,3460,214,293,507,石榴,招呼
2020-10-10,3460,188,217,405,石榴,招呼
2020-10-11,3460,289,312,601,石榴,招呼
2020-10-12,3460,179,173,352,石榴,招呼
2020-10-13,3460,137,167,304,石榴,招呼
2020-10-14,3460,130,149,279,石榴,招呼
2020-10-15,3460,118,140,258,石榴,招呼
2020-10-16,3460,162,247,409,石榴,招呼
2020-10-17,3460,185,243,428,石榴,招呼
2020-10-18,3460,263,251,514,石榴,招呼
2020-10-19,3460,161,160,321,石榴,招呼
2020-10-20,3460,127,141,268,石榴,招呼
2020-10-21,3460,123,147,270,石榴,招呼
2020-10-22,3460,115,139,254,石榴,招呼
2020-10-23,3460,164,221,385,石榴,招呼
2020-10-24,3460,173,233,406,石榴,招呼
2020-10-25,3460,284,275,559,石榴,招呼
2020-10-26,3460,163,169,332,石榴,招呼
2020-10-27,3460,111,174,285,石榴,招呼
2020-10-28,3460,133,150,283,石榴,招呼
2020-10-29,3460,133,155,288,石榴,招呼
2020-10-30,3460,138,215,353,石榴,招呼
2020-10-31,3460,151,217,368,石榴,招呼
2020-11-01,3460,259,253,512,石榴,招呼
2020-11-02,3460,167,175,342,石榴,招呼
2020-11-03,3460,135,149,284,石榴,招呼
2020-11-04,3460,122,135,257,石榴,招呼
2020-11-05,3460,131,153,284,石榴,招呼
2020-11-06,3460,197,250,447,石榴,招呼
2020-11-07,3460,211,251,462,石榴,招呼
2020-11-08,3460,226,316,542,石榴,招呼
2020-11-09,3460,129,138,267,石榴,招呼
2020-11-10,3460,132,155,287,石榴,招呼
2020-11-11,3460,124,148,272,石榴,招呼
2020-11-12,3460,143,159,302,石榴,招呼
2020-11-13,3460,147,248,395,石榴,招呼
2020-11-14,3460,190,255,445,石榴,招呼
2020-11-15,3460,331,295,626,石榴,招呼
2020-11-16,3460,174,170,344,石榴,招呼
2020-11-17,3460,128,148,276,石榴,招呼
2020-11-18,3460,114,130,244,石榴,招呼
2020-11-19,3460,140,160,300,石榴,招呼
2020-11-20,3460,163,231,394,石榴,招呼
2020-11-21,3460,210,272,482,石榴,招呼
2020-11-22,3460,326,304,630,石榴,招呼
2020-11-23,3460,160,168,328,石榴,招呼
2020-11-24,3460,98,147,245,石榴,招呼
2020-11-25,3460,122,170,292,石榴,招呼
2020-11-26,3460,167,182,349,石榴,招呼
2020-11-27,3460,145,224,369,石榴,招呼
2020-11-28,3460,172,211,383,石榴,招呼
2020-11-29,3460,275,265,540,石榴,招呼
2020-11-30,3460,178,175,353,石榴,招呼
2020-12-01,3460,133,139,272,石榴,招呼
2020-12-02,3460,124,134,258,石榴,招呼
2020-12-03,3460,144,154,298,石榴,招呼
2020-12-04,3460,169,239,408,石榴,招呼
2020-12-05,3460,159,194,353,石榴,招呼
2020-12-06,3460,271,229,500,石榴,招呼
2020-12-07,3460,157,176,333,石榴,招呼
2020-12-08,3460,151,170,321,石榴,招呼
2020-12-09,3460,118,134,252,石榴,招呼
2020-12-10,3460,125,164,289,石榴,招呼
2020-12-11,3460,144,232,376,石榴,招呼
2020-12-12,3460,186,220,406,石榴,招呼
2020-12-13,3460,264,304,568,石榴,招呼
2020-12-14,3460,174,184,358,石榴,招呼
2020-12-15,3460,119,145,264,石榴,招呼
2020-12-16,3460,144,149,293,石榴,招呼
2020-12-17,3460,152,162,314,石榴,招呼
2020-12-18,3460,167,228,395,石榴,招呼
2020-12-19,3460,181,256,437,石榴,招呼
2020-12-20,3460,273,257,530,石榴,招呼
2020-12-21,3460,151,144,295,石榴,招呼
2020-12-22,3460,122,148,270,石榴,招呼
2020-12-23,3460,116,135,251,石榴,招呼
2020-12-24,3460,129,152,281,石榴,招呼
2020-12-25,3460,180,220,400,石榴,招呼
2020-12-26,3460,185,244,429,石榴,招呼
2020-12-27,3460,222,237,459,石榴,招呼
2020-12-28,3460,163,167,330,石榴,招呼
2020-12-29,3460,136,159,295,石榴,招呼
2020-12-30,3460,141,162,303,石榴,招呼
2020-12-31,3460,183,259,442,石榴,招呼
2020-01-01,3470,6556,7369,13925,斗六,一等
2020-01-02,3470,4822,5117,9939,斗六,一等
2020-01-03,3470,6743,6490,13233,斗六,一等
2020-01-04,3470,5684,6071,11755,斗六,一等
2020-01-05,3470,7433,7080,14513,斗六,一等
2020-01-06,3470,5200,5364,10564,斗六,一等
2020-01-07,3470,4583,4532,9115,斗六,一等
2020-01-08,3470,4746,4876,9622,斗六,一等
2020-01-09,3470,5281,5426,10707,斗六,一等
2020-01-10,3470,9251,9708,18959,斗六,一等
2020-01-11,3470,8477,8655,17132,斗六,一等
2020-01-12,3470,9881,8439,18320,斗六,一等
2020-01-13,3470,6192,6127,12319,斗六,一等
2020-01-14,3470,5115,5151,10266,斗六,一等
2020-01-15,3470,5159,5023,10182,斗六,一等
2020-01-16,3470,5764,5824,11588,斗六,一等
2020-01-17,3470,6559,6652,13211,斗六,一等
2020-01-18,3470,6520,6441,12961,斗六,一等
2020-01-19,3470,6731,6595,13326,斗六,一等
2020-01-20,3470,5815,6098,11913,斗六,一等
2020-01-21,3470,5976,6566,12542,斗六,一等
2020-01-22,3470,6712,7952,14664,斗六,一等
2020-01-23,3470,6362,8489,14851,斗六,一等
2020-01-24,3470,5202,6935,12137,斗六,一等
2020-01-25,3470,7213,7085,14298,斗六,一等
2020-01-26,3470,7529,7194,14723,斗六,一等
2020-01-27,3470,8990,7798,16788,斗六,一等
2020-01-28,3470,8177,6951,15128,斗六,一等
2020-01-29,3470,7379,5959,13338,斗六,一等
2020-01-30,3470,5676,5054,10730,斗六,一等
2020-01-31,3470,5715,5664,11379,斗六,一等
2020-02-01,3470,5054,5049,10103,斗六,一等
2020-02-02,3470,5614,5252,10866,斗六,一等
2020-02-03,3470,5072,4934,10006,斗六,一等
2020-02-04,3470,4582,4499,9081,斗六,一等
2020-02-05,3470,4779,4887,9666,斗六,一等
2020-02-06,3470,4673,4793,9466,斗六,一等
2020-02-07,3470,5848,6159,12007,斗六,一等
2020-02-08,3470,5257,5327,10584,斗六,一等
2020-02-09,3470,6445,6037,12482,斗六,一等
2020-02-10,3470,5110,5198,10308,斗六,一等
2020-02-11,3470,4571,4749,9320,斗六,一等
2020-02-12,3470,4816,4855,9671,斗六,一等
2020-02-13,3470,4614,4528,9142,斗六,一等
2020-02-14,3470,5442,5625,11067,斗六,一等
2020-02-15,3470,5420,5627,11047,斗六,一等
2020-02-16,3470,5903,5993,11896,斗六,一等
2020-02-17,3470,4676,4723,9399,斗六,一等
2020-02-18,3470,4275,4260,8535,斗六,一等
2020-02-19,3470,4468,4538,9006,斗六,一等
2020-02-20,3470,4612,4622,9234,斗六,一等
2020-02-21,3470,5517,5859,11376,斗六,一等
2020-02-22,3470,5091,5348,10439,斗六,一等
2020-02-23,3470,6004,5488,11492,斗六,一等
2020-02-24,3470,4947,4937,9884,斗六,一等
2020-02-25,3470,4126,4213,8339,斗六,一等
2020-02-26,3470,4507,4343,8850,斗六,一等
2020-02-27,3470,6103,6796,12899,斗六,一等
2020-02-28,3470,5705,6316,12021,斗六,一等
2020-02-29,3470,5114,5231,10345,斗六,一等
2020-03-01,3470,7632,6837,14469,斗六,一等
2020-03-02,3470,4464,4417,8881,斗六,一等
2020-03-03,3470,3878,3725,7603,斗六,一等
2020-03-04,3470,3748,3748,7496,斗六,一等
2020-03-05,3470,3773,3862,7635,斗六,一等
2020-03-06,3470,6539,6785,13324,斗六,一等
2020-03-07,3470,5384,5743,11127,斗六,一等
2020-03-08,3470,7355,6655,14010,斗六,一等
2020-03-09,3470,4582,4592,9174,斗六,一等
2020-03-10,3470,3770,3697,7467,斗六,一等
2020-03-11,3470,3996,4079,8075,斗六,一等
2020-03-12,3470,4239,4281,8520,斗六,一等
2020-03-13,3470,6937,7265,14202,斗六,一等
2020-03-14,3470,4731,4933,9664,斗六,一等
2020-03-15,3470,7513,7190,14703,斗六,一等
2020-03-16,3470,4656,4754,9410,斗六,一等
2020-03-17,3470,3955,3883,7838,斗六,一等
2020-03-18,3470,3727,3793,7520,斗六,一等
2020-03-19,3470,3776,3864,7640,斗六,一等
2020-03-20,3470,6112,6749,12861,斗六,一等
2020-03-21,3470,4359,4635,8994,斗六,一等
2020-03-22,3470,6264,5550,11814,斗六,一等
2020-03-23,3470,4079,4170,8249,斗六,一等
2020-03-24,3470,3496,3506,7002,斗六,一等
2020-03-25,3470,3482,3559,7041,斗六,一等
2020-03-26,3470,3811,3732,7543,斗六,一等
2020-03-27,3470,5497,5913,11410,斗六,一等
2020-03-28,3470,4014,4254,8268,斗六,一等
2020-03-29,3470,5279,4577,9856,斗六,一等
2020-03-30,3470,4956,3894,8850,斗六,一等
2020-03-31,3470,4683,4000,8683,斗六,一等
2020-04-01,3470,5381,6903,12284,斗六,一等
2020-04-02,3470,4021,5560,9581,斗六,一等
2020-04-03,3470,3943,4533,8476,斗六,一等
2020-04-04,3470,3846,3548,7394,斗六,一等
2020-04-05,3470,7107,6061,13168,斗六,一等
2020-04-06,3470,4723,4271,8994,斗六,一等
2020-04-07,3470,3402,3257,6659,斗六,一等
2020-04-08,3470,3356,3348,6704,斗六,一等
2020-04-09,3470,3412,3378,6790,斗六,一等
2020-04-10,3470,5182,5287,10469,斗六,一等
2020-04-11,3470,3740,3878,7618,斗六,一等
2020-04-12,3470,5176,4808,9984,斗六,一等
2020-04-13,3470,3805,3765,7570,斗六,一等
2020-04-14,3470,3219,3247,6466,斗六,一等
2020-04-15,3470,3409,3464,6873,斗六,一等
2020-04-16,3470,3631,3709,7340,斗六,一等
2020-04-17,3470,5866,5975,11841,斗六,一等
2020-04-18,3470,4127,4252,8379,斗六,一等
2020-04-19,3470,5664,5426,11090,斗六,一等
2020-04-20,3470,4028,4146,8174,斗六,一等
2020-04-21,3470,3280,3263,6543,斗六,一等
2020-04-22,3470,3083,3094,6177,斗六,一等
2020-04-23,3470,3247,3258,6505,斗六,一等
2020-04-24,3470,5036,5334,10370,斗六,一等
2020-04-25,3470,3333,3485,6818,斗六,一等
2020-04-26,3470,4686,4186,8872,斗六,一等
2020-04-27,3470,3675,3647,7322,斗六,一等
2020-04-28,3470,3234,3149,6383,斗六,一等
2020-04-29,3470,3211,3401,6612,斗六,一等
2020-04-30,3470,3951,4407,8358,斗六,一等
2020-05-01,3470,5732,6308,12040,斗六,一等
2020-05-02,3470,3938,4061,7999,斗六,一等
2020-05-03,3470,6264,5292,11556,斗六,一等
2020-05-04,3470,4188,4089,8277,斗六,一等
2020-05-05,3470,3531,3436,6967,斗六,一等
2020-05-06,3470,3575,3642,7217,斗六,一等
2020-05-07,3470,3869,4016,7885,斗六,一等
2020-05-08,3470,7583,7869,15452,斗六,一等
2020-05-09,3470,5023,5552,10575,斗六,一等
2020-05-10,3470,7530,7032,14562,斗六,一等
2020-05-11,3470,4984,4791,9775,斗六,一等
2020-05-12,3470,3669,3573,7242,斗六,一等
2020-05-13,3470,3688,3715,7403,斗六,一等
2020-05-14,3470,3888,3836,7724,斗六,一等
2020-05-15,3470,6148,6446,12594,斗六,一等
2020-05-16,3470,4550,4733,9283,斗六,一等
2020-05-17,3470,6441,5891,12332,斗六,一等
2020-05-18,3470,4367,4408,8775,斗六,一等
2020-05-19,3470,3256,3213,6469,斗六,一等
2020-05-20,3470,3540,3560,7100,斗六,一等
2020-05-21,3470,3678,3758,7436,斗六,一等
2020-05-22,3470,5821,6054,11875,斗六,一等
2020-05-23,3470,4530,4523,9053,斗六,一等
2020-05-24,3470,6837,6513,13350,斗六,一等
2020-05-25,3470,4473,4560,9033,斗六,一等
2020-05-26,3470,3544,3538,7082,斗六,一等
2020-05-27,3470,3408,3413,6821,斗六,一等
2020-05-28,3470,3697,3676,7373,斗六,一等
2020-05-29,3470,6426,6744,13170,斗六,一等
2020-05-30,3470,5263,5478,10741,斗六,一等
2020-05-31,3470,7281,6811,14092,斗六,一等
2020-06-01,3470,4469,4635,9104,斗六,一等
2020-06-02,3470,3749,3680,7429,斗六,一等
2020-06-03,3470,3890,3882,7772,斗六,一等
2020-06-04,3470,3946,3959,7905,斗六,一等
2020-06-05,3470,6836,7074,13910,斗六,一等
2020-06-06,3470,5833,6118,11951,斗六,一等
2020-06-07,3470,7392,7071,14463,斗六,一等
2020-06-08,3470,4567,4655,9222,斗六,一等
2020-06-09,3470,3945,3870,7815,斗六,一等
2020-06-10,3470,4162,4236,8398,斗六,一等
2020-06-11,3470,4452,4479,8931,斗六,一等
2020-06-12,3470,6838,6769,13607,斗六,一等
2020-06-13,3470,6352,6373,12725,斗六,一等
2020-06-14,3470,7818,7576,15394,斗六,一等
2020-06-15,3470,5067,5226,10293,斗六,一等
2020-06-16,3470,4391,4281,8672,斗六,一等
2020-06-17,3470,4755,4599,9354,斗六,一等
2020-06-18,3470,4374,4317,8691,斗六,一等
2020-06-19,3470,5080,5412,10492,斗六,一等
2020-06-20,3470,5960,5907,11867,斗六,一等
2020-06-21,3470,6623,6481,13104,斗六,一等
2020-06-22,3470,4735,4873,9608,斗六,一等
2020-06-23,3470,4680,4992,9672,斗六,一等
2020-06-24,3470,7664,8316,15980,斗六,一等
2020-06-25,3470,6378,7544,13922,斗六,一等
2020-06-26,3470,6870,7000,13870,斗六,一等
2020-06-27,3470,6990,6501,13491,斗六,一等
2020-06-28,3470,9332,8131,17463,斗六,一等
2020-06-29,3470,5766,5557,11323,斗六,一等
2020-06-30,3470,4811,4622,9433,斗六,一等
2020-07-01,3470,4496,4563,9059,斗六,一等
2020-07-02,3470,4360,4374,8734,斗六,一等
2020-07-03,3470,6158,6190,12348,斗六,一等
2020-07-04,3470,5828,5721,11549,斗六,一等
2020-07-05,3470,6511,6232,12743,斗六,一等
2020-07-06,3470,5393,5302,10695,斗六,一等
2020-07-07,3470,5215,5294,10509,斗六,一等
2020-07-08,3470,5319,5323,10642,斗六,一等
2020-07-09,3470,5421,5177,10598,斗六,一等
2020-07-10,3470,6525,6847,13372,斗六,一等
2020-07-11,3470,6564,6670,13234,斗六,一等
2020-07-12,3470,7617,7147,14764,斗六,一等
2020-07-13,3470,5661,6087,11748,斗六,一等
2020-07-14,3470,5535,5529,11064,斗六,一等
2020-07-15,3470,5852,5850,11702,斗六,一等
2020-07-16,3470,5678,5639,11317,斗六,一等
2020-07-17,3470,7309,7457,14766,斗六,一等
2020-07-18,3470,6753,6806,13559,斗六,一等
2020-07-19,3470,7683,7365,15048,斗六,一等
2020-07-20,3470,5835,5933,11768,斗六,一等
2020-07-21,3470,5403,5470,10873,斗六,一等
2020-07-22,3470,5558,5586,11144,斗六,一等
2020-07-23,3470,5528,5587,11115,斗六,一等
2020-07-24,3470,6917,6917,13834,斗六,一等
2020-07-25,3470,6515,6866,13381,斗六,一等
2020-07-26,3470,7341,6869,14210,斗六,一等
2020-07-27,3470,5417,5623,11040,斗六,一等
2020-07-28,3470,4988,5083,10071,斗六,一等
2020-07-29,3470,5178,5108,10286,斗六,一等
2020-07-30,3470,5219,5164,10383,斗六,一等
2020-07-31,3470,6559,6840,13399,斗六,一等
2020-08-01,3470,6043,6464,12507,斗六,一等
2020-08-02,3470,7044,6589,13633,斗六,一等
2020-08-03,3470,4747,4916,9663,斗六,一等
2020-08-04,3470,4437,4363,8800,斗六,一等
2020-08-05,3470,4834,4902,9736,斗六,一等
2020-08-06,3470,5013,5094,10107,斗六,一等
2020-08-07,3470,6975,7475,14450,斗六,一等
2020-08-08,3470,5951,6539,12490,斗六,一等
2020-08-09,3470,8162,7228,15390,斗六,一等
2020-08-10,3470,5702,5726,11428,斗六,一等
2020-08-11,3470,4699,4601,9300,斗六,一等
2020-08-12,3470,5036,4936,9972,斗六,一等
2020-08-13,3470,5222,5234,10456,斗六,一等
2020-08-14,3470,7104,7155,14259,斗六,一等
2020-08-15,3470,6664,6709,13373,斗六,一等
2020-08-16,3470,7936,7843,15779,斗六,一等
2020-08-17,3470,6004,5943,11947,斗六,一等
2020-08-18,3470,5262,5353,10615,斗六,一等
2020-08-19,3470,5141,5135,10276,斗六,一等
2020-08-20,3470,5379,5483,10862,斗六,一等
2020-08-21,3470,7175,7029,14204,斗六,一等
2020-08-22,3470,6703,6674,13377,斗六,一等
2020-08-23,3470,7068,6896,13964,斗六,一等
2020-08-24,3470,6091,6311,12402,斗六,一等
2020-08-25,3470,5758,5688,11446,斗六,一等
2020-08-26,3470,5254,5343,10597,斗六,一等
2020-08-27,3470,4982,5256,10238,斗六,一等
2020-08-28,3470,6271,6569,12840,斗六,一等
2020-08-29,3470,5905,5983,11888,斗六,一等
2020-08-30,3470,6830,6255,13085,斗六,一等
2020-08-31,3470,5125,5250,10375,斗六,一等
2020-09-01,3470,4447,4561,9008,斗六,一等
2020-09-02,3470,4439,4453,8892,斗六,一等
2020-09-03,3470,4697,4609,9306,斗六,一等
2020-09-04,3470,6101,6391,12492,斗六,一等
2020-09-05,3470,5853,6022,11875,斗六,一等
2020-09-06,3470,7082,6644,13726,斗六,一等
2020-09-07,3470,5093,5308,10401,斗六,一等
2020-09-08,3470,4621,4504,9125,斗六,一等
2020-09-09,3470,5494,4662,10156,斗六,一等
2020-09-10,3470,5008,5038,10046,斗六,一等
2020-09-11,3470,6423,7243,13666,斗六,一等
2020-09-12,3470,6237,6569,12806,斗六,一等
2020-09-13,3470,8417,8368,16785,斗六,一等
2020-09-14,3470,4777,4770,9547,斗六,一等
2020-09-15,3470,4072,4008,8080,斗六,一等
2020-09-16,3470,4093,4109,8202,斗六,一等
2020-09-17,3470,4325,4272,8597,斗六,一等
2020-09-18,3470,7616,7795,15411,斗六,一等
2020-09-19,3470,6422,6552,12974,斗六,一等
2020-09-20,3470,8525,8204,16729,斗六,一等
2020-09-21,3470,4985,5020,10005,斗六,一等
2020-09-22,3470,4385,4357,8742,斗六,一等
2020-09-23,3470,4171,4278,8449,斗六,一等
2020-09-24,3470,4370,4404,8774,斗六,一等
2020-09-25,3470,5378,5638,11016,斗六,一等
2020-09-26,3470,5681,5485,11166,斗六,一等
2020-09-27,3470,6982,6723,13705,斗六,一等
2020-09-28,3470,4706,4929,9635,斗六,一等
2020-09-29,3470,4465,4627,9092,斗六,一等
2020-09-30,3470,8567,9527,18094,斗六,一等
2020-10-01,3470,7512,8754,16266,斗六,一等
2020-10-02,3470,7012,7001,14013,斗六,一等
2020-10-03,3470,7559,6884,14443,斗六,一等
2020-10-04,3470,10743,9527,20270,斗六,一等
2020-10-05,3470,5655,5481,11136,斗六,一等
2020-10-06,3470,4304,4276,8580,斗六,一等
2020-10-07,3470,4444,4454,8898,斗六,一等
2020-10-08,3470,7573,7734,15307,斗六,一等
2020-10-09,3470,7462,7747,15209,斗六,一等
2020-10-10,3470,6632,6380,13012,斗六,一等
2020-10-11,3470,9397,8991,18388,斗六,一等
2020-10-12,3470,5186,5226,10412,斗六,一等
2020-10-13,3470,4374,4315,8689,斗六,一等
2020-10-14,3470,4252,4322,8574,斗六,一等
2020-10-15,3470,4438,4390,8828,斗六,一等
2020-10-16,3470,6894,7277,14171,斗六,一等
2020-10-17,3470,6834,6711,13545,斗六,一等
2020-10-18,3470,8973,8501,17474,斗六,一等
2020-10-19,3470,5075,5148,10223,斗六,一等
2020-10-20,3470,4578,4521,9099,斗六,一等
2020-10-21,3470,4446,4564,9010,斗六,一等
2020-10-22,3470,4398,4556,8954,斗六,一等
2020-10-23,3470,7388,7642,15030,斗六,一等
2020-10-24,3470,6521,6896,13417,斗六,一等
2020-10-25,3470,8176,7734,15910,斗六,一等
2020-10-26,3470,5071,4957,10028,斗六,一等
2020-10-27,3470,4326,4275,8601,斗六,一等
2020-10-28,3470,4193,4239,8432,斗六,一等
2020-10-29,3470,4415,4352,8767,斗六,一等
2020-10-30,3470,7482,7334,14816,斗六,一等
2020-10-31,3470,6322,6536,12858,斗六,一等
2020-11-01,3470,7826,7904,15730,斗六,一等
2020-11-02,3470,4792,4942,9734,斗六,一等
2020-11-03,3470,3951,4007,7958,斗六,一等
2020-11-04,3470,4274,4189,8463,斗六,一等
2020-11-05,3470,4519,4466,8985,斗六,一等
2020-11-06,3470,7426,7545,14971,斗六,一等
2020-11-07,3470,6149,6597,12746,斗六,一等
2020-11-08,3470,8265,7957,16222,斗六,一等
2020-11-09,3470,4822,4974,9796,斗六,一等
2020-11-10,3470,4249,4278,8527,斗六,一等
2020-11-11,3470,4348,4370,8718,斗六,一等
2020-11-12,3470,4553,4708,9261,斗六,一等
2020-11-13,3470,7848,8224,16072,斗六,一等
2020-11-14,3470,6737,6816,13553,斗六,一等
2020-11-15,3470,9335,8996,18331,斗六,一等
2020-11-16,3470,5218,5333,10551,斗六,一等
2020-11-17,3470,4488,4636,9124,斗六,一等
2020-11-18,3470,4437,4394,8831,斗六,一等
2020-11-19,3470,4743,4752,9495,斗六,一等
2020-11-20,3470,7818,7995,15813,斗六,一等
2020-11-21,3470,6945,7042,13987,斗六,一等
2020-11-22,3470,8530,8150,16680,斗六,一等
2020-11-23,3470,5292,5333,10625,斗六,一等
2020-11-24,3470,4383,4314,8697,斗六,一等
2020-11-25,3470,4395,4548,8943,斗六,一等
2020-11-26,3470,4664,4654,9318,斗六,一等
2020-11-27,3470,7012,7855,14867,斗六,一等
2020-11-28,3470,7323,7501,14824,斗六,一等
2020-11-29,3470,8576,7661,16237,斗六,一等
2020-11-30,3470,5007,5113,10120,斗六,一等
2020-12-01,3470,4168,4176,8344,斗六,一等
2020-12-02,3470,4297,4381,8678,斗六,一等
2020-12-03,3470,4445,4481,8926,斗六,一等
2020-12-04,3470,8023,7795,15818,斗六,一等
2020-12-05,3470,6646,6827,13473,斗六,一等
2020-12-06,3470,8804,8666,17470,斗六,一等
2020-12-07,3470,5160,5329,10489,斗六,一等
2020-12-08,3470,4370,4432,8802,斗六,一等
2020-12-09,3470,4150,4095,8245,斗六,一等
2020-12-10,3470,4526,4485,9011,斗六,一等
2020-12-11,3470,7796,7900,15696,斗六,一等
2020-12-12,3470,7038,6807,13845,斗六,一等
2020-12-13,3470,8719,8663,17382,斗六,一等
2020-12-14,3470,5190,5256,10446,斗六,一等
2020-12-15,3470,4401,4474,8875,斗六,一等
2020-12-16,3470,4403,4413,8816,斗六,一等
2020-12-17,3470,4737,4891,9628,斗六,一等
2020-12-18,3470,7862,7921,15783,斗六,一等
2020-12-19,3470,7470,7421,14891,斗六,一等
2020-12-20,3470,8158,8218,16376,斗六,一等
2020-12-21,3470,4965,5110,10075,斗六,一等
2020-12-22,3470,4374,4411,8785,斗六,一等
2020-12-23,3470,4120,4096,8216,斗六,一等
2020-12-24,3470,4786,4777,9563,斗六,一等
2020-12-25,3470,7731,7454,15185,斗六,一等
2020-12-26,3470,5924,6414,12338,斗六,一等
2020-12-27,3470,7966,7642,15608,斗六,一等
2020-12-28,3470,5014,5136,10150,斗六,一等
2020-12-29,3470,4249,4307,8556,斗六,一等
2020-12-30,3470,4710,4750,9460,斗六,一等
2020-12-31,3470,8993,8222,17215,斗六,一等
2020-01-01,3480,2168,2285,4453,斗南,二等
2020-01-02,3480,1677,1655,3332,斗南,二等
2020-01-03,3480,2164,2552,4716,斗南,二等
2020-01-04,3480,1941,2161,4102,斗南,二等
2020-01-05,3480,2939,2156,5095,斗南,二等
2020-01-06,3480,1869,1818,3687,斗南,二等
2020-01-07,3480,1496,1531,3027,斗南,二等
2020-01-08,3480,1636,1647,3283,斗南,二等
2020-01-09,3480,1654,1812,3466,斗南,二等
2020-01-10,3480,2673,3933,6606,斗南,二等
2020-01-11,3480,2954,3126,6080,斗南,二等
2020-01-12,3480,3506,2459,5965,斗南,二等
2020-01-13,3480,2156,1973,4129,斗南,二等
2020-01-14,3480,1784,1743,3527,斗南,二等
2020-01-15,3480,1773,1745,3518,斗南,二等
2020-01-16,3480,2048,2071,4119,斗南,二等
2020-01-17,3480,2429,2575,5004,斗南,二等
2020-01-18,3480,2071,2234,4305,斗南,二等
2020-01-19,3480,2308,2086,4394,斗南,二等
2020-01-20,3480,2009,2099,4108,斗南,二等
2020-01-21,3480,1851,2081,3932,斗南,二等
2020-01-22,3480,2142,2935,5077,斗南,二等
2020-01-23,3480,1964,3297,5261,斗南,二等
2020-01-24,3480,1525,2661,4186,斗南,二等
2020-01-25,3480,2490,2265,4755,斗南,二等
2020-01-26,3480,2742,2467,5209,斗南,二等
2020-01-27,3480,3440,2752,6192,斗南,二等
2020-01-28,3480,3098,2242,5340,斗南,二等
2020-01-29,3480,2747,1848,4595,斗南,二等
2020-01-30,3480,1998,1625,3623,斗南,二等
2020-01-31,3480,1950,1913,3863,斗南,二等
2020-02-01,3480,1600,1629,3229,斗南,二等
2020-02-02,3480,1974,1642,3616,斗南,二等
2020-02-03,3480,1845,1716,3561,斗南,二等
2020-02-04,3480,1578,1519,3097,斗南,二等
2020-02-05,3480,1591,1592,3183,斗南,二等
2020-02-06,3480,1694,1655,3349,斗南,二等
2020-02-07,3480,1943,2204,4147,斗南,二等
2020-02-08,3480,1629,1823,3452,斗南,二等
2020-02-09,3480,2213,1854,4067,斗南,二等
2020-02-10,3480,1730,1620,3350,斗南,二等
2020-02-11,3480,1539,1485,3024,斗南,二等
2020-02-12,3480,1534,1515,3049,斗南,二等
2020-02-13,3480,1517,1479,2996,斗南,二等
2020-02-14,3480,1835,1964,3799,斗南,二等
2020-02-15,3480,1784,1907,3691,斗南,二等
2020-02-16,3480,2068,1891,3959,斗南,二等
2020-02-17,3480,1636,1616,3252,斗南,二等
2020-02-18,3480,1436,1356,2792,斗南,二等
2020-02-19,3480,1432,1368,2800,斗南,二等
2020-02-20,3480,1476,1520,2996,斗南,二等
2020-02-21,3480,1768,2009,3777,斗南,二等
2020-02-22,3480,1757,1836,3593,斗南,二等
2020-02-23,3480,2103,1721,3824,斗南,二等
2020-02-24,3480,1811,1563,3374,斗南,二等
2020-02-25,3480,1519,1488,3007,斗南,二等
2020-02-26,3480,1407,1484,2891,斗南,二等
2020-02-27,3480,1947,2553,4500,斗南,二等
2020-02-28,3480,1815,2277,4092,斗南,二等
2020-02-29,3480,1737,1713,3450,斗南,二等
2020-03-01,3480,3007,1888,4895,斗南,二等
2020-03-02,3480,1619,1448,3067,斗南,二等
2020-03-03,3480,1334,1356,2690,斗南,二等
2020-03-04,3480,1319,1307,2626,斗南,二等
2020-03-05,3480,1323,1348,2671,斗南,二等
2020-03-06,3480,2164,2823,4987,斗南,二等
2020-03-07,3480,1686,1894,3580,斗南,二等
2020-03-08,3480,2769,1982,4751,斗南,二等
2020-03-09,3480,1695,1506,3201,斗南,二等
2020-03-10,3480,1374,1354,2728,斗南,二等
2020-03-11,3480,1496,1443,2939,斗南,二等
2020-03-12,3480,1479,1568,3047,斗南,二等
2020-03-13,3480,2355,2988,5343,斗南,二等
2020-03-14,3480,1636,1831,3467,斗南,二等
2020-03-15,3480,3078,2210,5288,斗南,二等
2020-03-16,3480,1669,1606,3275,斗南,二等
2020-03-17,3480,1405,1395,2800,斗南,二等
2020-03-18,3480,1369,1358,2727,斗南,二等
2020-03-19,3480,1337,1438,2775,斗南,二等
2020-03-20,3480,2185,2722,4907,斗南,二等
2020-03-21,3480,1449,1688,3137,斗南,二等
2020-03-22,3480,2562,1711,4273,斗南,二等
2020-03-23,3480,1525,1369,2894,斗南,二等
2020-03-24,3480,1239,1244,2483,斗南,二等
2020-03-25,3480,1248,1242,2490,斗南,二等
2020-03-26,3480,1278,1355,2633,斗南,二等
2020-03-27,3480,1855,2367,4222,斗南,二等
2020-03-28,3480,1254,1500,2754,斗南,二等
2020-03-29,3480,2100,1409,3509,斗南,二等
2020-03-30,3480,1441,1397,2838,斗南,二等
2020-03-31,3480,1601,1455,3056,斗南,二等
2020-04-01,3480,1903,2804,4707,斗南,二等
2020-04-02,3480,1320,2258,3578,斗南,二等
2020-04-03,3480,1366,1694,3060,斗南,二等
2020-04-04,3480,1426,1215,2641,斗南,二等
2020-04-05,3480,3204,1709,4913,斗南,二等
2020-04-06,3480,1690,1357,3047,斗南,二等
2020-04-07,3480,1258,1177,2435,斗南,二等
2020-04-08,3480,1170,1173,2343,斗南,二等
2020-04-09,3480,1144,1198,2342,斗南,二等
2020-04-10,3480,1820,2191,4011,斗南,二等
2020-04-11,3480,1222,1371,2593,斗南,二等
2020-04-12,3480,2085,1442,3527,斗南,二等
2020-04-13,3480,1471,1373,2844,斗南,二等
2020-04-14,3480,1233,1217,2450,斗南,二等
2020-04-15,3480,1233,1245,2478,斗南,二等
2020-04-16,3480,1213,1329,2542,斗南,二等
2020-04-17,3480,2018,2515,4533,斗南,二等
2020-04-18,3480,1415,1562,2977,斗南,二等
2020-04-19,3480,2313,1576,3889,斗南,二等
2020-04-20,3480,1498,1391,2889,斗南,二等
2020-04-21,3480,1187,1210,2397,斗南,二等
2020-04-22,3480,1150,1145,2295,斗南,二等
2020-04-23,3480,1095,1214,2309,斗南,二等
2020-04-24,3480,1556,2285,3841,斗南,二等
2020-04-25,3480,1120,1262,2382,斗南,二等
2020-04-26,3480,1947,1129,3076,斗南,二等
2020-04-27,3480,1367,1320,2687,斗南,二等
2020-04-28,3480,1164,1196,2360,斗南,二等
2020-04-29,3480,1222,1266,2488,斗南,二等
2020-04-30,3480,1313,1591,2904,斗南,二等
2020-05-01,3480,2035,2711,4746,斗南,二等
2020-05-02,3480,1351,1493,2844,斗南,二等
2020-05-03,3480,2659,1699,4358,斗南,二等
2020-05-04,3480,1647,1492,3139,斗南,二等
2020-05-05,3480,1198,1229,2427,斗南,二等
2020-05-06,3480,1211,1305,2516,斗南,二等
2020-05-07,3480,1277,1407,2684,斗南,二等
2020-05-08,3480,2423,3236,5659,斗南,二等
2020-05-09,3480,1576,2085,3661,斗南,二等
2020-05-10,3480,3221,1951,5172,斗南,二等
2020-05-11,3480,1808,1596,3404,斗南,二等
2020-05-12,3480,1287,1299,2586,斗南,二等
2020-05-13,3480,1257,1300,2557,斗南,二等
2020-05-14,3480,1364,1446,2810,斗南,二等
2020-05-15,3480,2122,2605,4727,斗南,二等
2020-05-16,3480,1573,1668,3241,斗南,二等
2020-05-17,3480,2570,1805,4375,斗南,二等
2020-05-18,3480,1615,1465,3080,斗南,二等
2020-05-19,3480,1165,1111,2276,斗南,二等
2020-05-20,3480,1241,1284,2525,斗南,二等
2020-05-21,3480,1233,1311,2544,斗南,二等
2020-05-22,3480,1967,2385,4352,斗南,二等
2020-05-23,3480,1441,1647,3088,斗南,二等
2020-05-24,3480,2614,1882,4496,斗南,二等
2020-05-25,3480,1582,1483,3065,斗南,二等
2020-05-26,3480,1266,1301,2567,斗南,二等
2020-05-27,3480,1139,1201,2340,斗南,二等
2020-05-28,3480,1162,1299,2461,斗南,二等
2020-05-29,3480,2076,2799,4875,斗南,二等
2020-05-30,3480,1740,1870,3610,斗南,二等
2020-05-31,3480,2936,2053,4989,斗南,二等
2020-06-01,3480,1641,1541,3182,斗南,二等
2020-06-02,3480,1293,1285,2578,斗南,二等
2020-06-03,3480,1304,1339,2643,斗南,二等
2020-06-04,3480,1284,1460,2744,斗南,二等
2020-06-05,3480,2246,2709,4955,斗南,二等
2020-06-06,3480,1934,2063,3997,斗南,二等
2020-06-07,3480,2812,2134,4946,斗南,二等
2020-06-08,3480,1627,1487,3114,斗南,二等
2020-06-09,3480,1341,1362,2703,斗南,二等
2020-06-10,3480,1510,1494,3004,斗南,二等
2020-06-11,3480,1542,1536,3078,斗南,二等
2020-06-12,3480,2182,2673,4855,斗南,二等
2020-06-13,3480,1774,2052,3826,斗南,二等
2020-06-14,3480,2825,2156,4981,斗南,二等
2020-06-15,3480,1744,1602,3346,斗南,二等
2020-06-16,3480,1399,1527,2926,斗南,二等
2020-06-17,3480,1393,1363,2756,斗南,二等
2020-06-18,3480,1498,1561,3059,斗南,二等
2020-06-19,3480,1658,2060,3718,斗南,二等
2020-06-20,3480,2157,2121,4278,斗南,二等
2020-06-21,3480,2339,2038,4377,斗南,二等
2020-06-22,3480,1710,1702,3412,斗南,二等
2020-06-23,3480,1595,1669,3264,斗南,二等
2020-06-24,3480,2318,3207,5525,斗南,二等
2020-06-25,3480,2179,2948,5127,斗南,二等
2020-06-26,3480,2276,2369,4645,斗南,二等
2020-06-27,3480,2459,1971,4430,斗南,二等
2020-06-28,3480,3531,2300,5831,斗南,二等
2020-06-29,3480,2114,1827,3941,斗南,二等
2020-06-30,3480,1639,1562,3201,斗南,二等
2020-07-01,3480,1617,1588,3205,斗南,二等
2020-07-02,3480,1467,1515,2982,斗南,二等
2020-07-03,3480,1927,2221,4148,斗南,二等
2020-07-04,3480,1922,1864,3786,斗南,二等
2020-07-05,3480,2114,1948,4062,斗南,二等
2020-07-06,3480,1819,1761,3580,斗南,二等
2020-07-07,3480,1709,1811,3520,斗南,二等
2020-07-08,3480,1635,1608,3243,斗南,二等
2020-07-09,3480,1757,1736,3493,斗南,二等
2020-07-10,3480,2128,2395,4523,斗南,二等
2020-07-11,3480,2081,2111,4192,斗南,二等
2020-07-12,3480,2691,2218,4909,斗南,二等
2020-07-13,3480,1887,1855,3742,斗南,二等
2020-07-14,3480,1722,1813,3535,斗南,二等
2020-07-15,3480,1771,1548,3319,斗南,二等
2020-07-16,3480,1661,1705,3366,斗南,二等
2020-07-17,3480,2122,2512,4634,斗南,二等
2020-07-18,3480,2038,2185,4223,斗南,二等
2020-07-19,3480,2622,2241,4863,斗南,二等
2020-07-20,3480,1967,1849,3816,斗南,二等
2020-07-21,3480,1685,1649,3334,斗南,二等
2020-07-22,3480,1778,1798,3576,斗南,二等
2020-07-23,3480,1824,1832,3656,斗南,二等
2020-07-24,3480,2100,2430,4530,斗南,二等
2020-07-25,3480,2044,2268,4312,斗南,二等
2020-07-26,3480,2552,2119,4671,斗南,二等
2020-07-27,3480,1872,1704,3576,斗南,二等
2020-07-28,3480,1664,1612,3276,斗南,二等
2020-07-29,3480,1739,1692,3431,斗南,二等
2020-07-30,3480,1681,1749,3430,斗南,二等
2020-07-31,3480,2147,2346,4493,斗南,二等
2020-08-01,3480,1927,2210,4137,斗南,二等
2020-08-02,3480,2524,2039,4563,斗南,二等
2020-08-03,3480,1726,1666,3392,斗南,二等
2020-08-04,3480,1473,1436,2909,斗南,二等
2020-08-05,3480,1742,1716,3458,斗南,二等
2020-08-06,3480,1698,1853,3551,斗南,二等
2020-08-07,3480,2200,2809,5009,斗南,二等
2020-08-08,3480,1957,2280,4237,斗南,二等
2020-08-09,3480,2961,2051,5012,斗南,二等
2020-08-10,3480,1956,1819,3775,斗南,二等
2020-08-11,3480,1624,1590,3214,斗南,二等
2020-08-12,3480,1895,1715,3610,斗南,二等
2020-08-13,3480,1762,1689,3451,斗南,二等
2020-08-14,3480,2382,2646,5028,斗南,二等
2020-08-15,3480,2227,2348,4575,斗南,二等
2020-08-16,3480,2851,2418,5269,斗南,二等
2020-08-17,3480,2019,1946,3965,斗南,二等
2020-08-18,3480,1733,1679,3412,斗南,二等
2020-08-19,3480,1662,1764,3426,斗南,二等
2020-08-20,3480,1741,1831,3572,斗南,二等
2020-08-21,3480,2260,2567,4827,斗南,二等
2020-08-22,3480,2073,2158,4231,斗南,二等
2020-08-23,3480,2566,2207,4773,斗南,二等
2020-08-24,3480,1879,1854,3733,斗南,二等
2020-08-25,3480,1809,1804,3613,斗南,二等
2020-08-26,3480,1714,1689,3403,斗南,二等
2020-08-27,3480,1629,1594,3223,斗南,二等
2020-08-28,3480,2033,2410,4443,斗南,二等
2020-08-29,3480,1920,2034,3954,斗南,二等
2020-08-30,3480,2384,1922,4306,斗南,二等
2020-08-31,3480,1772,1807,3579,斗南,二等
2020-09-01,3480,1515,1642,3157,斗南,二等
2020-09-02,3480,1608,1657,3265,斗南,二等
2020-09-03,3480,1770,1696,3466,斗南,二等
2020-09-04,3480,2135,2441,4576,斗南,二等
2020-09-05,3480,2089,2167,4256,斗南,二等
2020-09-06,3480,2779,2208,4987,斗南,二等
2020-09-07,3480,1813,1794,3607,斗南,二等
2020-09-08,3480,1660,1636,3296,斗南,二等
2020-09-09,3480,2106,1793,3899,斗南,二等
2020-09-10,3480,1818,1876,3694,斗南,二等
2020-09-11,3480,2181,2730,4911,斗南,二等
2020-09-12,3480,2207,2263,4470,斗南,二等
2020-09-13,3480,3184,2536,5720,斗南,二等
2020-09-14,3480,1741,1625,3366,斗南,二等
2020-09-15,3480,1475,1515,2990,斗南,二等
2020-09-16,3480,1497,1503,3000,斗南,二等
2020-09-17,3480,1487,1609,3096,斗南,二等
2020-09-18,3480,2606,3284,5890,斗南,二等
2020-09-19,3480,2112,2358,4470,斗南,二等
2020-09-20,3480,3316,2472,5788,斗南,二等
2020-09-21,3480,1875,1722,3597,斗南,二等
2020-09-22,3480,1470,1448,2918,斗南,二等
2020-09-23,3480,1510,1502,3012,斗南,二等
2020-09-24,3480,1501,1612,3113,斗南,二等
2020-09-25,3480,1716,2017,3733,斗南,二等
2020-09-26,3480,1847,2027,3874,斗南,二等
2020-09-27,3480,2602,2128,4730,斗南,二等
2020-09-28,3480,1683,1720,3403,斗南,二等
2020-09-29,3480,1530,1692,3222,斗南,二等
2020-09-30,3480,2865,4228,7093,斗南,二等
2020-10-01,3480,2523,3624,6147,斗南,二等
2020-10-02,3480,2546,2671,5217,斗南,二等
2020-10-03,3480,2850,2462,5312,斗南,二等
2020-10-04,3480,4461,2787,7248,斗南,二等
2020-10-05,3480,2132,1790,3922,斗南,二等
2020-10-06,3480,1574,1552,3126,斗南,二等
2020-10-07,3480,1595,1579,3174,斗南,二等
2020-10-08,3480,2392,3239,5631,斗南,二等
2020-10-09,3480,2538,2887,5425,斗南,二等
2020-10-10,3480,2303,2170,4473,斗南,二等
2020-10-11,3480,3596,2661,6257,斗南,二等
2020-10-12,3480,1920,1731,3651,斗南,二等
2020-10-13,3480,1553,1551,3104,斗南,二等
2020-10-14,3480,1570,1563,3133,斗南,二等
2020-10-15,3480,1565,1639,3204,斗南,二等
2020-10-16,3480,2514,3034,5548,斗南,二等
2020-10-17,3480,2197,2288,4485,斗南,二等
2020-10-18,3480,3184,2662,5846,斗南,二等
2020-10-19,3480,1863,1763,3626,斗南,二等
2020-10-20,3480,1520,1525,3045,斗南,二等
2020-10-21,3480,1536,1598,3134,斗南,二等
2020-10-22,3480,1510,1655,3165,斗南,二等
2020-10-23,3480,2726,3199,5925,斗南,二等
2020-10-24,3480,2248,2692,4940,斗南,二等
2020-10-25,3480,3417,2561,5978,斗南,二等
2020-10-26,3480,1977,1680,3657,斗南,二等
2020-10-27,3480,1676,1609,3285,斗南,二等
2020-10-28,3480,1534,1536,3070,斗南,二等
2020-10-29,3480,1561,1684,3245,斗南,二等
2020-10-30,3480,2376,3063,5439,斗南,二等
2020-10-31,3480,2187,2284,4471,斗南,二等
2020-11-01,3480,3321,2407,5728,斗南,二等
2020-11-02,3480,1830,1701,3531,斗南,二等
2020-11-03,3480,1508,1570,3078,斗南,二等
2020-11-04,3480,1497,1524,3021,斗南,二等
2020-11-05,3480,1513,1603,3116,斗南,二等
2020-11-06,3480,2398,3057,5455,斗南,二等
2020-11-07,3480,2068,2207,4275,斗南,二等
2020-11-08,3480,3186,2379,5565,斗南,二等
2020-11-09,3480,1750,1698,3448,斗南,二等
2020-11-10,3480,1569,1539,3108,斗南,二等
2020-11-11,3480,1559,1668,3227,斗南,二等
2020-11-12,3480,1602,1743,3345,斗南,二等
2020-11-13,3480,2856,3426,6282,斗南,二等
2020-11-14,3480,2310,2355,4665,斗南,二等
2020-11-15,3480,3519,2723,6242,斗南,二等
2020-11-16,3480,2001,1806,3807,斗南,二等
2020-11-17,3480,1591,1540,3131,斗南,二等
2020-11-18,3480,1613,1610,3223,斗南,二等
2020-11-19,3480,1615,1750,3365,斗南,二等
2020-11-20,3480,2888,3387,6275,斗南,二等
2020-11-21,3480,2400,2496,4896,斗南,二等
2020-11-22,3480,3380,2582,5962,斗南,二等
2020-11-23,3480,1929,1786,3715,斗南,二等
2020-11-24,3480,1540,1492,3032,斗南,二等
2020-11-25,3480,1590,1598,3188,斗南,二等
2020-11-26,3480,1643,1660,3303,斗南,二等
2020-11-27,3480,2233,3385,5618,斗南,二等
2020-11-28,3480,2432,2566,4998,斗南,二等
2020-11-29,3480,3350,2269,5619,斗南,二等
2020-11-30,3480,1961,1731,3692,斗南,二等
2020-12-01,3480,1564,1602,3166,斗南,二等
2020-12-02,3480,1516,1531,3047,斗南,二等
2020-12-03,3480,1526,1632,3158,斗南,二等
2020-12-04,3480,2812,3296,6108,斗南,二等
2020-12-05,3480,2438,2566,5004,斗南,二等
2020-12-06,3480,3478,2685,6163,斗南,二等
2020-12-07,3480,1948,1720,3668,斗南,二等
2020-12-08,3480,1548,1620,3168,斗南,二等
2020-12-09,3480,1480,1476,2956,斗南,二等
2020-12-10,3480,1510,1619,3129,斗南,二等
2020-12-11,3480,2649,3227,5876,斗南,二等
2020-12-12,3480,2219,2473,4692,斗南,二等
2020-12-13,3480,3480,2641,6121,斗南,二等
2020-12-14,3480,1944,1775,3719,斗南,二等
2020-12-15,3480,1579,1551,3130,斗南,二等
2020-12-16,3480,1602,1612,3214,斗南,二等
2020-12-17,3480,1593,1785,3378,斗南,二等
2020-12-18,3480,2550,3280,5830,斗南,二等
2020-12-19,3480,2577,2692,5269,斗南,二等
2020-12-20,3480,3311,2532,5843,斗南,二等
2020-12-21,3480,1884,1679,3563,斗南,二等
2020-12-22,3480,1533,1527,3060,斗南,二等
2020-12-23,3480,1485,1481,2966,斗南,二等
2020-12-24,3480,1717,1786,3503,斗南,二等
2020-12-25,3480,2366,3084,5450,斗南,二等
2020-12-26,3480,2167,2311,4478,斗南,二等
2020-12-27,3480,3173,2433,5606,斗南,二等
2020-12-28,3480,1931,1775,3706,斗南,二等
2020-12-29,3480,1540,1620,3160,斗南,二等
2020-12-30,3480,1641,1743,3384,斗南,二等
2020-12-31,3480,2926,3262,6188,斗南,二等
2020-01-01,3490,212,249,461,石龜,招呼
2020-01-02,3490,130,151,281,石龜,招呼
2020-01-03,3490,153,222,375,石龜,招呼
2020-01-04,3490,144,225,369,石龜,招呼
2020-01-05,3490,221,217,438,石龜,招呼
2020-01-06,3490,173,193,366,石龜,招呼
2020-01-07,3490,129,150,279,石龜,招呼
2020-01-08,3490,137,169,306,石龜,招呼
2020-01-09,3490,116,172,288,石龜,招呼
2020-01-10,3490,163,283,446,石龜,招呼
2020-01-11,3490,208,228,436,石龜,招呼
2020-01-12,3490,217,229,446,石龜,招呼
2020-01-13,3490,135,169,304,石龜,招呼
2020-01-14,3490,127,153,280,石龜,招呼
2020-01-15,3490,141,157,298,石龜,招呼
2020-01-16,3490,151,213,364,石龜,招呼
2020-01-17,3490,137,177,314,石龜,招呼
2020-01-18,3490,149,193,342,石龜,招呼
2020-01-19,3490,152,197,349,石龜,招呼
2020-01-20,3490,158,186,344,石龜,招呼
2020-01-21,3490,146,176,322,石龜,招呼
2020-01-22,3490,145,202,347,石龜,招呼
2020-01-23,3490,148,270,418,石龜,招呼
2020-01-24,3490,137,235,372,石龜,招呼
2020-01-25,3490,183,199,382,石龜,招呼
2020-01-26,3490,167,197,364,石龜,招呼
2020-01-27,3490,216,253,469,石龜,招呼
2020-01-28,3490,163,179,342,石龜,招呼
2020-01-29,3490,166,170,336,石龜,招呼
2020-01-30,3490,146,161,307,石龜,招呼
2020-01-31,3490,144,158,302,石龜,招呼
2020-02-01,3490,137,162,299,石龜,招呼
2020-02-02,3490,117,179,296,石龜,招呼
2020-02-03,3490,122,147,269,石龜,招呼
2020-02-04,3490,120,137,257,石龜,招呼
2020-02-05,3490,130,172,302,石龜,招呼
2020-02-06,3490,115,143,258,石龜,招呼
2020-02-07,3490,129,176,305,石龜,招呼
2020-02-08,3490,128,194,322,石龜,招呼
2020-02-09,3490,160,186,346,石龜,招呼
2020-02-10,3490,140,150,290,石龜,招呼
2020-02-11,3490,135,153,288,石龜,招呼
2020-02-12,3490,123,141,264,石龜,招呼
2020-02-13,3490,125,140,265,石龜,招呼
2020-02-14,3490,122,171,293,石龜,招呼
2020-02-15,3490,163,200,363,石龜,招呼
2020-02-16,3490,170,191,361,石龜,招呼
2020-02-17,3490,144,165,309,石龜,招呼
2020-02-18,3490,129,137,266,石龜,招呼
2020-02-19,3490,131,146,277,石龜,招呼
2020-02-20,3490,122,130,252,石龜,招呼
2020-02-21,3490,125,167,292,石龜,招呼
2020-02-22,3490,139,172,311,石龜,招呼
2020-02-23,3490,145,152,297,石龜,招呼
2020-02-24,3490,142,160,302,石龜,招呼
2020-02-25,3490,124,148,272,石龜,招呼
2020-02-26,3490,142,155,297,石龜,招呼
2020-02-27,3490,146,231,377,石龜,招呼
2020-02-28,3490,202,223,425,石龜,招呼
2020-02-29,3490,121,149,270,石龜,招呼
2020-03-01,3490,203,158,361,石龜,招呼
2020-03-02,3490,121,147,268,石龜,招呼
2020-03-03,3490,98,159,257,石龜,招呼
2020-03-04,3490,131,151,282,石龜,招呼
2020-03-05,3490,134,169,303,石龜,招呼
2020-03-06,3490,134,235,369,石龜,招呼
2020-03-07,3490,120,190,310,石龜,招呼
2020-03-08,3490,173,162,335,石龜,招呼
2020-03-09,3490,144,171,315,石龜,招呼
2020-03-10,3490,124,165,289,石龜,招呼
2020-03-11,3490,124,162,286,石龜,招呼
2020-03-12,3490,133,178,311,石龜,招呼
2020-03-13,3490,144,258,402,石龜,招呼
2020-03-14,3490,110,148,258,石龜,招呼
2020-03-15,3490,182,172,354,石龜,招呼
2020-03-16,3490,146,156,302,石龜,招呼
2020-03-17,3490,136,172,308,石龜,招呼
2020-03-18,3490,122,152,274,石龜,招呼
2020-03-19,3490,133,145,278,石龜,招呼
2020-03-20,3490,142,213,355,石龜,招呼
2020-03-21,3490,111,147,258,石龜,招呼
2020-03-22,3490,126,113,239,石龜,招呼
2020-03-23,3490,128,145,273,石龜,招呼
2020-03-24,3490,119,153,272,石龜,招呼
2020-03-25,3490,103,142,245,石龜,招呼
2020-03-26,3490,124,153,277,石龜,招呼
2020-03-27,3490,115,190,305,石龜,招呼
2020-03-28,3490,97,109,206,石龜,招呼
2020-03-29,3490,129,115,244,石龜,招呼
2020-03-30,3490,129,153,282,石龜,招呼
2020-03-31,3490,124,139,263,石龜,招呼
2020-04-01,3490,117,193,310,石龜,招呼
2020-04-02,3490,93,143,236,石龜,招呼
2020-04-03,3490,121,139,260,石龜,招呼
2020-04-04,3490,92,104,196,石龜,招呼
2020-04-05,3490,152,106,258,石龜,招呼
2020-04-06,3490,140,161,301,石龜,招呼
2020-04-07,3490,124,140,264,石龜,招呼
2020-04-08,3490,113,133,246,石龜,招呼
2020-04-09,3490,112,140,252,石龜,招呼
2020-04-10,3490,107,176,283,石龜,招呼
2020-04-11,3490,101,134,235,石龜,招呼
2020-04-12,3490,134,134,268,石龜,招呼
2020-04-13,3490,123,144,267,石龜,招呼
2020-04-14,3490,117,147,264,石龜,招呼
2020-04-15,3490,110,135,245,石龜,招呼
2020-04-16,3490,121,143,264,石龜,招呼
2020-04-17,3490,115,181,296,石龜,招呼
2020-04-18,3490,103,163,266,石龜,招呼
2020-04-19,3490,142,127,269,石龜,招呼
2020-04-20,3490,137,147,284,石龜,招呼
2020-04-21,3490,119,146,265,石龜,招呼
2020-04-22,3490,104,127,231,石龜,招呼
2020-04-23,3490,105,137,242,石龜,招呼
2020-04-24,3490,116,174,290,石龜,招呼
2020-04-25,3490,81,116,197,石龜,招呼
2020-04-26,3490,139,124,263,石龜,招呼
2020-04-27,3490,114,131,245,石龜,招呼
2020-04-28,3490,119,141,260,石龜,招呼
2020-04-29,3490,110,142,252,石龜,招呼
2020-04-30,3490,115,160,275,石龜,招呼
2020-05-01,3490,128,195,323,石龜,招呼
2020-05-02,3490,116,153,269,石龜,招呼
2020-05-03,3490,145,128,273,石龜,招呼
2020-05-04,3490,150,150,300,石龜,招呼
2020-05-05,3490,151,160,311,石龜,招呼
2020-05-06,3490,114,143,257,石龜,招呼
2020-05-07,3490,123,141,264,石龜,招呼
2020-05-08,3490,117,230,347,石龜,招呼
2020-05-09,3490,112,156,268,石龜,招呼
2020-05-10,3490,154,124,278,石龜,招呼
2020-05-11,3490,143,153,296,石龜,招呼
2020-05-12,3490,123,140,263,石龜,招呼
2020-05-13,3490,135,151,286,石龜,招呼
2020-05-14,3490,119,152,271,石龜,招呼
2020-05-15,3490,118,186,304,石龜,招呼
2020-05-16,3490,110,146,256,石龜,招呼
2020-05-17,3490,166,148,314,石龜,招呼
2020-05-18,3490,137,144,281,石龜,招呼
2020-05-19,3490,64,128,192,石龜,招呼
2020-05-20,3490,106,131,237,石龜,招呼
2020-05-21,3490,117,130,247,石龜,招呼
2020-05-22,3490,112,159,271,石龜,招呼
2020-05-23,3490,130,141,271,石龜,招呼
2020-05-24,3490,191,174,365,石龜,招呼
2020-05-25,3490,121,138,259,石龜,招呼
2020-05-26,3490,122,134,256,石龜,招呼
2020-05-27,3490,103,127,230,石龜,招呼
2020-05-28,3490,113,153,266,石龜,招呼
2020-05-29,3490,129,200,329,石龜,招呼
2020-05-30,3490,156,191,347,石龜,招呼
2020-05-31,3490,160,134,294,石龜,招呼
2020-06-01,3490,137,155,292,石龜,招呼
2020-06-02,3490,130,137,267,石龜,招呼
2020-06-03,3490,122,129,251,石龜,招呼
2020-06-04,3490,124,153,277,石龜,招呼
2020-06-05,3490,139,215,354,石龜,招呼
2020-06-06,3490,129,169,298,石龜,招呼
2020-06-07,3490,203,168,371,石龜,招呼
2020-06-08,3490,133,160,293,石龜,招呼
2020-06-09,3490,137,156,293,石龜,招呼
2020-06-10,3490,131,157,288,石龜,招呼
2020-06-11,3490,136,157,293,石龜,招呼
2020-06-12,3490,127,225,352,石龜,招呼
2020-06-13,3490,127,156,283,石龜,招呼
2020-06-14,3490,183,177,360,石龜,招呼
2020-06-15,3490,143,161,304,石龜,招呼
2020-06-16,3490,130,149,279,石龜,招呼
2020-06-17,3490,117,150,267,石龜,招呼
2020-06-18,3490,116,133,249,石龜,招呼
2020-06-19,3490,130,154,284,石龜,招呼
2020-06-20,3490,118,150,268,石龜,招呼
2020-06-21,3490,154,166,320,石龜,招呼
2020-06-22,3490,131,146,277,石龜,招呼
2020-06-23,3490,126,170,296,石龜,招呼
2020-06-24,3490,125,203,328,石龜,招呼
2020-06-25,3490,133,209,342,石龜,招呼
2020-06-26,3490,156,195,351,石龜,招呼
2020-06-27,3490,157,163,320,石龜,招呼
2020-06-28,3490,194,178,372,石龜,招呼
2020-06-29,3490,140,159,299,石龜,招呼
2020-06-30,3490,133,168,301,石龜,招呼
2020-07-01,3490,116,135,251,石龜,招呼
2020-07-02,3490,105,145,250,石龜,招呼
2020-07-03,3490,129,152,281,石龜,招呼
2020-07-04,3490,162,190,352,石龜,招呼
2020-07-05,3490,148,142,290,石龜,招呼
2020-07-06,3490,178,212,390,石龜,招呼
2020-07-07,3490,129,173,302,石龜,招呼
2020-07-08,3490,138,163,301,石龜,招呼
2020-07-09,3490,136,139,275,石龜,招呼
2020-07-10,3490,133,201,334,石龜,招呼
2020-07-11,3490,179,201,380,石龜,招呼
2020-07-12,3490,185,207,392,石龜,招呼
2020-07-13,3490,121,141,262,石龜,招呼
2020-07-14,3490,113,170,283,石龜,招呼
2020-07-15,3490,113,121,234,石龜,招呼
2020-07-16,3490,115,118,233,石龜,招呼
2020-07-17,3490,144,168,312,石龜,招呼
2020-07-18,3490,163,166,329,石龜,招呼
2020-07-19,3490,141,178,319,石龜,招呼
2020-07-20,3490,148,155,303,石龜,招呼
2020-07-21,3490,97,131,228,石龜,招呼
2020-07-22,3490,125,144,269,石龜,招呼
2020-07-23,3490,110,125,235,石龜,招呼
2020-07-24,3490,130,185,315,石龜,招呼
2020-07-25,3490,136,137,273,石龜,招呼
2020-07-26,3490,147,132,279,石龜,招呼
2020-07-27,3490,126,160,286,石龜,招呼
2020-07-28,3490,106,122,228,石龜,招呼
2020-07-29,3490,140,147,287,石龜,招呼
2020-07-30,3490,125,132,257,石龜,招呼
2020-07-31,3490,105,126,231,石龜,招呼
2020-08-01,3490,139,167,306,石龜,招呼
2020-08-02,3490,148,142,290,石龜,招呼
2020-08-03,3490,130,157,287,石龜,招呼
2020-08-04,3490,112,133,245,石龜,招呼
2020-08-05,3490,133,144,277,石龜,招呼
2020-08-06,3490,142,157,299,石龜,招呼
2020-08-07,3490,142,196,338,石龜,招呼
2020-08-08,3490,136,197,333,石龜,招呼
2020-08-09,3490,183,185,368,石龜,招呼
2020-08-10,3490,99,140,239,石龜,招呼
2020-08-11,3490,121,155,276,石龜,招呼
2020-08-12,3490,119,143,262,石龜,招呼
2020-08-13,3490,126,134,260,石龜,招呼
2020-08-14,3490,163,171,334,石龜,招呼
2020-08-15,3490,132,147,279,石龜,招呼
2020-08-16,3490,149,189,338,石龜,招呼
2020-08-17,3490,122,147,269,石龜,招呼
2020-08-18,3490,141,154,295,石龜,招呼
2020-08-19,3490,114,135,249,石龜,招呼
2020-08-20,3490,107,130,237,石龜,招呼
2020-08-21,3490,123,169,292,石龜,招呼
2020-08-22,3490,131,156,287,石龜,招呼
2020-08-23,3490,152,168,320,石龜,招呼
2020-08-24,3490,142,166,308,石龜,招呼
2020-08-25,3490,62,139,201,石龜,招呼
2020-08-26,3490,125,138,263,石龜,招呼
2020-08-27,3490,124,143,267,石龜,招呼
2020-08-28,3490,125,202,327,石龜,招呼
2020-08-29,3490,124,135,259,石龜,招呼
2020-08-30,3490,164,176,340,石龜,招呼
2020-08-31,3490,137,165,302,石龜,招呼
2020-09-01,3490,134,157,291,石龜,招呼
2020-09-02,3490,129,141,270,石龜,招呼
2020-09-03,3490,139,149,288,石龜,招呼
2020-09-04,3490,133,205,338,石龜,招呼
2020-09-05,3490,1187,172,1359,石龜,招呼
2020-09-06,3490,153,158,311,石龜,招呼
2020-09-07,3490,125,181,306,石龜,招呼
2020-09-08,3490,133,147,280,石龜,招呼
2020-09-09,3490,679,190,869,石龜,招呼
2020-09-10,3490,168,205,373,石龜,招呼
2020-09-11,3490,134,191,325,石龜,招呼
2020-09-12,3490,166,188,354,石龜,招呼
2020-09-13,3490,192,192,384,石龜,招呼
2020-09-14,3490,130,138,268,石龜,招呼
2020-09-15,3490,117,141,258,石龜,招呼
2020-09-16,3490,118,129,247,石龜,招呼
2020-09-17,3490,120,151,271,石龜,招呼
2020-09-18,3490,124,211,335,石龜,招呼
2020-09-19,3490,151,169,320,石龜,招呼
2020-09-20,3490,206,173,379,石龜,招呼
2020-09-21,3490,132,173,305,石龜,招呼
2020-09-22,3490,121,159,280,石龜,招呼
2020-09-23,3490,119,144,263,石龜,招呼
2020-09-24,3490,132,156,288,石龜,招呼
2020-09-25,3490,136,163,299,石龜,招呼
2020-09-26,3490,97,158,255,石龜,招呼
2020-09-27,3490,189,182,371,石龜,招呼
2020-09-28,3490,131,152,283,石龜,招呼
2020-09-29,3490,108,140,248,石龜,招呼
2020-09-30,3490,139,258,397,石龜,招呼
2020-10-01,3490,161,263,424,石龜,招呼
2020-10-02,3490,184,243,427,石龜,招呼
2020-10-03,3490,209,209,418,石龜,招呼
2020-10-04,3490,222,134,356,石龜,招呼
2020-10-05,3490,166,171,337,石龜,招呼
2020-10-06,3490,143,172,315,石龜,招呼
2020-10-07,3490,143,145,288,石龜,招呼
2020-10-08,3490,133,229,362,石龜,招呼
2020-10-09,3490,183,235,418,石龜,招呼
2020-10-10,3490,136,172,308,石龜,招呼
2020-10-11,3490,181,191,372,石龜,招呼
2020-10-12,3490,146,150,296,石龜,招呼
2020-10-13,3490,132,149,281,石龜,招呼
2020-10-14,3490,122,162,284,石龜,招呼
2020-10-15,3490,141,170,311,石龜,招呼
2020-10-16,3490,145,223,368,石龜,招呼
2020-10-17,3490,134,172,306,石龜,招呼
2020-10-18,3490,171,162,333,石龜,招呼
2020-10-19,3490,148,156,304,石龜,招呼
2020-10-20,3490,138,154,292,石龜,招呼
2020-10-21,3490,149,159,308,石龜,招呼
2020-10-22,3490,136,160,296,石龜,招呼
2020-10-23,3490,138,197,335,石龜,招呼
2020-10-24,3490,162,205,367,石龜,招呼
2020-10-25,3490,190,135,325,石龜,招呼
2020-10-26,3490,130,146,276,石龜,招呼
2020-10-27,3490,122,151,273,石龜,招呼
2020-10-28,3490,123,138,261,石龜,招呼
2020-10-29,3490,124,151,275,石龜,招呼
2020-10-30,3490,141,207,348,石龜,招呼
2020-10-31,3490,145,167,312,石龜,招呼
2020-11-01,3490,180,177,357,石龜,招呼
2020-11-02,3490,144,161,305,石龜,招呼
2020-11-03,3490,129,156,285,石龜,招呼
2020-11-04,3490,128,140,268,石龜,招呼
2020-11-05,3490,148,175,323,石龜,招呼
2020-11-06,3490,150,207,357,石龜,招呼
2020-11-07,3490,105,167,272,石龜,招呼
2020-11-08,3490,227,163,390,石龜,招呼
2020-11-09,3490,132,142,274,石龜,招呼
2020-11-10,3490,120,143,263,石龜,招呼
2020-11-11,3490,126,138,264,石龜,招呼
2020-11-12,3490,137,162,299,石龜,招呼
2020-11-13,3490,148,227,375,石龜,招呼
2020-11-14,3490,152,183,335,石龜,招呼
2020-11-15,3490,204,198,402,石龜,招呼
2020-11-16,3490,131,153,284,石龜,招呼
2020-11-17,3490,135,153,288,石龜,招呼
2020-11-18,3490,124,141,265,石龜,招呼
2020-11-19,3490,116,138,254,石龜,招呼
2020-11-20,3490,162,238,400,石龜,招呼
2020-11-21,3490,141,179,320,石龜,招呼
2020-11-22,3490,187,180,367,石龜,招呼
2020-11-23,3490,132,162,294,石龜,招呼
2020-11-24,3490,96,134,230,石龜,招呼
2020-11-25,3490,142,149,291,石龜,招呼
2020-11-26,3490,121,142,263,石龜,招呼
2020-11-27,3490,140,228,368,石龜,招呼
2020-11-28,3490,170,173,343,石龜,招呼
2020-11-29,3490,179,157,336,石龜,招呼
2020-11-30,3490,146,148,294,石龜,招呼
2020-12-01,3490,134,192,326,石龜,招呼
2020-12-02,3490,123,139,262,石龜,招呼
2020-12-03,3490,139,156,295,石龜,招呼
2020-12-04,3490,138,237,375,石龜,招呼
2020-12-05,3490,160,195,355,石龜,招呼
2020-12-06,3490,248,231,479,石龜,招呼
2020-12-07,3490,156,181,337,石龜,招呼
2020-12-08,3490,112,122,234,石龜,招呼
2020-12-09,3490,117,144,261,石龜,招呼
2020-12-10,3490,113,139,252,石龜,招呼
2020-12-11,3490,132,221,353,石龜,招呼
2020-12-12,3490,151,223,374,石龜,招呼
2020-12-13,3490,230,191,421,石龜,招呼
2020-12-14,3490,155,162,317,石龜,招呼
2020-12-15,3490,122,137,259,石龜,招呼
2020-12-16,3490,120,138,258,石龜,招呼
2020-12-17,3490,116,147,263,石龜,招呼
2020-12-18,3490,147,242,389,石龜,招呼
2020-12-19,3490,166,217,383,石龜,招呼
2020-12-20,3490,220,168,388,石龜,招呼
2020-12-21,3490,128,151,279,石龜,招呼
2020-12-22,3490,134,145,279,石龜,招呼
2020-12-23,3490,113,150,263,石龜,招呼
2020-12-24,3490,113,150,263,石龜,招呼
2020-12-25,3490,143,209,352,石龜,招呼
2020-12-26,3490,134,182,316,石龜,招呼
2020-12-27,3490,166,129,295,石龜,招呼
2020-12-28,3490,126,143,269,石龜,招呼
2020-12-29,3490,120,156,276,石龜,招呼
2020-12-30,3490,123,161,284,石龜,招呼
2020-12-31,3490,131,214,345,石龜,招呼
2020-01-01,4050,1626,2189,3815,大林,三等
2020-01-02,4050,1460,1527,2987,大林,三等
2020-01-03,4050,2131,1786,3917,大林,三等
2020-01-04,4050,1512,1533,3045,大林,三等
2020-01-05,4050,1700,1940,3640,大林,三等
2020-01-06,4050,2045,2186,4231,大林,三等
2020-01-07,4050,1482,1510,2992,大林,三等
2020-01-08,4050,1581,1614,3195,大林,三等
2020-01-09,4050,1588,1592,3180,大林,三等
2020-01-10,4050,2521,2328,4849,大林,三等
2020-01-11,4050,1851,1778,3629,大林,三等
2020-01-12,4050,2009,1788,3797,大林,三等
2020-01-13,4050,2275,2455,4730,大林,三等
2020-01-14,4050,1563,1534,3097,大林,三等
2020-01-15,4050,1598,1569,3167,大林,三等
2020-01-16,4050,1695,1829,3524,大林,三等
2020-01-17,4050,1853,1723,3576,大林,三等
2020-01-18,4050,1455,1286,2741,大林,三等
2020-01-19,4050,1473,1555,3028,大林,三等
2020-01-20,4050,2365,2314,4679,大林,三等
2020-01-21,4050,1711,1667,3378,大林,三等
2020-01-22,4050,1799,1853,3652,大林,三等
2020-01-23,4050,1683,1894,3577,大林,三等
2020-01-24,4050,1205,1539,2744,大林,三等
2020-01-25,4050,1528,1391,2919,大林,三等
2020-01-26,4050,1601,1534,3135,大林,三等
2020-01-27,4050,2380,2144,4524,大林,三等
2020-01-28,4050,1481,1317,2798,大林,三等
2020-01-29,4050,1564,1332,2896,大林,三等
2020-01-30,4050,1515,1346,2861,大林,三等
2020-01-31,4050,1575,1414,2989,大林,三等
2020-02-01,4050,1209,1043,2252,大林,三等
2020-02-02,4050,1178,1261,2439,大林,三等
2020-02-03,4050,2018,1963,3981,大林,三等
2020-02-04,4050,1322,1260,2582,大林,三等
2020-02-05,4050,1475,1376,2851,大林,三等
2020-02-06,4050,1332,1270,2602,大林,三等
2020-02-07,4050,1529,1451,2980,大林,三等
2020-02-08,4050,1244,1179,2423,大林,三等
2020-02-09,4050,1343,1357,2700,大林,三等
2020-02-10,4050,2069,2049,4118,大林,三等
2020-02-11,4050,1399,1372,2771,大林,三等
2020-02-12,4050,1497,1413,2910,大林,三等
2020-02-13,4050,1260,1228,2488,大林,三等
2020-02-14,4050,1544,1386,2930,大林,三等
2020-02-15,4050,1290,1187,2477,大林,三等
2020-02-16,4050,1383,1384,2767,大林,三等
2020-02-17,4050,1714,1727,3441,大林,三等
2020-02-18,4050,1287,1326,2613,大林,三等
2020-02-19,4050,1304,1290,2594,大林,三等
2020-02-20,4050,1293,1202,2495,大林,三等
2020-02-21,4050,1561,1482,3043,大林,三等
2020-02-22,4050,1293,1179,2472,大林,三等
2020-02-23,4050,1354,1483,2837,大林,三等
2020-02-24,4050,2022,2133,4155,大林,三等
2020-02-25,4050,1298,1371,2669,大林,三等
2020-02-26,4050,1469,1364,2833,大林,三等
2020-02-27,4050,1997,1659,3656,大林,三等
2020-02-28,4050,1569,1358,2927,大林,三等
2020-02-29,4050,1134,1128,2262,大林,三等
2020-03-01,4050,1474,1676,3150,大林,三等
2020-03-02,4050,1807,1908,3715,大林,三等
2020-03-03,4050,1271,1308,2579,大林,三等
2020-03-04,4050,1298,1341,2639,大林,三等
2020-03-05,4050,1312,1279,2591,大林,三等
2020-03-06,4050,2114,1725,3839,大林,三等
2020-03-07,4050,1398,1197,2595,大林,三等
2020-03-08,4050,1412,1910,3322,大林,三等
2020-03-09,4050,1803,1841,3644,大林,三等
2020-03-10,4050,1297,1309,2606,大林,三等
2020-03-11,4050,1408,1392,2800,大林,三等
2020-03-12,4050,1403,1356,2759,大林,三等
2020-03-13,4050,2090,1733,3823,大林,三等
2020-03-14,4050,1247,1055,2302,大林,三等
2020-03-15,4050,1560,1959,3519,大林,三等
2020-03-16,4050,1792,1839,3631,大林,三等
2020-03-17,4050,1308,1334,2642,大林,三等
2020-03-18,4050,1307,1285,2592,大林,三等
2020-03-19,4050,1245,1192,2437,大林,三等
2020-03-20,4050,1983,1568,3551,大林,三等
2020-03-21,4050,1158,1663,2821,大林,三等
2020-03-22,4050,1264,1668,2932,大林,三等
2020-03-23,4050,1555,1606,3161,大林,三等
2020-03-24,4050,1222,1372,2594,大林,三等
2020-03-25,4050,1089,1172,2261,大林,三等
2020-03-26,4050,1202,1194,2396,大林,三等
2020-03-27,4050,1776,1419,3195,大林,三等
2020-03-28,4050,1114,936,2050,大林,三等
2020-03-29,4050,1011,1403,2414,大林,三等
2020-03-30,4050,1402,1507,2909,大林,三等
2020-03-31,4050,1185,1191,2376,大林,三等
2020-04-01,4050,1958,1564,3522,大林,三等
2020-04-02,4050,1352,1358,2710,大林,三等
2020-04-03,4050,1128,1078,2206,大林,三等
2020-04-04,4050,841,676,1517,大林,三等
2020-04-05,4050,1289,1269,2558,大林,三等
2020-04-06,4050,1311,1592,2903,大林,三等
2020-04-07,4050,1029,1166,2195,大林,三等
2020-04-08,4050,1100,1091,2191,大林,三等
2020-04-09,4050,1147,1117,2264,大林,三等
2020-04-10,4050,1725,1317,3042,大林,三等
2020-04-11,4050,1068,942,2010,大林,三等
2020-04-12,4050,1050,1461,2511,大林,三等
2020-04-13,4050,1324,1377,2701,大林,三等
2020-04-14,4050,1117,1098,2215,大林,三等
2020-04-15,4050,1171,1141,2312,大林,三等
2020-04-16,4050,1208,1167,2375,大林,三等
2020-04-17,4050,1845,1512,3357,大林,三等
2020-04-18,4050,1148,1010,2158,大林,三等
2020-04-19,4050,1158,1498,2656,大林,三等
2020-04-20,4050,1350,1368,2718,大林,三等
2020-04-21,4050,1028,1065,2093,大林,三等
2020-04-22,4050,1051,1071,2122,大林,三等
2020-04-23,4050,1051,1007,2058,大林,三等
2020-04-24,4050,1624,1337,2961,大林,三等
2020-04-25,4050,974,823,1797,大林,三等
2020-04-26,4050,1001,1268,2269,大林,三等
2020-04-27,4050,1289,1470,2759,大林,三等
2020-04-28,4050,1087,1118,2205,大林,三等
2020-04-29,4050,1110,1132,2242,大林,三等
2020-04-30,4050,1275,1243,2518,大林,三等
2020-05-01,4050,1602,1299,2901,大林,三等
2020-05-02,4050,1002,999,2001,大林,三等
2020-05-03,4050,1181,1431,2612,大林,三等
2020-05-04,4050,1549,1626,3175,大林,三等
2020-05-05,4050,1160,1182,2342,大林,三等
2020-05-06,4050,1193,1204,2397,大林,三等
2020-05-07,4050,1295,1224,2519,大林,三等
2020-05-08,4050,2086,1693,3779,大林,三等
2020-05-09,4050,1191,1170,2361,大林,三等
2020-05-10,4050,1374,1628,3002,大林,三等
2020-05-11,4050,1600,1694,3294,大林,三等
2020-05-12,4050,1230,1243,2473,大林,三等
2020-05-13,4050,1198,1193,2391,大林,三等
2020-05-14,4050,1210,1228,2438,大林,三等
2020-05-15,4050,1972,1502,3474,大林,三等
2020-05-16,4050,1107,1046,2153,大林,三等
2020-05-17,4050,1255,1667,2922,大林,三等
2020-05-18,4050,1372,1406,2778,大林,三等
2020-05-19,4050,1084,1101,2185,大林,三等
2020-05-20,4050,1147,1116,2263,大林,三等
2020-05-21,4050,1185,1166,2351,大林,三等
2020-05-22,4050,1819,1415,3234,大林,三等
2020-05-23,4050,1099,1007,2106,大林,三等
2020-05-24,4050,1395,1698,3093,大林,三等
2020-05-25,4050,1654,1764,3418,大林,三等
2020-05-26,4050,1249,1194,2443,大林,三等
2020-05-27,4050,1168,1170,2338,大林,三等
2020-05-28,4050,1252,1206,2458,大林,三等
2020-05-29,4050,1841,1567,3408,大林,三等
2020-05-30,4050,1460,1304,2764,大林,三等
2020-05-31,4050,1420,1692,3112,大林,三等
2020-06-01,4050,1641,1743,3384,大林,三等
2020-06-02,4050,1260,1305,2565,大林,三等
2020-06-03,4050,1223,1210,2433,大林,三等
2020-06-04,4050,1394,1336,2730,大林,三等
2020-06-05,4050,2045,1581,3626,大林,三等
2020-06-06,4050,1385,1234,2619,大林,三等
2020-06-07,4050,1366,1731,3097,大林,三等
2020-06-08,4050,1340,1403,2743,大林,三等
2020-06-09,4050,1244,1262,2506,大林,三等
2020-06-10,4050,1233,1280,2513,大林,三等
2020-06-11,4050,1326,1271,2597,大林,三等
2020-06-12,4050,1875,1629,3504,大林,三等
2020-06-13,4050,1567,1277,2844,大林,三等
2020-06-14,4050,1470,1805,3275,大林,三等
2020-06-15,4050,1802,1934,3736,大林,三等
2020-06-16,4050,1313,1354,2667,大林,三等
2020-06-17,4050,1260,1256,2516,大林,三等
2020-06-18,4050,1404,1333,2737,大林,三等
2020-06-19,4050,1660,1522,3182,大林,三等
2020-06-20,4050,1307,1182,2489,大林,三等
2020-06-21,4050,1471,1666,3137,大林,三等
2020-06-22,4050,1587,1679,3266,大林,三等
2020-06-23,4050,1312,1327,2639,大林,三等
2020-06-24,4050,2013,1891,3904,大林,三等
2020-06-25,4050,1456,1490,2946,大林,三等
2020-06-26,4050,1613,1547,3160,大林,三等
2020-06-27,4050,1464,1226,2690,大林,三等
2020-06-28,4050,1697,1771,3468,大林,三等
2020-06-29,4050,1842,1801,3643,大林,三等
2020-06-30,4050,1382,1361,2743,大林,三等
2020-07-01,4050,1314,1307,2621,大林,三等
2020-07-02,4050,1366,1321,2687,大林,三等
2020-07-03,4050,1624,1430,3054,大林,三等
2020-07-04,4050,1389,1217,2606,大林,三等
2020-07-05,4050,1219,1333,2552,大林,三等
2020-07-06,4050,1815,1789,3604,大林,三等
2020-07-07,4050,1446,1426,2872,大林,三等
2020-07-08,4050,1465,1467,2932,大林,三等
2020-07-09,4050,1410,1366,2776,大林,三等
2020-07-10,4050,1813,1624,3437,大林,三等
2020-07-11,4050,1387,1274,2661,大林,三等
2020-07-12,4050,1387,1596,2983,大林,三等
2020-07-13,4050,1919,1878,3797,大林,三等
2020-07-14,4050,1514,1583,3097,大林,三等
2020-07-15,4050,1562,1432,2994,大林,三等
2020-07-16,4050,1357,1327,2684,大林,三等
2020-07-17,4050,1767,1502,3269,大林,三等
2020-07-18,4050,1339,1216,2555,大林,三等
2020-07-19,4050,1360,1404,2764,大林,三等
2020-07-20,4050,1525,1541,3066,大林,三等
2020-07-21,4050,1380,1415,2795,大林,三等
2020-07-22,4050,1436,1417,2853,大林,三等
2020-07-23,4050,1445,1360,2805,大林,三等
2020-07-24,4050,1718,1542,3260,大林,三等
2020-07-25,4050,1322,1205,2527,大林,三等
2020-07-26,4050,1406,1378,2784,大林,三等
2020-07-27,4050,1798,1793,3591,大林,三等
2020-07-28,4050,1321,1329,2650,大林,三等
2020-07-29,4050,1387,1316,2703,大林,三等
2020-07-30,4050,1473,1370,2843,大林,三等
2020-07-31,4050,1779,1596,3375,大林,三等
2020-08-01,4050,1256,1140,2396,大林,三等
2020-08-02,4050,1331,1387,2718,大林,三等
2020-08-03,4050,1534,1562,3096,大林,三等
2020-08-04,4050,1263,1228,2491,大林,三等
2020-08-05,4050,1444,1372,2816,大林,三等
2020-08-06,4050,1423,1427,2850,大林,三等
2020-08-07,4050,1704,1701,3405,大林,三等
2020-08-08,4050,1453,1323,2776,大林,三等
2020-08-09,4050,1535,1406,2941,大林,三等
2020-08-10,4050,1473,1463,2936,大林,三等
2020-08-11,4050,1302,1317,2619,大林,三等
2020-08-12,4050,1337,1289,2626,大林,三等
2020-08-13,4050,1390,1358,2748,大林,三等
2020-08-14,4050,1861,1556,3417,大林,三等
2020-08-15,4050,1253,1154,2407,大林,三等
2020-08-16,4050,1461,1639,3100,大林,三等
2020-08-17,4050,1820,1854,3674,大林,三等
2020-08-18,4050,1415,1334,2749,大林,三等
2020-08-19,4050,1341,1318,2659,大林,三等
2020-08-20,4050,1367,1262,2629,大林,三等
2020-08-21,4050,1727,1488,3215,大林,三等
2020-08-22,4050,1357,1138,2495,大林,三等
2020-08-23,4050,1271,1407,2678,大林,三等
2020-08-24,4050,1888,1847,3735,大林,三等
2020-08-25,4050,1429,1403,2832,大林,三等
2020-08-26,4050,1350,1274,2624,大林,三等
2020-08-27,4050,1277,1209,2486,大林,三等
2020-08-28,4050,1640,1453,3093,大林,三等
2020-08-29,4050,1293,1184,2477,大林,三等
2020-08-30,4050,1254,1272,2526,大林,三等
2020-08-31,4050,1716,1727,3443,大林,三等
2020-09-01,4050,1274,1299,2573,大林,三等
2020-09-02,4050,1353,1302,2655,大林,三等
2020-09-03,4050,1418,1329,2747,大林,三等
2020-09-04,4050,1592,1509,3101,大林,三等
2020-09-05,4050,1361,1220,2581,大林,三等
2020-09-06,4050,1496,1537,3033,大林,三等
2020-09-07,4050,1751,1855,3606,大林,三等
2020-09-08,4050,1587,1547,3134,大林,三等
2020-09-09,4050,1728,1712,3440,大林,三等
2020-09-10,4050,1770,1742,3512,大林,三等
2020-09-11,4050,1821,1747,3568,大林,三等
2020-09-12,4050,1600,1401,3001,大林,三等
2020-09-13,4050,1626,1794,3420,大林,三等
2020-09-14,4050,1647,1881,3528,大林,三等
2020-09-15,4050,1291,1625,2916,大林,三等
2020-09-16,4050,1348,1305,2653,大林,三等
2020-09-17,4050,1308,1294,2602,大林,三等
2020-09-18,4050,2606,1754,4360,大林,三等
2020-09-19,4050,1483,1442,2925,大林,三等
2020-09-20,4050,1579,2075,3654,大林,三等
2020-09-21,4050,1757,1845,3602,大林,三等
2020-09-22,4050,1287,1293,2580,大林,三等
2020-09-23,4050,1373,1402,2775,大林,三等
2020-09-24,4050,1435,1390,2825,大林,三等
2020-09-25,4050,1615,1525,3140,大林,三等
2020-09-26,4050,1542,1280,2822,大林,三等
2020-09-27,4050,1551,1822,3373,大林,三等
2020-09-28,4050,1688,1779,3467,大林,三等
2020-09-29,4050,1350,1312,2662,大林,三等
2020-09-30,4050,2601,2032,4633,大林,三等
2020-10-01,4050,1611,1738,3349,大林,三等
2020-10-02,4050,1762,1586,3348,大林,三等
2020-10-03,4050,1633,1472,3105,大林,三等
2020-10-04,4050,1917,2275,4192,大林,三等
2020-10-05,4050,1776,1755,3531,大林,三等
2020-10-06,4050,1310,1402,2712,大林,三等
2020-10-07,4050,1398,1347,2745,大林,三等
2020-10-08,4050,2305,1804,4109,大林,三等
2020-10-09,4050,2062,1816,3878,大林,三等
2020-10-10,4050,1440,1229,2669,大林,三等
2020-10-11,4050,1662,2150,3812,大林,三等
2020-10-12,4050,1818,1829,3647,大林,三等
2020-10-13,4050,1283,1341,2624,大林,三等
2020-10-14,4050,1424,1356,2780,大林,三等
2020-10-15,4050,1437,1425,2862,大林,三等
2020-10-16,4050,2264,1722,3986,大林,三等
2020-10-17,4050,1657,1418,3075,大林,三等
2020-10-18,4050,1678,2069,3747,大林,三等
2020-10-19,4050,1901,1903,3804,大林,三等
2020-10-20,4050,1266,1395,2661,大林,三等
2020-10-21,4050,1449,1478,2927,大林,三等
2020-10-22,4050,1444,1355,2799,大林,三等
2020-10-23,4050,2371,1785,4156,大林,三等
2020-10-24,4050,1498,1421,2919,大林,三等
2020-10-25,4050,1675,2066,3741,大林,三等
2020-10-26,4050,1842,1854,3696,大林,三等
2020-10-27,4050,1353,1312,2665,大林,三等
2020-10-28,4050,1387,1286,2673,大林,三等
2020-10-29,4050,1430,1400,2830,大林,三等
2020-10-30,4050,2180,1743,3923,大林,三等
2020-10-31,4050,1617,1434,3051,大林,三等
2020-11-01,4050,1656,2000,3656,大林,三等
2020-11-02,4050,1737,1785,3522,大林,三等
2020-11-03,4050,1249,1244,2493,大林,三等
2020-11-04,4050,1415,1366,2781,大林,三等
2020-11-05,4050,1428,1354,2782,大林,三等
2020-11-06,4050,2298,1709,4007,大林,三等
2020-11-07,4050,1577,1369,2946,大林,三等
2020-11-08,4050,1571,2096,3667,大林,三等
2020-11-09,4050,1630,1678,3308,大林,三等
2020-11-10,4050,1319,1345,2664,大林,三等
2020-11-11,4050,1476,1359,2835,大林,三等
2020-11-12,4050,1413,1358,2771,大林,三等
2020-11-13,4050,2321,1765,4086,大林,三等
2020-11-14,4050,1658,1442,3100,大林,三等
2020-11-15,4050,1892,2425,4317,大林,三等
2020-11-16,4050,1852,2050,3902,大林,三等
2020-11-17,4050,1427,1435,2862,大林,三等
2020-11-18,4050,1365,1380,2745,大林,三等
2020-11-19,4050,1465,1379,2844,大林,三等
2020-11-20,4050,2449,1878,4327,大林,三等
2020-11-21,4050,1742,1514,3256,大林,三等
2020-11-22,4050,1610,2214,3824,大林,三等
2020-11-23,4050,1903,1877,3780,大林,三等
2020-11-24,4050,1288,1267,2555,大林,三等
2020-11-25,4050,1404,1354,2758,大林,三等
2020-11-26,4050,1469,1330,2799,大林,三等
2020-11-27,4050,2194,1729,3923,大林,三等
2020-11-28,4050,1625,1399,3024,大林,三等
2020-11-29,4050,1588,2092,3680,大林,三等
2020-11-30,4050,1792,1849,3641,大林,三等
2020-12-01,4050,1325,1329,2654,大林,三等
2020-12-02,4050,1366,1335,2701,大林,三等
2020-12-03,4050,1407,1391,2798,大林,三等
2020-12-04,4050,2336,1812,4148,大林,三等
2020-12-05,4050,1781,1531,3312,大林,三等
2020-12-06,4050,1766,2272,4038,大林,三等
2020-12-07,4050,1822,1893,3715,大林,三等
2020-12-08,4050,1330,1360,2690,大林,三等
2020-12-09,4050,1341,1295,2636,大林,三等
2020-12-10,4050,1384,1349,2733,大林,三等
2020-12-11,4050,2317,1782,4099,大林,三等
2020-12-12,4050,1766,1432,3198,大林,三等
2020-12-13,4050,1798,2389,4187,大林,三等
2020-12-14,4050,1897,2063,3960,大林,三等
2020-12-15,4050,1359,1339,2698,大林,三等
2020-12-16,4050,1458,1415,2873,大林,三等
2020-12-17,4050,1524,1412,2936,大林,三等
2020-12-18,4050,2146,1959,4105,大林,三等
2020-12-19,4050,2557,2044,4601,大林,三等
2020-12-20,4050,1711,2170,3881,大林,三等
2020-12-21,4050,1493,1524,3017,大林,三等
2020-12-22,4050,1364,1322,2686,大林,三等
2020-12-23,4050,1339,1308,2647,大林,三等
2020-12-24,4050,1648,1373,3021,大林,三等
2020-12-25,4050,2237,1797,4034,大林,三等
2020-12-26,4050,1555,1358,2913,大林,三等
2020-12-27,4050,1583,2124,3707,大林,三等
2020-12-28,4050,1661,1642,3303,大林,三等
2020-12-29,4050,1312,1334,2646,大林,三等
2020-12-30,4050,1603,1450,3053,大林,三等
2020-12-31,4050,2564,1850,4414,大林,三等
2020-01-01,4060,2019,2548,4567,民雄,三等
2020-01-02,4060,1698,1755,3453,民雄,三等
2020-01-03,4060,2485,1950,4435,民雄,三等
2020-01-04,4060,2080,1784,3864,民雄,三等
2020-01-05,4060,1988,2245,4233,民雄,三等
2020-01-06,4060,1593,1881,3474,民雄,三等
2020-01-07,4060,1441,1522,2963,民雄,三等
2020-01-08,4060,1601,1575,3176,民雄,三等
2020-01-09,4060,2338,1549,3887,民雄,三等
2020-01-10,4060,4275,2766,7041,民雄,三等
2020-01-11,4060,2585,2369,4954,民雄,三等
2020-01-12,4060,2337,2481,4818,民雄,三等
2020-01-13,4060,1888,2147,4035,民雄,三等
2020-01-14,4060,1652,1642,3294,民雄,三等
2020-01-15,4060,1569,1505,3074,民雄,三等
2020-01-16,4060,2087,1987,4074,民雄,三等
2020-01-17,4060,2127,1896,4023,民雄,三等
2020-01-18,4060,1737,1667,3404,民雄,三等
2020-01-19,4060,1784,1720,3504,民雄,三等
2020-01-20,4060,1992,1833,3825,民雄,三等
2020-01-21,4060,1889,1809,3698,民雄,三等
2020-01-22,4060,2202,1942,4144,民雄,三等
2020-01-23,4060,1711,1829,3540,民雄,三等
2020-01-24,4060,1098,1334,2432,民雄,三等
2020-01-25,4060,1422,1365,2787,民雄,三等
2020-01-26,4060,1469,1574,3043,民雄,三等
2020-01-27,4060,2143,1685,3828,民雄,三等
2020-01-28,4060,1793,1476,3269,民雄,三等
2020-01-29,4060,1579,1317,2896,民雄,三等
2020-01-30,4060,1466,1447,2913,民雄,三等
2020-01-31,4060,1645,1630,3275,民雄,三等
2020-02-01,4060,1316,1258,2574,民雄,三等
2020-02-02,4060,1398,1409,2807,民雄,三等
2020-02-03,4060,1391,1685,3076,民雄,三等
2020-02-04,4060,1816,1467,3283,民雄,三等
2020-02-05,4060,1297,1289,2586,民雄,三等
2020-02-06,4060,1348,1184,2532,民雄,三等
2020-02-07,4060,1731,1698,3429,民雄,三等
2020-02-08,4060,1502,1425,2927,民雄,三等
2020-02-09,4060,1679,1611,3290,民雄,三等
2020-02-10,4060,1538,1581,3119,民雄,三等
2020-02-11,4060,1312,1340,2652,民雄,三等
2020-02-12,4060,1237,1216,2453,民雄,三等
2020-02-13,4060,1286,1221,2507,民雄,三等
2020-02-14,4060,1717,1574,3291,民雄,三等
2020-02-15,4060,1577,1332,2909,民雄,三等
2020-02-16,4060,1572,1559,3131,民雄,三等
2020-02-17,4060,1409,1409,2818,民雄,三等
2020-02-18,4060,1317,1288,2605,民雄,三等
2020-02-19,4060,1314,1281,2595,民雄,三等
2020-02-20,4060,1298,1208,2506,民雄,三等
2020-02-21,4060,1726,1626,3352,民雄,三等
2020-02-22,4060,1494,1430,2924,民雄,三等
2020-02-23,4060,1584,1552,3136,民雄,三等
2020-02-24,4060,1482,1628,3110,民雄,三等
2020-02-25,4060,1579,1577,3156,民雄,三等
2020-02-26,4060,1446,1474,2920,民雄,三等
2020-02-27,4060,2420,1963,4383,民雄,三等
2020-02-28,4060,2066,1765,3831,民雄,三等
2020-02-29,4060,1579,1723,3302,民雄,三等
2020-03-01,4060,2012,2601,4613,民雄,三等
2020-03-02,4060,1498,1759,3257,民雄,三等
2020-03-03,4060,1287,1346,2633,民雄,三等
2020-03-04,4060,1376,1319,2695,民雄,三等
2020-03-05,4060,1750,1301,3051,民雄,三等
2020-03-06,4060,3045,2063,5108,民雄,三等
2020-03-07,4060,1902,1668,3570,民雄,三等
2020-03-08,4060,1997,2615,4612,民雄,三等
2020-03-09,4060,1550,1901,3451,民雄,三等
2020-03-10,4060,1308,1355,2663,民雄,三等
2020-03-11,4060,1451,1381,2832,民雄,三等
2020-03-12,4060,1816,1429,3245,民雄,三等
2020-03-13,4060,3505,2124,5629,民雄,三等
2020-03-14,4060,1700,1569,3269,民雄,三等
2020-03-15,4060,2117,2874,4991,民雄,三等
2020-03-16,4060,1484,1986,3470,民雄,三等
2020-03-17,4060,1311,1346,2657,民雄,三等
2020-03-18,4060,1324,1344,2668,民雄,三等
2020-03-19,4060,1695,1306,3001,民雄,三等
2020-03-20,4060,3029,1969,4998,民雄,三等
2020-03-21,4060,1589,1441,3030,民雄,三等
2020-03-22,4060,1875,2354,4229,民雄,三等
2020-03-23,4060,1426,1812,3238,民雄,三等
2020-03-24,4060,1224,1313,2537,民雄,三等
2020-03-25,4060,1254,1208,2462,民雄,三等
2020-03-26,4060,1643,1240,2883,民雄,三等
2020-03-27,4060,2527,1734,4261,民雄,三等
2020-03-28,4060,1377,1258,2635,民雄,三等
2020-03-29,4060,1586,1638,3224,民雄,三等
2020-03-30,4060,1426,1475,2901,民雄,三等
2020-03-31,4060,2183,1322,3505,民雄,三等
2020-04-01,4060,2863,1918,4781,民雄,三等
2020-04-02,4060,1699,1495,3194,民雄,三等
2020-04-03,4060,1409,1269,2678,民雄,三等
2020-04-04,4060,1010,1003,2013,民雄,三等
2020-04-05,4060,1881,2094,3975,民雄,三等
2020-04-06,4060,1373,2184,3557,民雄,三等
2020-04-07,4060,1143,2061,3204,民雄,三等
2020-04-08,4060,1160,1272,2432,民雄,三等
2020-04-09,4060,1435,1162,2597,民雄,三等
2020-04-10,4060,2291,1541,3832,民雄,三等
2020-04-11,4060,1263,1160,2423,民雄,三等
2020-04-12,4060,1429,1771,3200,民雄,三等
2020-04-13,4060,1246,1519,2765,民雄,三等
2020-04-14,4060,1154,1167,2321,民雄,三等
2020-04-15,4060,1248,1161,2409,民雄,三等
2020-04-16,4060,1636,1295,2931,民雄,三等
2020-04-17,4060,2878,1835,4713,民雄,三等
2020-04-18,4060,1592,1438,3030,民雄,三等
2020-04-19,4060,1640,2138,3778,民雄,三等
2020-04-20,4060,1335,1732,3067,民雄,三等
2020-04-21,4060,1084,1148,2232,民雄,三等
2020-04-22,4060,1124,1133,2257,民雄,三等
2020-04-23,4060,1456,1163,2619,民雄,三等
2020-04-24,4060,2393,1569,3962,民雄,三等
2020-04-25,4060,1205,1146,2351,民雄,三等
2020-04-26,4060,1380,1795,3175,民雄,三等
2020-04-27,4060,1197,1594,2791,民雄,三等
2020-04-28,4060,1147,1203,2350,民雄,三等
2020-04-29,4060,1149,1139,2288,民雄,三等
2020-04-30,4060,1784,1380,3164,民雄,三等
2020-05-01,4060,3010,1927,4937,民雄,三等
2020-05-02,4060,1422,1248,2670,民雄,三等
2020-05-03,4060,1731,2363,4094,民雄,三等
2020-05-04,4060,1433,1879,3312,民雄,三等
2020-05-05,4060,1230,1248,2478,民雄,三等
2020-05-06,4060,1250,1213,2463,民雄,三等
2020-05-07,4060,1888,1295,3183,民雄,三等
2020-05-08,4060,3969,2128,6097,民雄,三等
2020-05-09,4060,1783,1571,3354,民雄,三等
2020-05-10,4060,1970,3078,5048,民雄,三等
2020-05-11,4060,1480,2138,3618,民雄,三等
2020-05-12,4060,1194,1282,2476,民雄,三等
2020-05-13,4060,1239,1230,2469,民雄,三等
2020-05-14,4060,1593,1200,2793,民雄,三等
2020-05-15,4060,2741,1917,4658,民雄,三等
2020-05-16,4060,1766,1518,3284,民雄,三等
2020-05-17,4060,1796,2245,4041,民雄,三等
2020-05-18,4060,1369,1822,3191,民雄,三等
2020-05-19,4060,1097,1213,2310,民雄,三等
2020-05-20,4060,1236,1188,2424,民雄,三等
2020-05-21,4060,1636,1153,2789,民雄,三等
2020-05-22,4060,2810,1681,4491,民雄,三等
2020-05-23,4060,1575,1320,2895,民雄,三等
2020-05-24,4060,2121,2666,4787,民雄,三等
2020-05-25,4060,1411,1884,3295,民雄,三等
2020-05-26,4060,1240,1198,2438,民雄,三等
2020-05-27,4060,1219,1228,2447,民雄,三等
2020-05-28,4060,1582,1246,2828,民雄,三等
2020-05-29,4060,3109,1907,5016,民雄,三等
2020-05-30,4060,1839,1584,3423,民雄,三等
2020-05-31,4060,2077,2649,4726,民雄,三等
2020-06-01,4060,1426,1879,3305,民雄,三等
2020-06-02,4060,1212,1254,2466,民雄,三等
2020-06-03,4060,1313,1249,2562,民雄,三等
2020-06-04,4060,1823,1326,3149,民雄,三等
2020-06-05,4060,3533,1892,5425,民雄,三等
2020-06-06,4060,1958,1730,3688,民雄,三等
2020-06-07,4060,1908,2935,4843,民雄,三等
2020-06-08,4060,1392,1958,3350,民雄,三等
2020-06-09,4060,1307,1373,2680,民雄,三等
2020-06-10,4060,1489,1360,2849,民雄,三等
2020-06-11,4060,1689,1412,3101,民雄,三等
2020-06-12,4060,2842,2169,5011,民雄,三等
2020-06-13,4060,1924,1746,3670,民雄,三等
2020-06-14,4060,2544,2417,4961,民雄,三等
2020-06-15,4060,1702,2015,3717,民雄,三等
2020-06-16,4060,1423,1424,2847,民雄,三等
2020-06-17,4060,1400,1336,2736,民雄,三等
2020-06-18,4060,1555,1334,2889,民雄,三等
2020-06-19,4060,2002,1569,3571,民雄,三等
2020-06-20,4060,1940,1733,3673,民雄,三等
2020-06-21,4060,2088,2107,4195,民雄,三等
2020-06-22,4060,1532,1671,3203,民雄,三等
2020-06-23,4060,1597,1523,3120,民雄,三等
2020-06-24,4060,2797,2256,5053,民雄,三等
2020-06-25,4060,2594,2003,4597,民雄,三等
2020-06-26,4060,1995,1767,3762,民雄,三等
2020-06-27,4060,1967,1688,3655,民雄,三等
2020-06-28,4060,2218,2343,4561,民雄,三等
2020-06-29,4060,1777,2045,3822,民雄,三等
2020-06-30,4060,1622,1556,3178,民雄,三等
2020-07-01,4060,1505,1460,2965,民雄,三等
2020-07-02,4060,1448,1402,2850,民雄,三等
2020-07-03,4060,2106,1711,3817,民雄,三等
2020-07-04,4060,1792,1587,3379,民雄,三等
2020-07-05,4060,1796,1627,3423,民雄,三等
2020-07-06,4060,1582,1604,3186,民雄,三等
2020-07-07,4060,1430,1480,2910,民雄,三等
2020-07-08,4060,1706,1585,3291,民雄,三等
2020-07-09,4060,1523,1443,2966,民雄,三等
2020-07-10,4060,1985,1747,3732,民雄,三等
2020-07-11,4060,1739,1536,3275,民雄,三等
2020-07-12,4060,1859,1757,3616,民雄,三等
2020-07-13,4060,1603,1761,3364,民雄,三等
2020-07-14,4060,1817,1732,3549,民雄,三等
2020-07-15,4060,1424,1421,2845,民雄,三等
2020-07-16,4060,1414,1390,2804,民雄,三等
2020-07-17,4060,1918,1758,3676,民雄,三等
2020-07-18,4060,1712,1693,3405,民雄,三等
2020-07-19,4060,1846,1796,3642,民雄,三等
2020-07-20,4060,1577,1656,3233,民雄,三等
2020-07-21,4060,1541,1453,2994,民雄,三等
2020-07-22,4060,1476,1418,2894,民雄,三等
2020-07-23,4060,1570,1402,2972,民雄,三等
2020-07-24,4060,2321,1819,4140,民雄,三等
2020-07-25,4060,1698,1604,3302,民雄,三等
2020-07-26,4060,2018,1785,3803,民雄,三等
2020-07-27,4060,1530,1616,3146,民雄,三等
2020-07-28,4060,1364,1421,2785,民雄,三等
2020-07-29,4060,1408,1362,2770,民雄,三等
2020-07-30,4060,1453,1435,2888,民雄,三等
2020-07-31,4060,2153,1739,3892,民雄,三等
2020-08-01,4060,1578,1482,3060,民雄,三等
2020-08-02,4060,1655,1735,3390,民雄,三等
2020-08-03,4060,1355,1479,2834,民雄,三等
2020-08-04,4060,1281,1338,2619,民雄,三等
2020-08-05,4060,1398,1327,2725,民雄,三等
2020-08-06,4060,1464,1485,2949,民雄,三等
2020-08-07,4060,2353,1883,4236,民雄,三等
2020-08-08,4060,1621,1641,3262,民雄,三等
2020-08-09,4060,2137,1996,4133,民雄,三等
2020-08-10,4060,1470,1702,3172,民雄,三等
2020-08-11,4060,1436,1379,2815,民雄,三等
2020-08-12,4060,1384,1369,2753,民雄,三等
2020-08-13,4060,1531,1447,2978,民雄,三等
2020-08-14,4060,2265,1890,4155,民雄,三等
2020-08-15,4060,1793,1630,3423,民雄,三等
2020-08-16,4060,1968,2096,4064,民雄,三等
2020-08-17,4060,1738,1761,3499,民雄,三等
2020-08-18,4060,1449,1442,2891,民雄,三等
2020-08-19,4060,1385,1397,2782,民雄,三等
2020-08-20,4060,1550,1495,3045,民雄,三等
2020-08-21,4060,2127,1739,3866,民雄,三等
2020-08-22,4060,1780,1600,3380,民雄,三等
2020-08-23,4060,1825,1839,3664,民雄,三等
2020-08-24,4060,1539,1706,3245,民雄,三等
2020-08-25,4060,1459,1402,2861,民雄,三等
2020-08-26,4060,1339,1323,2662,民雄,三等
2020-08-27,4060,1354,1271,2625,民雄,三等
2020-08-28,4060,1865,1796,3661,民雄,三等
2020-08-29,4060,1679,1528,3207,民雄,三等
2020-08-30,4060,1725,1748,3473,民雄,三等
2020-08-31,4060,1574,1777,3351,民雄,三等
2020-09-01,4060,1432,1464,2896,民雄,三等
2020-09-02,4060,1528,1499,3027,民雄,三等
2020-09-03,4060,1828,1421,3249,民雄,三等
2020-09-04,4060,2269,1969,4238,民雄,三等
2020-09-05,4060,1999,1829,3828,民雄,三等
2020-09-06,4060,2027,2694,4721,民雄,三等
2020-09-07,4060,1445,1726,3171,民雄,三等
2020-09-08,4060,3958,3977,7935,民雄,三等
2020-09-09,4060,5061,5263,10324,民雄,三等
2020-09-10,4060,4593,4677,9270,民雄,三等
2020-09-11,4060,3184,1969,5153,民雄,三等
2020-09-12,4060,2105,1736,3841,民雄,三等
2020-09-13,4060,2189,2760,4949,民雄,三等
2020-09-14,4060,1469,1926,3395,民雄,三等
2020-09-15,4060,1270,1366,2636,民雄,三等
2020-09-16,4060,1309,1283,2592,民雄,三等
2020-09-17,4060,1661,1320,2981,民雄,三等
2020-09-18,4060,3554,2210,5764,民雄,三等
2020-09-19,4060,2096,1799,3895,民雄,三等
2020-09-20,4060,2212,2992,5204,民雄,三等
2020-09-21,4060,1578,1931,3509,民雄,三等
2020-09-22,4060,1280,1365,2645,民雄,三等
2020-09-23,4060,1306,1298,2604,民雄,三等
2020-09-24,4060,1623,1398,3021,民雄,三等
2020-09-25,4060,2334,1757,4091,民雄,三等
2020-09-26,4060,2153,1681,3834,民雄,三等
2020-09-27,4060,1919,2347,4266,民雄,三等
2020-09-28,4060,1458,1752,3210,民雄,三等
2020-09-29,4060,1458,1380,2838,民雄,三等
2020-09-30,4060,4849,2493,7342,民雄,三等
2020-10-01,4060,3366,2159,5525,民雄,三等
2020-10-02,4060,1990,1942,3932,民雄,三等
2020-10-03,4060,2036,1935,3971,民雄,三等
2020-10-04,4060,2587,4510,7097,民雄,三等
2020-10-05,4060,1617,2282,3899,民雄,三等
2020-10-06,4060,1347,1394,2741,民雄,三等
2020-10-07,4060,1422,1395,2817,民雄,三等
2020-10-08,4060,3532,2137,5669,民雄,三等
2020-10-09,4060,3019,2111,5130,民雄,三等
2020-10-10,4060,1995,1702,3697,民雄,三等
2020-10-11,4060,2314,3322,5636,民雄,三等
2020-10-12,4060,1538,2101,3639,民雄,三等
2020-10-13,4060,1390,1414,2804,民雄,三等
2020-10-14,4060,1347,1336,2683,民雄,三等
2020-10-15,4060,1665,1404,3069,民雄,三等
2020-10-16,4060,3132,2143,5275,民雄,三等
2020-10-17,4060,2324,1958,4282,民雄,三等
2020-10-18,4060,2436,3130,5566,民雄,三等
2020-10-19,4060,1596,1957,3553,民雄,三等
2020-10-20,4060,1404,1506,2910,民雄,三等
2020-10-21,4060,1492,1452,2944,民雄,三等
2020-10-22,4060,1709,1479,3188,民雄,三等
2020-10-23,4060,3209,2386,5595,民雄,三等
2020-10-24,4060,2252,2407,4659,民雄,三等
2020-10-25,4060,2470,2693,5163,民雄,三等
2020-10-26,4060,1670,1997,3667,民雄,三等
2020-10-27,4060,1344,1345,2689,民雄,三等
2020-10-28,4060,1388,1387,2775,民雄,三等
2020-10-29,4060,1751,1432,3183,民雄,三等
2020-10-30,4060,3432,2143,5575,民雄,三等
2020-10-31,4060,2139,1941,4080,民雄,三等
2020-11-01,4060,2121,2877,4998,民雄,三等
2020-11-02,4060,1531,1976,3507,民雄,三等
2020-11-03,4060,1272,1362,2634,民雄,三等
2020-11-04,4060,1392,1373,2765,民雄,三等
2020-11-05,4060,1793,1395,3188,民雄,三等
2020-11-06,4060,3663,2257,5920,民雄,三等
2020-11-07,4060,2172,1906,4078,民雄,三等
2020-11-08,4060,2103,3067,5170,民雄,三等
2020-11-09,4060,1485,1992,3477,民雄,三等
2020-11-10,4060,1237,1328,2565,民雄,三等
2020-11-11,4060,1438,1438,2876,民雄,三等
2020-11-12,4060,1940,1500,3440,民雄,三等
2020-11-13,4060,3999,2333,6332,民雄,三等
2020-11-14,4060,2311,2033,4344,民雄,三等
2020-11-15,4060,2494,3568,6062,民雄,三等
2020-11-16,4060,1701,2161,3862,民雄,三等
2020-11-17,4060,1460,1527,2987,民雄,三等
2020-11-18,4060,1464,1475,2939,民雄,三等
2020-11-19,4060,1870,1589,3459,民雄,三等
2020-11-20,4060,3771,2466,6237,民雄,三等
2020-11-21,4060,2280,1969,4249,民雄,三等
2020-11-22,4060,2373,3007,5380,民雄,三等
2020-11-23,4060,1644,2065,3709,民雄,三等
2020-11-24,4060,1414,1409,2823,民雄,三等
2020-11-25,4060,1430,1407,2837,民雄,三等
2020-11-26,4060,1880,1523,3403,民雄,三等
2020-11-27,4060,3693,2301,5994,民雄,三等
2020-11-28,4060,2296,2100,4396,民雄,三等
2020-11-29,4060,2250,3243,5493,民雄,三等
2020-11-30,4060,1557,2032,3589,民雄,三等
2020-12-01,4060,1321,1445,2766,民雄,三等
2020-12-02,4060,1371,1325,2696,民雄,三等
2020-12-03,4060,1855,1402,3257,民雄,三等
2020-12-04,4060,3991,2309,6300,民雄,三等
2020-12-05,4060,2465,2021,4486,民雄,三等
2020-12-06,4060,2461,3477,5938,民雄,三等
2020-12-07,4060,1649,2244,3893,民雄,三等
2020-12-08,4060,1445,1505,2950,民雄,三等
2020-12-09,4060,1316,1307,2623,民雄,三等
2020-12-10,4060,1760,1417,3177,民雄,三等
2020-12-11,4060,3917,2312,6229,民雄,三等
2020-12-12,4060,2275,1945,4220,民雄,三等
2020-12-13,4060,2362,3504,5866,民雄,三等
2020-12-14,4060,1687,2197,3884,民雄,三等
2020-12-15,4060,1452,1482,2934,民雄,三等
2020-12-16,4060,1489,1466,2955,民雄,三等
2020-12-17,4060,1776,1521,3297,民雄,三等
2020-12-18,4060,3637,2405,6042,民雄,三等
2020-12-19,4060,2606,2268,4874,民雄,三等
2020-12-20,4060,2422,3201,5623,民雄,三等
2020-12-21,4060,1637,2133,3770,民雄,三等
2020-12-22,4060,1498,1516,3014,民雄,三等
2020-12-23,4060,1340,1327,2667,民雄,三等
2020-12-24,4060,1888,1544,3432,民雄,三等
2020-12-25,4060,3531,2346,5877,民雄,三等
2020-12-26,4060,2141,1854,3995,民雄,三等
2020-12-27,4060,2280,2793,5073,民雄,三等
2020-12-28,4060,1632,2110,3742,民雄,三等
2020-12-29,4060,1425,1422,2847,民雄,三等
2020-12-30,4060,1691,1533,3224,民雄,三等
2020-12-31,4060,4356,2282,6638,民雄,三等
2020-01-01,4070,764,787,1551,嘉北,簡易
2020-01-02,4070,828,916,1744,嘉北,簡易
2020-01-03,4070,1025,1109,2134,嘉北,簡易
2020-01-04,4070,762,762,1524,嘉北,簡易
2020-01-05,4070,777,759,1536,嘉北,簡易
2020-01-06,4070,984,1031,2015,嘉北,簡易
2020-01-07,4070,888,958,1846,嘉北,簡易
2020-01-08,4070,930,1003,1933,嘉北,簡易
2020-01-09,4070,848,920,1768,嘉北,簡易
2020-01-10,4070,1057,1274,2331,嘉北,簡易
2020-01-11,4070,836,858,1694,嘉北,簡易
2020-01-12,4070,856,844,1700,嘉北,簡易
2020-01-13,4070,1055,1092,2147,嘉北,簡易
2020-01-14,4070,899,957,1856,嘉北,簡易
2020-01-15,4070,884,954,1838,嘉北,簡易
2020-01-16,4070,918,1014,1932,嘉北,簡易
2020-01-17,4070,1086,1096,2182,嘉北,簡易
2020-01-18,4070,754,811,1565,嘉北,簡易
2020-01-19,4070,747,787,1534,嘉北,簡易
2020-01-20,4070,1104,1201,2305,嘉北,簡易
2020-01-21,4070,1011,1118,2129,嘉北,簡易
2020-01-22,4070,957,1124,2081,嘉北,簡易
2020-01-23,4070,970,1034,2004,嘉北,簡易
2020-01-24,4070,531,592,1123,嘉北,簡易
2020-01-25,4070,558,568,1126,嘉北,簡易
2020-01-26,4070,591,614,1205,嘉北,簡易
2020-01-27,4070,780,789,1569,嘉北,簡易
2020-01-28,4070,831,855,1686,嘉北,簡易
2020-01-29,4070,808,752,1560,嘉北,簡易
2020-01-30,4070,729,757,1486,嘉北,簡易
2020-01-31,4070,898,927,1825,嘉北,簡易
2020-02-01,4070,576,591,1167,嘉北,簡易
2020-02-02,4070,580,527,1107,嘉北,簡易
2020-02-03,4070,891,936,1827,嘉北,簡易
2020-02-04,4070,778,798,1576,嘉北,簡易
2020-02-05,4070,872,910,1782,嘉北,簡易
2020-02-06,4070,802,840,1642,嘉北,簡易
2020-02-07,4070,990,1029,2019,嘉北,簡易
2020-02-08,4070,582,587,1169,嘉北,簡易
2020-02-09,4070,655,680,1335,嘉北,簡易
2020-02-10,4070,974,1010,1984,嘉北,簡易
2020-02-11,4070,871,901,1772,嘉北,簡易
2020-02-12,4070,895,923,1818,嘉北,簡易
2020-02-13,4070,761,834,1595,嘉北,簡易
2020-02-14,4070,898,945,1843,嘉北,簡易
2020-02-15,4070,654,717,1371,嘉北,簡易
2020-02-16,4070,579,628,1207,嘉北,簡易
2020-02-17,4070,836,898,1734,嘉北,簡易
2020-02-18,4070,820,912,1732,嘉北,簡易
2020-02-19,4070,816,874,1690,嘉北,簡易
2020-02-20,4070,721,808,1529,嘉北,簡易
2020-02-21,4070,906,989,1895,嘉北,簡易
2020-02-22,4070,639,725,1364,嘉北,簡易
2020-02-23,4070,595,582,1177,嘉北,簡易
2020-02-24,4070,891,946,1837,嘉北,簡易
2020-02-25,4070,749,773,1522,嘉北,簡易
2020-02-26,4070,775,812,1587,嘉北,簡易
2020-02-27,4070,903,977,1880,嘉北,簡易
2020-02-28,4070,595,646,1241,嘉北,簡易
2020-02-29,4070,508,550,1058,嘉北,簡易
2020-03-01,4070,668,625,1293,嘉北,簡易
2020-03-02,4070,756,774,1530,嘉北,簡易
2020-03-03,4070,747,781,1528,嘉北,簡易
2020-03-04,4070,716,754,1470,嘉北,簡易
2020-03-05,4070,635,744,1379,嘉北,簡易
2020-03-06,4070,881,1029,1910,嘉北,簡易
2020-03-07,4070,592,642,1234,嘉北,簡易
2020-03-08,4070,685,610,1295,嘉北,簡易
2020-03-09,4070,835,836,1671,嘉北,簡易
2020-03-10,4070,635,708,1343,嘉北,簡易
2020-03-11,4070,698,781,1479,嘉北,簡易
2020-03-12,4070,681,742,1423,嘉北,簡易
2020-03-13,4070,830,981,1811,嘉北,簡易
2020-03-14,4070,523,562,1085,嘉北,簡易
2020-03-15,4070,704,655,1359,嘉北,簡易
2020-03-16,4070,820,850,1670,嘉北,簡易
2020-03-17,4070,701,773,1474,嘉北,簡易
2020-03-18,4070,733,808,1541,嘉北,簡易
2020-03-19,4070,627,718,1345,嘉北,簡易
2020-03-20,4070,792,933,1725,嘉北,簡易
2020-03-21,4070,519,579,1098,嘉北,簡易
2020-03-22,4070,555,527,1082,嘉北,簡易
2020-03-23,4070,699,731,1430,嘉北,簡易
2020-03-24,4070,652,704,1356,嘉北,簡易
2020-03-25,4070,629,657,1286,嘉北,簡易
2020-03-26,4070,566,621,1187,嘉北,簡易
2020-03-27,4070,701,839,1540,嘉北,簡易
2020-03-28,4070,428,474,902,嘉北,簡易
2020-03-29,4070,458,470,928,嘉北,簡易
2020-03-30,4070,719,764,1483,嘉北,簡易
2020-03-31,4070,658,741,1399,嘉北,簡易
2020-04-01,4070,756,870,1626,嘉北,簡易
2020-04-02,4070,565,716,1281,嘉北,簡易
2020-04-03,4070,438,515,953,嘉北,簡易
2020-04-04,4070,385,393,778,嘉北,簡易
2020-04-05,4070,553,474,1027,嘉北,簡易
2020-04-06,4070,697,729,1426,嘉北,簡易
2020-04-07,4070,613,624,1237,嘉北,簡易
2020-04-08,4070,620,653,1273,嘉北,簡易
2020-04-09,4070,581,640,1221,嘉北,簡易
2020-04-10,4070,723,782,1505,嘉北,簡易
2020-04-11,4070,400,440,840,嘉北,簡易
2020-04-12,4070,478,437,915,嘉北,簡易
2020-04-13,4070,680,740,1420,嘉北,簡易
2020-04-14,4070,621,687,1308,嘉北,簡易
2020-04-15,4070,666,716,1382,嘉北,簡易
2020-04-16,4070,587,621,1208,嘉北,簡易
2020-04-17,4070,730,844,1574,嘉北,簡易
2020-04-18,4070,485,514,999,嘉北,簡易
2020-04-19,4070,516,455,971,嘉北,簡易
2020-04-20,4070,692,705,1397,嘉北,簡易
2020-04-21,4070,598,628,1226,嘉北,簡易
2020-04-22,4070,594,648,1242,嘉北,簡易
2020-04-23,4070,557,621,1178,嘉北,簡易
2020-04-24,4070,709,810,1519,嘉北,簡易
2020-04-25,4070,397,474,871,嘉北,簡易
2020-04-26,4070,490,433,923,嘉北,簡易
2020-04-27,4070,695,722,1417,嘉北,簡易
2020-04-28,4070,610,630,1240,嘉北,簡易
2020-04-29,4070,653,701,1354,嘉北,簡易
2020-04-30,4070,638,707,1345,嘉北,簡易
2020-05-01,4070,519,625,1144,嘉北,簡易
2020-05-02,4070,429,496,925,嘉北,簡易
2020-05-03,4070,472,452,924,嘉北,簡易
2020-05-04,4070,704,732,1436,嘉北,簡易
2020-05-05,4070,613,647,1260,嘉北,簡易
2020-05-06,4070,627,670,1297,嘉北,簡易
2020-05-07,4070,611,690,1301,嘉北,簡易
2020-05-08,4070,824,981,1805,嘉北,簡易
2020-05-09,4070,519,620,1139,嘉北,簡易
2020-05-10,4070,666,562,1228,嘉北,簡易
2020-05-11,4070,768,780,1548,嘉北,簡易
2020-05-12,4070,692,714,1406,嘉北,簡易
2020-05-13,4070,702,748,1450,嘉北,簡易
2020-05-14,4070,616,710,1326,嘉北,簡易
2020-05-15,4070,806,943,1749,嘉北,簡易
2020-05-16,4070,571,593,1164,嘉北,簡易
2020-05-17,4070,578,595,1173,嘉北,簡易
2020-05-18,4070,738,752,1490,嘉北,簡易
2020-05-19,4070,619,621,1240,嘉北,簡易
2020-05-20,4070,620,665,1285,嘉北,簡易
2020-05-21,4070,601,633,1234,嘉北,簡易
2020-05-22,4070,710,786,1496,嘉北,簡易
2020-05-23,4070,511,575,1086,嘉北,簡易
2020-05-24,4070,597,590,1187,嘉北,簡易
2020-05-25,4070,771,792,1563,嘉北,簡易
2020-05-26,4070,659,690,1349,嘉北,簡易
2020-05-27,4070,665,693,1358,嘉北,簡易
2020-05-28,4070,655,706,1361,嘉北,簡易
2020-05-29,4070,813,938,1751,嘉北,簡易
2020-05-30,4070,624,643,1267,嘉北,簡易
2020-05-31,4070,732,666,1398,嘉北,簡易
2020-06-01,4070,821,813,1634,嘉北,簡易
2020-06-02,4070,649,686,1335,嘉北,簡易
2020-06-03,4070,687,766,1453,嘉北,簡易
2020-06-04,4070,653,734,1387,嘉北,簡易
2020-06-05,4070,813,910,1723,嘉北,簡易
2020-06-06,4070,610,695,1305,嘉北,簡易
2020-06-07,4070,574,567,1141,嘉北,簡易
2020-06-08,4070,737,744,1481,嘉北,簡易
2020-06-09,4070,715,792,1507,嘉北,簡易
2020-06-10,4070,756,814,1570,嘉北,簡易
2020-06-11,4070,686,766,1452,嘉北,簡易
2020-06-12,4070,911,990,1901,嘉北,簡易
2020-06-13,4070,631,670,1301,嘉北,簡易
2020-06-14,4070,624,674,1298,嘉北,簡易
2020-06-15,4070,887,921,1808,嘉北,簡易
2020-06-16,4070,748,774,1522,嘉北,簡易
2020-06-17,4070,721,768,1489,嘉北,簡易
2020-06-18,4070,747,814,1561,嘉北,簡易
2020-06-19,4070,811,913,1724,嘉北,簡易
2020-06-20,4070,635,692,1327,嘉北,簡易
2020-06-21,4070,925,1041,1966,嘉北,簡易
2020-06-22,4070,837,891,1728,嘉北,簡易
2020-06-23,4070,779,838,1617,嘉北,簡易
2020-06-24,4070,842,993,1835,嘉北,簡易
2020-06-25,4070,582,707,1289,嘉北,簡易
2020-06-26,4070,788,822,1610,嘉北,簡易
2020-06-27,4070,657,630,1287,嘉北,簡易
2020-06-28,4070,726,703,1429,嘉北,簡易
2020-06-29,4070,917,933,1850,嘉北,簡易
2020-06-30,4070,814,845,1659,嘉北,簡易
2020-07-01,4070,776,803,1579,嘉北,簡易
2020-07-02,4070,707,748,1455,嘉北,簡易
2020-07-03,4070,865,880,1745,嘉北,簡易
2020-07-04,4070,632,668,1300,嘉北,簡易
2020-07-05,4070,587,641,1228,嘉北,簡易
2020-07-06,4070,894,901,1795,嘉北,簡易
2020-07-07,4070,859,890,1749,嘉北,簡易
2020-07-08,4070,788,873,1661,嘉北,簡易
2020-07-09,4070,768,831,1599,嘉北,簡易
2020-07-10,4070,889,888,1777,嘉北,簡易
2020-07-11,4070,629,637,1266,嘉北,簡易
2020-07-12,4070,667,686,1353,嘉北,簡易
2020-07-13,4070,902,986,1888,嘉北,簡易
2020-07-14,4070,849,899,1748,嘉北,簡易
2020-07-15,4070,811,864,1675,嘉北,簡易
2020-07-16,4070,785,821,1606,嘉北,簡易
2020-07-17,4070,906,966,1872,嘉北,簡易
2020-07-18,4070,634,722,1356,嘉北,簡易
2020-07-19,4070,660,671,1331,嘉北,簡易
2020-07-20,4070,865,878,1743,嘉北,簡易
2020-07-21,4070,821,882,1703,嘉北,簡易
2020-07-22,4070,852,878,1730,嘉北,簡易
2020-07-23,4070,813,829,1642,嘉北,簡易
2020-07-24,4070,916,977,1893,嘉北,簡易
2020-07-25,4070,778,765,1543,嘉北,簡易
2020-07-26,4070,648,680,1328,嘉北,簡易
2020-07-27,4070,868,909,1777,嘉北,簡易
2020-07-28,4070,779,806,1585,嘉北,簡易
2020-07-29,4070,762,815,1577,嘉北,簡易
2020-07-30,4070,782,828,1610,嘉北,簡易
2020-07-31,4070,911,934,1845,嘉北,簡易
2020-08-01,4070,625,692,1317,嘉北,簡易
2020-08-02,4070,609,634,1243,嘉北,簡易
2020-08-03,4070,826,846,1672,嘉北,簡易
2020-08-04,4070,752,768,1520,嘉北,簡易
2020-08-05,4070,780,823,1603,嘉北,簡易
2020-08-06,4070,835,890,1725,嘉北,簡易
2020-08-07,4070,964,1006,1970,嘉北,簡易
2020-08-08,4070,695,716,1411,嘉北,簡易
2020-08-09,4070,648,719,1367,嘉北,簡易
2020-08-10,4070,801,828,1629,嘉北,簡易
2020-08-11,4070,803,835,1638,嘉北,簡易
2020-08-12,4070,762,818,1580,嘉北,簡易
2020-08-13,4070,783,834,1617,嘉北,簡易
2020-08-14,4070,943,983,1926,嘉北,簡易
2020-08-15,4070,669,726,1395,嘉北,簡易
2020-08-16,4070,737,689,1426,嘉北,簡易
2020-08-17,4070,990,1018,2008,嘉北,簡易
2020-08-18,4070,853,874,1727,嘉北,簡易
2020-08-19,4070,786,835,1621,嘉北,簡易
2020-08-20,4070,785,812,1597,嘉北,簡易
2020-08-21,4070,920,981,1901,嘉北,簡易
2020-08-22,4070,648,716,1364,嘉北,簡易
2020-08-23,4070,663,622,1285,嘉北,簡易
2020-08-24,4070,880,930,1810,嘉北,簡易
2020-08-25,4070,869,928,1797,嘉北,簡易
2020-08-26,4070,813,837,1650,嘉北,簡易
2020-08-27,4070,762,801,1563,嘉北,簡易
2020-08-28,4070,942,1009,1951,嘉北,簡易
2020-08-29,4070,666,688,1354,嘉北,簡易
2020-08-30,4070,601,631,1232,嘉北,簡易
2020-08-31,4070,895,943,1838,嘉北,簡易
2020-09-01,4070,833,857,1690,嘉北,簡易
2020-09-02,4070,809,807,1616,嘉北,簡易
2020-09-03,4070,812,831,1643,嘉北,簡易
2020-09-04,4070,968,1015,1983,嘉北,簡易
2020-09-05,4070,683,717,1400,嘉北,簡易
2020-09-06,4070,716,729,1445,嘉北,簡易
2020-09-07,4070,852,898,1750,嘉北,簡易
2020-09-08,4070,1165,1166,2331,嘉北,簡易
2020-09-09,4070,1240,1307,2547,嘉北,簡易
2020-09-10,4070,1096,1091,2187,嘉北,簡易
2020-09-11,4070,953,1030,1983,嘉北,簡易
2020-09-12,4070,738,756,1494,嘉北,簡易
2020-09-13,4070,782,758,1540,嘉北,簡易
2020-09-14,4070,868,917,1785,嘉北,簡易
2020-09-15,4070,815,819,1634,嘉北,簡易
2020-09-16,4070,793,828,1621,嘉北,簡易
2020-09-17,4070,744,781,1525,嘉北,簡易
2020-09-18,4070,903,1060,1963,嘉北,簡易
2020-09-19,4070,745,789,1534,嘉北,簡易
2020-09-20,4070,772,758,1530,嘉北,簡易
2020-09-21,4070,849,867,1716,嘉北,簡易
2020-09-22,4070,767,803,1570,嘉北,簡易
2020-09-23,4070,755,789,1544,嘉北,簡易
2020-09-24,4070,737,795,1532,嘉北,簡易
2020-09-25,4070,835,891,1726,嘉北,簡易
2020-09-26,4070,691,729,1420,嘉北,簡易
2020-09-27,4070,727,736,1463,嘉北,簡易
2020-09-28,4070,869,957,1826,嘉北,簡易
2020-09-29,4070,796,857,1653,嘉北,簡易
2020-09-30,4070,982,1149,2131,嘉北,簡易
2020-10-01,4070,718,930,1648,嘉北,簡易
2020-10-02,4070,734,784,1518,嘉北,簡易
2020-10-03,4070,656,673,1329,嘉北,簡易
2020-10-04,4070,878,729,1607,嘉北,簡易
2020-10-05,4070,928,924,1852,嘉北,簡易
2020-10-06,4070,842,867,1709,嘉北,簡易
2020-10-07,4070,819,872,1691,嘉北,簡易
2020-10-08,4070,821,1024,1845,嘉北,簡易
2020-10-09,4070,1009,1074,2083,嘉北,簡易
2020-10-10,4070,686,719,1405,嘉北,簡易
2020-10-11,4070,803,719,1522,嘉北,簡易
2020-10-12,4070,901,946,1847,嘉北,簡易
2020-10-13,4070,820,875,1695,嘉北,簡易
2020-10-14,4070,793,825,1618,嘉北,簡易
2020-10-15,4070,764,795,1559,嘉北,簡易
2020-10-16,4070,940,1100,2040,嘉北,簡易
2020-10-17,4070,770,860,1630,嘉北,簡易
2020-10-18,4070,802,817,1619,嘉北,簡易
2020-10-19,4070,931,982,1913,嘉北,簡易
2020-10-20,4070,858,866,1724,嘉北,簡易
2020-10-21,4070,795,866,1661,嘉北,簡易
2020-10-22,4070,785,812,1597,嘉北,簡易
2020-10-23,4070,916,1022,1938,嘉北,簡易
2020-10-24,4070,712,790,1502,嘉北,簡易
2020-10-25,4070,735,684,1419,嘉北,簡易
2020-10-26,4070,930,928,1858,嘉北,簡易
2020-10-27,4070,787,835,1622,嘉北,簡易
2020-10-28,4070,786,872,1658,嘉北,簡易
2020-10-29,4070,777,809,1586,嘉北,簡易
2020-10-30,4070,911,1043,1954,嘉北,簡易
2020-10-31,4070,710,799,1509,嘉北,簡易
2020-11-01,4070,748,711,1459,嘉北,簡易
2020-11-02,4070,878,880,1758,嘉北,簡易
2020-11-03,4070,745,792,1537,嘉北,簡易
2020-11-04,4070,790,856,1646,嘉北,簡易
2020-11-05,4070,797,847,1644,嘉北,簡易
2020-11-06,4070,937,1085,2022,嘉北,簡易
2020-11-07,4070,672,711,1383,嘉北,簡易
2020-11-08,4070,770,736,1506,嘉北,簡易
2020-11-09,4070,835,852,1687,嘉北,簡易
2020-11-10,4070,773,778,1551,嘉北,簡易
2020-11-11,4070,798,849,1647,嘉北,簡易
2020-11-12,4070,763,827,1590,嘉北,簡易
2020-11-13,4070,949,1111,2060,嘉北,簡易
2020-11-14,4070,723,801,1524,嘉北,簡易
2020-11-15,4070,792,788,1580,嘉北,簡易
2020-11-16,4070,957,947,1904,嘉北,簡易
2020-11-17,4070,856,909,1765,嘉北,簡易
2020-11-18,4070,770,826,1596,嘉北,簡易
2020-11-19,4070,852,890,1742,嘉北,簡易
2020-11-20,4070,975,1136,2111,嘉北,簡易
2020-11-21,4070,744,799,1543,嘉北,簡易
2020-11-22,4070,758,746,1504,嘉北,簡易
2020-11-23,4070,906,927,1833,嘉北,簡易
2020-11-24,4070,797,833,1630,嘉北,簡易
2020-11-25,4070,855,898,1753,嘉北,簡易
2020-11-26,4070,828,867,1695,嘉北,簡易
2020-11-27,4070,967,1064,2031,嘉北,簡易
2020-11-28,4070,760,874,1634,嘉北,簡易
2020-11-29,4070,781,736,1517,嘉北,簡易
2020-11-30,4070,929,904,1833,嘉北,簡易
2020-12-01,4070,748,829,1577,嘉北,簡易
2020-12-02,4070,765,826,1591,嘉北,簡易
2020-12-03,4070,774,800,1574,嘉北,簡易
2020-12-04,4070,912,1034,1946,嘉北,簡易
2020-12-05,4070,708,798,1506,嘉北,簡易
2020-12-06,4070,765,723,1488,嘉北,簡易
2020-12-07,4070,891,911,1802,嘉北,簡易
2020-12-08,4070,827,845,1672,嘉北,簡易
2020-12-09,4070,771,811,1582,嘉北,簡易
2020-12-10,4070,734,788,1522,嘉北,簡易
2020-12-11,4070,963,1092,2055,嘉北,簡易
2020-12-12,4070,810,806,1616,嘉北,簡易
2020-12-13,4070,772,742,1514,嘉北,簡易
2020-12-14,4070,882,904,1786,嘉北,簡易
2020-12-15,4070,828,864,1692,嘉北,簡易
2020-12-16,4070,769,839,1608,嘉北,簡易
2020-12-17,4070,763,809,1572,嘉北,簡易
2020-12-18,4070,963,1139,2102,嘉北,簡易
2020-12-19,4070,860,941,1801,嘉北,簡易
2020-12-20,4070,748,770,1518,嘉北,簡易
2020-12-21,4070,820,820,1640,嘉北,簡易
2020-12-22,4070,801,808,1609,嘉北,簡易
2020-12-23,4070,721,755,1476,嘉北,簡易
2020-12-24,4070,742,790,1532,嘉北,簡易
2020-12-25,4070,948,1081,2029,嘉北,簡易
2020-12-26,4070,721,775,1496,嘉北,簡易
2020-12-27,4070,721,666,1387,嘉北,簡易
2020-12-28,4070,826,862,1688,嘉北,簡易
2020-12-29,4070,793,831,1624,嘉北,簡易
2020-12-30,4070,770,844,1614,嘉北,簡易
2020-12-31,4070,976,1044,2020,嘉北,簡易
2020-01-01,4080,12112,11891,24003,嘉義,一等
2020-01-02,4080,8215,8246,16461,嘉義,一等
2020-01-03,4080,9893,10912,20805,嘉義,一等
2020-01-04,4080,9464,9824,19288,嘉義,一等
2020-01-05,4080,12070,10408,22478,嘉義,一等
2020-01-06,4080,8843,8482,17325,嘉義,一等
2020-01-07,4080,7660,7579,15239,嘉義,一等
2020-01-08,4080,7970,7612,15582,嘉義,一等
2020-01-09,4080,8909,8744,17653,嘉義,一等
2020-01-10,4080,13234,16671,29905,嘉義,一等
2020-01-11,4080,13646,14152,27798,嘉義,一等
2020-01-12,4080,15631,12756,28387,嘉義,一等
2020-01-13,4080,10366,9703,20069,嘉義,一等
2020-01-14,4080,8680,8467,17147,嘉義,一等
2020-01-15,4080,8682,8495,17177,嘉義,一等
2020-01-16,4080,10418,10087,20505,嘉義,一等
2020-01-17,4080,10937,11412,22349,嘉義,一等
2020-01-18,4080,10695,11099,21794,嘉義,一等
2020-01-19,4080,11605,10800,22405,嘉義,一等
2020-01-20,4080,10459,10599,21058,嘉義,一等
2020-01-21,4080,10183,11006,21189,嘉義,一等
2020-01-22,4080,11146,13381,24527,嘉義,一等
2020-01-23,4080,9932,13404,23336,嘉義,一等
2020-01-24,4080,7673,10452,18125,嘉義,一等
2020-01-25,4080,11666,11918,23584,嘉義,一等
2020-01-26,4080,12653,12115,24768,嘉義,一等
2020-01-27,4080,15292,13755,29047,嘉義,一等
2020-01-28,4080,13734,11279,25013,嘉義,一等
2020-01-29,4080,12278,9965,22243,嘉義,一等
2020-01-30,4080,9877,9060,18937,嘉義,一等
2020-01-31,4080,9762,9770,19532,嘉義,一等
2020-02-01,4080,8704,8719,17423,嘉義,一等
2020-02-02,4080,9499,8454,17953,嘉義,一等
2020-02-03,4080,8946,9157,18103,嘉義,一等
2020-02-04,4080,8195,8119,16314,嘉義,一等
2020-02-05,4080,8325,8394,16719,嘉義,一等
2020-02-06,4080,8158,8304,16462,嘉義,一等
2020-02-07,4080,9868,10502,20370,嘉義,一等
2020-02-08,4080,8584,9329,17913,嘉義,一等
2020-02-09,4080,10863,9633,20496,嘉義,一等
2020-02-10,4080,8929,8826,17755,嘉義,一等
2020-02-11,4080,7929,7947,15876,嘉義,一等
2020-02-12,4080,8400,8280,16680,嘉義,一等
2020-02-13,4080,7808,7784,15592,嘉義,一等
2020-02-14,4080,9464,9791,19255,嘉義,一等
2020-02-15,4080,9114,9742,18856,嘉義,一等
2020-02-16,4080,10186,9544,19730,嘉義,一等
2020-02-17,4080,8041,8194,16235,嘉義,一等
2020-02-18,4080,7626,7544,15170,嘉義,一等
2020-02-19,4080,7721,7850,15571,嘉義,一等
2020-02-20,4080,7807,7819,15626,嘉義,一等
2020-02-21,4080,9326,10364,19690,嘉義,一等
2020-02-22,4080,8736,9588,18324,嘉義,一等
2020-02-23,4080,10524,8979,19503,嘉義,一等
2020-02-24,4080,8605,8333,16938,嘉義,一等
2020-02-25,4080,7313,7040,14353,嘉義,一等
2020-02-26,4080,7500,7306,14806,嘉義,一等
2020-02-27,4080,9519,11226,20745,嘉義,一等
2020-02-28,4080,9899,11535,21434,嘉義,一等
2020-02-29,4080,9208,8865,18073,嘉義,一等
2020-03-01,4080,12969,9964,22933,嘉義,一等
2020-03-02,4080,7776,7250,15026,嘉義,一等
2020-03-03,4080,6594,6454,13048,嘉義,一等
2020-03-04,4080,6648,6506,13154,嘉義,一等
2020-03-05,4080,6629,6707,13336,嘉義,一等
2020-03-06,4080,10062,11657,21719,嘉義,一等
2020-03-07,4080,8494,9411,17905,嘉義,一等
2020-03-08,4080,11972,9790,21762,嘉義,一等
2020-03-09,4080,8046,7499,15545,嘉義,一等
2020-03-10,4080,6450,6401,12851,嘉義,一等
2020-03-11,4080,6913,6769,13682,嘉義,一等
2020-03-12,4080,7189,7181,14370,嘉義,一等
2020-03-13,4080,10182,12183,22365,嘉義,一等
2020-03-14,4080,7803,8912,16715,嘉義,一等
2020-03-15,4080,12884,10488,23372,嘉義,一等
2020-03-16,4080,8143,7655,15798,嘉義,一等
2020-03-17,4080,6891,6671,13562,嘉義,一等
2020-03-18,4080,6527,6434,12961,嘉義,一等
2020-03-19,4080,6588,6625,13213,嘉義,一等
2020-03-20,4080,9334,11084,20418,嘉義,一等
2020-03-21,4080,7620,8150,15770,嘉義,一等
2020-03-22,4080,10581,8427,19008,嘉義,一等
2020-03-23,4080,7115,6599,13714,嘉義,一等
2020-03-24,4080,6268,6012,12280,嘉義,一等
2020-03-25,4080,6080,6109,12189,嘉義,一等
2020-03-26,4080,6191,6370,12561,嘉義,一等
2020-03-27,4080,8838,9597,18435,嘉義,一等
2020-03-28,4080,6618,7061,13679,嘉義,一等
2020-03-29,4080,8931,6906,15837,嘉義,一等
2020-03-30,4080,6975,6396,13371,嘉義,一等
2020-03-31,4080,6273,6742,13015,嘉義,一等
2020-04-01,4080,8651,11365,20016,嘉義,一等
2020-04-02,4080,7000,9950,16950,嘉義,一等
2020-04-03,4080,6985,8201,15186,嘉義,一等
2020-04-04,4080,6801,5734,12535,嘉義,一等
2020-04-05,4080,11462,8249,19711,嘉義,一等
2020-04-06,4080,7841,6391,14232,嘉義,一等
2020-04-07,4080,5783,5441,11224,嘉義,一等
2020-04-08,4080,5466,5333,10799,嘉義,一等
2020-04-09,4080,5679,5702,11381,嘉義,一等
2020-04-10,4080,7497,8437,15934,嘉義,一等
2020-04-11,4080,5616,6331,11947,嘉義,一等
2020-04-12,4080,8068,6533,14601,嘉義,一等
2020-04-13,4080,6354,5922,12276,嘉義,一等
2020-04-14,4080,5559,5437,10996,嘉義,一等
2020-04-15,4080,5841,5648,11489,嘉義,一等
2020-04-16,4080,6062,6236,12298,嘉義,一等
2020-04-17,4080,8867,10354,19221,嘉義,一等
2020-04-18,4080,6860,7344,14204,嘉義,一等
2020-04-19,4080,9361,7613,16974,嘉義,一等
2020-04-20,4080,7120,6552,13672,嘉義,一等
2020-04-21,4080,5461,5258,10719,嘉義,一等
2020-04-22,4080,5460,5283,10743,嘉義,一等
2020-04-23,4080,5454,5549,11003,嘉義,一等
2020-04-24,4080,7465,8697,16162,嘉義,一等
2020-04-25,4080,5391,5999,11390,嘉義,一等
2020-04-26,4080,7622,6213,13835,嘉義,一等
2020-04-27,4080,6502,5361,11863,嘉義,一等
2020-04-28,4080,5590,5307,10897,嘉義,一等
2020-04-29,4080,5647,5527,11174,嘉義,一等
2020-04-30,4080,6515,7445,13960,嘉義,一等
2020-05-01,4080,8718,10606,19324,嘉義,一等
2020-05-02,4080,6489,6662,13151,嘉義,一等
2020-05-03,4080,10336,8144,18480,嘉義,一等
2020-05-04,4080,7418,6599,14017,嘉義,一等
2020-05-05,4080,5989,5815,11804,嘉義,一等
2020-05-06,4080,5996,5848,11844,嘉義,一等
2020-05-07,4080,6476,6757,13233,嘉義,一等
2020-05-08,4080,10296,12624,22920,嘉義,一等
2020-05-09,4080,7330,9109,16439,嘉義,一等
2020-05-10,4080,11987,9450,21437,嘉義,一等
2020-05-11,4080,8299,7399,15698,嘉義,一等
2020-05-12,4080,6384,6037,12421,嘉義,一等
2020-05-13,4080,6656,6315,12971,嘉義,一等
2020-05-14,4080,6637,6734,13371,嘉義,一等
2020-05-15,4080,9537,10911,20448,嘉義,一等
2020-05-16,4080,7579,8206,15785,嘉義,一等
2020-05-17,4080,10594,9093,19687,嘉義,一等
2020-05-18,4080,7461,6808,14269,嘉義,一等
2020-05-19,4080,5588,5733,11321,嘉義,一等
2020-05-20,4080,5834,5782,11616,嘉義,一等
2020-05-21,4080,6065,6113,12178,嘉義,一等
2020-05-22,4080,8159,9679,17838,嘉義,一等
2020-05-23,4080,7060,7592,14652,嘉義,一等
2020-05-24,4080,11399,9580,20979,嘉義,一等
2020-05-25,4080,7808,7297,15105,嘉義,一等
2020-05-26,4080,6128,5935,12063,嘉義,一等
2020-05-27,4080,6007,5854,11861,嘉義,一等
2020-05-28,4080,6366,6597,12963,嘉義,一等
2020-05-29,4080,9484,11141,20625,嘉義,一等
2020-05-30,4080,8779,9640,18419,嘉義,一等
2020-05-31,4080,11787,9948,21735,嘉義,一等
2020-06-01,4080,7656,7177,14833,嘉義,一等
2020-06-02,4080,6656,6457,13113,嘉義,一等
2020-06-03,4080,6479,6379,12858,嘉義,一等
2020-06-04,4080,7084,7017,14101,嘉義,一等
2020-06-05,4080,10544,10995,21539,嘉義,一等
2020-06-06,4080,9149,9905,19054,嘉義,一等
2020-06-07,4080,11631,10640,22271,嘉義,一等
2020-06-08,4080,7799,7394,15193,嘉義,一等
2020-06-09,4080,6814,6611,13425,嘉義,一等
2020-06-10,4080,7058,6954,14012,嘉義,一等
2020-06-11,4080,7484,7388,14872,嘉義,一等
2020-06-12,4080,10363,11634,21997,嘉義,一等
2020-06-13,4080,9723,10482,20205,嘉義,一等
2020-06-14,4080,13133,11351,24484,嘉義,一等
2020-06-15,4080,9426,8492,17918,嘉義,一等
2020-06-16,4080,7186,7140,14326,嘉義,一等
2020-06-17,4080,7115,7031,14146,嘉義,一等
2020-06-18,4080,7417,7512,14929,嘉義,一等
2020-06-19,4080,8886,9549,18435,嘉義,一等
2020-06-20,4080,9042,11076,20118,嘉義,一等
2020-06-21,4080,20560,20360,40920,嘉義,一等
2020-06-22,4080,9729,8115,17844,嘉義,一等
2020-06-23,4080,8071,8174,16245,嘉義,一等
2020-06-24,4080,11155,13897,25052,嘉義,一等
2020-06-25,4080,10346,13440,23786,嘉義,一等
2020-06-26,4080,11789,12153,23942,嘉義,一等
2020-06-27,4080,12178,10555,22733,嘉義,一等
2020-06-28,4080,14270,11304,25574,嘉義,一等
2020-06-29,4080,9772,8627,18399,嘉義,一等
2020-06-30,4080,8069,7869,15938,嘉義,一等
2020-07-01,4080,7665,7359,15024,嘉義,一等
2020-07-02,4080,7581,7476,15057,嘉義,一等
2020-07-03,4080,9316,10078,19394,嘉義,一等
2020-07-04,4080,9409,9605,19014,嘉義,一等
2020-07-05,4080,10234,9886,20120,嘉義,一等
2020-07-06,4080,8385,8402,16787,嘉義,一等
2020-07-07,4080,8223,8115,16338,嘉義,一等
2020-07-08,4080,9138,8428,17566,嘉義,一等
2020-07-09,4080,8677,8246,16923,嘉義,一等
2020-07-10,4080,10228,10910,21138,嘉義,一等
2020-07-11,4080,10139,10622,20761,嘉義,一等
2020-07-12,4080,12149,11284,23433,嘉義,一等
2020-07-13,4080,8892,8798,17690,嘉義,一等
2020-07-14,4080,9362,8779,18141,嘉義,一等
2020-07-15,4080,8615,8942,17557,嘉義,一等
2020-07-16,4080,8881,9048,17929,嘉義,一等
2020-07-17,4080,11436,12007,23443,嘉義,一等
2020-07-18,4080,10375,11324,21699,嘉義,一等
2020-07-19,4080,12293,11316,23609,嘉義,一等
2020-07-20,4080,9797,9556,19353,嘉義,一等
2020-07-21,4080,8511,8774,17285,嘉義,一等
2020-07-22,4080,9499,9165,18664,嘉義,一等
2020-07-23,4080,9001,9332,18333,嘉義,一等
2020-07-24,4080,11179,11831,23010,嘉義,一等
2020-07-25,4080,10526,11246,21772,嘉義,一等
2020-07-26,4080,11830,11115,22945,嘉義,一等
2020-07-27,4080,9418,9637,19055,嘉義,一等
2020-07-28,4080,8497,8183,16680,嘉義,一等
2020-07-29,4080,8753,8397,17150,嘉義,一等
2020-07-30,4080,8567,8467,17034,嘉義,一等
2020-07-31,4080,10959,11364,22323,嘉義,一等
2020-08-01,4080,10149,10536,20685,嘉義,一等
2020-08-02,4080,11079,10292,21371,嘉義,一等
2020-08-03,4080,8045,8017,16062,嘉義,一等
2020-08-04,4080,7436,7348,14784,嘉義,一等
2020-08-05,4080,7974,8122,16096,嘉義,一等
2020-08-06,4080,8597,8673,17270,嘉義,一等
2020-08-07,4080,10963,12406,23369,嘉義,一等
2020-08-08,4080,9641,10833,20474,嘉義,一等
2020-08-09,4080,12938,11166,24104,嘉義,一等
2020-08-10,4080,9443,8680,18123,嘉義,一等
2020-08-11,4080,7993,7917,15910,嘉義,一等
2020-08-12,4080,8326,8452,16778,嘉義,一等
2020-08-13,4080,8928,8975,17903,嘉義,一等
2020-08-14,4080,11604,11644,23248,嘉義,一等
2020-08-15,4080,11027,11599,22626,嘉義,一等
2020-08-16,4080,13158,11904,25062,嘉義,一等
2020-08-17,4080,9862,10286,20148,嘉義,一等
2020-08-18,4080,8866,9187,18053,嘉義,一等
2020-08-19,4080,8854,8710,17564,嘉義,一等
2020-08-20,4080,9092,9069,18161,嘉義,一等
2020-08-21,4080,11501,11987,23488,嘉義,一等
2020-08-22,4080,10370,10884,21254,嘉義,一等
2020-08-23,4080,11593,10557,22150,嘉義,一等
2020-08-24,4080,9631,9789,19420,嘉義,一等
2020-08-25,4080,9350,9119,18469,嘉義,一等
2020-08-26,4080,8464,8325,16789,嘉義,一等
2020-08-27,4080,8061,8409,16470,嘉義,一等
2020-08-28,4080,10063,10858,20921,嘉義,一等
2020-08-29,4080,9462,9898,19360,嘉義,一等
2020-08-30,4080,10627,9769,20396,嘉義,一等
2020-08-31,4080,8451,8487,16938,嘉義,一等
2020-09-01,4080,7372,7640,15012,嘉義,一等
2020-09-02,4080,7680,7511,15191,嘉義,一等
2020-09-03,4080,8362,8054,16416,嘉義,一等
2020-09-04,4080,10103,10801,20904,嘉義,一等
2020-09-05,4080,9903,10480,20383,嘉義,一等
2020-09-06,4080,12115,10824,22939,嘉義,一等
2020-09-07,4080,8594,8478,17072,嘉義,一等
2020-09-08,4080,9319,8470,17789,嘉義,一等
2020-09-09,4080,9680,9567,19247,嘉義,一等
2020-09-10,4080,9111,9293,18404,嘉義,一等
2020-09-11,4080,10860,11556,22416,嘉義,一等
2020-09-12,4080,10378,10983,21361,嘉義,一等
2020-09-13,4080,13688,12207,25895,嘉義,一等
2020-09-14,4080,8243,7808,16051,嘉義,一等
2020-09-15,4080,7124,6997,14121,嘉義,一等
2020-09-16,4080,7075,6995,14070,嘉義,一等
2020-09-17,4080,7644,7377,15021,嘉義,一等
2020-09-18,4080,11247,13338,24585,嘉義,一等
2020-09-19,4080,10776,11408,22184,嘉義,一等
2020-09-20,4080,14179,11806,25985,嘉義,一等
2020-09-21,4080,8515,8083,16598,嘉義,一等
2020-09-22,4080,7490,7220,14710,嘉義,一等
2020-09-23,4080,7317,7136,14453,嘉義,一等
2020-09-24,4080,7615,7534,15149,嘉義,一等
2020-09-25,4080,8584,9204,17788,嘉義,一等
2020-09-26,4080,9078,9623,18701,嘉義,一等
2020-09-27,4080,11446,10379,21825,嘉義,一等
2020-09-28,4080,8094,7847,15941,嘉義,一等
2020-09-29,4080,7456,7820,15276,嘉義,一等
2020-09-30,4080,12552,15964,28516,嘉義,一等
2020-10-01,4080,11208,14664,25872,嘉義,一等
2020-10-02,4080,12279,12276,24555,嘉義,一等
2020-10-03,4080,13224,11667,24891,嘉義,一等
2020-10-04,4080,16725,12702,29427,嘉義,一等
2020-10-05,4080,9499,8281,17780,嘉義,一等
2020-10-06,4080,7439,7106,14545,嘉義,一等
2020-10-07,4080,7488,7483,14971,嘉義,一等
2020-10-08,4080,11112,13215,24327,嘉義,一等
2020-10-09,4080,12910,14963,27873,嘉義,一等
2020-10-10,4080,13123,12369,25492,嘉義,一等
2020-10-11,4080,15177,12323,27500,嘉義,一等
2020-10-12,4080,9025,8395,17420,嘉義,一等
2020-10-13,4080,7561,7364,14925,嘉義,一等
2020-10-14,4080,7560,7249,14809,嘉義,一等
2020-10-15,4080,7844,7863,15707,嘉義,一等
2020-10-16,4080,11132,12453,23585,嘉義,一等
2020-10-17,4080,11424,12042,23466,嘉義,一等
2020-10-18,4080,14197,12635,26832,嘉義,一等
2020-10-19,4080,8824,8156,16980,嘉義,一等
2020-10-20,4080,7557,7400,14957,嘉義,一等
2020-10-21,4080,7770,7638,15408,嘉義,一等
2020-10-22,4080,7962,7966,15928,嘉義,一等
2020-10-23,4080,11132,13225,24357,嘉義,一等
2020-10-24,4080,11081,12513,23594,嘉義,一等
2020-10-25,4080,14095,11551,25646,嘉義,一等
2020-10-26,4080,9063,8376,17439,嘉義,一等
2020-10-27,4080,7662,7758,15420,嘉義,一等
2020-10-28,4080,7576,7431,15007,嘉義,一等
2020-10-29,4080,7868,7794,15662,嘉義,一等
2020-10-30,4080,11512,13068,24580,嘉義,一等
2020-10-31,4080,10884,11968,22852,嘉義,一等
2020-11-01,4080,13739,11463,25202,嘉義,一等
2020-11-02,4080,8324,8086,16410,嘉義,一等
2020-11-03,4080,7100,6934,14034,嘉義,一等
2020-11-04,4080,7398,7205,14603,嘉義,一等
2020-11-05,4080,7469,7495,14964,嘉義,一等
2020-11-06,4080,10961,12490,23451,嘉義,一等
2020-11-07,4080,10298,11404,21702,嘉義,一等
2020-11-08,4080,13660,10737,24397,嘉義,一等
2020-11-09,4080,8284,7697,15981,嘉義,一等
2020-11-10,4080,7267,7036,14303,嘉義,一等
2020-11-11,4080,7478,7582,15060,嘉義,一等
2020-11-12,4080,8109,8242,16351,嘉義,一等
2020-11-13,4080,11953,13989,25942,嘉義,一等
2020-11-14,4080,11316,12212,23528,嘉義,一等
2020-11-15,4080,15419,13121,28540,嘉義,一等
2020-11-16,4080,9254,8627,17881,嘉義,一等
2020-11-17,4080,7687,7414,15101,嘉義,一等
2020-11-18,4080,7614,7562,15176,嘉義,一等
2020-11-19,4080,8282,8123,16405,嘉義,一等
2020-11-20,4080,11527,13854,25381,嘉義,一等
2020-11-21,4080,11397,12466,23863,嘉義,一等
2020-11-22,4080,14600,12068,26668,嘉義,一等
2020-11-23,4080,9050,8541,17591,嘉義,一等
2020-11-24,4080,7355,7189,14544,嘉義,一等
2020-11-25,4080,7371,7378,14749,嘉義,一等
2020-11-26,4080,7832,8191,16023,嘉義,一等
2020-11-27,4080,11996,13444,25440,嘉義,一等
2020-11-28,4080,11355,12463,23818,嘉義,一等
2020-11-29,4080,14321,11986,26307,嘉義,一等
2020-11-30,4080,9001,8180,17181,嘉義,一等
2020-12-01,4080,7053,6891,13944,嘉義,一等
2020-12-02,4080,7204,7068,14272,嘉義,一等
2020-12-03,4080,7657,7694,15351,嘉義,一等
2020-12-04,4080,11439,13283,24722,嘉義,一等
2020-12-05,4080,11906,12326,24232,嘉義,一等
2020-12-06,4080,14471,12714,27185,嘉義,一等
2020-12-07,4080,9158,8681,17839,嘉義,一等
2020-12-08,4080,7603,7198,14801,嘉義,一等
2020-12-09,4080,7276,7092,14368,嘉義,一等
2020-12-10,4080,7630,7725,15355,嘉義,一等
2020-12-11,4080,11878,13449,25327,嘉義,一等
2020-12-12,4080,11598,12405,24003,嘉義,一等
2020-12-13,4080,14819,13003,27822,嘉義,一等
2020-12-14,4080,9254,8764,18018,嘉義,一等
2020-12-15,4080,7537,7347,14884,嘉義,一等
2020-12-16,4080,7814,7587,15401,嘉義,一等
2020-12-17,4080,7929,8209,16138,嘉義,一等
2020-12-18,4080,11821,14099,25920,嘉義,一等
2020-12-19,4080,13711,14240,27951,嘉義,一等
2020-12-20,4080,14694,12506,27200,嘉義,一等
2020-12-21,4080,9101,7933,17034,嘉義,一等
2020-12-22,4080,7564,7198,14762,嘉義,一等
2020-12-23,4080,7396,6955,14351,嘉義,一等
2020-12-24,4080,7931,8005,15936,嘉義,一等
2020-12-25,4080,11774,12952,24726,嘉義,一等
2020-12-26,4080,10932,11745,22677,嘉義,一等
2020-12-27,4080,13307,11874,25181,嘉義,一等
2020-12-28,4080,8743,8190,16933,嘉義,一等
2020-12-29,4080,7283,7169,14452,嘉義,一等
2020-12-30,4080,8062,8021,16083,嘉義,一等
2020-12-31,4080,12931,14440,27371,嘉義,一等
2020-01-01,4090,773,886,1659,水上,簡易
2020-01-02,4090,596,576,1172,水上,簡易
2020-01-03,4090,687,874,1561,水上,簡易
2020-01-04,4090,695,725,1420,水上,簡易
2020-01-05,4090,938,754,1692,水上,簡易
2020-01-06,4090,701,671,1372,水上,簡易
2020-01-07,4090,590,591,1181,水上,簡易
2020-01-08,4090,585,595,1180,水上,簡易
2020-01-09,4090,558,643,1201,水上,簡易
2020-01-10,4090,802,1185,1987,水上,簡易
2020-01-11,4090,1005,1053,2058,水上,簡易
2020-01-12,4090,1029,728,1757,水上,簡易
2020-01-13,4090,739,707,1446,水上,簡易
2020-01-14,4090,665,672,1337,水上,簡易
2020-01-15,4090,635,613,1248,水上,簡易
2020-01-16,4090,905,881,1786,水上,簡易
2020-01-17,4090,841,819,1660,水上,簡易
2020-01-18,4090,715,686,1401,水上,簡易
2020-01-19,4090,720,664,1384,水上,簡易
2020-01-20,4090,755,762,1517,水上,簡易
2020-01-21,4090,744,729,1473,水上,簡易
2020-01-22,4090,773,878,1651,水上,簡易
2020-01-23,4090,636,830,1466,水上,簡易
2020-01-24,4090,481,644,1125,水上,簡易
2020-01-25,4090,669,629,1298,水上,簡易
2020-01-26,4090,708,624,1332,水上,簡易
2020-01-27,4090,912,750,1662,水上,簡易
2020-01-28,4090,805,647,1452,水上,簡易
2020-01-29,4090,754,575,1329,水上,簡易
2020-01-30,4090,697,622,1319,水上,簡易
2020-01-31,4090,694,672,1366,水上,簡易
2020-02-01,4090,523,542,1065,水上,簡易
2020-02-02,4090,577,528,1105,水上,簡易
2020-02-03,4090,649,589,1238,水上,簡易
2020-02-04,4090,661,605,1266,水上,簡易
2020-02-05,4090,652,628,1280,水上,簡易
2020-02-06,4090,598,570,1168,水上,簡易
2020-02-07,4090,713,731,1444,水上,簡易
2020-02-08,4090,571,559,1130,水上,簡易
2020-02-09,4090,686,628,1314,水上,簡易
2020-02-10,4090,669,631,1300,水上,簡易
2020-02-11,4090,608,577,1185,水上,簡易
2020-02-12,4090,620,610,1230,水上,簡易
2020-02-13,4090,567,555,1122,水上,簡易
2020-02-14,4090,693,678,1371,水上,簡易
2020-02-15,4090,654,639,1293,水上,簡易
2020-02-16,4090,687,622,1309,水上,簡易
2020-02-17,4090,585,548,1133,水上,簡易
2020-02-18,4090,590,555,1145,水上,簡易
2020-02-19,4090,624,604,1228,水上,簡易
2020-02-20,4090,613,565,1178,水上,簡易
2020-02-21,4090,687,740,1427,水上,簡易
2020-02-22,4090,637,632,1269,水上,簡易
2020-02-23,4090,740,668,1408,水上,簡易
2020-02-24,4090,698,626,1324,水上,簡易
2020-02-25,4090,596,617,1213,水上,簡易
2020-02-26,4090,551,610,1161,水上,簡易
2020-02-27,4090,697,781,1478,水上,簡易
2020-02-28,4090,742,794,1536,水上,簡易
2020-02-29,4090,603,596,1199,水上,簡易
2020-03-01,4090,829,585,1414,水上,簡易
2020-03-02,4090,598,598,1196,水上,簡易
2020-03-03,4090,569,601,1170,水上,簡易
2020-03-04,4090,570,601,1171,水上,簡易
2020-03-05,4090,591,589,1180,水上,簡易
2020-03-06,4090,786,935,1721,水上,簡易
2020-03-07,4090,710,706,1416,水上,簡易
2020-03-08,4090,881,684,1565,水上,簡易
2020-03-09,4090,637,620,1257,水上,簡易
2020-03-10,4090,563,555,1118,水上,簡易
2020-03-11,4090,641,654,1295,水上,簡易
2020-03-12,4090,559,570,1129,水上,簡易
2020-03-13,4090,790,932,1722,水上,簡易
2020-03-14,4090,523,633,1156,水上,簡易
2020-03-15,4090,884,697,1581,水上,簡易
2020-03-16,4090,623,584,1207,水上,簡易
2020-03-17,4090,559,572,1131,水上,簡易
2020-03-18,4090,549,550,1099,水上,簡易
2020-03-19,4090,530,564,1094,水上,簡易
2020-03-20,4090,754,858,1612,水上,簡易
2020-03-21,4090,574,588,1162,水上,簡易
2020-03-22,4090,710,569,1279,水上,簡易
2020-03-23,4090,579,546,1125,水上,簡易
2020-03-24,4090,506,506,1012,水上,簡易
2020-03-25,4090,533,543,1076,水上,簡易
2020-03-26,4090,484,515,999,水上,簡易
2020-03-27,4090,672,807,1479,水上,簡易
2020-03-28,4090,475,534,1009,水上,簡易
2020-03-29,4090,648,517,1165,水上,簡易
2020-03-30,4090,551,534,1085,水上,簡易
2020-03-31,4090,505,564,1069,水上,簡易
2020-04-01,4090,634,819,1453,水上,簡易
2020-04-02,4090,498,660,1158,水上,簡易
2020-04-03,4090,530,609,1139,水上,簡易
2020-04-04,4090,534,452,986,水上,簡易
2020-04-05,4090,824,475,1299,水上,簡易
2020-04-06,4090,613,479,1092,水上,簡易
2020-04-07,4090,503,467,970,水上,簡易
2020-04-08,4090,444,476,920,水上,簡易
2020-04-09,4090,499,523,1022,水上,簡易
2020-04-10,4090,588,713,1301,水上,簡易
2020-04-11,4090,475,481,956,水上,簡易
2020-04-12,4090,630,520,1150,水上,簡易
2020-04-13,4090,516,528,1044,水上,簡易
2020-04-14,4090,492,473,965,水上,簡易
2020-04-15,4090,529,531,1060,水上,簡易
2020-04-16,4090,492,522,1014,水上,簡易
2020-04-17,4090,661,793,1454,水上,簡易
2020-04-18,4090,518,588,1106,水上,簡易
2020-04-19,4090,706,516,1222,水上,簡易
2020-04-20,4090,598,535,1133,水上,簡易
2020-04-21,4090,435,455,890,水上,簡易
2020-04-22,4090,483,502,985,水上,簡易
2020-04-23,4090,487,512,999,水上,簡易
2020-04-24,4090,607,741,1348,水上,簡易
2020-04-25,4090,415,472,887,水上,簡易
2020-04-26,4090,608,457,1065,水上,簡易
2020-04-27,4090,527,533,1060,水上,簡易
2020-04-28,4090,487,482,969,水上,簡易
2020-04-29,4090,494,530,1024,水上,簡易
2020-04-30,4090,480,561,1041,水上,簡易
2020-05-01,4090,580,824,1404,水上,簡易
2020-05-02,4090,533,568,1101,水上,簡易
2020-05-03,4090,764,483,1247,水上,簡易
2020-05-04,4090,577,582,1159,水上,簡易
2020-05-05,4090,497,492,989,水上,簡易
2020-05-06,4090,475,496,971,水上,簡易
2020-05-07,4090,497,555,1052,水上,簡易
2020-05-08,4090,670,915,1585,水上,簡易
2020-05-09,4090,576,680,1256,水上,簡易
2020-05-10,4090,843,550,1393,水上,簡易
2020-05-11,4090,625,563,1188,水上,簡易
2020-05-12,4090,494,518,1012,水上,簡易
2020-05-13,4090,513,534,1047,水上,簡易
2020-05-14,4090,507,541,1048,水上,簡易
2020-05-15,4090,715,804,1519,水上,簡易
2020-05-16,4090,518,538,1056,水上,簡易
2020-05-17,4090,762,615,1377,水上,簡易
2020-05-18,4090,593,548,1141,水上,簡易
2020-05-19,4090,470,495,965,水上,簡易
2020-05-20,4090,465,473,938,水上,簡易
2020-05-21,4090,451,492,943,水上,簡易
2020-05-22,4090,577,662,1239,水上,簡易
2020-05-23,4090,530,615,1145,水上,簡易
2020-05-24,4090,755,608,1363,水上,簡易
2020-05-25,4090,584,548,1132,水上,簡易
2020-05-26,4090,536,509,1045,水上,簡易
2020-05-27,4090,510,522,1032,水上,簡易
2020-05-28,4090,539,566,1105,水上,簡易
2020-05-29,4090,661,862,1523,水上,簡易
2020-05-30,4090,668,670,1338,水上,簡易
2020-05-31,4090,814,674,1488,水上,簡易
2020-06-01,4090,610,566,1176,水上,簡易
2020-06-02,4090,583,569,1152,水上,簡易
2020-06-03,4090,535,534,1069,水上,簡易
2020-06-04,4090,543,590,1133,水上,簡易
2020-06-05,4090,729,824,1553,水上,簡易
2020-06-06,4090,664,694,1358,水上,簡易
2020-06-07,4090,841,675,1516,水上,簡易
2020-06-08,4090,593,549,1142,水上,簡易
2020-06-09,4090,577,548,1125,水上,簡易
2020-06-10,4090,610,594,1204,水上,簡易
2020-06-11,4090,584,606,1190,水上,簡易
2020-06-12,4090,728,890,1618,水上,簡易
2020-06-13,4090,665,679,1344,水上,簡易
2020-06-14,4090,878,678,1556,水上,簡易
2020-06-15,4090,770,779,1549,水上,簡易
2020-06-16,4090,589,585,1174,水上,簡易
2020-06-17,4090,569,593,1162,水上,簡易
2020-06-18,4090,568,585,1153,水上,簡易
2020-06-19,4090,606,635,1241,水上,簡易
2020-06-20,4090,645,677,1322,水上,簡易
2020-06-21,4090,1055,987,2042,水上,簡易
2020-06-22,4090,684,578,1262,水上,簡易
2020-06-23,4090,616,616,1232,水上,簡易
2020-06-24,4090,750,902,1652,水上,簡易
2020-06-25,4090,682,845,1527,水上,簡易
2020-06-26,4090,804,728,1532,水上,簡易
2020-06-27,4090,696,634,1330,水上,簡易
2020-06-28,4090,933,718,1651,水上,簡易
2020-06-29,4090,723,673,1396,水上,簡易
2020-06-30,4090,596,604,1200,水上,簡易
2020-07-01,4090,582,548,1130,水上,簡易
2020-07-02,4090,546,531,1077,水上,簡易
2020-07-03,4090,713,724,1437,水上,簡易
2020-07-04,4090,661,661,1322,水上,簡易
2020-07-05,4090,691,607,1298,水上,簡易
2020-07-06,4090,666,648,1314,水上,簡易
2020-07-07,4090,584,593,1177,水上,簡易
2020-07-08,4090,573,569,1142,水上,簡易
2020-07-09,4090,589,603,1192,水上,簡易
2020-07-10,4090,709,718,1427,水上,簡易
2020-07-11,4090,653,679,1332,水上,簡易
2020-07-12,4090,699,670,1369,水上,簡易
2020-07-13,4090,663,621,1284,水上,簡易
2020-07-14,4090,687,734,1421,水上,簡易
2020-07-15,4090,628,582,1210,水上,簡易
2020-07-16,4090,573,571,1144,水上,簡易
2020-07-17,4090,765,752,1517,水上,簡易
2020-07-18,4090,690,713,1403,水上,簡易
2020-07-19,4090,747,563,1310,水上,簡易
2020-07-20,4090,669,620,1289,水上,簡易
2020-07-21,4090,688,575,1263,水上,簡易
2020-07-22,4090,662,590,1252,水上,簡易
2020-07-23,4090,640,574,1214,水上,簡易
2020-07-24,4090,804,772,1576,水上,簡易
2020-07-25,4090,627,657,1284,水上,簡易
2020-07-26,4090,722,650,1372,水上,簡易
2020-07-27,4090,619,579,1198,水上,簡易
2020-07-28,4090,625,590,1215,水上,簡易
2020-07-29,4090,595,536,1131,水上,簡易
2020-07-30,4090,602,574,1176,水上,簡易
2020-07-31,4090,763,791,1554,水上,簡易
2020-08-01,4090,603,661,1264,水上,簡易
2020-08-02,4090,647,585,1232,水上,簡易
2020-08-03,4090,599,598,1197,水上,簡易
2020-08-04,4090,583,583,1166,水上,簡易
2020-08-05,4090,629,585,1214,水上,簡易
2020-08-06,4090,609,608,1217,水上,簡易
2020-08-07,4090,798,799,1597,水上,簡易
2020-08-08,4090,636,678,1314,水上,簡易
2020-08-09,4090,854,642,1496,水上,簡易
2020-08-10,4090,613,649,1262,水上,簡易
2020-08-11,4090,579,536,1115,水上,簡易
2020-08-12,4090,517,571,1088,水上,簡易
2020-08-13,4090,616,613,1229,水上,簡易
2020-08-14,4090,787,733,1520,水上,簡易
2020-08-15,4090,659,670,1329,水上,簡易
2020-08-16,4090,732,694,1426,水上,簡易
2020-08-17,4090,709,680,1389,水上,簡易
2020-08-18,4090,560,543,1103,水上,簡易
2020-08-19,4090,595,556,1151,水上,簡易
2020-08-20,4090,613,588,1201,水上,簡易
2020-08-21,4090,799,715,1514,水上,簡易
2020-08-22,4090,675,645,1320,水上,簡易
2020-08-23,4090,723,608,1331,水上,簡易
2020-08-24,4090,756,664,1420,水上,簡易
2020-08-25,4090,669,610,1279,水上,簡易
2020-08-26,4090,611,583,1194,水上,簡易
2020-08-27,4090,516,490,1006,水上,簡易
2020-08-28,4090,675,646,1321,水上,簡易
2020-08-29,4090,562,586,1148,水上,簡易
2020-08-30,4090,633,567,1200,水上,簡易
2020-08-31,4090,617,624,1241,水上,簡易
2020-09-01,4090,559,581,1140,水上,簡易
2020-09-02,4090,538,553,1091,水上,簡易
2020-09-03,4090,621,585,1206,水上,簡易
2020-09-04,4090,770,699,1469,水上,簡易
2020-09-05,4090,667,681,1348,水上,簡易
2020-09-06,4090,726,655,1381,水上,簡易
2020-09-07,4090,620,636,1256,水上,簡易
2020-09-08,4090,751,786,1537,水上,簡易
2020-09-09,4090,932,967,1899,水上,簡易
2020-09-10,4090,807,835,1642,水上,簡易
2020-09-11,4090,757,732,1489,水上,簡易
2020-09-12,4090,664,682,1346,水上,簡易
2020-09-13,4090,859,723,1582,水上,簡易
2020-09-14,4090,634,603,1237,水上,簡易
2020-09-15,4090,598,580,1178,水上,簡易
2020-09-16,4090,558,585,1143,水上,簡易
2020-09-17,4090,546,570,1116,水上,簡易
2020-09-18,4090,766,928,1694,水上,簡易
2020-09-19,4090,599,716,1315,水上,簡易
2020-09-20,4090,964,707,1671,水上,簡易
2020-09-21,4090,659,637,1296,水上,簡易
2020-09-22,4090,550,566,1116,水上,簡易
2020-09-23,4090,623,606,1229,水上,簡易
2020-09-24,4090,618,628,1246,水上,簡易
2020-09-25,4090,664,730,1394,水上,簡易
2020-09-26,4090,552,660,1212,水上,簡易
2020-09-27,4090,751,641,1392,水上,簡易
2020-09-28,4090,614,565,1179,水上,簡易
2020-09-29,4090,581,572,1153,水上,簡易
2020-09-30,4090,779,1107,1886,水上,簡易
2020-10-01,4090,721,896,1617,水上,簡易
2020-10-02,4090,813,849,1662,水上,簡易
2020-10-03,4090,803,710,1513,水上,簡易
2020-10-04,4090,1065,731,1796,水上,簡易
2020-10-05,4090,721,655,1376,水上,簡易
2020-10-06,4090,583,577,1160,水上,簡易
2020-10-07,4090,616,606,1222,水上,簡易
2020-10-08,4090,748,893,1641,水上,簡易
2020-10-09,4090,837,909,1746,水上,簡易
2020-10-10,4090,782,700,1482,水上,簡易
2020-10-11,4090,976,729,1705,水上,簡易
2020-10-12,4090,661,634,1295,水上,簡易
2020-10-13,4090,567,578,1145,水上,簡易
2020-10-14,4090,597,599,1196,水上,簡易
2020-10-15,4090,566,598,1164,水上,簡易
2020-10-16,4090,747,872,1619,水上,簡易
2020-10-17,4090,764,804,1568,水上,簡易
2020-10-18,4090,877,815,1692,水上,簡易
2020-10-19,4090,697,638,1335,水上,簡易
2020-10-20,4090,569,564,1133,水上,簡易
2020-10-21,4090,605,582,1187,水上,簡易
2020-10-22,4090,640,578,1218,水上,簡易
2020-10-23,4090,777,909,1686,水上,簡易
2020-10-24,4090,667,806,1473,水上,簡易
2020-10-25,4090,977,828,1805,水上,簡易
2020-10-26,4090,691,642,1333,水上,簡易
2020-10-27,4090,613,589,1202,水上,簡易
2020-10-28,4090,548,561,1109,水上,簡易
2020-10-29,4090,600,573,1173,水上,簡易
2020-10-30,4090,763,939,1702,水上,簡易
2020-10-31,4090,713,759,1472,水上,簡易
2020-11-01,4090,1135,874,2009,水上,簡易
2020-11-02,4090,648,623,1271,水上,簡易
2020-11-03,4090,545,561,1106,水上,簡易
2020-11-04,4090,571,550,1121,水上,簡易
2020-11-05,4090,547,557,1104,水上,簡易
2020-11-06,4090,691,850,1541,水上,簡易
2020-11-07,4090,686,717,1403,水上,簡易
2020-11-08,4090,863,732,1595,水上,簡易
2020-11-09,4090,613,564,1177,水上,簡易
2020-11-10,4090,535,531,1066,水上,簡易
2020-11-11,4090,629,611,1240,水上,簡易
2020-11-12,4090,568,571,1139,水上,簡易
2020-11-13,4090,792,982,1774,水上,簡易
2020-11-14,4090,752,765,1517,水上,簡易
2020-11-15,4090,957,730,1687,水上,簡易
2020-11-16,4090,718,671,1389,水上,簡易
2020-11-17,4090,579,560,1139,水上,簡易
2020-11-18,4090,611,592,1203,水上,簡易
2020-11-19,4090,544,610,1154,水上,簡易
2020-11-20,4090,769,947,1716,水上,簡易
2020-11-21,4090,694,748,1442,水上,簡易
2020-11-22,4090,918,740,1658,水上,簡易
2020-11-23,4090,698,607,1305,水上,簡易
2020-11-24,4090,597,620,1217,水上,簡易
2020-11-25,4090,586,663,1249,水上,簡易
2020-11-26,4090,615,629,1244,水上,簡易
2020-11-27,4090,835,1008,1843,水上,簡易
2020-11-28,4090,760,812,1572,水上,簡易
2020-11-29,4090,888,690,1578,水上,簡易
2020-11-30,4090,651,620,1271,水上,簡易
2020-12-01,4090,531,562,1093,水上,簡易
2020-12-02,4090,607,607,1214,水上,簡易
2020-12-03,4090,625,662,1287,水上,簡易
2020-12-04,4090,801,968,1769,水上,簡易
2020-12-05,4090,690,820,1510,水上,簡易
2020-12-06,4090,1065,843,1908,水上,簡易
2020-12-07,4090,754,659,1413,水上,簡易
2020-12-08,4090,609,594,1203,水上,簡易
2020-12-09,4090,593,592,1185,水上,簡易
2020-12-10,4090,605,598,1203,水上,簡易
2020-12-11,4090,776,940,1716,水上,簡易
2020-12-12,4090,751,783,1534,水上,簡易
2020-12-13,4090,982,789,1771,水上,簡易
2020-12-14,4090,700,626,1326,水上,簡易
2020-12-15,4090,607,616,1223,水上,簡易
2020-12-16,4090,596,607,1203,水上,簡易
2020-12-17,4090,619,640,1259,水上,簡易
2020-12-18,4090,753,978,1731,水上,簡易
2020-12-19,4090,779,813,1592,水上,簡易
2020-12-20,4090,1043,817,1860,水上,簡易
2020-12-21,4090,696,608,1304,水上,簡易
2020-12-22,4090,637,603,1240,水上,簡易
2020-12-23,4090,585,589,1174,水上,簡易
2020-12-24,4090,615,620,1235,水上,簡易
2020-12-25,4090,774,976,1750,水上,簡易
2020-12-26,4090,729,796,1525,水上,簡易
2020-12-27,4090,851,674,1525,水上,簡易
2020-12-28,4090,675,610,1285,水上,簡易
2020-12-29,4090,592,577,1169,水上,簡易
2020-12-30,4090,573,610,1183,水上,簡易
2020-12-31,4090,801,899,1700,水上,簡易
2020-01-01,4100,197,198,395,南靖,甲簡
2020-01-02,4100,191,195,386,南靖,甲簡
2020-01-03,4100,195,303,498,南靖,甲簡
2020-01-04,4100,155,237,392,南靖,甲簡
2020-01-05,4100,299,165,464,南靖,甲簡
2020-01-06,4100,194,192,386,南靖,甲簡
2020-01-07,4100,200,204,404,南靖,甲簡
2020-01-08,4100,163,168,331,南靖,甲簡
2020-01-09,4100,149,175,324,南靖,甲簡
2020-01-10,4100,203,415,618,南靖,甲簡
2020-01-11,4100,310,302,612,南靖,甲簡
2020-01-12,4100,349,230,579,南靖,甲簡
2020-01-13,4100,210,212,422,南靖,甲簡
2020-01-14,4100,180,191,371,南靖,甲簡
2020-01-15,4100,174,204,378,南靖,甲簡
2020-01-16,4100,177,217,394,南靖,甲簡
2020-01-17,4100,182,226,408,南靖,甲簡
2020-01-18,4100,153,181,334,南靖,甲簡
2020-01-19,4100,229,220,449,南靖,甲簡
2020-01-20,4100,208,201,409,南靖,甲簡
2020-01-21,4100,176,199,375,南靖,甲簡
2020-01-22,4100,216,268,484,南靖,甲簡
2020-01-23,4100,179,271,450,南靖,甲簡
2020-01-24,4100,137,239,376,南靖,甲簡
2020-01-25,4100,233,203,436,南靖,甲簡
2020-01-26,4100,247,245,492,南靖,甲簡
2020-01-27,4100,314,267,581,南靖,甲簡
2020-01-28,4100,234,183,417,南靖,甲簡
2020-01-29,4100,258,160,418,南靖,甲簡
2020-01-30,4100,163,162,325,南靖,甲簡
2020-01-31,4100,192,221,413,南靖,甲簡
2020-02-01,4100,162,176,338,南靖,甲簡
2020-02-02,4100,205,158,363,南靖,甲簡
2020-02-03,4100,196,155,351,南靖,甲簡
2020-02-04,4100,200,213,413,南靖,甲簡
2020-02-05,4100,160,164,324,南靖,甲簡
2020-02-06,4100,150,169,319,南靖,甲簡
2020-02-07,4100,182,228,410,南靖,甲簡
2020-02-08,4100,150,190,340,南靖,甲簡
2020-02-09,4100,223,187,410,南靖,甲簡
2020-02-10,4100,176,159,335,南靖,甲簡
2020-02-11,4100,125,132,257,南靖,甲簡
2020-02-12,4100,156,161,317,南靖,甲簡
2020-02-13,4100,141,144,285,南靖,甲簡
2020-02-14,4100,169,226,395,南靖,甲簡
2020-02-15,4100,180,207,387,南靖,甲簡
2020-02-16,4100,176,150,326,南靖,甲簡
2020-02-17,4100,154,150,304,南靖,甲簡
2020-02-18,4100,134,141,275,南靖,甲簡
2020-02-19,4100,142,137,279,南靖,甲簡
2020-02-20,4100,150,153,303,南靖,甲簡
2020-02-21,4100,157,229,386,南靖,甲簡
2020-02-22,4100,143,203,346,南靖,甲簡
2020-02-23,4100,230,158,388,南靖,甲簡
2020-02-24,4100,163,140,303,南靖,甲簡
2020-02-25,4100,159,153,312,南靖,甲簡
2020-02-26,4100,160,155,315,南靖,甲簡
2020-02-27,4100,212,302,514,南靖,甲簡
2020-02-28,4100,132,197,329,南靖,甲簡
2020-02-29,4100,154,156,310,南靖,甲簡
2020-03-01,4100,292,136,428,南靖,甲簡
2020-03-02,4100,195,165,360,南靖,甲簡
2020-03-03,4100,154,164,318,南靖,甲簡
2020-03-04,4100,154,181,335,南靖,甲簡
2020-03-05,4100,146,169,315,南靖,甲簡
2020-03-06,4100,175,344,519,南靖,甲簡
2020-03-07,4100,138,180,318,南靖,甲簡
2020-03-08,4100,277,139,416,南靖,甲簡
2020-03-09,4100,187,160,347,南靖,甲簡
2020-03-10,4100,132,144,276,南靖,甲簡
2020-03-11,4100,138,157,295,南靖,甲簡
2020-03-12,4100,148,180,328,南靖,甲簡
2020-03-13,4100,146,351,497,南靖,甲簡
2020-03-14,4100,138,179,317,南靖,甲簡
2020-03-15,4100,323,161,484,南靖,甲簡
2020-03-16,4100,181,152,333,南靖,甲簡
2020-03-17,4100,136,157,293,南靖,甲簡
2020-03-18,4100,119,156,275,南靖,甲簡
2020-03-19,4100,148,176,324,南靖,甲簡
2020-03-20,4100,135,341,476,南靖,甲簡
2020-03-21,4100,115,168,283,南靖,甲簡
2020-03-22,4100,258,122,380,南靖,甲簡
2020-03-23,4100,165,147,312,南靖,甲簡
2020-03-24,4100,139,143,282,南靖,甲簡
2020-03-25,4100,128,139,267,南靖,甲簡
2020-03-26,4100,148,178,326,南靖,甲簡
2020-03-27,4100,154,286,440,南靖,甲簡
2020-03-28,4100,94,157,251,南靖,甲簡
2020-03-29,4100,202,101,303,南靖,甲簡
2020-03-30,4100,163,148,311,南靖,甲簡
2020-03-31,4100,129,171,300,南靖,甲簡
2020-04-01,4100,150,315,465,南靖,甲簡
2020-04-02,4100,112,224,336,南靖,甲簡
2020-04-03,4100,150,188,338,南靖,甲簡
2020-04-04,4100,152,140,292,南靖,甲簡
2020-04-05,4100,326,103,429,南靖,甲簡
2020-04-06,4100,161,140,301,南靖,甲簡
2020-04-07,4100,142,140,282,南靖,甲簡
2020-04-08,4100,118,131,249,南靖,甲簡
2020-04-09,4100,119,163,282,南靖,甲簡
2020-04-10,4100,142,256,398,南靖,甲簡
2020-04-11,4100,87,124,211,南靖,甲簡
2020-04-12,4100,205,103,308,南靖,甲簡
2020-04-13,4100,171,156,327,南靖,甲簡
2020-04-14,4100,133,135,268,南靖,甲簡
2020-04-15,4100,126,153,279,南靖,甲簡
2020-04-16,4100,141,174,315,南靖,甲簡
2020-04-17,4100,163,289,452,南靖,甲簡
2020-04-18,4100,101,168,269,南靖,甲簡
2020-04-19,4100,219,111,330,南靖,甲簡
2020-04-20,4100,182,140,322,南靖,甲簡
2020-04-21,4100,129,128,257,南靖,甲簡
2020-04-22,4100,117,141,258,南靖,甲簡
2020-04-23,4100,117,150,267,南靖,甲簡
2020-04-24,4100,132,261,393,南靖,甲簡
2020-04-25,4100,81,111,192,南靖,甲簡
2020-04-26,4100,210,100,310,南靖,甲簡
2020-04-27,4100,160,153,313,南靖,甲簡
2020-04-28,4100,135,143,278,南靖,甲簡
2020-04-29,4100,125,138,263,南靖,甲簡
2020-04-30,4100,157,210,367,南靖,甲簡
2020-05-01,4100,137,321,458,南靖,甲簡
2020-05-02,4100,103,156,259,南靖,甲簡
2020-05-03,4100,279,114,393,南靖,甲簡
2020-05-04,4100,189,159,348,南靖,甲簡
2020-05-05,4100,138,144,282,南靖,甲簡
2020-05-06,4100,123,154,277,南靖,甲簡
2020-05-07,4100,134,171,305,南靖,甲簡
2020-05-08,4100,148,377,525,南靖,甲簡
2020-05-09,4100,109,176,285,南靖,甲簡
2020-05-10,4100,345,124,469,南靖,甲簡
2020-05-11,4100,196,150,346,南靖,甲簡
2020-05-12,4100,146,138,284,南靖,甲簡
2020-05-13,4100,126,142,268,南靖,甲簡
2020-05-14,4100,136,179,315,南靖,甲簡
2020-05-15,4100,160,316,476,南靖,甲簡
2020-05-16,4100,87,127,214,南靖,甲簡
2020-05-17,4100,229,112,341,南靖,甲簡
2020-05-18,4100,173,139,312,南靖,甲簡
2020-05-19,4100,122,131,253,南靖,甲簡
2020-05-20,4100,127,165,292,南靖,甲簡
2020-05-21,4100,143,145,288,南靖,甲簡
2020-05-22,4100,151,283,434,南靖,甲簡
2020-05-23,4100,99,149,248,南靖,甲簡
2020-05-24,4100,253,120,373,南靖,甲簡
2020-05-25,4100,178,154,332,南靖,甲簡
2020-05-26,4100,138,144,282,南靖,甲簡
2020-05-27,4100,105,140,245,南靖,甲簡
2020-05-28,4100,137,184,321,南靖,甲簡
2020-05-29,4100,160,318,478,南靖,甲簡
2020-05-30,4100,155,206,361,南靖,甲簡
2020-05-31,4100,283,159,442,南靖,甲簡
2020-06-01,4100,175,149,324,南靖,甲簡
2020-06-02,4100,150,165,315,南靖,甲簡
2020-06-03,4100,109,131,240,南靖,甲簡
2020-06-04,4100,130,170,300,南靖,甲簡
2020-06-05,4100,152,321,473,南靖,甲簡
2020-06-06,4100,164,218,382,南靖,甲簡
2020-06-07,4100,263,125,388,南靖,甲簡
2020-06-08,4100,162,150,312,南靖,甲簡
2020-06-09,4100,153,163,316,南靖,甲簡
2020-06-10,4100,139,153,292,南靖,甲簡
2020-06-11,4100,144,184,328,南靖,甲簡
2020-06-12,4100,173,293,466,南靖,甲簡
2020-06-13,4100,186,220,406,南靖,甲簡
2020-06-14,4100,267,174,441,南靖,甲簡
2020-06-15,4100,180,169,349,南靖,甲簡
2020-06-16,4100,156,157,313,南靖,甲簡
2020-06-17,4100,151,156,307,南靖,甲簡
2020-06-18,4100,149,173,322,南靖,甲簡
2020-06-19,4100,167,248,415,南靖,甲簡
2020-06-20,4100,137,201,338,南靖,甲簡
2020-06-21,4100,300,225,525,南靖,甲簡
2020-06-22,4100,221,184,405,南靖,甲簡
2020-06-23,4100,193,159,352,南靖,甲簡
2020-06-24,4100,165,306,471,南靖,甲簡
2020-06-25,4100,168,294,462,南靖,甲簡
2020-06-26,4100,225,267,492,南靖,甲簡
2020-06-27,4100,223,174,397,南靖,甲簡
2020-06-28,4100,321,159,480,南靖,甲簡
2020-06-29,4100,194,147,341,南靖,甲簡
2020-06-30,4100,145,147,292,南靖,甲簡
2020-07-01,4100,145,156,301,南靖,甲簡
2020-07-02,4100,152,162,314,南靖,甲簡
2020-07-03,4100,149,229,378,南靖,甲簡
2020-07-04,4100,152,200,352,南靖,甲簡
2020-07-05,4100,217,175,392,南靖,甲簡
2020-07-06,4100,175,169,344,南靖,甲簡
2020-07-07,4100,151,150,301,南靖,甲簡
2020-07-08,4100,165,166,331,南靖,甲簡
2020-07-09,4100,171,177,348,南靖,甲簡
2020-07-10,4100,180,234,414,南靖,甲簡
2020-07-11,4100,200,250,450,南靖,甲簡
2020-07-12,4100,281,202,483,南靖,甲簡
2020-07-13,4100,176,176,352,南靖,甲簡
2020-07-14,4100,154,187,341,南靖,甲簡
2020-07-15,4100,149,147,296,南靖,甲簡
2020-07-16,4100,165,161,326,南靖,甲簡
2020-07-17,4100,180,255,435,南靖,甲簡
2020-07-18,4100,195,209,404,南靖,甲簡
2020-07-19,4100,257,166,423,南靖,甲簡
2020-07-20,4100,183,159,342,南靖,甲簡
2020-07-21,4100,156,145,301,南靖,甲簡
2020-07-22,4100,177,176,353,南靖,甲簡
2020-07-23,4100,157,170,327,南靖,甲簡
2020-07-24,4100,193,259,452,南靖,甲簡
2020-07-25,4100,167,186,353,南靖,甲簡
2020-07-26,4100,238,188,426,南靖,甲簡
2020-07-27,4100,198,176,374,南靖,甲簡
2020-07-28,4100,149,153,302,南靖,甲簡
2020-07-29,4100,141,159,300,南靖,甲簡
2020-07-30,4100,144,163,307,南靖,甲簡
2020-07-31,4100,184,228,412,南靖,甲簡
2020-08-01,4100,164,210,374,南靖,甲簡
2020-08-02,4100,247,167,414,南靖,甲簡
2020-08-03,4100,169,145,314,南靖,甲簡
2020-08-04,4100,119,134,253,南靖,甲簡
2020-08-05,4100,139,148,287,南靖,甲簡
2020-08-06,4100,164,192,356,南靖,甲簡
2020-08-07,4100,163,267,430,南靖,甲簡
2020-08-08,4100,164,223,387,南靖,甲簡
2020-08-09,4100,293,158,451,南靖,甲簡
2020-08-10,4100,180,155,335,南靖,甲簡
2020-08-11,4100,123,154,277,南靖,甲簡
2020-08-12,4100,153,157,310,南靖,甲簡
2020-08-13,4100,160,186,346,南靖,甲簡
2020-08-14,4100,195,218,413,南靖,甲簡
2020-08-15,4100,160,200,360,南靖,甲簡
2020-08-16,4100,228,167,395,南靖,甲簡
2020-08-17,4100,190,165,355,南靖,甲簡
2020-08-18,4100,150,149,299,南靖,甲簡
2020-08-19,4100,154,145,299,南靖,甲簡
2020-08-20,4100,204,230,434,南靖,甲簡
2020-08-21,4100,189,218,407,南靖,甲簡
2020-08-22,4100,157,203,360,南靖,甲簡
2020-08-23,4100,242,189,431,南靖,甲簡
2020-08-24,4100,176,162,338,南靖,甲簡
2020-08-25,4100,156,152,308,南靖,甲簡
2020-08-26,4100,119,141,260,南靖,甲簡
2020-08-27,4100,124,137,261,南靖,甲簡
2020-08-28,4100,166,209,375,南靖,甲簡
2020-08-29,4100,170,190,360,南靖,甲簡
2020-08-30,4100,189,147,336,南靖,甲簡
2020-08-31,4100,186,155,341,南靖,甲簡
2020-09-01,4100,149,165,314,南靖,甲簡
2020-09-02,4100,146,142,288,南靖,甲簡
2020-09-03,4100,149,163,312,南靖,甲簡
2020-09-04,4100,186,243,429,南靖,甲簡
2020-09-05,4100,151,183,334,南靖,甲簡
2020-09-06,4100,258,171,429,南靖,甲簡
2020-09-07,4100,193,149,342,南靖,甲簡
2020-09-08,4100,166,161,327,南靖,甲簡
2020-09-09,4100,181,199,380,南靖,甲簡
2020-09-10,4100,198,210,408,南靖,甲簡
2020-09-11,4100,176,261,437,南靖,甲簡
2020-09-12,4100,163,216,379,南靖,甲簡
2020-09-13,4100,282,140,422,南靖,甲簡
2020-09-14,4100,167,156,323,南靖,甲簡
2020-09-15,4100,129,148,277,南靖,甲簡
2020-09-16,4100,150,166,316,南靖,甲簡
2020-09-17,4100,187,202,389,南靖,甲簡
2020-09-18,4100,176,347,523,南靖,甲簡
2020-09-19,4100,145,194,339,南靖,甲簡
2020-09-20,4100,320,134,454,南靖,甲簡
2020-09-21,4100,188,152,340,南靖,甲簡
2020-09-22,4100,158,163,321,南靖,甲簡
2020-09-23,4100,157,179,336,南靖,甲簡
2020-09-24,4100,159,167,326,南靖,甲簡
2020-09-25,4100,156,220,376,南靖,甲簡
2020-09-26,4100,181,225,406,南靖,甲簡
2020-09-27,4100,217,161,378,南靖,甲簡
2020-09-28,4100,174,159,333,南靖,甲簡
2020-09-29,4100,149,179,328,南靖,甲簡
2020-09-30,4100,178,391,569,南靖,甲簡
2020-10-01,4100,195,347,542,南靖,甲簡
2020-10-02,4100,287,308,595,南靖,甲簡
2020-10-03,4100,237,218,455,南靖,甲簡
2020-10-04,4100,441,184,625,南靖,甲簡
2020-10-05,4100,230,179,409,南靖,甲簡
2020-10-06,4100,155,162,317,南靖,甲簡
2020-10-07,4100,149,170,319,南靖,甲簡
2020-10-08,4100,168,334,502,南靖,甲簡
2020-10-09,4100,197,286,483,南靖,甲簡
2020-10-10,4100,221,196,417,南靖,甲簡
2020-10-11,4100,327,174,501,南靖,甲簡
2020-10-12,4100,201,153,354,南靖,甲簡
2020-10-13,4100,154,157,311,南靖,甲簡
2020-10-14,4100,150,158,308,南靖,甲簡
2020-10-15,4100,155,199,354,南靖,甲簡
2020-10-16,4100,180,361,541,南靖,甲簡
2020-10-17,4100,275,289,564,南靖,甲簡
2020-10-18,4100,343,292,635,南靖,甲簡
2020-10-19,4100,174,168,342,南靖,甲簡
2020-10-20,4100,151,170,321,南靖,甲簡
2020-10-21,4100,140,155,295,南靖,甲簡
2020-10-22,4100,148,277,425,南靖,甲簡
2020-10-23,4100,235,358,593,南靖,甲簡
2020-10-24,4100,194,251,445,南靖,甲簡
2020-10-25,4100,324,151,475,南靖,甲簡
2020-10-26,4100,205,163,368,南靖,甲簡
2020-10-27,4100,139,149,288,南靖,甲簡
2020-10-28,4100,124,141,265,南靖,甲簡
2020-10-29,4100,158,178,336,南靖,甲簡
2020-10-30,4100,183,352,535,南靖,甲簡
2020-10-31,4100,155,202,357,南靖,甲簡
2020-11-01,4100,287,192,479,南靖,甲簡
2020-11-02,4100,184,162,346,南靖,甲簡
2020-11-03,4100,140,155,295,南靖,甲簡
2020-11-04,4100,144,160,304,南靖,甲簡
2020-11-05,4100,154,178,332,南靖,甲簡
2020-11-06,4100,146,321,467,南靖,甲簡
2020-11-07,4100,159,214,373,南靖,甲簡
2020-11-08,4100,340,191,531,南靖,甲簡
2020-11-09,4100,174,149,323,南靖,甲簡
2020-11-10,4100,129,143,272,南靖,甲簡
2020-11-11,4100,137,167,304,南靖,甲簡
2020-11-12,4100,150,184,334,南靖,甲簡
2020-11-13,4100,187,363,550,南靖,甲簡
2020-11-14,4100,219,271,490,南靖,甲簡
2020-11-15,4100,374,191,565,南靖,甲簡
2020-11-16,4100,219,179,398,南靖,甲簡
2020-11-17,4100,215,208,423,南靖,甲簡
2020-11-18,4100,149,153,302,南靖,甲簡
2020-11-19,4100,174,202,376,南靖,甲簡
2020-11-20,4100,184,348,532,南靖,甲簡
2020-11-21,4100,171,228,399,南靖,甲簡
2020-11-22,4100,324,181,505,南靖,甲簡
2020-11-23,4100,187,157,344,南靖,甲簡
2020-11-24,4100,164,156,320,南靖,甲簡
2020-11-25,4100,132,153,285,南靖,甲簡
2020-11-26,4100,151,190,341,南靖,甲簡
2020-11-27,4100,178,351,529,南靖,甲簡
2020-11-28,4100,186,213,399,南靖,甲簡
2020-11-29,4100,316,175,491,南靖,甲簡
2020-11-30,4100,213,173,386,南靖,甲簡
2020-12-01,4100,143,157,300,南靖,甲簡
2020-12-02,4100,154,167,321,南靖,甲簡
2020-12-03,4100,168,184,352,南靖,甲簡
2020-12-04,4100,178,360,538,南靖,甲簡
2020-12-05,4100,190,249,439,南靖,甲簡
2020-12-06,4100,308,182,490,南靖,甲簡
2020-12-07,4100,190,180,370,南靖,甲簡
2020-12-08,4100,161,152,313,南靖,甲簡
2020-12-09,4100,128,145,273,南靖,甲簡
2020-12-10,4100,138,183,321,南靖,甲簡
2020-12-11,4100,177,343,520,南靖,甲簡
2020-12-12,4100,178,238,416,南靖,甲簡
2020-12-13,4100,361,197,558,南靖,甲簡
2020-12-14,4100,199,174,373,南靖,甲簡
2020-12-15,4100,151,156,307,南靖,甲簡
2020-12-16,4100,179,199,378,南靖,甲簡
2020-12-17,4100,157,202,359,南靖,甲簡
2020-12-18,4100,186,341,527,南靖,甲簡
2020-12-19,4100,160,234,394,南靖,甲簡
2020-12-20,4100,313,145,458,南靖,甲簡
2020-12-21,4100,176,149,325,南靖,甲簡
2020-12-22,4100,168,163,331,南靖,甲簡
2020-12-23,4100,136,147,283,南靖,甲簡
2020-12-24,4100,158,195,353,南靖,甲簡
2020-12-25,4100,180,350,530,南靖,甲簡
2020-12-26,4100,173,214,387,南靖,甲簡
2020-12-27,4100,307,164,471,南靖,甲簡
2020-12-28,4100,200,146,346,南靖,甲簡
2020-12-29,4100,146,147,293,南靖,甲簡
2020-12-30,4100,132,169,301,南靖,甲簡
2020-12-31,4100,171,362,533,南靖,甲簡
2020-01-01,4110,571,548,1119,後壁,甲簡
2020-01-02,4110,597,566,1163,後壁,甲簡
2020-01-03,4110,607,751,1358,後壁,甲簡
2020-01-04,4110,505,571,1076,後壁,甲簡
2020-01-05,4110,558,441,999,後壁,甲簡
2020-01-06,4110,672,589,1261,後壁,甲簡
2020-01-07,4110,580,554,1134,後壁,甲簡
2020-01-08,4110,556,575,1131,後壁,甲簡
2020-01-09,4110,577,564,1141,後壁,甲簡
2020-01-10,4110,672,990,1662,後壁,甲簡
2020-01-11,4110,631,671,1302,後壁,甲簡
2020-01-12,4110,767,535,1302,後壁,甲簡
2020-01-13,4110,673,594,1267,後壁,甲簡
2020-01-14,4110,554,574,1128,後壁,甲簡
2020-01-15,4110,592,545,1137,後壁,甲簡
2020-01-16,4110,761,670,1431,後壁,甲簡
2020-01-17,4110,614,712,1326,後壁,甲簡
2020-01-18,4110,479,528,1007,後壁,甲簡
2020-01-19,4110,576,498,1074,後壁,甲簡
2020-01-20,4110,645,576,1221,後壁,甲簡
2020-01-21,4110,556,645,1201,後壁,甲簡
2020-01-22,4110,584,674,1258,後壁,甲簡
2020-01-23,4110,472,730,1202,後壁,甲簡
2020-01-24,4110,391,603,994,後壁,甲簡
2020-01-25,4110,554,532,1086,後壁,甲簡
2020-01-26,4110,575,562,1137,後壁,甲簡
2020-01-27,4110,680,600,1280,後壁,甲簡
2020-01-28,4110,543,472,1015,後壁,甲簡
2020-01-29,4110,685,465,1150,後壁,甲簡
2020-01-30,4110,504,472,976,後壁,甲簡
2020-01-31,4110,536,559,1095,後壁,甲簡
2020-02-01,4110,371,401,772,後壁,甲簡
2020-02-02,4110,438,413,851,後壁,甲簡
2020-02-03,4110,574,576,1150,後壁,甲簡
2020-02-04,4110,525,494,1019,後壁,甲簡
2020-02-05,4110,479,476,955,後壁,甲簡
2020-02-06,4110,547,513,1060,後壁,甲簡
2020-02-07,4110,558,633,1191,後壁,甲簡
2020-02-08,4110,394,444,838,後壁,甲簡
2020-02-09,4110,511,428,939,後壁,甲簡
2020-02-10,4110,518,482,1000,後壁,甲簡
2020-02-11,4110,469,481,950,後壁,甲簡
2020-02-12,4110,567,523,1090,後壁,甲簡
2020-02-13,4110,484,454,938,後壁,甲簡
2020-02-14,4110,486,541,1027,後壁,甲簡
2020-02-15,4110,450,470,920,後壁,甲簡
2020-02-16,4110,475,421,896,後壁,甲簡
2020-02-17,4110,503,442,945,後壁,甲簡
2020-02-18,4110,503,487,990,後壁,甲簡
2020-02-19,4110,472,494,966,後壁,甲簡
2020-02-20,4110,435,444,879,後壁,甲簡
2020-02-21,4110,512,561,1073,後壁,甲簡
2020-02-22,4110,451,481,932,後壁,甲簡
2020-02-23,4110,469,387,856,後壁,甲簡
2020-02-24,4110,514,516,1030,後壁,甲簡
2020-02-25,4110,631,536,1167,後壁,甲簡
2020-02-26,4110,556,521,1077,後壁,甲簡
2020-02-27,4110,632,719,1351,後壁,甲簡
2020-02-28,4110,504,603,1107,後壁,甲簡
2020-02-29,4110,455,451,906,後壁,甲簡
2020-03-01,4110,656,391,1047,後壁,甲簡
2020-03-02,4110,562,554,1116,後壁,甲簡
2020-03-03,4110,481,482,963,後壁,甲簡
2020-03-04,4110,534,517,1051,後壁,甲簡
2020-03-05,4110,493,515,1008,後壁,甲簡
2020-03-06,4110,596,762,1358,後壁,甲簡
2020-03-07,4110,452,525,977,後壁,甲簡
2020-03-08,4110,641,426,1067,後壁,甲簡
2020-03-09,4110,624,559,1183,後壁,甲簡
2020-03-10,4110,463,463,926,後壁,甲簡
2020-03-11,4110,541,525,1066,後壁,甲簡
2020-03-12,4110,489,530,1019,後壁,甲簡
2020-03-13,4110,610,729,1339,後壁,甲簡
2020-03-14,4110,371,451,822,後壁,甲簡
2020-03-15,4110,569,351,920,後壁,甲簡
2020-03-16,4110,598,544,1142,後壁,甲簡
2020-03-17,4110,509,479,988,後壁,甲簡
2020-03-18,4110,473,485,958,後壁,甲簡
2020-03-19,4110,505,490,995,後壁,甲簡
2020-03-20,4110,519,707,1226,後壁,甲簡
2020-03-21,4110,398,486,884,後壁,甲簡
2020-03-22,4110,490,354,844,後壁,甲簡
2020-03-23,4110,619,460,1079,後壁,甲簡
2020-03-24,4110,467,463,930,後壁,甲簡
2020-03-25,4110,504,463,967,後壁,甲簡
2020-03-26,4110,483,478,961,後壁,甲簡
2020-03-27,4110,533,636,1169,後壁,甲簡
2020-03-28,4110,313,366,679,後壁,甲簡
2020-03-29,4110,438,316,754,後壁,甲簡
2020-03-30,4110,539,481,1020,後壁,甲簡
2020-03-31,4110,468,477,945,後壁,甲簡
2020-04-01,4110,497,676,1173,後壁,甲簡
2020-04-02,4110,301,452,753,後壁,甲簡
2020-04-03,4110,385,448,833,後壁,甲簡
2020-04-04,4110,330,305,635,後壁,甲簡
2020-04-05,4110,605,300,905,後壁,甲簡
2020-04-06,4110,507,440,947,後壁,甲簡
2020-04-07,4110,469,409,878,後壁,甲簡
2020-04-08,4110,421,390,811,後壁,甲簡
2020-04-09,4110,425,414,839,後壁,甲簡
2020-04-10,4110,501,588,1089,後壁,甲簡
2020-04-11,4110,288,372,660,後壁,甲簡
2020-04-12,4110,403,269,672,後壁,甲簡
2020-04-13,4110,521,458,979,後壁,甲簡
2020-04-14,4110,414,432,846,後壁,甲簡
2020-04-15,4110,467,461,928,後壁,甲簡
2020-04-16,4110,440,457,897,後壁,甲簡
2020-04-17,4110,522,639,1161,後壁,甲簡
2020-04-18,4110,322,388,710,後壁,甲簡
2020-04-19,4110,421,282,703,後壁,甲簡
2020-04-20,4110,502,463,965,後壁,甲簡
2020-04-21,4110,501,428,929,後壁,甲簡
2020-04-22,4110,453,434,887,後壁,甲簡
2020-04-23,4110,434,423,857,後壁,甲簡
2020-04-24,4110,460,586,1046,後壁,甲簡
2020-04-25,4110,286,352,638,後壁,甲簡
2020-04-26,4110,388,236,624,後壁,甲簡
2020-04-27,4110,477,437,914,後壁,甲簡
2020-04-28,4110,445,437,882,後壁,甲簡
2020-04-29,4110,448,418,866,後壁,甲簡
2020-04-30,4110,447,502,949,後壁,甲簡
2020-05-01,4110,482,612,1094,後壁,甲簡
2020-05-02,4110,308,369,677,後壁,甲簡
2020-05-03,4110,526,322,848,後壁,甲簡
2020-05-04,4110,541,478,1019,後壁,甲簡
2020-05-05,4110,462,478,940,後壁,甲簡
2020-05-06,4110,478,463,941,後壁,甲簡
2020-05-07,4110,444,463,907,後壁,甲簡
2020-05-08,4110,555,733,1288,後壁,甲簡
2020-05-09,4110,349,465,814,後壁,甲簡
2020-05-10,4110,553,331,884,後壁,甲簡
2020-05-11,4110,578,476,1054,後壁,甲簡
2020-05-12,4110,465,486,951,後壁,甲簡
2020-05-13,4110,474,475,949,後壁,甲簡
2020-05-14,4110,451,443,894,後壁,甲簡
2020-05-15,4110,553,661,1214,後壁,甲簡
2020-05-16,4110,321,393,714,後壁,甲簡
2020-05-17,4110,539,359,898,後壁,甲簡
2020-05-18,4110,522,466,988,後壁,甲簡
2020-05-19,4110,418,445,863,後壁,甲簡
2020-05-20,4110,440,442,882,後壁,甲簡
2020-05-21,4110,407,435,842,後壁,甲簡
2020-05-22,4110,511,588,1099,後壁,甲簡
2020-05-23,4110,315,392,707,後壁,甲簡
2020-05-24,4110,558,401,959,後壁,甲簡
2020-05-25,4110,581,511,1092,後壁,甲簡
2020-05-26,4110,474,429,903,後壁,甲簡
2020-05-27,4110,432,455,887,後壁,甲簡
2020-05-28,4110,443,489,932,後壁,甲簡
2020-05-29,4110,582,701,1283,後壁,甲簡
2020-05-30,4110,417,429,846,後壁,甲簡
2020-05-31,4110,513,376,889,後壁,甲簡
2020-06-01,4110,553,486,1039,後壁,甲簡
2020-06-02,4110,480,478,958,後壁,甲簡
2020-06-03,4110,447,455,902,後壁,甲簡
2020-06-04,4110,515,526,1041,後壁,甲簡
2020-06-05,4110,598,653,1251,後壁,甲簡
2020-06-06,4110,422,506,928,後壁,甲簡
2020-06-07,4110,583,415,998,後壁,甲簡
2020-06-08,4110,573,504,1077,後壁,甲簡
2020-06-09,4110,490,467,957,後壁,甲簡
2020-06-10,4110,480,462,942,後壁,甲簡
2020-06-11,4110,518,512,1030,後壁,甲簡
2020-06-12,4110,572,681,1253,後壁,甲簡
2020-06-13,4110,479,468,947,後壁,甲簡
2020-06-14,4110,568,453,1021,後壁,甲簡
2020-06-15,4110,725,604,1329,後壁,甲簡
2020-06-16,4110,464,473,937,後壁,甲簡
2020-06-17,4110,452,445,897,後壁,甲簡
2020-06-18,4110,544,495,1039,後壁,甲簡
2020-06-19,4110,488,544,1032,後壁,甲簡
2020-06-20,4110,471,518,989,後壁,甲簡
2020-06-21,4110,536,465,1001,後壁,甲簡
2020-06-22,4110,536,491,1027,後壁,甲簡
2020-06-23,4110,475,516,991,後壁,甲簡
2020-06-24,4110,601,752,1353,後壁,甲簡
2020-06-25,4110,478,623,1101,後壁,甲簡
2020-06-26,4110,588,615,1203,後壁,甲簡
2020-06-27,4110,513,422,935,後壁,甲簡
2020-06-28,4110,629,414,1043,後壁,甲簡
2020-06-29,4110,580,511,1091,後壁,甲簡
2020-06-30,4110,507,468,975,後壁,甲簡
2020-07-01,4110,477,459,936,後壁,甲簡
2020-07-02,4110,435,465,900,後壁,甲簡
2020-07-03,4110,593,603,1196,後壁,甲簡
2020-07-04,4110,386,421,807,後壁,甲簡
2020-07-05,4110,464,397,861,後壁,甲簡
2020-07-06,4110,504,493,997,後壁,甲簡
2020-07-07,4110,515,508,1023,後壁,甲簡
2020-07-08,4110,475,489,964,後壁,甲簡
2020-07-09,4110,501,478,979,後壁,甲簡
2020-07-10,4110,560,606,1166,後壁,甲簡
2020-07-11,4110,521,504,1025,後壁,甲簡
2020-07-12,4110,520,454,974,後壁,甲簡
2020-07-13,4110,495,489,984,後壁,甲簡
2020-07-14,4110,611,558,1169,後壁,甲簡
2020-07-15,4110,477,453,930,後壁,甲簡
2020-07-16,4110,458,442,900,後壁,甲簡
2020-07-17,4110,573,532,1105,後壁,甲簡
2020-07-18,4110,453,549,1002,後壁,甲簡
2020-07-19,4110,513,419,932,後壁,甲簡
2020-07-20,4110,555,490,1045,後壁,甲簡
2020-07-21,4110,514,489,1003,後壁,甲簡
2020-07-22,4110,497,469,966,後壁,甲簡
2020-07-23,4110,515,482,997,後壁,甲簡
2020-07-24,4110,578,570,1148,後壁,甲簡
2020-07-25,4110,410,443,853,後壁,甲簡
2020-07-26,4110,517,467,984,後壁,甲簡
2020-07-27,4110,559,519,1078,後壁,甲簡
2020-07-28,4110,491,470,961,後壁,甲簡
2020-07-29,4110,605,561,1166,後壁,甲簡
2020-07-30,4110,458,459,917,後壁,甲簡
2020-07-31,4110,559,632,1191,後壁,甲簡
2020-08-01,4110,453,528,981,後壁,甲簡
2020-08-02,4110,511,409,920,後壁,甲簡
2020-08-03,4110,466,446,912,後壁,甲簡
2020-08-04,4110,445,440,885,後壁,甲簡
2020-08-05,4110,490,468,958,後壁,甲簡
2020-08-06,4110,518,488,1006,後壁,甲簡
2020-08-07,4110,558,653,1211,後壁,甲簡
2020-08-08,4110,421,509,930,後壁,甲簡
2020-08-09,4110,528,436,964,後壁,甲簡
2020-08-10,4110,513,468,981,後壁,甲簡
2020-08-11,4110,509,424,933,後壁,甲簡
2020-08-12,4110,487,487,974,後壁,甲簡
2020-08-13,4110,562,524,1086,後壁,甲簡
2020-08-14,4110,616,629,1245,後壁,甲簡
2020-08-15,4110,457,530,987,後壁,甲簡
2020-08-16,4110,557,433,990,後壁,甲簡
2020-08-17,4110,517,488,1005,後壁,甲簡
2020-08-18,4110,571,514,1085,後壁,甲簡
2020-08-19,4110,519,486,1005,後壁,甲簡
2020-08-20,4110,499,493,992,後壁,甲簡
2020-08-21,4110,557,592,1149,後壁,甲簡
2020-08-22,4110,381,433,814,後壁,甲簡
2020-08-23,4110,517,430,947,後壁,甲簡
2020-08-24,4110,595,536,1131,後壁,甲簡
2020-08-25,4110,602,527,1129,後壁,甲簡
2020-08-26,4110,458,454,912,後壁,甲簡
2020-08-27,4110,440,443,883,後壁,甲簡
2020-08-28,4110,546,571,1117,後壁,甲簡
2020-08-29,4110,441,484,925,後壁,甲簡
2020-08-30,4110,458,357,815,後壁,甲簡
2020-08-31,4110,596,554,1150,後壁,甲簡
2020-09-01,4110,537,540,1077,後壁,甲簡
2020-09-02,4110,539,473,1012,後壁,甲簡
2020-09-03,4110,528,527,1055,後壁,甲簡
2020-09-04,4110,638,645,1283,後壁,甲簡
2020-09-05,4110,402,482,884,後壁,甲簡
2020-09-06,4110,498,451,949,後壁,甲簡
2020-09-07,4110,591,529,1120,後壁,甲簡
2020-09-08,4110,543,550,1093,後壁,甲簡
2020-09-09,4110,563,544,1107,後壁,甲簡
2020-09-10,4110,552,554,1106,後壁,甲簡
2020-09-11,4110,531,614,1145,後壁,甲簡
2020-09-12,4110,452,451,903,後壁,甲簡
2020-09-13,4110,611,427,1038,後壁,甲簡
2020-09-14,4110,560,522,1082,後壁,甲簡
2020-09-15,4110,542,520,1062,後壁,甲簡
2020-09-16,4110,486,494,980,後壁,甲簡
2020-09-17,4110,515,510,1025,後壁,甲簡
2020-09-18,4110,562,706,1268,後壁,甲簡
2020-09-19,4110,514,558,1072,後壁,甲簡
2020-09-20,4110,561,447,1008,後壁,甲簡
2020-09-21,4110,580,501,1081,後壁,甲簡
2020-09-22,4110,521,500,1021,後壁,甲簡
2020-09-23,4110,516,514,1030,後壁,甲簡
2020-09-24,4110,510,498,1008,後壁,甲簡
2020-09-25,4110,543,566,1109,後壁,甲簡
2020-09-26,4110,502,576,1078,後壁,甲簡
2020-09-27,4110,489,396,885,後壁,甲簡
2020-09-28,4110,568,545,1113,後壁,甲簡
2020-09-29,4110,533,518,1051,後壁,甲簡
2020-09-30,4110,593,797,1390,後壁,甲簡
2020-10-01,4110,572,750,1322,後壁,甲簡
2020-10-02,4110,630,745,1375,後壁,甲簡
2020-10-03,4110,802,734,1536,後壁,甲簡
2020-10-04,4110,785,500,1285,後壁,甲簡
2020-10-05,4110,629,510,1139,後壁,甲簡
2020-10-06,4110,541,509,1050,後壁,甲簡
2020-10-07,4110,530,495,1025,後壁,甲簡
2020-10-08,4110,612,731,1343,後壁,甲簡
2020-10-09,4110,569,664,1233,後壁,甲簡
2020-10-10,4110,568,543,1111,後壁,甲簡
2020-10-11,4110,696,488,1184,後壁,甲簡
2020-10-12,4110,597,536,1133,後壁,甲簡
2020-10-13,4110,504,483,987,後壁,甲簡
2020-10-14,4110,516,513,1029,後壁,甲簡
2020-10-15,4110,544,497,1041,後壁,甲簡
2020-10-16,4110,570,693,1263,後壁,甲簡
2020-10-17,4110,428,1486,1914,後壁,甲簡
2020-10-18,4110,1925,1066,2991,後壁,甲簡
2020-10-19,4110,580,503,1083,後壁,甲簡
2020-10-20,4110,501,496,997,後壁,甲簡
2020-10-21,4110,535,485,1020,後壁,甲簡
2020-10-22,4110,512,488,1000,後壁,甲簡
2020-10-23,4110,616,752,1368,後壁,甲簡
2020-10-24,4110,516,650,1166,後壁,甲簡
2020-10-25,4110,661,455,1116,後壁,甲簡
2020-10-26,4110,605,540,1145,後壁,甲簡
2020-10-27,4110,510,460,970,後壁,甲簡
2020-10-28,4110,515,490,1005,後壁,甲簡
2020-10-29,4110,481,497,978,後壁,甲簡
2020-10-30,4110,611,712,1323,後壁,甲簡
2020-10-31,4110,444,518,962,後壁,甲簡
2020-11-01,4110,663,490,1153,後壁,甲簡
2020-11-02,4110,548,489,1037,後壁,甲簡
2020-11-03,4110,508,493,1001,後壁,甲簡
2020-11-04,4110,498,498,996,後壁,甲簡
2020-11-05,4110,496,487,983,後壁,甲簡
2020-11-06,4110,628,724,1352,後壁,甲簡
2020-11-07,4110,519,582,1101,後壁,甲簡
2020-11-08,4110,588,453,1041,後壁,甲簡
2020-11-09,4110,540,496,1036,後壁,甲簡
2020-11-10,4110,531,490,1021,後壁,甲簡
2020-11-11,4110,530,509,1039,後壁,甲簡
2020-11-12,4110,522,503,1025,後壁,甲簡
2020-11-13,4110,608,780,1388,後壁,甲簡
2020-11-14,4110,483,556,1039,後壁,甲簡
2020-11-15,4110,658,526,1184,後壁,甲簡
2020-11-16,4110,596,527,1123,後壁,甲簡
2020-11-17,4110,568,526,1094,後壁,甲簡
2020-11-18,4110,514,527,1041,後壁,甲簡
2020-11-19,4110,533,534,1067,後壁,甲簡
2020-11-20,4110,624,756,1380,後壁,甲簡
2020-11-21,4110,483,546,1029,後壁,甲簡
2020-11-22,4110,672,501,1173,後壁,甲簡
2020-11-23,4110,637,573,1210,後壁,甲簡
2020-11-24,4110,503,510,1013,後壁,甲簡
2020-11-25,4110,523,496,1019,後壁,甲簡
2020-11-26,4110,523,565,1088,後壁,甲簡
2020-11-27,4110,660,798,1458,後壁,甲簡
2020-11-28,4110,520,602,1122,後壁,甲簡
2020-11-29,4110,677,480,1157,後壁,甲簡
2020-11-30,4110,552,527,1079,後壁,甲簡
2020-12-01,4110,520,478,998,後壁,甲簡
2020-12-02,4110,498,475,973,後壁,甲簡
2020-12-03,4110,483,496,979,後壁,甲簡
2020-12-04,4110,632,693,1325,後壁,甲簡
2020-12-05,4110,564,602,1166,後壁,甲簡
2020-12-06,4110,678,532,1210,後壁,甲簡
2020-12-07,4110,609,559,1168,後壁,甲簡
2020-12-08,4110,539,509,1048,後壁,甲簡
2020-12-09,4110,519,508,1027,後壁,甲簡
2020-12-10,4110,503,507,1010,後壁,甲簡
2020-12-11,4110,649,801,1450,後壁,甲簡
2020-12-12,4110,549,873,1422,後壁,甲簡
2020-12-13,4110,736,556,1292,後壁,甲簡
2020-12-14,4110,646,584,1230,後壁,甲簡
2020-12-15,4110,537,526,1063,後壁,甲簡
2020-12-16,4110,518,529,1047,後壁,甲簡
2020-12-17,4110,537,513,1050,後壁,甲簡
2020-12-18,4110,634,763,1397,後壁,甲簡
2020-12-19,4110,521,618,1139,後壁,甲簡
2020-12-20,4110,696,515,1211,後壁,甲簡
2020-12-21,4110,596,493,1089,後壁,甲簡
2020-12-22,4110,518,497,1015,後壁,甲簡
2020-12-23,4110,505,511,1016,後壁,甲簡
2020-12-24,4110,511,551,1062,後壁,甲簡
2020-12-25,4110,631,748,1379,後壁,甲簡
2020-12-26,4110,425,532,957,後壁,甲簡
2020-12-27,4110,619,435,1054,後壁,甲簡
2020-12-28,4110,576,523,1099,後壁,甲簡
2020-12-29,4110,493,484,977,後壁,甲簡
2020-12-30,4110,511,513,1024,後壁,甲簡
2020-12-31,4110,586,716,1302,後壁,甲簡
2020-01-01,4120,4884,5363,10247,新營,一等
2020-01-02,4120,5020,4891,9911,新營,一等
2020-01-03,4120,5566,6247,11813,新營,一等
2020-01-04,4120,4592,4946,9538,新營,一等
2020-01-05,4120,5672,4787,10459,新營,一等
2020-01-06,4120,5419,5069,10488,新營,一等
2020-01-07,4120,5076,5012,10088,新營,一等
2020-01-08,4120,4856,4892,9748,新營,一等
2020-01-09,4120,5080,5447,10527,新營,一等
2020-01-10,4120,6367,8776,15143,新營,一等
2020-01-11,4120,6052,6623,12675,新營,一等
2020-01-12,4120,7258,5369,12627,新營,一等
2020-01-13,4120,5865,5477,11342,新營,一等
2020-01-14,4120,5206,5086,10292,新營,一等
2020-01-15,4120,5315,5260,10575,新營,一等
2020-01-16,4120,5751,5909,11660,新營,一等
2020-01-17,4120,5701,6019,11720,新營,一等
2020-01-18,4120,5487,5541,11028,新營,一等
2020-01-19,4120,5454,5059,10513,新營,一等
2020-01-20,4120,5783,5899,11682,新營,一等
2020-01-21,4120,5779,6162,11941,新營,一等
2020-01-22,4120,5826,7232,13058,新營,一等
2020-01-23,4120,4690,6750,11440,新營,一等
2020-01-24,4120,3714,5724,9438,新營,一等
2020-01-25,4120,5950,5970,11920,新營,一等
2020-01-26,4120,6618,6320,12938,新營,一等
2020-01-27,4120,7986,6752,14738,新營,一等
2020-01-28,4120,6418,5230,11648,新營,一等
2020-01-29,4120,5803,4521,10324,新營,一等
2020-01-30,4120,5501,4931,10432,新營,一等
2020-01-31,4120,5574,5604,11178,新營,一等
2020-02-01,4120,4284,4404,8688,新營,一等
2020-02-02,4120,4493,3986,8479,新營,一等
2020-02-03,4120,5316,5120,10436,新營,一等
2020-02-04,4120,4874,4633,9507,新營,一等
2020-02-05,4120,4802,4935,9737,新營,一等
2020-02-06,4120,4875,4972,9847,新營,一等
2020-02-07,4120,5665,6585,12250,新營,一等
2020-02-08,4120,4871,5887,10758,新營,一等
2020-02-09,4120,5869,4609,10478,新營,一等
2020-02-10,4120,5100,4822,9922,新營,一等
2020-02-11,4120,4768,4696,9464,新營,一等
2020-02-12,4120,4757,4758,9515,新營,一等
2020-02-13,4120,4533,4540,9073,新營,一等
2020-02-14,4120,5102,5373,10475,新營,一等
2020-02-15,4120,4857,5250,10107,新營,一等
2020-02-16,4120,4924,4512,9436,新營,一等
2020-02-17,4120,4385,4268,8653,新營,一等
2020-02-18,4120,4361,4329,8690,新營,一等
2020-02-19,4120,4335,4332,8667,新營,一等
2020-02-20,4120,4474,4454,8928,新營,一等
2020-02-21,4120,4903,5580,10483,新營,一等
2020-02-22,4120,3823,4115,7938,新營,一等
2020-02-23,4120,4529,3886,8415,新營,一等
2020-02-24,4120,4706,4464,9170,新營,一等
2020-02-25,4120,4591,4491,9082,新營,一等
2020-02-26,4120,4474,4502,8976,新營,一等
2020-02-27,4120,5623,6329,11952,新營,一等
2020-02-28,4120,4377,5081,9458,新營,一等
2020-02-29,4120,3740,3689,7429,新營,一等
2020-03-01,4120,5558,4056,9614,新營,一等
2020-03-02,4120,4926,4475,9401,新營,一等
2020-03-03,4120,4313,4311,8624,新營,一等
2020-03-04,4120,4253,4150,8403,新營,一等
2020-03-05,4120,4159,4296,8455,新營,一等
2020-03-06,4120,5319,6497,11816,新營,一等
2020-03-07,4120,3550,4095,7645,新營,一等
2020-03-08,4120,5182,3894,9076,新營,一等
2020-03-09,4120,4716,4428,9144,新營,一等
2020-03-10,4120,4225,4144,8369,新營,一等
2020-03-11,4120,4251,4359,8610,新營,一等
2020-03-12,4120,4576,4618,9194,新營,一等
2020-03-13,4120,5347,6647,11994,新營,一等
2020-03-14,4120,3252,3834,7086,新營,一等
2020-03-15,4120,5537,4091,9628,新營,一等
2020-03-16,4120,4890,4508,9398,新營,一等
2020-03-17,4120,4326,4294,8620,新營,一等
2020-03-18,4120,4293,4234,8527,新營,一等
2020-03-19,4120,4134,4343,8477,新營,一等
2020-03-20,4120,4996,6051,11047,新營,一等
2020-03-21,4120,3142,3665,6807,新營,一等
2020-03-22,4120,4455,3233,7688,新營,一等
2020-03-23,4120,4448,4171,8619,新營,一等
2020-03-24,4120,4095,4036,8131,新營,一等
2020-03-25,4120,3872,3924,7796,新營,一等
2020-03-26,4120,3857,4031,7888,新營,一等
2020-03-27,4120,4763,5551,10314,新營,一等
2020-03-28,4120,2769,3210,5979,新營,一等
2020-03-29,4120,3753,2983,6736,新營,一等
2020-03-30,4120,4337,4008,8345,新營,一等
2020-03-31,4120,3851,4230,8081,新營,一等
2020-04-01,4120,4761,6063,10824,新營,一等
2020-04-02,4120,3136,4481,7617,新營,一等
2020-04-03,4120,3183,3850,7033,新營,一等
2020-04-04,4120,3067,2720,5787,新營,一等
2020-04-05,4120,5074,2893,7967,新營,一等
2020-04-06,4120,4606,3817,8423,新營,一等
2020-04-07,4120,3781,3596,7377,新營,一等
2020-04-08,4120,3635,3637,7272,新營,一等
2020-04-09,4120,3757,3918,7675,新營,一等
2020-04-10,4120,4601,4971,9572,新營,一等
2020-04-11,4120,2605,3084,5689,新營,一等
2020-04-12,4120,3630,2954,6584,新營,一等
2020-04-13,4120,4157,3820,7977,新營,一等
2020-04-14,4120,3808,3777,7585,新營,一等
2020-04-15,4120,3845,3945,7790,新營,一等
2020-04-16,4120,3881,4072,7953,新營,一等
2020-04-17,4120,4653,5726,10379,新營,一等
2020-04-18,4120,3094,3448,6542,新營,一等
2020-04-19,4120,4153,3029,7182,新營,一等
2020-04-20,4120,4098,3857,7955,新營,一等
2020-04-21,4120,3713,3688,7401,新營,一等
2020-04-22,4120,3516,3613,7129,新營,一等
2020-04-23,4120,3598,3792,7390,新營,一等
2020-04-24,4120,4330,5071,9401,新營,一等
2020-04-25,4120,2408,2763,5171,新營,一等
2020-04-26,4120,3365,2523,5888,新營,一等
2020-04-27,4120,4056,3948,8004,新營,一等
2020-04-28,4120,3757,3708,7465,新營,一等
2020-04-29,4120,3661,3718,7379,新營,一等
2020-04-30,4120,3910,4493,8403,新營,一等
2020-05-01,4120,4108,5396,9504,新營,一等
2020-05-02,4120,2755,2811,5566,新營,一等
2020-05-03,4120,4527,3152,7679,新營,一等
2020-05-04,4120,4386,4023,8409,新營,一等
2020-05-05,4120,3971,3870,7841,新營,一等
2020-05-06,4120,3911,4016,7927,新營,一等
2020-05-07,4120,3952,4218,8170,新營,一等
2020-05-08,4120,4997,6558,11555,新營,一等
2020-05-09,4120,3242,4240,7482,新營,一等
2020-05-10,4120,5380,3621,9001,新營,一等
2020-05-11,4120,4770,4192,8962,新營,一等
2020-05-12,4120,3971,3853,7824,新營,一等
2020-05-13,4120,4036,3994,8030,新營,一等
2020-05-14,4120,4059,3688,7747,新營,一等
2020-05-15,4120,5231,6116,11347,新營,一等
2020-05-16,4120,3247,3601,6848,新營,一等
2020-05-17,4120,4512,3431,7943,新營,一等
2020-05-18,4120,4415,4401,8816,新營,一等
2020-05-19,4120,3853,3765,7618,新營,一等
2020-05-20,4120,3812,3756,7568,新營,一等
2020-05-21,4120,3778,3952,7730,新營,一等
2020-05-22,4120,4532,5340,9872,新營,一等
2020-05-23,4120,3077,3470,6547,新營,一等
2020-05-24,4120,4810,3940,8750,新營,一等
2020-05-25,4120,4593,4257,8850,新營,一等
2020-05-26,4120,4014,3926,7940,新營,一等
2020-05-27,4120,3771,3843,7614,新營,一等
2020-05-28,4120,3968,4115,8083,新營,一等
2020-05-29,4120,5064,6158,11222,新營,一等
2020-05-30,4120,3851,4176,8027,新營,一等
2020-05-31,4120,5320,4130,9450,新營,一等
2020-06-01,4120,4684,4279,8963,新營,一等
2020-06-02,4120,4136,4103,8239,新營,一等
2020-06-03,4120,4113,4119,8232,新營,一等
2020-06-04,4120,4161,4276,8437,新營,一等
2020-06-05,4120,5419,6098,11517,新營,一等
2020-06-06,4120,4222,4595,8817,新營,一等
2020-06-07,4120,5249,4300,9549,新營,一等
2020-06-08,4120,4529,4296,8825,新營,一等
2020-06-09,4120,4140,4079,8219,新營,一等
2020-06-10,4120,4224,4212,8436,新營,一等
2020-06-11,4120,4487,4643,9130,新營,一等
2020-06-12,4120,5457,6234,11691,新營,一等
2020-06-13,4120,4352,4646,8998,新營,一等
2020-06-14,4120,5882,4817,10699,新營,一等
2020-06-15,4120,5303,5031,10334,新營,一等
2020-06-16,4120,4241,4225,8466,新營,一等
2020-06-17,4120,4339,4319,8658,新營,一等
2020-06-18,4120,4352,4476,8828,新營,一等
2020-06-19,4120,5006,5394,10400,新營,一等
2020-06-20,4120,4545,4890,9435,新營,一等
2020-06-21,4120,5002,4637,9639,新營,一等
2020-06-22,4120,4764,4619,9383,新營,一等
2020-06-23,4120,4573,4601,9174,新營,一等
2020-06-24,4120,5605,7133,12738,新營,一等
2020-06-25,4120,4365,5843,10208,新營,一等
2020-06-26,4120,5055,5390,10445,新營,一等
2020-06-27,4120,5041,4482,9523,新營,一等
2020-06-28,4120,6119,4181,10300,新營,一等
2020-06-29,4120,5418,4843,10261,新營,一等
2020-06-30,4120,4602,4568,9170,新營,一等
2020-07-01,4120,4369,4391,8760,新營,一等
2020-07-02,4120,4347,4427,8774,新營,一等
2020-07-03,4120,5186,5710,10896,新營,一等
2020-07-04,4120,4278,4270,8548,新營,一等
2020-07-05,4120,4736,4324,9060,新營,一等
2020-07-06,4120,4690,4803,9493,新營,一等
2020-07-07,4120,4729,4679,9408,新營,一等
2020-07-08,4120,4833,4659,9492,新營,一等
2020-07-09,4120,4768,4812,9580,新營,一等
2020-07-10,4120,5643,6142,11785,新營,一等
2020-07-11,4120,4826,4923,9749,新營,一等
2020-07-12,4120,5440,4761,10201,新營,一等
2020-07-13,4120,4769,4755,9524,新營,一等
2020-07-14,4120,5357,5214,10571,新營,一等
2020-07-15,4120,4851,4811,9662,新營,一等
2020-07-16,4120,4827,4907,9734,新營,一等
2020-07-17,4120,5921,6415,12336,新營,一等
2020-07-18,4120,4748,5070,9818,新營,一等
2020-07-19,4120,5667,5088,10755,新營,一等
2020-07-20,4120,5204,5131,10335,新營,一等
2020-07-21,4120,5250,5090,10340,新營,一等
2020-07-22,4120,4815,5012,9827,新營,一等
2020-07-23,4120,5229,5213,10442,新營,一等
2020-07-24,4120,5518,5985,11503,新營,一等
2020-07-25,4120,4813,5078,9891,新營,一等
2020-07-26,4120,5345,4844,10189,新營,一等
2020-07-27,4120,4919,4909,9828,新營,一等
2020-07-28,4120,4781,4740,9521,新營,一等
2020-07-29,4120,4844,4702,9546,新營,一等
2020-07-30,4120,4810,4673,9483,新營,一等
2020-07-31,4120,5667,6059,11726,新營,一等
2020-08-01,4120,4661,4955,9616,新營,一等
2020-08-02,4120,5093,4495,9588,新營,一等
2020-08-03,4120,4658,4409,9067,新營,一等
2020-08-04,4120,4270,4204,8474,新營,一等
2020-08-05,4120,4739,4729,9468,新營,一等
2020-08-06,4120,4807,5085,9892,新營,一等
2020-08-07,4120,5955,6854,12809,新營,一等
2020-08-08,4120,4343,4976,9319,新營,一等
2020-08-09,4120,5977,4852,10829,新營,一等
2020-08-10,4120,5055,4903,9958,新營,一等
2020-08-11,4120,4368,4229,8597,新營,一等
2020-08-12,4120,4853,4807,9660,新營,一等
2020-08-13,4120,5129,5090,10219,新營,一等
2020-08-14,4120,5857,6211,12068,新營,一等
2020-08-15,4120,5026,5289,10315,新營,一等
2020-08-16,4120,5658,5295,10953,新營,一等
2020-08-17,4120,5385,5327,10712,新營,一等
2020-08-18,4120,5296,5214,10510,新營,一等
2020-08-19,4120,4730,4780,9510,新營,一等
2020-08-20,4120,5166,5236,10402,新營,一等
2020-08-21,4120,5970,6137,12107,新營,一等
2020-08-22,4120,4728,4902,9630,新營,一等
2020-08-23,4120,5144,4704,9848,新營,一等
2020-08-24,4120,5048,5048,10096,新營,一等
2020-08-25,4120,5093,5122,10215,新營,一等
2020-08-26,4120,4301,4389,8690,新營,一等
2020-08-27,4120,4311,4377,8688,新營,一等
2020-08-28,4120,5333,5604,10937,新營,一等
2020-08-29,4120,4324,4521,8845,新營,一等
2020-08-30,4120,4590,4058,8648,新營,一等
2020-08-31,4120,4893,4799,9692,新營,一等
2020-09-01,4120,4450,4593,9043,新營,一等
2020-09-02,4120,4371,4311,8682,新營,一等
2020-09-03,4120,4821,4681,9502,新營,一等
2020-09-04,4120,5709,6152,11861,新營,一等
2020-09-05,4120,4566,4852,9418,新營,一等
2020-09-06,4120,5386,4584,9970,新營,一等
2020-09-07,4120,4847,4778,9625,新營,一等
2020-09-08,4120,4782,4674,9456,新營,一等
2020-09-09,4120,4605,4019,8624,新營,一等
2020-09-10,4120,4659,4764,9423,新營,一等
2020-09-11,4120,5742,6453,12195,新營,一等
2020-09-12,4120,4382,4842,9224,新營,一等
2020-09-13,4120,6023,4802,10825,新營,一等
2020-09-14,4120,4920,4638,9558,新營,一等
2020-09-15,4120,4519,4540,9059,新營,一等
2020-09-16,4120,4305,4393,8698,新營,一等
2020-09-17,4120,4554,4651,9205,新營,一等
2020-09-18,4120,5633,6995,12628,新營,一等
2020-09-19,4120,4464,4937,9401,新營,一等
2020-09-20,4120,6128,4824,10952,新營,一等
2020-09-21,4120,5026,4722,9748,新營,一等
2020-09-22,4120,4637,4522,9159,新營,一等
2020-09-23,4120,4582,4580,9162,新營,一等
2020-09-24,4120,4609,4795,9404,新營,一等
2020-09-25,4120,4870,5399,10269,新營,一等
2020-09-26,4120,4438,4911,9349,新營,一等
2020-09-27,4120,4965,4269,9234,新營,一等
2020-09-28,4120,4865,4686,9551,新營,一等
2020-09-29,4120,4581,4766,9347,新營,一等
2020-09-30,4120,5792,8312,14104,新營,一等
2020-10-01,4120,4854,7052,11906,新營,一等
2020-10-02,4120,5878,6072,11950,新營,一等
2020-10-03,4120,6012,5225,11237,新營,一等
2020-10-04,4120,7457,4644,12101,新營,一等
2020-10-05,4120,5562,4799,10361,新營,一等
2020-10-06,4120,4741,4671,9412,新營,一等
2020-10-07,4120,4574,4758,9332,新營,一等
2020-10-08,4120,5842,7045,12887,新營,一等
2020-10-09,4120,4920,6007,10927,新營,一等
2020-10-10,4120,5212,4892,10104,新營,一等
2020-10-11,4120,6474,4842,11316,新營,一等
2020-10-12,4120,5238,4861,10099,新營,一等
2020-10-13,4120,4679,4613,9292,新營,一等
2020-10-14,4120,4553,4625,9178,新營,一等
2020-10-15,4120,4697,4786,9483,新營,一等
2020-10-16,4120,5779,6693,12472,新營,一等
2020-10-17,4120,5106,5292,10398,新營,一等
2020-10-18,4120,6667,6745,13412,新營,一等
2020-10-19,4120,5132,4915,10047,新營,一等
2020-10-20,4120,4837,4775,9612,新營,一等
2020-10-21,4120,4774,4700,9474,新營,一等
2020-10-22,4120,4768,5031,9799,新營,一等
2020-10-23,4120,5631,7038,12669,新營,一等
2020-10-24,4120,5043,5597,10640,新營,一等
2020-10-25,4120,6366,4786,11152,新營,一等
2020-10-26,4120,5380,5083,10463,新營,一等
2020-10-27,4120,4801,5007,9808,新營,一等
2020-10-28,4120,4555,4540,9095,新營,一等
2020-10-29,4120,4612,4935,9547,新營,一等
2020-10-30,4120,6376,7051,13427,新營,一等
2020-10-31,4120,4921,5345,10266,新營,一等
2020-11-01,4120,6139,5291,11430,新營,一等
2020-11-02,4120,5017,4553,9570,新營,一等
2020-11-03,4120,4493,4525,9018,新營,一等
2020-11-04,4120,4599,4567,9166,新營,一等
2020-11-05,4120,4656,4677,9333,新營,一等
2020-11-06,4120,5665,6641,12306,新營,一等
2020-11-07,4120,4556,4837,9393,新營,一等
2020-11-08,4120,5936,5121,11057,新營,一等
2020-11-09,4120,4892,4583,9475,新營,一等
2020-11-10,4120,4618,4588,9206,新營,一等
2020-11-11,4120,4659,4731,9390,新營,一等
2020-11-12,4120,4705,4986,9691,新營,一等
2020-11-13,4120,6291,7340,13631,新營,一等
2020-11-14,4120,5261,5651,10912,新營,一等
2020-11-15,4120,6606,5917,12523,新營,一等
2020-11-16,4120,5621,5169,10790,新營,一等
2020-11-17,4120,4812,4721,9533,新營,一等
2020-11-18,4120,4762,4836,9598,新營,一等
2020-11-19,4120,4945,5030,9975,新營,一等
2020-11-20,4120,6313,7199,13512,新營,一等
2020-11-21,4120,5169,5642,10811,新營,一等
2020-11-22,4120,6416,5628,12044,新營,一等
2020-11-23,4120,5248,4882,10130,新營,一等
2020-11-24,4120,4718,4657,9375,新營,一等
2020-11-25,4120,4705,4669,9374,新營,一等
2020-11-26,4120,4733,4925,9658,新營,一等
2020-11-27,4120,5952,7042,12994,新營,一等
2020-11-28,4120,4836,5511,10347,新營,一等
2020-11-29,4120,6191,5083,11274,新營,一等
2020-11-30,4120,5296,4714,10010,新營,一等
2020-12-01,4120,4655,4478,9133,新營,一等
2020-12-02,4120,4946,4567,9513,新營,一等
2020-12-03,4120,4577,4807,9384,新營,一等
2020-12-04,4120,5802,6939,12741,新營,一等
2020-12-05,4120,5055,5444,10499,新營,一等
2020-12-06,4120,6326,5522,11848,新營,一等
2020-12-07,4120,5217,4888,10105,新營,一等
2020-12-08,4120,4762,4694,9456,新營,一等
2020-12-09,4120,4459,4482,8941,新營,一等
2020-12-10,4120,4622,4751,9373,新營,一等
2020-12-11,4120,6225,7010,13235,新營,一等
2020-12-12,4120,5208,5533,10741,新營,一等
2020-12-13,4120,6318,5666,11984,新營,一等
2020-12-14,4120,5270,4885,10155,新營,一等
2020-12-15,4120,4733,4684,9417,新營,一等
2020-12-16,4120,4796,4773,9569,新營,一等
2020-12-17,4120,4729,4911,9640,新營,一等
2020-12-18,4120,6154,7062,13216,新營,一等
2020-12-19,4120,5036,5527,10563,新營,一等
2020-12-20,4120,6331,5238,11569,新營,一等
2020-12-21,4120,4932,4580,9512,新營,一等
2020-12-22,4120,4598,4511,9109,新營,一等
2020-12-23,4120,4783,4421,9204,新營,一等
2020-12-24,4120,4652,4860,9512,新營,一等
2020-12-25,4120,5623,6810,12433,新營,一等
2020-12-26,4120,4852,5189,10041,新營,一等
2020-12-27,4120,5557,5027,10584,新營,一等
2020-12-28,4120,5074,4704,9778,新營,一等
2020-12-29,4120,5044,4981,10025,新營,一等
2020-12-30,4120,4636,4714,9350,新營,一等
2020-12-31,4120,6318,6941,13259,新營,一等
2020-01-01,4130,770,1075,1845,柳營,簡易
2020-01-02,4130,1031,1056,2087,柳營,簡易
2020-01-03,4130,1356,1132,2488,柳營,簡易
2020-01-04,4130,504,525,1029,柳營,簡易
2020-01-05,4130,501,726,1227,柳營,簡易
2020-01-06,4130,1090,1047,2137,柳營,簡易
2020-01-07,4130,1073,1041,2114,柳營,簡易
2020-01-08,4130,784,801,1585,柳營,簡易
2020-01-09,4130,998,1004,2002,柳營,簡易
2020-01-10,4130,1529,1098,2627,柳營,簡易
2020-01-11,4130,492,568,1060,柳營,簡易
2020-01-12,4130,575,646,1221,柳營,簡易
2020-01-13,4130,842,857,1699,柳營,簡易
2020-01-14,4130,789,813,1602,柳營,簡易
2020-01-15,4130,752,791,1543,柳營,簡易
2020-01-16,4130,733,760,1493,柳營,簡易
2020-01-17,4130,844,754,1598,柳營,簡易
2020-01-18,4130,438,457,895,柳營,簡易
2020-01-19,4130,434,521,955,柳營,簡易
2020-01-20,4130,707,773,1480,柳營,簡易
2020-01-21,4130,710,721,1431,柳營,簡易
2020-01-22,4130,843,745,1588,柳營,簡易
2020-01-23,4130,455,535,990,柳營,簡易
2020-01-24,4130,247,353,600,柳營,簡易
2020-01-25,4130,402,389,791,柳營,簡易
2020-01-26,4130,333,379,712,柳營,簡易
2020-01-27,4130,390,396,786,柳營,簡易
2020-01-28,4130,487,459,946,柳營,簡易
2020-01-29,4130,452,477,929,柳營,簡易
2020-01-30,4130,594,592,1186,柳營,簡易
2020-01-31,4130,593,542,1135,柳營,簡易
2020-02-01,4130,356,401,757,柳營,簡易
2020-02-02,4130,303,375,678,柳營,簡易
2020-02-03,4130,806,793,1599,柳營,簡易
2020-02-04,4130,650,642,1292,柳營,簡易
2020-02-05,4130,704,728,1432,柳營,簡易
2020-02-06,4130,677,640,1317,柳營,簡易
2020-02-07,4130,718,665,1383,柳營,簡易
2020-02-08,4130,393,417,810,柳營,簡易
2020-02-09,4130,340,412,752,柳營,簡易
2020-02-10,4130,659,670,1329,柳營,簡易
2020-02-11,4130,623,609,1232,柳營,簡易
2020-02-12,4130,630,647,1277,柳營,簡易
2020-02-13,4130,636,623,1259,柳營,簡易
2020-02-14,4130,621,605,1226,柳營,簡易
2020-02-15,4130,382,392,774,柳營,簡易
2020-02-16,4130,394,409,803,柳營,簡易
2020-02-17,4130,556,570,1126,柳營,簡易
2020-02-18,4130,551,574,1125,柳營,簡易
2020-02-19,4130,618,599,1217,柳營,簡易
2020-02-20,4130,617,607,1224,柳營,簡易
2020-02-21,4130,618,636,1254,柳營,簡易
2020-02-22,4130,371,393,764,柳營,簡易
2020-02-23,4130,379,445,824,柳營,簡易
2020-02-24,4130,876,1137,2013,柳營,簡易
2020-02-25,4130,1004,1014,2018,柳營,簡易
2020-02-26,4130,986,981,1967,柳營,簡易
2020-02-27,4130,1679,988,2667,柳營,簡易
2020-02-28,4130,494,476,970,柳營,簡易
2020-02-29,4130,332,333,665,柳營,簡易
2020-03-01,4130,407,1010,1417,柳營,簡易
2020-03-02,4130,982,980,1962,柳營,簡易
2020-03-03,4130,1003,967,1970,柳營,簡易
2020-03-04,4130,972,1007,1979,柳營,簡易
2020-03-05,4130,985,982,1967,柳營,簡易
2020-03-06,4130,1627,1013,2640,柳營,簡易
2020-03-07,4130,458,499,957,柳營,簡易
2020-03-08,4130,479,991,1470,柳營,簡易
2020-03-09,4130,984,987,1971,柳營,簡易
2020-03-10,4130,995,963,1958,柳營,簡易
2020-03-11,4130,1004,990,1994,柳營,簡易
2020-03-12,4130,985,978,1963,柳營,簡易
2020-03-13,4130,1706,1037,2743,柳營,簡易
2020-03-14,4130,377,373,750,柳營,簡易
2020-03-15,4130,408,996,1404,柳營,簡易
2020-03-16,4130,999,1002,2001,柳營,簡易
2020-03-17,4130,944,969,1913,柳營,簡易
2020-03-18,4130,972,980,1952,柳營,簡易
2020-03-19,4130,981,943,1924,柳營,簡易
2020-03-20,4130,1544,928,2472,柳營,簡易
2020-03-21,4130,308,342,650,柳營,簡易
2020-03-22,4130,367,882,1249,柳營,簡易
2020-03-23,4130,870,936,1806,柳營,簡易
2020-03-24,4130,914,906,1820,柳營,簡易
2020-03-25,4130,896,880,1776,柳營,簡易
2020-03-26,4130,890,882,1772,柳營,簡易
2020-03-27,4130,1444,924,2368,柳營,簡易
2020-03-28,4130,356,345,701,柳營,簡易
2020-03-29,4130,317,755,1072,柳營,簡易
2020-03-30,4130,885,883,1768,柳營,簡易
2020-03-31,4130,883,880,1763,柳營,簡易
2020-04-01,4130,1515,943,2458,柳營,簡易
2020-04-02,4130,480,457,937,柳營,簡易
2020-04-03,4130,410,413,823,柳營,簡易
2020-04-04,4130,244,240,484,柳營,簡易
2020-04-05,4130,327,855,1182,柳營,簡易
2020-04-06,4130,919,904,1823,柳營,簡易
2020-04-07,4130,886,883,1769,柳營,簡易
2020-04-08,4130,899,903,1802,柳營,簡易
2020-04-09,4130,921,889,1810,柳營,簡易
2020-04-10,4130,1389,898,2287,柳營,簡易
2020-04-11,4130,372,365,737,柳營,簡易
2020-04-12,4130,312,779,1091,柳營,簡易
2020-04-13,4130,902,899,1801,柳營,簡易
2020-04-14,4130,872,873,1745,柳營,簡易
2020-04-15,4130,889,882,1771,柳營,簡易
2020-04-16,4130,907,887,1794,柳營,簡易
2020-04-17,4130,1160,949,2109,柳營,簡易
2020-04-18,4130,397,385,782,柳營,簡易
2020-04-19,4130,320,516,836,柳營,簡易
2020-04-20,4130,878,893,1771,柳營,簡易
2020-04-21,4130,876,857,1733,柳營,簡易
2020-04-22,4130,866,825,1691,柳營,簡易
2020-04-23,4130,830,795,1625,柳營,簡易
2020-04-24,4130,1348,837,2185,柳營,簡易
2020-04-25,4130,323,313,636,柳營,簡易
2020-04-26,4130,273,809,1082,柳營,簡易
2020-04-27,4130,876,875,1751,柳營,簡易
2020-04-28,4130,874,865,1739,柳營,簡易
2020-04-29,4130,805,795,1600,柳營,簡易
2020-04-30,4130,875,800,1675,柳營,簡易
2020-05-01,4130,1266,799,2065,柳營,簡易
2020-05-02,4130,295,298,593,柳營,簡易
2020-05-03,4130,301,769,1070,柳營,簡易
2020-05-04,4130,907,940,1847,柳營,簡易
2020-05-05,4130,914,874,1788,柳營,簡易
2020-05-06,4130,948,902,1850,柳營,簡易
2020-05-07,4130,885,844,1729,柳營,簡易
2020-05-08,4130,1566,925,2491,柳營,簡易
2020-05-09,4130,338,370,708,柳營,簡易
2020-05-10,4130,315,882,1197,柳營,簡易
2020-05-11,4130,888,890,1778,柳營,簡易
2020-05-12,4130,912,885,1797,柳營,簡易
2020-05-13,4130,907,882,1789,柳營,簡易
2020-05-14,4130,955,933,1888,柳營,簡易
2020-05-15,4130,1587,937,2524,柳營,簡易
2020-05-16,4130,353,324,677,柳營,簡易
2020-05-17,4130,324,340,664,柳營,簡易
2020-05-18,4130,705,1292,1997,柳營,簡易
2020-05-19,4130,910,912,1822,柳營,簡易
2020-05-20,4130,902,889,1791,柳營,簡易
2020-05-21,4130,875,864,1739,柳營,簡易
2020-05-22,4130,1364,886,2250,柳營,簡易
2020-05-23,4130,472,478,950,柳營,簡易
2020-05-24,4130,401,893,1294,柳營,簡易
2020-05-25,4130,944,931,1875,柳營,簡易
2020-05-26,4130,906,887,1793,柳營,簡易
2020-05-27,4130,865,835,1700,柳營,簡易
2020-05-28,4130,877,852,1729,柳營,簡易
2020-05-29,4130,1502,932,2434,柳營,簡易
2020-05-30,4130,379,401,780,柳營,簡易
2020-05-31,4130,384,886,1270,柳營,簡易
2020-06-01,4130,996,993,1989,柳營,簡易
2020-06-02,4130,968,933,1901,柳營,簡易
2020-06-03,4130,929,941,1870,柳營,簡易
2020-06-04,4130,910,914,1824,柳營,簡易
2020-06-05,4130,1452,901,2353,柳營,簡易
2020-06-06,4130,435,492,927,柳營,簡易
2020-06-07,4130,349,929,1278,柳營,簡易
2020-06-08,4130,939,938,1877,柳營,簡易
2020-06-09,4130,928,893,1821,柳營,簡易
2020-06-10,4130,944,951,1895,柳營,簡易
2020-06-11,4130,961,940,1901,柳營,簡易
2020-06-12,4130,1230,963,2193,柳營,簡易
2020-06-13,4130,454,515,969,柳營,簡易
2020-06-14,4130,464,645,1109,柳營,簡易
2020-06-15,4130,951,1048,1999,柳營,簡易
2020-06-16,4130,919,902,1821,柳營,簡易
2020-06-17,4130,888,866,1754,柳營,簡易
2020-06-18,4130,877,871,1748,柳營,簡易
2020-06-19,4130,1355,1110,2465,柳營,簡易
2020-06-20,4130,605,599,1204,柳營,簡易
2020-06-21,4130,299,452,751,柳營,簡易
2020-06-22,4130,784,816,1600,柳營,簡易
2020-06-23,4130,717,715,1432,柳營,簡易
2020-06-24,4130,807,780,1587,柳營,簡易
2020-06-25,4130,411,495,906,柳營,簡易
2020-06-26,4130,539,548,1087,柳營,簡易
2020-06-27,4130,344,387,731,柳營,簡易
2020-06-28,4130,327,470,797,柳營,簡易
2020-06-29,4130,827,828,1655,柳營,簡易
2020-06-30,4130,790,816,1606,柳營,簡易
2020-07-01,4130,768,780,1548,柳營,簡易
2020-07-02,4130,715,739,1454,柳營,簡易
2020-07-03,4130,905,755,1660,柳營,簡易
2020-07-04,4130,392,444,836,柳營,簡易
2020-07-05,4130,309,482,791,柳營,簡易
2020-07-06,4130,730,770,1500,柳營,簡易
2020-07-07,4130,745,777,1522,柳營,簡易
2020-07-08,4130,751,782,1533,柳營,簡易
2020-07-09,4130,755,806,1561,柳營,簡易
2020-07-10,4130,901,762,1663,柳營,簡易
2020-07-11,4130,347,408,755,柳營,簡易
2020-07-12,4130,418,552,970,柳營,簡易
2020-07-13,4130,728,797,1525,柳營,簡易
2020-07-14,4130,738,766,1504,柳營,簡易
2020-07-15,4130,755,727,1482,柳營,簡易
2020-07-16,4130,687,689,1376,柳營,簡易
2020-07-17,4130,959,830,1789,柳營,簡易
2020-07-18,4130,423,449,872,柳營,簡易
2020-07-19,4130,354,518,872,柳營,簡易
2020-07-20,4130,727,773,1500,柳營,簡易
2020-07-21,4130,732,756,1488,柳營,簡易
2020-07-22,4130,761,778,1539,柳營,簡易
2020-07-23,4130,776,751,1527,柳營,簡易
2020-07-24,4130,779,716,1495,柳營,簡易
2020-07-25,4130,459,468,927,柳營,簡易
2020-07-26,4130,372,417,789,柳營,簡易
2020-07-27,4130,626,652,1278,柳營,簡易
2020-07-28,4130,650,644,1294,柳營,簡易
2020-07-29,4130,624,640,1264,柳營,簡易
2020-07-30,4130,597,642,1239,柳營,簡易
2020-07-31,4130,666,666,1332,柳營,簡易
2020-08-01,4130,405,495,900,柳營,簡易
2020-08-02,4130,371,422,793,柳營,簡易
2020-08-03,4130,643,650,1293,柳營,簡易
2020-08-04,4130,631,690,1321,柳營,簡易
2020-08-05,4130,648,661,1309,柳營,簡易
2020-08-06,4130,711,690,1401,柳營,簡易
2020-08-07,4130,715,664,1379,柳營,簡易
2020-08-08,4130,345,416,761,柳營,簡易
2020-08-09,4130,408,441,849,柳營,簡易
2020-08-10,4130,621,663,1284,柳營,簡易
2020-08-11,4130,615,609,1224,柳營,簡易
2020-08-12,4130,652,662,1314,柳營,簡易
2020-08-13,4130,650,651,1301,柳營,簡易
2020-08-14,4130,673,634,1307,柳營,簡易
2020-08-15,4130,416,435,851,柳營,簡易
2020-08-16,4130,402,434,836,柳營,簡易
2020-08-17,4130,608,662,1270,柳營,簡易
2020-08-18,4130,643,633,1276,柳營,簡易
2020-08-19,4130,642,616,1258,柳營,簡易
2020-08-20,4130,651,653,1304,柳營,簡易
2020-08-21,4130,621,630,1251,柳營,簡易
2020-08-22,4130,412,452,864,柳營,簡易
2020-08-23,4130,398,381,779,柳營,簡易
2020-08-24,4130,719,783,1502,柳營,簡易
2020-08-25,4130,744,725,1469,柳營,簡易
2020-08-26,4130,693,710,1403,柳營,簡易
2020-08-27,4130,715,695,1410,柳營,簡易
2020-08-28,4130,946,702,1648,柳營,簡易
2020-08-29,4130,351,385,736,柳營,簡易
2020-08-30,4130,259,290,549,柳營,簡易
2020-08-31,4130,730,765,1495,柳營,簡易
2020-09-01,4130,658,652,1310,柳營,簡易
2020-09-02,4130,584,614,1198,柳營,簡易
2020-09-03,4130,626,605,1231,柳營,簡易
2020-09-04,4130,649,641,1290,柳營,簡易
2020-09-05,4130,356,405,761,柳營,簡易
2020-09-06,4130,383,367,750,柳營,簡易
2020-09-07,4130,640,664,1304,柳營,簡易
2020-09-08,4130,623,622,1245,柳營,簡易
2020-09-09,4130,609,651,1260,柳營,簡易
2020-09-10,4130,617,634,1251,柳營,簡易
2020-09-11,4130,598,638,1236,柳營,簡易
2020-09-12,4130,436,465,901,柳營,簡易
2020-09-13,4130,466,600,1066,柳營,簡易
2020-09-14,4130,1094,1085,2179,柳營,簡易
2020-09-15,4130,1050,1015,2065,柳營,簡易
2020-09-16,4130,1027,1018,2045,柳營,簡易
2020-09-17,4130,1042,1040,2082,柳營,簡易
2020-09-18,4130,1831,1089,2920,柳營,簡易
2020-09-19,4130,510,550,1060,柳營,簡易
2020-09-20,4130,486,1133,1619,柳營,簡易
2020-09-21,4130,1065,1051,2116,柳營,簡易
2020-09-22,4130,1037,1011,2048,柳營,簡易
2020-09-23,4130,1095,1092,2187,柳營,簡易
2020-09-24,4130,1021,1041,2062,柳營,簡易
2020-09-25,4130,1061,1060,2121,柳營,簡易
2020-09-26,4130,962,823,1785,柳營,簡易
2020-09-27,4130,881,1026,1907,柳營,簡易
2020-09-28,4130,1056,1038,2094,柳營,簡易
2020-09-29,4130,1055,1033,2088,柳營,簡易
2020-09-30,4130,1860,1144,3004,柳營,簡易
2020-10-01,4130,601,663,1264,柳營,簡易
2020-10-02,4130,660,708,1368,柳營,簡易
2020-10-03,4130,413,465,878,柳營,簡易
2020-10-04,4130,485,1129,1614,柳營,簡易
2020-10-05,4130,1115,1112,2227,柳營,簡易
2020-10-06,4130,1067,1027,2094,柳營,簡易
2020-10-07,4130,1058,1019,2077,柳營,簡易
2020-10-08,4130,1778,1069,2847,柳營,簡易
2020-10-09,4130,722,697,1419,柳營,簡易
2020-10-10,4130,489,463,952,柳營,簡易
2020-10-11,4130,475,1184,1659,柳營,簡易
2020-10-12,4130,1078,1035,2113,柳營,簡易
2020-10-13,4130,1030,991,2021,柳營,簡易
2020-10-14,4130,1064,1049,2113,柳營,簡易
2020-10-15,4130,1028,1013,2041,柳營,簡易
2020-10-16,4130,1719,1094,2813,柳營,簡易
2020-10-17,4130,639,610,1249,柳營,簡易
2020-10-18,4130,564,1230,1794,柳營,簡易
2020-10-19,4130,1077,1058,2135,柳營,簡易
2020-10-20,4130,1059,1044,2103,柳營,簡易
2020-10-21,4130,1038,1027,2065,柳營,簡易
2020-10-22,4130,1074,1066,2140,柳營,簡易
2020-10-23,4130,1311,1281,2592,柳營,簡易
2020-10-24,4130,1277,832,2109,柳營,簡易
2020-10-25,4130,504,491,995,柳營,簡易
2020-10-26,4130,892,1460,2352,柳營,簡易
2020-10-27,4130,1036,1005,2041,柳營,簡易
2020-10-28,4130,1066,1019,2085,柳營,簡易
2020-10-29,4130,1044,1054,2098,柳營,簡易
2020-10-30,4130,1760,1088,2848,柳營,簡易
2020-10-31,4130,516,571,1087,柳營,簡易
2020-11-01,4130,596,1097,1693,柳營,簡易
2020-11-02,4130,1058,1076,2134,柳營,簡易
2020-11-03,4130,1061,1006,2067,柳營,簡易
2020-11-04,4130,1044,994,2038,柳營,簡易
2020-11-05,4130,1087,1055,2142,柳營,簡易
2020-11-06,4130,1262,1033,2295,柳營,簡易
2020-11-07,4130,538,529,1067,柳營,簡易
2020-11-08,4130,571,716,1287,柳營,簡易
2020-11-09,4130,1070,1012,2082,柳營,簡易
2020-11-10,4130,774,779,1553,柳營,簡易
2020-11-11,4130,1021,936,1957,柳營,簡易
2020-11-12,4130,753,766,1519,柳營,簡易
2020-11-13,4130,1745,1046,2791,柳營,簡易
2020-11-14,4130,521,501,1022,柳營,簡易
2020-11-15,4130,502,1153,1655,柳營,簡易
2020-11-16,4130,1135,1137,2272,柳營,簡易
2020-11-17,4130,1074,1058,2132,柳營,簡易
2020-11-18,4130,1114,1070,2184,柳營,簡易
2020-11-19,4130,1108,1028,2136,柳營,簡易
2020-11-20,4130,1695,1094,2789,柳營,簡易
2020-11-21,4130,633,658,1291,柳營,簡易
2020-11-22,4130,671,1276,1947,柳營,簡易
2020-11-23,4130,1047,1026,2073,柳營,簡易
2020-11-24,4130,1066,1006,2072,柳營,簡易
2020-11-25,4130,1061,1055,2116,柳營,簡易
2020-11-26,4130,1065,1021,2086,柳營,簡易
2020-11-27,4130,1765,1120,2885,柳營,簡易
2020-11-28,4130,590,676,1266,柳營,簡易
2020-11-29,4130,597,1332,1929,柳營,簡易
2020-11-30,4130,1222,1182,2404,柳營,簡易
2020-12-01,4130,1076,1016,2092,柳營,簡易
2020-12-02,4130,1063,1004,2067,柳營,簡易
2020-12-03,4130,1049,1005,2054,柳營,簡易
2020-12-04,4130,1795,1068,2863,柳營,簡易
2020-12-05,4130,602,562,1164,柳營,簡易
2020-12-06,4130,507,1184,1691,柳營,簡易
2020-12-07,4130,1090,1102,2192,柳營,簡易
2020-12-08,4130,1087,1032,2119,柳營,簡易
2020-12-09,4130,1076,1047,2123,柳營,簡易
2020-12-10,4130,1119,1047,2166,柳營,簡易
2020-12-11,4130,1841,1072,2913,柳營,簡易
2020-12-12,4130,515,493,1008,柳營,簡易
2020-12-13,4130,593,1224,1817,柳營,簡易
2020-12-14,4130,1043,1064,2107,柳營,簡易
2020-12-15,4130,1058,1032,2090,柳營,簡易
2020-12-16,4130,1043,1057,2100,柳營,簡易
2020-12-17,4130,1088,1055,2143,柳營,簡易
2020-12-18,4130,1837,1108,2945,柳營,簡易
2020-12-19,4130,586,597,1183,柳營,簡易
2020-12-20,4130,509,1165,1674,柳營,簡易
2020-12-21,4130,1073,1068,2141,柳營,簡易
2020-12-22,4130,1085,1032,2117,柳營,簡易
2020-12-23,4130,1011,980,1991,柳營,簡易
2020-12-24,4130,999,960,1959,柳營,簡易
2020-12-25,4130,1627,1070,2697,柳營,簡易
2020-12-26,4130,765,658,1423,柳營,簡易
2020-12-27,4130,555,949,1504,柳營,簡易
2020-12-28,4130,1038,1077,2115,柳營,簡易
2020-12-29,4130,1015,1000,2015,柳營,簡易
2020-12-30,4130,1011,948,1959,柳營,簡易
2020-12-31,4130,1629,964,2593,柳營,簡易
2020-01-01,4140,493,516,1009,林鳳營,甲簡
2020-01-02,4140,561,632,1193,林鳳營,甲簡
2020-01-03,4140,560,742,1302,林鳳營,甲簡
2020-01-04,4140,470,601,1071,林鳳營,甲簡
2020-01-05,4140,715,492,1207,林鳳營,甲簡
2020-01-06,4140,588,595,1183,林鳳營,甲簡
2020-01-07,4140,582,681,1263,林鳳營,甲簡
2020-01-08,4140,509,575,1084,林鳳營,甲簡
2020-01-09,4140,542,633,1175,林鳳營,甲簡
2020-01-10,4140,540,895,1435,林鳳營,甲簡
2020-01-11,4140,664,705,1369,林鳳營,甲簡
2020-01-12,4140,811,482,1293,林鳳營,甲簡
2020-01-13,4140,638,647,1285,林鳳營,甲簡
2020-01-14,4140,579,626,1205,林鳳營,甲簡
2020-01-15,4140,557,603,1160,林鳳營,甲簡
2020-01-16,4140,582,658,1240,林鳳營,甲簡
2020-01-17,4140,556,655,1211,林鳳營,甲簡
2020-01-18,4140,639,654,1293,林鳳營,甲簡
2020-01-19,4140,698,602,1300,林鳳營,甲簡
2020-01-20,4140,589,598,1187,林鳳營,甲簡
2020-01-21,4140,575,600,1175,林鳳營,甲簡
2020-01-22,4140,584,757,1341,林鳳營,甲簡
2020-01-23,4140,453,649,1102,林鳳營,甲簡
2020-01-24,4140,304,478,782,林鳳營,甲簡
2020-01-25,4140,507,494,1001,林鳳營,甲簡
2020-01-26,4140,598,526,1124,林鳳營,甲簡
2020-01-27,4140,664,600,1264,林鳳營,甲簡
2020-01-28,4140,504,453,957,林鳳營,甲簡
2020-01-29,4140,572,482,1054,林鳳營,甲簡
2020-01-30,4140,510,492,1002,林鳳營,甲簡
2020-01-31,4140,612,574,1186,林鳳營,甲簡
2020-02-01,4140,412,443,855,林鳳營,甲簡
2020-02-02,4140,433,378,811,林鳳營,甲簡
2020-02-03,4140,507,509,1016,林鳳營,甲簡
2020-02-04,4140,484,528,1012,林鳳營,甲簡
2020-02-05,4140,461,472,933,林鳳營,甲簡
2020-02-06,4140,438,504,942,林鳳營,甲簡
2020-02-07,4140,490,571,1061,林鳳營,甲簡
2020-02-08,4140,471,515,986,林鳳營,甲簡
2020-02-09,4140,609,458,1067,林鳳營,甲簡
2020-02-10,4140,495,501,996,林鳳營,甲簡
2020-02-11,4140,453,455,908,林鳳營,甲簡
2020-02-12,4140,463,516,979,林鳳營,甲簡
2020-02-13,4140,456,451,907,林鳳營,甲簡
2020-02-14,4140,493,541,1034,林鳳營,甲簡
2020-02-15,4140,443,495,938,林鳳營,甲簡
2020-02-16,4140,547,397,944,林鳳營,甲簡
2020-02-17,4140,449,466,915,林鳳營,甲簡
2020-02-18,4140,424,454,878,林鳳營,甲簡
2020-02-19,4140,428,455,883,林鳳營,甲簡
2020-02-20,4140,411,425,836,林鳳營,甲簡
2020-02-21,4140,475,602,1077,林鳳營,甲簡
2020-02-22,4140,396,476,872,林鳳營,甲簡
2020-02-23,4140,533,342,875,林鳳營,甲簡
2020-02-24,4140,491,456,947,林鳳營,甲簡
2020-02-25,4140,513,571,1084,林鳳營,甲簡
2020-02-26,4140,518,547,1065,林鳳營,甲簡
2020-02-27,4140,532,686,1218,林鳳營,甲簡
2020-02-28,4140,454,573,1027,林鳳營,甲簡
2020-02-29,4140,507,438,945,林鳳營,甲簡
2020-03-01,4140,566,367,933,林鳳營,甲簡
2020-03-02,4140,544,524,1068,林鳳營,甲簡
2020-03-03,4140,528,544,1072,林鳳營,甲簡
2020-03-04,4140,496,540,1036,林鳳營,甲簡
2020-03-05,4140,486,549,1035,林鳳營,甲簡
2020-03-06,4140,533,748,1281,林鳳營,甲簡
2020-03-07,4140,391,473,864,林鳳營,甲簡
2020-03-08,4140,621,407,1028,林鳳營,甲簡
2020-03-09,4140,565,563,1128,林鳳營,甲簡
2020-03-10,4140,473,521,994,林鳳營,甲簡
2020-03-11,4140,502,530,1032,林鳳營,甲簡
2020-03-12,4140,521,552,1073,林鳳營,甲簡
2020-03-13,4140,509,770,1279,林鳳營,甲簡
2020-03-14,4140,349,418,767,林鳳營,甲簡
2020-03-15,4140,589,377,966,林鳳營,甲簡
2020-03-16,4140,585,553,1138,林鳳營,甲簡
2020-03-17,4140,542,545,1087,林鳳營,甲簡
2020-03-18,4140,472,530,1002,林鳳營,甲簡
2020-03-19,4140,468,534,1002,林鳳營,甲簡
2020-03-20,4140,505,721,1226,林鳳營,甲簡
2020-03-21,4140,370,409,779,林鳳營,甲簡
2020-03-22,4140,603,362,965,林鳳營,甲簡
2020-03-23,4140,529,511,1040,林鳳營,甲簡
2020-03-24,4140,470,505,975,林鳳營,甲簡
2020-03-25,4140,440,516,956,林鳳營,甲簡
2020-03-26,4140,502,530,1032,林鳳營,甲簡
2020-03-27,4140,490,635,1125,林鳳營,甲簡
2020-03-28,4140,274,378,652,林鳳營,甲簡
2020-03-29,4140,514,287,801,林鳳營,甲簡
2020-03-30,4140,518,507,1025,林鳳營,甲簡
2020-03-31,4140,483,536,1019,林鳳營,甲簡
2020-04-01,4140,433,664,1097,林鳳營,甲簡
2020-04-02,4140,346,480,826,林鳳營,甲簡
2020-04-03,4140,331,431,762,林鳳營,甲簡
2020-04-04,4140,313,285,598,林鳳營,甲簡
2020-04-05,4140,498,246,744,林鳳營,甲簡
2020-04-06,4140,501,454,955,林鳳營,甲簡
2020-04-07,4140,422,435,857,林鳳營,甲簡
2020-04-08,4140,440,458,898,林鳳營,甲簡
2020-04-09,4140,451,490,941,林鳳營,甲簡
2020-04-10,4140,454,631,1085,林鳳營,甲簡
2020-04-11,4140,282,344,626,林鳳營,甲簡
2020-04-12,4140,437,258,695,林鳳營,甲簡
2020-04-13,4140,514,499,1013,林鳳營,甲簡
2020-04-14,4140,442,459,901,林鳳營,甲簡
2020-04-15,4140,446,493,939,林鳳營,甲簡
2020-04-16,4140,453,487,940,林鳳營,甲簡
2020-04-17,4140,468,696,1164,林鳳營,甲簡
2020-04-18,4140,310,381,691,林鳳營,甲簡
2020-04-19,4140,487,269,756,林鳳營,甲簡
2020-04-20,4140,523,484,1007,林鳳營,甲簡
2020-04-21,4140,454,455,909,林鳳營,甲簡
2020-04-22,4140,438,482,920,林鳳營,甲簡
2020-04-23,4140,437,448,885,林鳳營,甲簡
2020-04-24,4140,434,615,1049,林鳳營,甲簡
2020-04-25,4140,243,330,573,林鳳營,甲簡
2020-04-26,4140,418,218,636,林鳳營,甲簡
2020-04-27,4140,512,494,1006,林鳳營,甲簡
2020-04-28,4140,438,481,919,林鳳營,甲簡
2020-04-29,4140,422,426,848,林鳳營,甲簡
2020-04-30,4140,489,526,1015,林鳳營,甲簡
2020-05-01,4140,422,621,1043,林鳳營,甲簡
2020-05-02,4140,303,375,678,林鳳營,甲簡
2020-05-03,4140,463,294,757,林鳳營,甲簡
2020-05-04,4140,516,505,1021,林鳳營,甲簡
2020-05-05,4140,468,479,947,林鳳營,甲簡
2020-05-06,4140,441,498,939,林鳳營,甲簡
2020-05-07,4140,475,509,984,林鳳營,甲簡
2020-05-08,4140,479,702,1181,林鳳營,甲簡
2020-05-09,4140,321,448,769,林鳳營,甲簡
2020-05-10,4140,594,317,911,林鳳營,甲簡
2020-05-11,4140,579,523,1102,林鳳營,甲簡
2020-05-12,4140,487,509,996,林鳳營,甲簡
2020-05-13,4140,477,525,1002,林鳳營,甲簡
2020-05-14,4140,505,521,1026,林鳳營,甲簡
2020-05-15,4140,505,675,1180,林鳳營,甲簡
2020-05-16,4140,319,383,702,林鳳營,甲簡
2020-05-17,4140,486,319,805,林鳳營,甲簡
2020-05-18,4140,534,498,1032,林鳳營,甲簡
2020-05-19,4140,469,456,925,林鳳營,甲簡
2020-05-20,4140,470,503,973,林鳳營,甲簡
2020-05-21,4140,438,481,919,林鳳營,甲簡
2020-05-22,4140,412,600,1012,林鳳營,甲簡
2020-05-23,4140,283,359,642,林鳳營,甲簡
2020-05-24,4140,528,312,840,林鳳營,甲簡
2020-05-25,4140,530,518,1048,林鳳營,甲簡
2020-05-26,4140,465,475,940,林鳳營,甲簡
2020-05-27,4140,424,464,888,林鳳營,甲簡
2020-05-28,4140,449,513,962,林鳳營,甲簡
2020-05-29,4140,520,722,1242,林鳳營,甲簡
2020-05-30,4140,453,538,991,林鳳營,甲簡
2020-05-31,4140,580,396,976,林鳳營,甲簡
2020-06-01,4140,573,560,1133,林鳳營,甲簡
2020-06-02,4140,498,511,1009,林鳳營,甲簡
2020-06-03,4140,486,502,988,林鳳營,甲簡
2020-06-04,4140,496,514,1010,林鳳營,甲簡
2020-06-05,4140,537,699,1236,林鳳營,甲簡
2020-06-06,4140,384,478,862,林鳳營,甲簡
2020-06-07,4140,585,385,970,林鳳營,甲簡
2020-06-08,4140,532,503,1035,林鳳營,甲簡
2020-06-09,4140,490,512,1002,林鳳營,甲簡
2020-06-10,4140,467,510,977,林鳳營,甲簡
2020-06-11,4140,507,524,1031,林鳳營,甲簡
2020-06-12,4140,543,699,1242,林鳳營,甲簡
2020-06-13,4140,481,564,1045,林鳳營,甲簡
2020-06-14,4140,574,422,996,林鳳營,甲簡
2020-06-15,4140,564,544,1108,林鳳營,甲簡
2020-06-16,4140,529,539,1068,林鳳營,甲簡
2020-06-17,4140,472,497,969,林鳳營,甲簡
2020-06-18,4140,505,523,1028,林鳳營,甲簡
2020-06-19,4140,519,624,1143,林鳳營,甲簡
2020-06-20,4140,450,561,1011,林鳳營,甲簡
2020-06-21,4140,592,459,1051,林鳳營,甲簡
2020-06-22,4140,564,533,1097,林鳳營,甲簡
2020-06-23,4140,505,546,1051,林鳳營,甲簡
2020-06-24,4140,512,700,1212,林鳳營,甲簡
2020-06-25,4140,434,594,1028,林鳳營,甲簡
2020-06-26,4140,642,651,1293,林鳳營,甲簡
2020-06-27,4140,536,468,1004,林鳳營,甲簡
2020-06-28,4140,570,372,942,林鳳營,甲簡
2020-06-29,4140,589,573,1162,林鳳營,甲簡
2020-06-30,4140,577,495,1072,林鳳營,甲簡
2020-07-01,4140,437,465,902,林鳳營,甲簡
2020-07-02,4140,477,475,952,林鳳營,甲簡
2020-07-03,4140,492,626,1118,林鳳營,甲簡
2020-07-04,4140,449,472,921,林鳳營,甲簡
2020-07-05,4140,450,352,802,林鳳營,甲簡
2020-07-06,4140,496,488,984,林鳳營,甲簡
2020-07-07,4140,471,501,972,林鳳營,甲簡
2020-07-08,4140,501,508,1009,林鳳營,甲簡
2020-07-09,4140,499,508,1007,林鳳營,甲簡
2020-07-10,4140,581,690,1271,林鳳營,甲簡
2020-07-11,4140,456,566,1022,林鳳營,甲簡
2020-07-12,4140,633,424,1057,林鳳營,甲簡
2020-07-13,4140,516,514,1030,林鳳營,甲簡
2020-07-14,4140,527,567,1094,林鳳營,甲簡
2020-07-15,4140,484,502,986,林鳳營,甲簡
2020-07-16,4140,566,563,1129,林鳳營,甲簡
2020-07-17,4140,620,680,1300,林鳳營,甲簡
2020-07-18,4140,495,562,1057,林鳳營,甲簡
2020-07-19,4140,638,502,1140,林鳳營,甲簡
2020-07-20,4140,545,593,1138,林鳳營,甲簡
2020-07-21,4140,546,507,1053,林鳳營,甲簡
2020-07-22,4140,469,495,964,林鳳營,甲簡
2020-07-23,4140,488,515,1003,林鳳營,甲簡
2020-07-24,4140,528,622,1150,林鳳營,甲簡
2020-07-25,4140,495,572,1067,林鳳營,甲簡
2020-07-26,4140,617,470,1087,林鳳營,甲簡
2020-07-27,4140,552,523,1075,林鳳營,甲簡
2020-07-28,4140,491,489,980,林鳳營,甲簡
2020-07-29,4140,494,481,975,林鳳營,甲簡
2020-07-30,4140,466,489,955,林鳳營,甲簡
2020-07-31,4140,589,623,1212,林鳳營,甲簡
2020-08-01,4140,449,497,946,林鳳營,甲簡
2020-08-02,4140,549,455,1004,林鳳營,甲簡
2020-08-03,4140,445,446,891,林鳳營,甲簡
2020-08-04,4140,446,453,899,林鳳營,甲簡
2020-08-05,4140,526,512,1038,林鳳營,甲簡
2020-08-06,4140,482,478,960,林鳳營,甲簡
2020-08-07,4140,505,644,1149,林鳳營,甲簡
2020-08-08,4140,436,517,953,林鳳營,甲簡
2020-08-09,4140,586,475,1061,林鳳營,甲簡
2020-08-10,4140,573,525,1098,林鳳營,甲簡
2020-08-11,4140,465,449,914,林鳳營,甲簡
2020-08-12,4140,548,527,1075,林鳳營,甲簡
2020-08-13,4140,494,515,1009,林鳳營,甲簡
2020-08-14,4140,592,693,1285,林鳳營,甲簡
2020-08-15,4140,496,509,1005,林鳳營,甲簡
2020-08-16,4140,542,451,993,林鳳營,甲簡
2020-08-17,4140,582,547,1129,林鳳營,甲簡
2020-08-18,4140,543,540,1083,林鳳營,甲簡
2020-08-19,4140,515,554,1069,林鳳營,甲簡
2020-08-20,4140,567,592,1159,林鳳營,甲簡
2020-08-21,4140,585,678,1263,林鳳營,甲簡
2020-08-22,4140,457,500,957,林鳳營,甲簡
2020-08-23,4140,532,480,1012,林鳳營,甲簡
2020-08-24,4140,580,542,1122,林鳳營,甲簡
2020-08-25,4140,536,534,1070,林鳳營,甲簡
2020-08-26,4140,432,430,862,林鳳營,甲簡
2020-08-27,4140,483,472,955,林鳳營,甲簡
2020-08-28,4140,530,601,1131,林鳳營,甲簡
2020-08-29,4140,457,502,959,林鳳營,甲簡
2020-08-30,4140,496,394,890,林鳳營,甲簡
2020-08-31,4140,542,567,1109,林鳳營,甲簡
2020-09-01,4140,553,538,1091,林鳳營,甲簡
2020-09-02,4140,529,529,1058,林鳳營,甲簡
2020-09-03,4140,556,589,1145,林鳳營,甲簡
2020-09-04,4140,582,655,1237,林鳳營,甲簡
2020-09-05,4140,483,490,973,林鳳營,甲簡
2020-09-06,4140,537,490,1027,林鳳營,甲簡
2020-09-07,4140,583,551,1134,林鳳營,甲簡
2020-09-08,4140,545,557,1102,林鳳營,甲簡
2020-09-09,4140,515,541,1056,林鳳營,甲簡
2020-09-10,4140,563,574,1137,林鳳營,甲簡
2020-09-11,4140,576,693,1269,林鳳營,甲簡
2020-09-12,4140,465,548,1013,林鳳營,甲簡
2020-09-13,4140,586,480,1066,林鳳營,甲簡
2020-09-14,4140,598,564,1162,林鳳營,甲簡
2020-09-15,4140,521,526,1047,林鳳營,甲簡
2020-09-16,4140,514,534,1048,林鳳營,甲簡
2020-09-17,4140,563,544,1107,林鳳營,甲簡
2020-09-18,4140,547,798,1345,林鳳營,甲簡
2020-09-19,4140,458,558,1016,林鳳營,甲簡
2020-09-20,4140,644,438,1082,林鳳營,甲簡
2020-09-21,4140,593,555,1148,林鳳營,甲簡
2020-09-22,4140,556,555,1111,林鳳營,甲簡
2020-09-23,4140,572,544,1116,林鳳營,甲簡
2020-09-24,4140,570,564,1134,林鳳營,甲簡
2020-09-25,4140,597,653,1250,林鳳營,甲簡
2020-09-26,4140,478,557,1035,林鳳營,甲簡
2020-09-27,4140,491,421,912,林鳳營,甲簡
2020-09-28,4140,595,553,1148,林鳳營,甲簡
2020-09-29,4140,543,561,1104,林鳳營,甲簡
2020-09-30,4140,577,858,1435,林鳳營,甲簡
2020-10-01,4140,527,741,1268,林鳳營,甲簡
2020-10-02,4140,632,670,1302,林鳳營,甲簡
2020-10-03,4140,586,554,1140,林鳳營,甲簡
2020-10-04,4140,729,398,1127,林鳳營,甲簡
2020-10-05,4140,613,556,1169,林鳳營,甲簡
2020-10-06,4140,571,554,1125,林鳳營,甲簡
2020-10-07,4140,527,562,1089,林鳳營,甲簡
2020-10-08,4140,596,772,1368,林鳳營,甲簡
2020-10-09,4140,541,716,1257,林鳳營,甲簡
2020-10-10,4140,574,538,1112,林鳳營,甲簡
2020-10-11,4140,590,429,1019,林鳳營,甲簡
2020-10-12,4140,597,568,1165,林鳳營,甲簡
2020-10-13,4140,553,558,1111,林鳳營,甲簡
2020-10-14,4140,580,572,1152,林鳳營,甲簡
2020-10-15,4140,552,586,1138,林鳳營,甲簡
2020-10-16,4140,589,769,1358,林鳳營,甲簡
2020-10-17,4140,502,574,1076,林鳳營,甲簡
2020-10-18,4140,1544,868,2412,林鳳營,甲簡
2020-10-19,4140,639,571,1210,林鳳營,甲簡
2020-10-20,4140,574,567,1141,林鳳營,甲簡
2020-10-21,4140,540,567,1107,林鳳營,甲簡
2020-10-22,4140,582,576,1158,林鳳營,甲簡
2020-10-23,4140,562,779,1341,林鳳營,甲簡
2020-10-24,4140,537,595,1132,林鳳營,甲簡
2020-10-25,4140,623,471,1094,林鳳營,甲簡
2020-10-26,4140,628,557,1185,林鳳營,甲簡
2020-10-27,4140,560,574,1134,林鳳營,甲簡
2020-10-28,4140,530,543,1073,林鳳營,甲簡
2020-10-29,4140,537,527,1064,林鳳營,甲簡
2020-10-30,4140,568,743,1311,林鳳營,甲簡
2020-10-31,4140,582,628,1210,林鳳營,甲簡
2020-11-01,4140,625,462,1087,林鳳營,甲簡
2020-11-02,4140,600,544,1144,林鳳營,甲簡
2020-11-03,4140,543,554,1097,林鳳營,甲簡
2020-11-04,4140,537,549,1086,林鳳營,甲簡
2020-11-05,4140,542,572,1114,林鳳營,甲簡
2020-11-06,4140,558,732,1290,林鳳營,甲簡
2020-11-07,4140,417,518,935,林鳳營,甲簡
2020-11-08,4140,596,440,1036,林鳳營,甲簡
2020-11-09,4140,603,539,1142,林鳳營,甲簡
2020-11-10,4140,552,582,1134,林鳳營,甲簡
2020-11-11,4140,529,557,1086,林鳳營,甲簡
2020-11-12,4140,565,603,1168,林鳳營,甲簡
2020-11-13,4140,578,798,1376,林鳳營,甲簡
2020-11-14,4140,512,620,1132,林鳳營,甲簡
2020-11-15,4140,624,480,1104,林鳳營,甲簡
2020-11-16,4140,644,560,1204,林鳳營,甲簡
2020-11-17,4140,564,595,1159,林鳳營,甲簡
2020-11-18,4140,571,574,1145,林鳳營,甲簡
2020-11-19,4140,559,580,1139,林鳳營,甲簡
2020-11-20,4140,605,822,1427,林鳳營,甲簡
2020-11-21,4140,530,608,1138,林鳳營,甲簡
2020-11-22,4140,683,528,1211,林鳳營,甲簡
2020-11-23,4140,620,554,1174,林鳳營,甲簡
2020-11-24,4140,569,575,1144,林鳳營,甲簡
2020-11-25,4140,541,545,1086,林鳳營,甲簡
2020-11-26,4140,552,573,1125,林鳳營,甲簡
2020-11-27,4140,615,800,1415,林鳳營,甲簡
2020-11-28,4140,505,556,1061,林鳳營,甲簡
2020-11-29,4140,652,488,1140,林鳳營,甲簡
2020-11-30,4140,633,561,1194,林鳳營,甲簡
2020-12-01,4140,550,569,1119,林鳳營,甲簡
2020-12-02,4140,530,532,1062,林鳳營,甲簡
2020-12-03,4140,572,573,1145,林鳳營,甲簡
2020-12-04,4140,570,757,1327,林鳳營,甲簡
2020-12-05,4140,513,623,1136,林鳳營,甲簡
2020-12-06,4140,645,495,1140,林鳳營,甲簡
2020-12-07,4140,636,555,1191,林鳳營,甲簡
2020-12-08,4140,556,584,1140,林鳳營,甲簡
2020-12-09,4140,522,534,1056,林鳳營,甲簡
2020-12-10,4140,544,541,1085,林鳳營,甲簡
2020-12-11,4140,579,774,1353,林鳳營,甲簡
2020-12-12,4140,560,601,1161,林鳳營,甲簡
2020-12-13,4140,608,478,1086,林鳳營,甲簡
2020-12-14,4140,605,556,1161,林鳳營,甲簡
2020-12-15,4140,553,570,1123,林鳳營,甲簡
2020-12-16,4140,543,543,1086,林鳳營,甲簡
2020-12-17,4140,546,580,1126,林鳳營,甲簡
2020-12-18,4140,626,830,1456,林鳳營,甲簡
2020-12-19,4140,585,627,1212,林鳳營,甲簡
2020-12-20,4140,595,483,1078,林鳳營,甲簡
2020-12-21,4140,626,548,1174,林鳳營,甲簡
2020-12-22,4140,572,576,1148,林鳳營,甲簡
2020-12-23,4140,515,541,1056,林鳳營,甲簡
2020-12-24,4140,559,547,1106,林鳳營,甲簡
2020-12-25,4140,608,785,1393,林鳳營,甲簡
2020-12-26,4140,474,553,1027,林鳳營,甲簡
2020-12-27,4140,629,461,1090,林鳳營,甲簡
2020-12-28,4140,627,605,1232,林鳳營,甲簡
2020-12-29,4140,532,583,1115,林鳳營,甲簡
2020-12-30,4140,526,566,1092,林鳳營,甲簡
2020-12-31,4140,548,754,1302,林鳳營,甲簡
2020-01-01,4150,1670,1771,3441,隆田,二等
2020-01-02,4150,1385,1486,2871,隆田,二等
2020-01-03,4150,1654,1635,3289,隆田,二等
2020-01-04,4150,1442,1242,2684,隆田,二等
2020-01-05,4150,1410,1628,3038,隆田,二等
2020-01-06,4150,1485,1546,3031,隆田,二等
2020-01-07,4150,1418,1401,2819,隆田,二等
2020-01-08,4150,1428,1425,2853,隆田,二等
2020-01-09,4150,1528,1838,3366,隆田,二等
2020-01-10,4150,2105,1943,4048,隆田,二等
2020-01-11,4150,1585,1531,3116,隆田,二等
2020-01-12,4150,1682,1701,3383,隆田,二等
2020-01-13,4150,1514,1692,3206,隆田,二等
2020-01-14,4150,1356,1351,2707,隆田,二等
2020-01-15,4150,1362,1387,2749,隆田,二等
2020-01-16,4150,1424,1443,2867,隆田,二等
2020-01-17,4150,1913,1596,3509,隆田,二等
2020-01-18,4150,1359,1223,2582,隆田,二等
2020-01-19,4150,1381,1597,2978,隆田,二等
2020-01-20,4150,1430,1449,2879,隆田,二等
2020-01-21,4150,1337,1339,2676,隆田,二等
2020-01-22,4150,1902,1530,3432,隆田,二等
2020-01-23,4150,1231,1388,2619,隆田,二等
2020-01-24,4150,1147,1185,2332,隆田,二等
2020-01-25,4150,1416,1313,2729,隆田,二等
2020-01-26,4150,1416,1470,2886,隆田,二等
2020-01-27,4150,1671,1616,3287,隆田,二等
2020-01-28,4150,1268,1062,2330,隆田,二等
2020-01-29,4150,1139,1251,2390,隆田,二等
2020-01-30,4150,1119,1130,2249,隆田,二等
2020-01-31,4150,1409,1191,2600,隆田,二等
2020-02-01,4150,1279,981,2260,隆田,二等
2020-02-02,4150,991,1206,2197,隆田,二等
2020-02-03,4150,1190,1202,2392,隆田,二等
2020-02-04,4150,1105,1127,2232,隆田,二等
2020-02-05,4150,1185,1192,2377,隆田,二等
2020-02-06,4150,1176,1150,2326,隆田,二等
2020-02-07,4150,1493,1393,2886,隆田,二等
2020-02-08,4150,1359,1099,2458,隆田,二等
2020-02-09,4150,1232,1380,2612,隆田,二等
2020-02-10,4150,1243,1297,2540,隆田,二等
2020-02-11,4150,1259,1242,2501,隆田,二等
2020-02-12,4150,1176,1159,2335,隆田,二等
2020-02-13,4150,1150,1110,2260,隆田,二等
2020-02-14,4150,1353,1284,2637,隆田,二等
2020-02-15,4150,1088,1094,2182,隆田,二等
2020-02-16,4150,1909,1678,3587,隆田,二等
2020-02-17,4150,1179,1213,2392,隆田,二等
2020-02-18,4150,1152,1307,2459,隆田,二等
2020-02-19,4150,1169,1135,2304,隆田,二等
2020-02-20,4150,1194,1146,2340,隆田,二等
2020-02-21,4150,1502,1275,2777,隆田,二等
2020-02-22,4150,1329,985,2314,隆田,二等
2020-02-23,4150,1154,1450,2604,隆田,二等
2020-02-24,4150,1249,1301,2550,隆田,二等
2020-02-25,4150,1377,1370,2747,隆田,二等
2020-02-26,4150,1363,1359,2722,隆田,二等
2020-02-27,4150,1809,1598,3407,隆田,二等
2020-02-28,4150,1386,1115,2501,隆田,二等
2020-02-29,4150,826,820,1646,隆田,二等
2020-03-01,4150,1218,1319,2537,隆田,二等
2020-03-02,4150,1414,1469,2883,隆田,二等
2020-03-03,4150,1331,1324,2655,隆田,二等
2020-03-04,4150,1316,1339,2655,隆田,二等
2020-03-05,4150,1389,1356,2745,隆田,二等
2020-03-06,4150,1850,1614,3464,隆田,二等
2020-03-07,4150,1335,1017,2352,隆田,二等
2020-03-08,4150,1183,1435,2618,隆田,二等
2020-03-09,4150,1457,1511,2968,隆田,二等
2020-03-10,4150,1352,1393,2745,隆田,二等
2020-03-11,4150,1422,1427,2849,隆田,二等
2020-03-12,4150,1399,1379,2778,隆田,二等
2020-03-13,4150,1665,1593,3258,隆田,二等
2020-03-14,4150,1357,962,2319,隆田,二等
2020-03-15,4150,1298,1591,2889,隆田,二等
2020-03-16,4150,1447,1479,2926,隆田,二等
2020-03-17,4150,1341,1364,2705,隆田,二等
2020-03-18,4150,1364,1354,2718,隆田,二等
2020-03-19,4150,1363,1364,2727,隆田,二等
2020-03-20,4150,1644,1587,3231,隆田,二等
2020-03-21,4150,1317,912,2229,隆田,二等
2020-03-22,4150,1038,1175,2213,隆田,二等
2020-03-23,4150,1361,1376,2737,隆田,二等
2020-03-24,4150,1248,1357,2605,隆田,二等
2020-03-25,4150,1217,1255,2472,隆田,二等
2020-03-26,4150,1237,1274,2511,隆田,二等
2020-03-27,4150,1522,1380,2902,隆田,二等
2020-03-28,4150,1084,824,1908,隆田,二等
2020-03-29,4150,869,1112,1981,隆田,二等
2020-03-30,4150,1332,1338,2670,隆田,二等
2020-03-31,4150,1233,1203,2436,隆田,二等
2020-04-01,4150,1387,1372,2759,隆田,二等
2020-04-02,4150,1014,952,1966,隆田,二等
2020-04-03,4150,858,861,1719,隆田,二等
2020-04-04,4150,678,617,1295,隆田,二等
2020-04-05,4150,1005,1091,2096,隆田,二等
2020-04-06,4150,1312,1608,2920,隆田,二等
2020-04-07,4150,1156,1241,2397,隆田,二等
2020-04-08,4150,1172,1175,2347,隆田,二等
2020-04-09,4150,1275,1260,2535,隆田,二等
2020-04-10,4150,1543,1376,2919,隆田,二等
2020-04-11,4150,1169,857,2026,隆田,二等
2020-04-12,4150,993,1251,2244,隆田,二等
2020-04-13,4150,1285,1309,2594,隆田,二等
2020-04-14,4150,1204,1185,2389,隆田,二等
2020-04-15,4150,1219,1191,2410,隆田,二等
2020-04-16,4150,1241,1237,2478,隆田,二等
2020-04-17,4150,1548,1448,2996,隆田,二等
2020-04-18,4150,1092,943,2035,隆田,二等
2020-04-19,4150,1017,1132,2149,隆田,二等
2020-04-20,4150,1332,1345,2677,隆田,二等
2020-04-21,4150,1170,1173,2343,隆田,二等
2020-04-22,4150,1204,1182,2386,隆田,二等
2020-04-23,4150,1198,1196,2394,隆田,二等
2020-04-24,4150,1531,1309,2840,隆田,二等
2020-04-25,4150,821,734,1555,隆田,二等
2020-04-26,4150,760,834,1594,隆田,二等
2020-04-27,4150,1328,1268,2596,隆田,二等
2020-04-28,4150,1263,1168,2431,隆田,二等
2020-04-29,4150,1121,1075,2196,隆田,二等
2020-04-30,4150,1232,1218,2450,隆田,二等
2020-05-01,4150,1367,1410,2777,隆田,二等
2020-05-02,4150,824,824,1648,隆田,二等
2020-05-03,4150,872,804,1676,隆田,二等
2020-05-04,4150,1370,1413,2783,隆田,二等
2020-05-05,4150,1181,1192,2373,隆田,二等
2020-05-06,4150,1207,1202,2409,隆田,二等
2020-05-07,4150,1286,1261,2547,隆田,二等
2020-05-08,4150,1474,1570,3044,隆田,二等
2020-05-09,4150,969,1016,1985,隆田,二等
2020-05-10,4150,1292,1207,2499,隆田,二等
2020-05-11,4150,1430,1396,2826,隆田,二等
2020-05-12,4150,1225,1233,2458,隆田,二等
2020-05-13,4150,1261,1248,2509,隆田,二等
2020-05-14,4150,1229,1241,2470,隆田,二等
2020-05-15,4150,1578,1454,3032,隆田,二等
2020-05-16,4150,871,813,1684,隆田,二等
2020-05-17,4150,1088,1135,2223,隆田,二等
2020-05-18,4150,1312,1341,2653,隆田,二等
2020-05-19,4150,1240,1215,2455,隆田,二等
2020-05-20,4150,1206,1366,2572,隆田,二等
2020-05-21,4150,1195,1192,2387,隆田,二等
2020-05-22,4150,1382,1296,2678,隆田,二等
2020-05-23,4150,913,875,1788,隆田,二等
2020-05-24,4150,1178,1153,2331,隆田,二等
2020-05-25,4150,1322,1329,2651,隆田,二等
2020-05-26,4150,1192,1166,2358,隆田,二等
2020-05-27,4150,1232,1203,2435,隆田,二等
2020-05-28,4150,1281,1296,2577,隆田,二等
2020-05-29,4150,1481,1483,2964,隆田,二等
2020-05-30,4150,1007,986,1993,隆田,二等
2020-05-31,4150,1213,1144,2357,隆田,二等
2020-06-01,4150,1350,1323,2673,隆田,二等
2020-06-02,4150,1272,1228,2500,隆田,二等
2020-06-03,4150,1231,1195,2426,隆田,二等
2020-06-04,4150,1240,1245,2485,隆田,二等
2020-06-05,4150,1580,1529,3109,隆田,二等
2020-06-06,4150,1166,1080,2246,隆田,二等
2020-06-07,4150,1231,1224,2455,隆田,二等
2020-06-08,4150,1349,1442,2791,隆田,二等
2020-06-09,4150,1315,1285,2600,隆田,二等
2020-06-10,4150,1272,1282,2554,隆田,二等
2020-06-11,4150,1312,1315,2627,隆田,二等
2020-06-12,4150,1568,1530,3098,隆田,二等
2020-06-13,4150,1267,1178,2445,隆田,二等
2020-06-14,4150,1412,1458,2870,隆田,二等
2020-06-15,4150,1409,1451,2860,隆田,二等
2020-06-16,4150,1260,1269,2529,隆田,二等
2020-06-17,4150,1222,1233,2455,隆田,二等
2020-06-18,4150,1254,1261,2515,隆田,二等
2020-06-19,4150,1460,1366,2826,隆田,二等
2020-06-20,4150,1204,1169,2373,隆田,二等
2020-06-21,4150,1131,1177,2308,隆田,二等
2020-06-22,4150,1380,1338,2718,隆田,二等
2020-06-23,4150,1265,1480,2745,隆田,二等
2020-06-24,4150,1575,1639,3214,隆田,二等
2020-06-25,4150,1256,1363,2619,隆田,二等
2020-06-26,4150,1312,1294,2606,隆田,二等
2020-06-27,4150,1197,1073,2270,隆田,二等
2020-06-28,4150,1367,1251,2618,隆田,二等
2020-06-29,4150,1426,1367,2793,隆田,二等
2020-06-30,4150,1259,1279,2538,隆田,二等
2020-07-01,4150,1226,1186,2412,隆田,二等
2020-07-02,4150,1198,1157,2355,隆田,二等
2020-07-03,4150,1540,1345,2885,隆田,二等
2020-07-04,4150,1021,1028,2049,隆田,二等
2020-07-05,4150,1071,1251,2322,隆田,二等
2020-07-06,4150,1301,1293,2594,隆田,二等
2020-07-07,4150,1265,1362,2627,隆田,二等
2020-07-08,4150,1232,1234,2466,隆田,二等
2020-07-09,4150,1296,1494,2790,隆田,二等
2020-07-10,4150,1556,1408,2964,隆田,二等
2020-07-11,4150,1633,1065,2698,隆田,二等
2020-07-12,4150,1255,1679,2934,隆田,二等
2020-07-13,4150,1204,1317,2521,隆田,二等
2020-07-14,4150,1206,1074,2280,隆田,二等
2020-07-15,4150,1161,1179,2340,隆田,二等
2020-07-16,4150,1126,1062,2188,隆田,二等
2020-07-17,4150,1420,1396,2816,隆田,二等
2020-07-18,4150,1760,1165,2925,隆田,二等
2020-07-19,4150,1387,1815,3202,隆田,二等
2020-07-20,4150,1282,1336,2618,隆田,二等
2020-07-21,4150,1181,1166,2347,隆田,二等
2020-07-22,4150,1230,1407,2637,隆田,二等
2020-07-23,4150,1204,1195,2399,隆田,二等
2020-07-24,4150,1434,1370,2804,隆田,二等
2020-07-25,4150,1701,1081,2782,隆田,二等
2020-07-26,4150,1230,1526,2756,隆田,二等
2020-07-27,4150,1231,1251,2482,隆田,二等
2020-07-28,4150,1111,1260,2371,隆田,二等
2020-07-29,4150,1166,1187,2353,隆田,二等
2020-07-30,4150,1154,1126,2280,隆田,二等
2020-07-31,4150,1360,1323,2683,隆田,二等
2020-08-01,4150,1616,1087,2703,隆田,二等
2020-08-02,4150,1088,1369,2457,隆田,二等
2020-08-03,4150,1099,1143,2242,隆田,二等
2020-08-04,4150,1052,1041,2093,隆田,二等
2020-08-05,4150,1092,1107,2199,隆田,二等
2020-08-06,4150,1098,1152,2250,隆田,二等
2020-08-07,4150,1476,1426,2902,隆田,二等
2020-08-08,4150,1649,1158,2807,隆田,二等
2020-08-09,4150,1415,1591,3006,隆田,二等
2020-08-10,4150,1239,1289,2528,隆田,二等
2020-08-11,4150,1094,1282,2376,隆田,二等
2020-08-12,4150,1185,1167,2352,隆田,二等
2020-08-13,4150,1166,1153,2319,隆田,二等
2020-08-14,4150,1478,1370,2848,隆田,二等
2020-08-15,4150,1676,1208,2884,隆田,二等
2020-08-16,4150,1404,1792,3196,隆田,二等
2020-08-17,4150,1212,1310,2522,隆田,二等
2020-08-18,4150,1229,1229,2458,隆田,二等
2020-08-19,4150,1161,1144,2305,隆田,二等
2020-08-20,4150,1271,1183,2454,隆田,二等
2020-08-21,4150,1751,1381,3132,隆田,二等
2020-08-22,4150,1402,1138,2540,隆田,二等
2020-08-23,4150,1235,1571,2806,隆田,二等
2020-08-24,4150,1333,1500,2833,隆田,二等
2020-08-25,4150,1285,1249,2534,隆田,二等
2020-08-26,4150,1104,1085,2189,隆田,二等
2020-08-27,4150,1022,1025,2047,隆田,二等
2020-08-28,4150,1523,1305,2828,隆田,二等
2020-08-29,4150,1223,1064,2287,隆田,二等
2020-08-30,4150,1109,1094,2203,隆田,二等
2020-08-31,4150,1273,1303,2576,隆田,二等
2020-09-01,4150,1239,1223,2462,隆田,二等
2020-09-02,4150,1412,1246,2658,隆田,二等
2020-09-03,4150,1426,1369,2795,隆田,二等
2020-09-04,4150,1689,1416,3105,隆田,二等
2020-09-05,4150,1091,1069,2160,隆田,二等
2020-09-06,4150,1227,1288,2515,隆田,二等
2020-09-07,4150,1297,1691,2988,隆田,二等
2020-09-08,4150,1341,1341,2682,隆田,二等
2020-09-09,4150,1286,1279,2565,隆田,二等
2020-09-10,4150,1256,1284,2540,隆田,二等
2020-09-11,4150,1538,1500,3038,隆田,二等
2020-09-12,4150,1251,1234,2485,隆田,二等
2020-09-13,4150,1465,1437,2902,隆田,二等
2020-09-14,4150,1412,1591,3003,隆田,二等
2020-09-15,4150,1337,1336,2673,隆田,二等
2020-09-16,4150,1314,1265,2579,隆田,二等
2020-09-17,4150,1291,1310,2601,隆田,二等
2020-09-18,4150,1841,1701,3542,隆田,二等
2020-09-19,4150,1212,1217,2429,隆田,二等
2020-09-20,4150,1496,1482,2978,隆田,二等
2020-09-21,4150,1407,1410,2817,隆田,二等
2020-09-22,4150,1368,1484,2852,隆田,二等
2020-09-23,4150,1394,1361,2755,隆田,二等
2020-09-24,4150,1321,1341,2662,隆田,二等
2020-09-25,4150,1380,1371,2751,隆田,二等
2020-09-26,4150,1263,1232,2495,隆田,二等
2020-09-27,4150,1553,1530,3083,隆田,二等
2020-09-28,4150,1354,1346,2700,隆田,二等
2020-09-29,4150,1302,1298,2600,隆田,二等
2020-09-30,4150,2057,1813,3870,隆田,二等
2020-10-01,4150,1299,1532,2831,隆田,二等
2020-10-02,4150,1512,1464,2976,隆田,二等
2020-10-03,4150,1360,1270,2630,隆田,二等
2020-10-04,4150,1476,1448,2924,隆田,二等
2020-10-05,4150,1459,1445,2904,隆田,二等
2020-10-06,4150,1335,1360,2695,隆田,二等
2020-10-07,4150,1379,1377,2756,隆田,二等
2020-10-08,4150,1585,1609,3194,隆田,二等
2020-10-09,4150,1744,1444,3188,隆田,二等
2020-10-10,4150,1364,1289,2653,隆田,二等
2020-10-11,4150,1540,1605,3145,隆田,二等
2020-10-12,4150,1436,1531,2967,隆田,二等
2020-10-13,4150,1317,1454,2771,隆田,二等
2020-10-14,4150,1390,1351,2741,隆田,二等
2020-10-15,4150,1377,1320,2697,隆田,二等
2020-10-16,4150,1613,1633,3246,隆田,二等
2020-10-17,4150,1668,1244,2912,隆田,二等
2020-10-18,4150,1722,1805,3527,隆田,二等
2020-10-19,4150,1437,1539,2976,隆田,二等
2020-10-20,4150,1383,1350,2733,隆田,二等
2020-10-21,4150,1394,1358,2752,隆田,二等
2020-10-22,4150,1372,1363,2735,隆田,二等
2020-10-23,4150,1649,1605,3254,隆田,二等
2020-10-24,4150,1658,1229,2887,隆田,二等
2020-10-25,4150,1384,1539,2923,隆田,二等
2020-10-26,4150,1459,1583,3042,隆田,二等
2020-10-27,4150,1365,1347,2712,隆田,二等
2020-10-28,4150,1298,1274,2572,隆田,二等
2020-10-29,4150,1326,1371,2697,隆田,二等
2020-10-30,4150,1805,1811,3616,隆田,二等
2020-10-31,4150,1754,1303,3057,隆田,二等
2020-11-01,4150,1354,1695,3049,隆田,二等
2020-11-02,4150,1361,1567,2928,隆田,二等
2020-11-03,4150,1280,1263,2543,隆田,二等
2020-11-04,4150,1299,1287,2586,隆田,二等
2020-11-05,4150,1318,1287,2605,隆田,二等
2020-11-06,4150,1910,1588,3498,隆田,二等
2020-11-07,4150,1490,1201,2691,隆田,二等
2020-11-08,4150,1412,1578,2990,隆田,二等
2020-11-09,4150,1367,1550,2917,隆田,二等
2020-11-10,4150,1427,1362,2789,隆田,二等
2020-11-11,4150,1410,1410,2820,隆田,二等
2020-11-12,4150,1420,1387,2807,隆田,二等
2020-11-13,4150,1739,1724,3463,隆田,二等
2020-11-14,4150,1823,1577,3400,隆田,二等
2020-11-15,4150,1611,1835,3446,隆田,二等
2020-11-16,4150,1538,1543,3081,隆田,二等
2020-11-17,4150,1352,1447,2799,隆田,二等
2020-11-18,4150,1381,1331,2712,隆田,二等
2020-11-19,4150,1346,1332,2678,隆田,二等
2020-11-20,4150,1696,1657,3353,隆田,二等
2020-11-21,4150,1661,1217,2878,隆田,二等
2020-11-22,4150,1438,1719,3157,隆田,二等
2020-11-23,4150,1487,1444,2931,隆田,二等
2020-11-24,4150,1297,1307,2604,隆田,二等
2020-11-25,4150,1315,1275,2590,隆田,二等
2020-11-26,4150,1315,1335,2650,隆田,二等
2020-11-27,4150,1808,1656,3464,隆田,二等
2020-11-28,4150,1742,1301,3043,隆田,二等
2020-11-29,4150,1487,1704,3191,隆田,二等
2020-11-30,4150,1387,1403,2790,隆田,二等
2020-12-01,4150,1336,1312,2648,隆田,二等
2020-12-02,4150,1298,1306,2604,隆田,二等
2020-12-03,4150,1363,1342,2705,隆田,二等
2020-12-04,4150,1733,1702,3435,隆田,二等
2020-12-05,4150,1734,1310,3044,隆田,二等
2020-12-06,4150,1587,1891,3478,隆田,二等
2020-12-07,4150,1501,1500,3001,隆田,二等
2020-12-08,4150,1387,1400,2787,隆田,二等
2020-12-09,4150,1268,1298,2566,隆田,二等
2020-12-10,4150,1242,1237,2479,隆田,二等
2020-12-11,4150,1791,1604,3395,隆田,二等
2020-12-12,4150,1820,1298,3118,隆田,二等
2020-12-13,4150,1509,1816,3325,隆田,二等
2020-12-14,4150,1431,1440,2871,隆田,二等
2020-12-15,4150,1331,1308,2639,隆田,二等
2020-12-16,4150,1387,1329,2716,隆田,二等
2020-12-17,4150,1437,1346,2783,隆田,二等
2020-12-18,4150,1802,1670,3472,隆田,二等
2020-12-19,4150,1726,1310,3036,隆田,二等
2020-12-20,4150,1473,1768,3241,隆田,二等
2020-12-21,4150,1449,1390,2839,隆田,二等
2020-12-22,4150,1361,1345,2706,隆田,二等
2020-12-23,4150,1393,1313,2706,隆田,二等
2020-12-24,4150,1330,1319,2649,隆田,二等
2020-12-25,4150,1871,1760,3631,隆田,二等
2020-12-26,4150,1640,1255,2895,隆田,二等
2020-12-27,4150,1296,1765,3061,隆田,二等
2020-12-28,4150,1427,1373,2800,隆田,二等
2020-12-29,4150,1385,1505,2890,隆田,二等
2020-12-30,4150,1308,1348,2656,隆田,二等
2020-12-31,4150,1853,1647,3500,隆田,二等
2020-01-01,4160,157,225,382,拔林,招呼
2020-01-02,4160,144,159,303,拔林,招呼
2020-01-03,4160,161,173,334,拔林,招呼
2020-01-04,4160,142,164,306,拔林,招呼
2020-01-05,4160,128,120,248,拔林,招呼
2020-01-06,4160,160,167,327,拔林,招呼
2020-01-07,4160,164,158,322,拔林,招呼
2020-01-08,4160,181,183,364,拔林,招呼
2020-01-09,4160,155,149,304,拔林,招呼
2020-01-10,4160,178,202,380,拔林,招呼
2020-01-11,4160,145,151,296,拔林,招呼
2020-01-12,4160,86,95,181,拔林,招呼
2020-01-13,4160,138,153,291,拔林,招呼
2020-01-14,4160,163,161,324,拔林,招呼
2020-01-15,4160,179,185,364,拔林,招呼
2020-01-16,4160,139,136,275,拔林,招呼
2020-01-17,4160,151,162,313,拔林,招呼
2020-01-18,4160,159,168,327,拔林,招呼
2020-01-19,4160,126,100,226,拔林,招呼
2020-01-20,4160,134,149,283,拔林,招呼
2020-01-21,4160,146,147,293,拔林,招呼
2020-01-22,4160,131,150,281,拔林,招呼
2020-01-23,4160,84,101,185,拔林,招呼
2020-01-24,4160,59,109,168,拔林,招呼
2020-01-25,4160,90,103,193,拔林,招呼
2020-01-26,4160,103,111,214,拔林,招呼
2020-01-27,4160,158,163,321,拔林,招呼
2020-01-28,4160,115,100,215,拔林,招呼
2020-01-29,4160,115,114,229,拔林,招呼
2020-01-30,4160,102,97,199,拔林,招呼
2020-01-31,4160,102,113,215,拔林,招呼
2020-02-01,4160,109,117,226,拔林,招呼
2020-02-02,4160,103,103,206,拔林,招呼
2020-02-03,4160,119,125,244,拔林,招呼
2020-02-04,4160,114,130,244,拔林,招呼
2020-02-05,4160,128,132,260,拔林,招呼
2020-02-06,4160,124,124,248,拔林,招呼
2020-02-07,4160,122,152,274,拔林,招呼
2020-02-08,4160,101,110,211,拔林,招呼
2020-02-09,4160,76,104,180,拔林,招呼
2020-02-10,4160,126,123,249,拔林,招呼
2020-02-11,4160,103,118,221,拔林,招呼
2020-02-12,4160,133,145,278,拔林,招呼
2020-02-13,4160,96,92,188,拔林,招呼
2020-02-14,4160,99,111,210,拔林,招呼
2020-02-15,4160,106,121,227,拔林,招呼
2020-02-16,4160,97,94,191,拔林,招呼
2020-02-17,4160,127,128,255,拔林,招呼
2020-02-18,4160,123,116,239,拔林,招呼
2020-02-19,4160,154,157,311,拔林,招呼
2020-02-20,4160,112,130,242,拔林,招呼
2020-02-21,4160,100,103,203,拔林,招呼
2020-02-22,4160,116,106,222,拔林,招呼
2020-02-23,4160,90,101,191,拔林,招呼
2020-02-24,4160,132,125,257,拔林,招呼
2020-02-25,4160,148,139,287,拔林,招呼
2020-02-26,4160,165,171,336,拔林,招呼
2020-02-27,4160,167,160,327,拔林,招呼
2020-02-28,4160,145,149,294,拔林,招呼
2020-02-29,4160,90,104,194,拔林,招呼
2020-03-01,4160,98,92,190,拔林,招呼
2020-03-02,4160,149,147,296,拔林,招呼
2020-03-03,4160,141,135,276,拔林,招呼
2020-03-04,4160,172,178,350,拔林,招呼
2020-03-05,4160,135,126,261,拔林,招呼
2020-03-06,4160,173,172,345,拔林,招呼
2020-03-07,4160,119,119,238,拔林,招呼
2020-03-08,4160,108,107,215,拔林,招呼
2020-03-09,4160,132,147,279,拔林,招呼
2020-03-10,4160,146,138,284,拔林,招呼
2020-03-11,4160,175,181,356,拔林,招呼
2020-03-12,4160,162,148,310,拔林,招呼
2020-03-13,4160,158,178,336,拔林,招呼
2020-03-14,4160,110,126,236,拔林,招呼
2020-03-15,4160,128,127,255,拔林,招呼
2020-03-16,4160,148,155,303,拔林,招呼
2020-03-17,4160,152,150,302,拔林,招呼
2020-03-18,4160,168,153,321,拔林,招呼
2020-03-19,4160,125,122,247,拔林,招呼
2020-03-20,4160,144,147,291,拔林,招呼
2020-03-21,4160,104,109,213,拔林,招呼
2020-03-22,4160,92,88,180,拔林,招呼
2020-03-23,4160,128,145,273,拔林,招呼
2020-03-24,4160,134,126,260,拔林,招呼
2020-03-25,4160,148,143,291,拔林,招呼
2020-03-26,4160,133,123,256,拔林,招呼
2020-03-27,4160,165,157,322,拔林,招呼
2020-03-28,4160,119,130,249,拔林,招呼
2020-03-29,4160,99,90,189,拔林,招呼
2020-03-30,4160,127,147,274,拔林,招呼
2020-03-31,4160,127,126,253,拔林,招呼
2020-04-01,4160,126,153,279,拔林,招呼
2020-04-02,4160,65,101,166,拔林,招呼
2020-04-03,4160,86,95,181,拔林,招呼
2020-04-04,4160,66,87,153,拔林,招呼
2020-04-05,4160,72,82,154,拔林,招呼
2020-04-06,4160,123,132,255,拔林,招呼
2020-04-07,4160,137,131,268,拔林,招呼
2020-04-08,4160,140,132,272,拔林,招呼
2020-04-09,4160,110,120,230,拔林,招呼
2020-04-10,4160,135,163,298,拔林,招呼
2020-04-11,4160,91,100,191,拔林,招呼
2020-04-12,4160,89,88,177,拔林,招呼
2020-04-13,4160,128,142,270,拔林,招呼
2020-04-14,4160,124,120,244,拔林,招呼
2020-04-15,4160,130,132,262,拔林,招呼
2020-04-16,4160,124,127,251,拔林,招呼
2020-04-17,4160,147,146,293,拔林,招呼
2020-04-18,4160,85,102,187,拔林,招呼
2020-04-19,4160,105,115,220,拔林,招呼
2020-04-20,4160,120,131,251,拔林,招呼
2020-04-21,4160,125,124,249,拔林,招呼
2020-04-22,4160,137,129,266,拔林,招呼
2020-04-23,4160,118,115,233,拔林,招呼
2020-04-24,4160,146,145,291,拔林,招呼
2020-04-25,4160,89,109,198,拔林,招呼
2020-04-26,4160,70,77,147,拔林,招呼
2020-04-27,4160,124,136,260,拔林,招呼
2020-04-28,4160,129,137,266,拔林,招呼
2020-04-29,4160,136,127,263,拔林,招呼
2020-04-30,4160,127,126,253,拔林,招呼
2020-05-01,4160,143,152,295,拔林,招呼
2020-05-02,4160,94,111,205,拔林,招呼
2020-05-03,4160,100,114,214,拔林,招呼
2020-05-04,4160,130,137,267,拔林,招呼
2020-05-05,4160,141,142,283,拔林,招呼
2020-05-06,4160,150,144,294,拔林,招呼
2020-05-07,4160,125,123,248,拔林,招呼
2020-05-08,4160,162,181,343,拔林,招呼
2020-05-09,4160,104,105,209,拔林,招呼
2020-05-10,4160,109,105,214,拔林,招呼
2020-05-11,4160,138,133,271,拔林,招呼
2020-05-12,4160,134,134,268,拔林,招呼
2020-05-13,4160,148,147,295,拔林,招呼
2020-05-14,4160,158,145,303,拔林,招呼
2020-05-15,4160,177,186,363,拔林,招呼
2020-05-16,4160,85,119,204,拔林,招呼
2020-05-17,4160,115,120,235,拔林,招呼
2020-05-18,4160,127,145,272,拔林,招呼
2020-05-19,4160,139,131,270,拔林,招呼
2020-05-20,4160,129,128,257,拔林,招呼
2020-05-21,4160,126,119,245,拔林,招呼
2020-05-22,4160,153,137,290,拔林,招呼
2020-05-23,4160,89,96,185,拔林,招呼
2020-05-24,4160,113,122,235,拔林,招呼
2020-05-25,4160,134,139,273,拔林,招呼
2020-05-26,4160,143,133,276,拔林,招呼
2020-05-27,4160,129,135,264,拔林,招呼
2020-05-28,4160,130,131,261,拔林,招呼
2020-05-29,4160,150,159,309,拔林,招呼
2020-05-30,4160,105,123,228,拔林,招呼
2020-05-31,4160,124,149,273,拔林,招呼
2020-06-01,4160,128,144,272,拔林,招呼
2020-06-02,4160,160,145,305,拔林,招呼
2020-06-03,4160,173,185,358,拔林,招呼
2020-06-04,4160,138,130,268,拔林,招呼
2020-06-05,4160,158,180,338,拔林,招呼
2020-06-06,4160,105,119,224,拔林,招呼
2020-06-07,4160,107,117,224,拔林,招呼
2020-06-08,4160,134,148,282,拔林,招呼
2020-06-09,4160,151,142,293,拔林,招呼
2020-06-10,4160,156,165,321,拔林,招呼
2020-06-11,4160,126,110,236,拔林,招呼
2020-06-12,4160,184,185,369,拔林,招呼
2020-06-13,4160,101,135,236,拔林,招呼
2020-06-14,4160,140,133,273,拔林,招呼
2020-06-15,4160,142,160,302,拔林,招呼
2020-06-16,4160,138,148,286,拔林,招呼
2020-06-17,4160,166,168,334,拔林,招呼
2020-06-18,4160,134,132,266,拔林,招呼
2020-06-19,4160,180,160,340,拔林,招呼
2020-06-20,4160,123,143,266,拔林,招呼
2020-06-21,4160,122,121,243,拔林,招呼
2020-06-22,4160,145,151,296,拔林,招呼
2020-06-23,4160,148,148,296,拔林,招呼
2020-06-24,4160,153,204,357,拔林,招呼
2020-06-25,4160,120,144,264,拔林,招呼
2020-06-26,4160,159,164,323,拔林,招呼
2020-06-27,4160,136,138,274,拔林,招呼
2020-06-28,4160,109,108,217,拔林,招呼
2020-06-29,4160,137,152,289,拔林,招呼
2020-06-30,4160,159,141,300,拔林,招呼
2020-07-01,4160,160,154,314,拔林,招呼
2020-07-02,4160,128,121,249,拔林,招呼
2020-07-03,4160,146,169,315,拔林,招呼
2020-07-04,4160,97,106,203,拔林,招呼
2020-07-05,4160,102,103,205,拔林,招呼
2020-07-06,4160,127,142,269,拔林,招呼
2020-07-07,4160,124,124,248,拔林,招呼
2020-07-08,4160,141,157,298,拔林,招呼
2020-07-09,4160,116,112,228,拔林,招呼
2020-07-10,4160,150,151,301,拔林,招呼
2020-07-11,4160,121,120,241,拔林,招呼
2020-07-12,4160,124,132,256,拔林,招呼
2020-07-13,4160,127,123,250,拔林,招呼
2020-07-14,4160,136,108,244,拔林,招呼
2020-07-15,4160,125,124,249,拔林,招呼
2020-07-16,4160,93,94,187,拔林,招呼
2020-07-17,4160,125,128,253,拔林,招呼
2020-07-18,4160,172,147,319,拔林,招呼
2020-07-19,4160,144,150,294,拔林,招呼
2020-07-20,4160,120,129,249,拔林,招呼
2020-07-21,4160,108,123,231,拔林,招呼
2020-07-22,4160,137,133,270,拔林,招呼
2020-07-23,4160,150,152,302,拔林,招呼
2020-07-24,4160,119,126,245,拔林,招呼
2020-07-25,4160,114,115,229,拔林,招呼
2020-07-26,4160,102,105,207,拔林,招呼
2020-07-27,4160,139,148,287,拔林,招呼
2020-07-28,4160,121,114,235,拔林,招呼
2020-07-29,4160,154,160,314,拔林,招呼
2020-07-30,4160,129,119,248,拔林,招呼
2020-07-31,4160,117,125,242,拔林,招呼
2020-08-01,4160,101,127,228,拔林,招呼
2020-08-02,4160,114,108,222,拔林,招呼
2020-08-03,4160,116,113,229,拔林,招呼
2020-08-04,4160,111,100,211,拔林,招呼
2020-08-05,4160,137,127,264,拔林,招呼
2020-08-06,4160,110,113,223,拔林,招呼
2020-08-07,4160,128,141,269,拔林,招呼
2020-08-08,4160,109,144,253,拔林,招呼
2020-08-09,4160,123,93,216,拔林,招呼
2020-08-10,4160,134,122,256,拔林,招呼
2020-08-11,4160,133,145,278,拔林,招呼
2020-08-12,4160,142,134,276,拔林,招呼
2020-08-13,4160,134,142,276,拔林,招呼
2020-08-14,4160,126,127,253,拔林,招呼
2020-08-15,4160,134,135,269,拔林,招呼
2020-08-16,4160,113,135,248,拔林,招呼
2020-08-17,4160,132,178,310,拔林,招呼
2020-08-18,4160,212,158,370,拔林,招呼
2020-08-19,4160,130,142,272,拔林,招呼
2020-08-20,4160,120,124,244,拔林,招呼
2020-08-21,4160,129,134,263,拔林,招呼
2020-08-22,4160,130,135,265,拔林,招呼
2020-08-23,4160,106,126,232,拔林,招呼
2020-08-24,4160,128,130,258,拔林,招呼
2020-08-25,4160,131,124,255,拔林,招呼
2020-08-26,4160,97,87,184,拔林,招呼
2020-08-27,4160,97,102,199,拔林,招呼
2020-08-28,4160,114,118,232,拔林,招呼
2020-08-29,4160,101,109,210,拔林,招呼
2020-08-30,4160,91,90,181,拔林,招呼
2020-08-31,4160,150,153,303,拔林,招呼
2020-09-01,4160,132,127,259,拔林,招呼
2020-09-02,4160,118,124,242,拔林,招呼
2020-09-03,4160,118,122,240,拔林,招呼
2020-09-04,4160,139,134,273,拔林,招呼
2020-09-05,4160,118,117,235,拔林,招呼
2020-09-06,4160,80,93,173,拔林,招呼
2020-09-07,4160,142,147,289,拔林,招呼
2020-09-08,4160,126,115,241,拔林,招呼
2020-09-09,4160,154,149,303,拔林,招呼
2020-09-10,4160,129,125,254,拔林,招呼
2020-09-11,4160,164,177,341,拔林,招呼
2020-09-12,4160,125,138,263,拔林,招呼
2020-09-13,4160,110,109,219,拔林,招呼
2020-09-14,4160,147,152,299,拔林,招呼
2020-09-15,4160,141,130,271,拔林,招呼
2020-09-16,4160,165,173,338,拔林,招呼
2020-09-17,4160,148,147,295,拔林,招呼
2020-09-18,4160,145,163,308,拔林,招呼
2020-09-19,4160,116,122,238,拔林,招呼
2020-09-20,4160,127,108,235,拔林,招呼
2020-09-21,4160,157,158,315,拔林,招呼
2020-09-22,4160,150,141,291,拔林,招呼
2020-09-23,4160,169,164,333,拔林,招呼
2020-09-24,4160,146,153,299,拔林,招呼
2020-09-25,4160,171,163,334,拔林,招呼
2020-09-26,4160,142,131,273,拔林,招呼
2020-09-27,4160,127,142,269,拔林,招呼
2020-09-28,4160,145,161,306,拔林,招呼
2020-09-29,4160,157,152,309,拔林,招呼
2020-09-30,4160,153,175,328,拔林,招呼
2020-10-01,4160,174,196,370,拔林,招呼
2020-10-02,4160,194,214,408,拔林,招呼
2020-10-03,4160,150,163,313,拔林,招呼
2020-10-04,4160,129,125,254,拔林,招呼
2020-10-05,4160,170,165,335,拔林,招呼
2020-10-06,4160,156,155,311,拔林,招呼
2020-10-07,4160,186,193,379,拔林,招呼
2020-10-08,4160,169,169,338,拔林,招呼
2020-10-09,4160,181,179,360,拔林,招呼
2020-10-10,4160,164,178,342,拔林,招呼
2020-10-11,4160,117,127,244,拔林,招呼
2020-10-12,4160,157,158,315,拔林,招呼
2020-10-13,4160,144,152,296,拔林,招呼
2020-10-14,4160,160,158,318,拔林,招呼
2020-10-15,4160,176,172,348,拔林,招呼
2020-10-16,4160,158,166,324,拔林,招呼
2020-10-17,4160,170,228,398,拔林,招呼
2020-10-18,4160,187,290,477,拔林,招呼
2020-10-19,4160,155,150,305,拔林,招呼
2020-10-20,4160,142,156,298,拔林,招呼
2020-10-21,4160,153,167,320,拔林,招呼
2020-10-22,4160,154,150,304,拔林,招呼
2020-10-23,4160,158,155,313,拔林,招呼
2020-10-24,4160,158,175,333,拔林,招呼
2020-10-25,4160,146,145,291,拔林,招呼
2020-10-26,4160,178,191,369,拔林,招呼
2020-10-27,4160,174,178,352,拔林,招呼
2020-10-28,4160,153,161,314,拔林,招呼
2020-10-29,4160,142,144,286,拔林,招呼
2020-10-30,4160,189,195,384,拔林,招呼
2020-10-31,4160,162,168,330,拔林,招呼
2020-11-01,4160,137,165,302,拔林,招呼
2020-11-02,4160,174,174,348,拔林,招呼
2020-11-03,4160,150,157,307,拔林,招呼
2020-11-04,4160,167,163,330,拔林,招呼
2020-11-05,4160,161,150,311,拔林,招呼
2020-11-06,4160,192,184,376,拔林,招呼
2020-11-07,4160,126,126,252,拔林,招呼
2020-11-08,4160,128,153,281,拔林,招呼
2020-11-09,4160,151,150,301,拔林,招呼
2020-11-10,4160,141,151,292,拔林,招呼
2020-11-11,4160,161,172,333,拔林,招呼
2020-11-12,4160,139,154,293,拔林,招呼
2020-11-13,4160,161,172,333,拔林,招呼
2020-11-14,4160,153,153,306,拔林,招呼
2020-11-15,4160,132,157,289,拔林,招呼
2020-11-16,4160,169,177,346,拔林,招呼
2020-11-17,4160,155,156,311,拔林,招呼
2020-11-18,4160,176,203,379,拔林,招呼
2020-11-19,4160,152,155,307,拔林,招呼
2020-11-20,4160,179,180,359,拔林,招呼
2020-11-21,4160,149,180,329,拔林,招呼
2020-11-22,4160,148,136,284,拔林,招呼
2020-11-23,4160,162,166,328,拔林,招呼
2020-11-24,4160,172,166,338,拔林,招呼
2020-11-25,4160,177,177,354,拔林,招呼
2020-11-26,4160,142,149,291,拔林,招呼
2020-11-27,4160,174,164,338,拔林,招呼
2020-11-28,4160,138,159,297,拔林,招呼
2020-11-29,4160,132,140,272,拔林,招呼
2020-11-30,4160,153,172,325,拔林,招呼
2020-12-01,4160,152,158,310,拔林,招呼
2020-12-02,4160,155,159,314,拔林,招呼
2020-12-03,4160,149,149,298,拔林,招呼
2020-12-04,4160,196,190,386,拔林,招呼
2020-12-05,4160,165,200,365,拔林,招呼
2020-12-06,4160,157,147,304,拔林,招呼
2020-12-07,4160,170,187,357,拔林,招呼
2020-12-08,4160,154,152,306,拔林,招呼
2020-12-09,4160,150,148,298,拔林,招呼
2020-12-10,4160,170,175,345,拔林,招呼
2020-12-11,4160,178,178,356,拔林,招呼
2020-12-12,4160,163,155,318,拔林,招呼
2020-12-13,4160,163,170,333,拔林,招呼
2020-12-14,4160,143,152,295,拔林,招呼
2020-12-15,4160,178,185,363,拔林,招呼
2020-12-16,4160,181,181,362,拔林,招呼
2020-12-17,4160,145,168,313,拔林,招呼
2020-12-18,4160,191,201,392,拔林,招呼
2020-12-19,4160,160,147,307,拔林,招呼
2020-12-20,4160,128,161,289,拔林,招呼
2020-12-21,4160,149,157,306,拔林,招呼
2020-12-22,4160,143,155,298,拔林,招呼
2020-12-23,4160,130,130,260,拔林,招呼
2020-12-24,4160,157,172,329,拔林,招呼
2020-12-25,4160,206,197,403,拔林,招呼
2020-12-26,4160,138,137,275,拔林,招呼
2020-12-27,4160,125,135,260,拔林,招呼
2020-12-28,4160,170,183,353,拔林,招呼
2020-12-29,4160,139,141,280,拔林,招呼
2020-12-30,4160,170,172,342,拔林,招呼
2020-12-31,4160,172,172,344,拔林,招呼
2020-01-01,4170,3491,3688,7179,善化,二等
2020-01-02,4170,3570,3691,7261,善化,二等
2020-01-03,4170,4060,4216,8276,善化,二等
2020-01-04,4170,3420,3109,6529,善化,二等
2020-01-05,4170,3242,3347,6589,善化,二等
2020-01-06,4170,3718,3792,7510,善化,二等
2020-01-07,4170,3391,3504,6895,善化,二等
2020-01-08,4170,3496,3472,6968,善化,二等
2020-01-09,4170,3464,3599,7063,善化,二等
2020-01-10,4170,4962,4906,9868,善化,二等
2020-01-11,4170,3847,3818,7665,善化,二等
2020-01-12,4170,3765,4085,7850,善化,二等
2020-01-13,4170,3802,3890,7692,善化,二等
2020-01-14,4170,3586,3567,7153,善化,二等
2020-01-15,4170,3561,3555,7116,善化,二等
2020-01-16,4170,4053,4018,8071,善化,二等
2020-01-17,4170,4331,4073,8404,善化,二等
2020-01-18,4170,3751,3478,7229,善化,二等
2020-01-19,4170,3046,3391,6437,善化,二等
2020-01-20,4170,3592,3729,7321,善化,二等
2020-01-21,4170,3593,3722,7315,善化,二等
2020-01-22,4170,4320,4250,8570,善化,二等
2020-01-23,4170,3345,3329,6674,善化,二等
2020-01-24,4170,2420,2682,5102,善化,二等
2020-01-25,4170,2872,2923,5795,善化,二等
2020-01-26,4170,3037,3005,6042,善化,二等
2020-01-27,4170,3476,3287,6763,善化,二等
2020-01-28,4170,3174,2979,6153,善化,二等
2020-01-29,4170,2929,3186,6115,善化,二等
2020-01-30,4170,3117,3012,6129,善化,二等
2020-01-31,4170,3408,3158,6566,善化,二等
2020-02-01,4170,2608,2491,5099,善化,二等
2020-02-02,4170,2420,2637,5057,善化,二等
2020-02-03,4170,3277,3332,6609,善化,二等
2020-02-04,4170,3001,2983,5984,善化,二等
2020-02-05,4170,3064,2936,6000,善化,二等
2020-02-06,4170,2969,2966,5935,善化,二等
2020-02-07,4170,3651,3355,7006,善化,二等
2020-02-08,4170,2701,2527,5228,善化,二等
2020-02-09,4170,2703,3025,5728,善化,二等
2020-02-10,4170,3001,3118,6119,善化,二等
2020-02-11,4170,2930,2908,5838,善化,二等
2020-02-12,4170,2940,2934,5874,善化,二等
2020-02-13,4170,2881,2866,5747,善化,二等
2020-02-14,4170,3619,3315,6934,善化,二等
2020-02-15,4170,2905,2669,5574,善化,二等
2020-02-16,4170,2769,2959,5728,善化,二等
2020-02-17,4170,2838,2873,5711,善化,二等
2020-02-18,4170,2828,2760,5588,善化,二等
2020-02-19,4170,2783,2803,5586,善化,二等
2020-02-20,4170,2929,2910,5839,善化,二等
2020-02-21,4170,3633,3276,6909,善化,二等
2020-02-22,4170,2782,2472,5254,善化,二等
2020-02-23,4170,2530,2847,5377,善化,二等
2020-02-24,4170,2905,3017,5922,善化,二等
2020-02-25,4170,3212,3212,6424,善化,二等
2020-02-26,4170,3188,3256,6444,善化,二等
2020-02-27,4170,4270,4025,8295,善化,二等
2020-02-28,4170,3159,2922,6081,善化,二等
2020-02-29,4170,2440,2309,4749,善化,二等
2020-03-01,4170,2863,2965,5828,善化,二等
2020-03-02,4170,3419,3433,6852,善化,二等
2020-03-03,4170,3178,3220,6398,善化,二等
2020-03-04,4170,3189,3232,6421,善化,二等
2020-03-05,4170,3096,3191,6287,善化,二等
2020-03-06,4170,4058,4170,8228,善化,二等
2020-03-07,4170,2754,2483,5237,善化,二等
2020-03-08,4170,2928,2933,5861,善化,二等
2020-03-09,4170,3415,3412,6827,善化,二等
2020-03-10,4170,3132,3110,6242,善化,二等
2020-03-11,4170,3288,3241,6529,善化,二等
2020-03-12,4170,3131,3265,6396,善化,二等
2020-03-13,4170,4003,4208,8211,善化,二等
2020-03-14,4170,2246,2123,4369,善化,二等
2020-03-15,4170,2933,2956,5889,善化,二等
2020-03-16,4170,3333,3355,6688,善化,二等
2020-03-17,4170,3101,3125,6226,善化,二等
2020-03-18,4170,3047,3133,6180,善化,二等
2020-03-19,4170,3057,3129,6186,善化,二等
2020-03-20,4170,3762,3949,7711,善化,二等
2020-03-21,4170,2076,2031,4107,善化,二等
2020-03-22,4170,2438,2359,4797,善化,二等
2020-03-23,4170,3135,3179,6314,善化,二等
2020-03-24,4170,2934,2949,5883,善化,二等
2020-03-25,4170,2877,2937,5814,善化,二等
2020-03-26,4170,2893,2957,5850,善化,二等
2020-03-27,4170,3547,3671,7218,善化,二等
2020-03-28,4170,1998,1893,3891,善化,二等
2020-03-29,4170,2067,2240,4307,善化,二等
2020-03-30,4170,3081,3097,6178,善化,二等
2020-03-31,4170,2917,3054,5971,善化,二等
2020-04-01,4170,3436,3728,7164,善化,二等
2020-04-02,4170,2604,2659,5263,善化,二等
2020-04-03,4170,2289,2326,4615,善化,二等
2020-04-04,4170,1629,1505,3134,善化,二等
2020-04-05,4170,2466,2370,4836,善化,二等
2020-04-06,4170,3140,2977,6117,善化,二等
2020-04-07,4170,2698,2672,5370,善化,二等
2020-04-08,4170,2730,2772,5502,善化,二等
2020-04-09,4170,2814,2822,5636,善化,二等
2020-04-10,4170,3347,3389,6736,善化,二等
2020-04-11,4170,2010,1876,3886,善化,二等
2020-04-12,4170,2118,2195,4313,善化,二等
2020-04-13,4170,2946,3005,5951,善化,二等
2020-04-14,4170,2867,2919,5786,善化,二等
2020-04-15,4170,2872,2909,5781,善化,二等
2020-04-16,4170,2929,3010,5939,善化,二等
2020-04-17,4170,3571,3700,7271,善化,二等
2020-04-18,4170,2177,1992,4169,善化,二等
2020-04-19,4170,2267,2429,4696,善化,二等
2020-04-20,4170,3012,2960,5972,善化,二等
2020-04-21,4170,2682,2767,5449,善化,二等
2020-04-22,4170,2645,2741,5386,善化,二等
2020-04-23,4170,2669,2702,5371,善化,二等
2020-04-24,4170,3139,3321,6460,善化,二等
2020-04-25,4170,1896,1622,3518,善化,二等
2020-04-26,4170,1816,1955,3771,善化,二等
2020-04-27,4170,2858,2975,5833,善化,二等
2020-04-28,4170,2729,2785,5514,善化,二等
2020-04-29,4170,2587,2568,5155,善化,二等
2020-04-30,4170,3175,2987,6162,善化,二等
2020-05-01,4170,3094,3311,6405,善化,二等
2020-05-02,4170,1957,1942,3899,善化,二等
2020-05-03,4170,2408,2492,4900,善化,二等
2020-05-04,4170,2982,2948,5930,善化,二等
2020-05-05,4170,2801,2840,5641,善化,二等
2020-05-06,4170,2838,2960,5798,善化,二等
2020-05-07,4170,3032,3012,6044,善化,二等
2020-05-08,4170,3772,4029,7801,善化,二等
2020-05-09,4170,2476,2490,4966,善化,二等
2020-05-10,4170,2771,2623,5394,善化,二等
2020-05-11,4170,3312,3276,6588,善化,二等
2020-05-12,4170,2969,3078,6047,善化,二等
2020-05-13,4170,2925,2956,5881,善化,二等
2020-05-14,4170,2975,3074,6049,善化,二等
2020-05-15,4170,3898,3904,7802,善化,二等
2020-05-16,4170,2237,2147,4384,善化,二等
2020-05-17,4170,2474,2518,4992,善化,二等
2020-05-18,4170,3097,3135,6232,善化,二等
2020-05-19,4170,2813,2801,5614,善化,二等
2020-05-20,4170,2803,2874,5677,善化,二等
2020-05-21,4170,2903,2856,5759,善化,二等
2020-05-22,4170,3316,3515,6831,善化,二等
2020-05-23,4170,2346,2150,4496,善化,二等
2020-05-24,4170,2653,2771,5424,善化,二等
2020-05-25,4170,3227,3250,6477,善化,二等
2020-05-26,4170,2880,2911,5791,善化,二等
2020-05-27,4170,2798,2775,5573,善化,二等
2020-05-28,4170,2997,3059,6056,善化,二等
2020-05-29,4170,3814,3921,7735,善化,二等
2020-05-30,4170,2810,2699,5509,善化,二等
2020-05-31,4170,2948,2960,5908,善化,二等
2020-06-01,4170,3219,3299,6518,善化,二等
2020-06-02,4170,3017,3035,6052,善化,二等
2020-06-03,4170,2914,3052,5966,善化,二等
2020-06-04,4170,2928,3008,5936,善化,二等
2020-06-05,4170,3879,3897,7776,善化,二等
2020-06-06,4170,2921,2651,5572,善化,二等
2020-06-07,4170,2831,3115,5946,善化,二等
2020-06-08,4170,3281,3287,6568,善化,二等
2020-06-09,4170,2988,3084,6072,善化,二等
2020-06-10,4170,3089,3125,6214,善化,二等
2020-06-11,4170,3135,3230,6365,善化,二等
2020-06-12,4170,3954,3806,7760,善化,二等
2020-06-13,4170,2957,2767,5724,善化,二等
2020-06-14,4170,3068,3188,6256,善化,二等
2020-06-15,4170,3349,3408,6757,善化,二等
2020-06-16,4170,3169,3143,6312,善化,二等
2020-06-17,4170,2993,3024,6017,善化,二等
2020-06-18,4170,3029,3096,6125,善化,二等
2020-06-19,4170,3428,3483,6911,善化,二等
2020-06-20,4170,2886,2793,5679,善化,二等
2020-06-21,4170,2788,2878,5666,善化,二等
2020-06-22,4170,3060,3148,6208,善化,二等
2020-06-23,4170,3035,3089,6124,善化,二等
2020-06-24,4170,3824,4096,7920,善化,二等
2020-06-25,4170,3334,3260,6594,善化,二等
2020-06-26,4170,3399,3244,6643,善化,二等
2020-06-27,4170,2786,2751,5537,善化,二等
2020-06-28,4170,3096,3191,6287,善化,二等
2020-06-29,4170,3306,3287,6593,善化,二等
2020-06-30,4170,3037,3030,6067,善化,二等
2020-07-01,4170,2838,2813,5651,善化,二等
2020-07-02,4170,2904,2898,5802,善化,二等
2020-07-03,4170,3601,3367,6968,善化,二等
2020-07-04,4170,2835,2498,5333,善化,二等
2020-07-05,4170,2583,2912,5495,善化,二等
2020-07-06,4170,3208,3284,6492,善化,二等
2020-07-07,4170,3119,3176,6295,善化,二等
2020-07-08,4170,3099,3132,6231,善化,二等
2020-07-09,4170,3005,3182,6187,善化,二等
2020-07-10,4170,3890,3599,7489,善化,二等
2020-07-11,4170,3301,2901,6202,善化,二等
2020-07-12,4170,2957,3420,6377,善化,二等
2020-07-13,4170,3121,3307,6428,善化,二等
2020-07-14,4170,3565,3569,7134,善化,二等
2020-07-15,4170,3059,3011,6070,善化,二等
2020-07-16,4170,3071,3032,6103,善化,二等
2020-07-17,4170,3886,3627,7513,善化,二等
2020-07-18,4170,3211,3053,6264,善化,二等
2020-07-19,4170,2930,3291,6221,善化,二等
2020-07-20,4170,3320,3295,6615,善化,二等
2020-07-21,4170,3127,3198,6325,善化,二等
2020-07-22,4170,3157,3175,6332,善化,二等
2020-07-23,4170,3208,3238,6446,善化,二等
2020-07-24,4170,3939,3628,7567,善化,二等
2020-07-25,4170,3225,2919,6144,善化,二等
2020-07-26,4170,2849,3231,6080,善化,二等
2020-07-27,4170,3178,3240,6418,善化,二等
2020-07-28,4170,3013,2897,5910,善化,二等
2020-07-29,4170,2972,3066,6038,善化,二等
2020-07-30,4170,2981,2981,5962,善化,二等
2020-07-31,4170,3937,3615,7552,善化,二等
2020-08-01,4170,2987,2657,5644,善化,二等
2020-08-02,4170,2660,3059,5719,善化,二等
2020-08-03,4170,2798,2878,5676,善化,二等
2020-08-04,4170,2869,2777,5646,善化,二等
2020-08-05,4170,3002,3071,6073,善化,二等
2020-08-06,4170,3076,3114,6190,善化,二等
2020-08-07,4170,3886,3741,7627,善化,二等
2020-08-08,4170,3046,2799,5845,善化,二等
2020-08-09,4170,3214,3512,6726,善化,二等
2020-08-10,4170,3174,3256,6430,善化,二等
2020-08-11,4170,2798,2791,5589,善化,二等
2020-08-12,4170,3025,3008,6033,善化,二等
2020-08-13,4170,3190,3226,6416,善化,二等
2020-08-14,4170,4050,3746,7796,善化,二等
2020-08-15,4170,3458,2988,6446,善化,二等
2020-08-16,4170,3089,3542,6631,善化,二等
2020-08-17,4170,3354,3378,6732,善化,二等
2020-08-18,4170,3239,3272,6511,善化,二等
2020-08-19,4170,3207,3133,6340,善化,二等
2020-08-20,4170,3269,3223,6492,善化,二等
2020-08-21,4170,4070,3668,7738,善化,二等
2020-08-22,4170,3103,2864,5967,善化,二等
2020-08-23,4170,2845,3206,6051,善化,二等
2020-08-24,4170,3287,3360,6647,善化,二等
2020-08-25,4170,3256,3201,6457,善化,二等
2020-08-26,4170,2609,2641,5250,善化,二等
2020-08-27,4170,2603,2604,5207,善化,二等
2020-08-28,4170,3691,3417,7108,善化,二等
2020-08-29,4170,3016,2680,5696,善化,二等
2020-08-30,4170,2334,2625,4959,善化,二等
2020-08-31,4170,3194,3306,6500,善化,二等
2020-09-01,4170,3050,3089,6139,善化,二等
2020-09-02,4170,3069,3080,6149,善化,二等
2020-09-03,4170,3268,3266,6534,善化,二等
2020-09-04,4170,3967,3627,7594,善化,二等
2020-09-05,4170,2951,2649,5600,善化,二等
2020-09-06,4170,2978,3209,6187,善化,二等
2020-09-07,4170,3161,3292,6453,善化,二等
2020-09-08,4170,3232,3266,6498,善化,二等
2020-09-09,4170,3099,3146,6245,善化,二等
2020-09-10,4170,3148,3362,6510,善化,二等
2020-09-11,4170,3939,3902,7841,善化,二等
2020-09-12,4170,3124,2824,5948,善化,二等
2020-09-13,4170,3218,3331,6549,善化,二等
2020-09-14,4170,3276,3398,6674,善化,二等
2020-09-15,4170,3252,3254,6506,善化,二等
2020-09-16,4170,3080,3159,6239,善化,二等
2020-09-17,4170,3190,3296,6486,善化,二等
2020-09-18,4170,4071,4268,8339,善化,二等
2020-09-19,4170,3302,3123,6425,善化,二等
2020-09-20,4170,3430,3556,6986,善化,二等
2020-09-21,4170,3372,3381,6753,善化,二等
2020-09-22,4170,3226,3236,6462,善化,二等
2020-09-23,4170,3292,3343,6635,善化,二等
2020-09-24,4170,3248,3242,6490,善化,二等
2020-09-25,4170,3670,3662,7332,善化,二等
2020-09-26,4170,3273,3115,6388,善化,二等
2020-09-27,4170,2881,3151,6032,善化,二等
2020-09-28,4170,3427,3439,6866,善化,二等
2020-09-29,4170,3247,3425,6672,善化,二等
2020-09-30,4170,4328,4845,9173,善化,二等
2020-10-01,4170,3707,3930,7637,善化,二等
2020-10-02,4170,3890,3758,7648,善化,二等
2020-10-03,4170,3368,3240,6608,善化,二等
2020-10-04,4170,3833,3383,7216,善化,二等
2020-10-05,4170,3613,3609,7222,善化,二等
2020-10-06,4170,3293,3376,6669,善化,二等
2020-10-07,4170,3234,3308,6542,善化,二等
2020-10-08,4170,4066,4429,8495,善化,二等
2020-10-09,4170,3744,3586,7330,善化,二等
2020-10-10,4170,3309,3151,6460,善化,二等
2020-10-11,4170,3379,3422,6801,善化,二等
2020-10-12,4170,3616,3526,7142,善化,二等
2020-10-13,4170,3313,3344,6657,善化,二等
2020-10-14,4170,3223,3255,6478,善化,二等
2020-10-15,4170,3290,3374,6664,善化,二等
2020-10-16,4170,4228,4351,8579,善化,二等
2020-10-17,4170,4325,3607,7932,善化,二等
2020-10-18,4170,4098,4030,8128,善化,二等
2020-10-19,4170,3510,3471,6981,善化,二等
2020-10-20,4170,3356,3347,6703,善化,二等
2020-10-21,4170,3317,3324,6641,善化,二等
2020-10-22,4170,3319,3380,6699,善化,二等
2020-10-23,4170,4290,4365,8655,善化,二等
2020-10-24,4170,3277,3163,6440,善化,二等
2020-10-25,4170,3391,3604,6995,善化,二等
2020-10-26,4170,3475,3440,6915,善化,二等
2020-10-27,4170,3310,3355,6665,善化,二等
2020-10-28,4170,3139,3226,6365,善化,二等
2020-10-29,4170,3208,3247,6455,善化,二等
2020-10-30,4170,4138,4240,8378,善化,二等
2020-10-31,4170,3301,3165,6466,善化,二等
2020-11-01,4170,3356,3524,6880,善化,二等
2020-11-02,4170,3415,3372,6787,善化,二等
2020-11-03,4170,3202,3252,6454,善化,二等
2020-11-04,4170,3209,3203,6412,善化,二等
2020-11-05,4170,3350,3390,6740,善化,二等
2020-11-06,4170,4121,4148,8269,善化,二等
2020-11-07,4170,3048,2756,5804,善化,二等
2020-11-08,4170,3246,3577,6823,善化,二等
2020-11-09,4170,3327,3322,6649,善化,二等
2020-11-10,4170,3338,3322,6660,善化,二等
2020-11-11,4170,3299,3291,6590,善化,二等
2020-11-12,4170,3316,3340,6656,善化,二等
2020-11-13,4170,4423,3650,8073,善化,二等
2020-11-14,4170,3333,3181,6514,善化,二等
2020-11-15,4170,3542,3584,7126,善化,二等
2020-11-16,4170,3656,3645,7301,善化,二等
2020-11-17,4170,3519,3533,7052,善化,二等
2020-11-18,4170,3373,3399,6772,善化,二等
2020-11-19,4170,3408,3477,6885,善化,二等
2020-11-20,4170,4328,4327,8655,善化,二等
2020-11-21,4170,3286,3086,6372,善化,二等
2020-11-22,4170,3367,3587,6954,善化,二等
2020-11-23,4170,3529,3512,7041,善化,二等
2020-11-24,4170,3276,3349,6625,善化,二等
2020-11-25,4170,3269,3284,6553,善化,二等
2020-11-26,4170,3310,3382,6692,善化,二等
2020-11-27,4170,4381,4450,8831,善化,二等
2020-11-28,4170,3458,3323,6781,善化,二等
2020-11-29,4170,3484,3588,7072,善化,二等
2020-11-30,4170,3469,3488,6957,善化,二等
2020-12-01,4170,3308,3291,6599,善化,二等
2020-12-02,4170,3321,3356,6677,善化,二等
2020-12-03,4170,3315,3353,6668,善化,二等
2020-12-04,4170,4340,4481,8821,善化,二等
2020-12-05,4170,3378,3155,6533,善化,二等
2020-12-06,4170,3563,3676,7239,善化,二等
2020-12-07,4170,3613,3581,7194,善化,二等
2020-12-08,4170,3270,3314,6584,善化,二等
2020-12-09,4170,3229,3193,6422,善化,二等
2020-12-10,4170,3225,3292,6517,善化,二等
2020-12-11,4170,4330,4349,8679,善化,二等
2020-12-12,4170,3469,3241,6710,善化,二等
2020-12-13,4170,3645,3691,7336,善化,二等
2020-12-14,4170,3415,3539,6954,善化,二等
2020-12-15,4170,3273,3298,6571,善化,二等
2020-12-16,4170,3336,3356,6692,善化,二等
2020-12-17,4170,3592,3426,7018,善化,二等
2020-12-18,4170,4428,4488,8916,善化,二等
2020-12-19,4170,3368,3229,6597,善化,二等
2020-12-20,4170,3307,3675,6982,善化,二等
2020-12-21,4170,3399,3347,6746,善化,二等
2020-12-22,4170,3274,3324,6598,善化,二等
2020-12-23,4170,3204,3231,6435,善化,二等
2020-12-24,4170,3403,3401,6804,善化,二等
2020-12-25,4170,4376,4302,8678,善化,二等
2020-12-26,4170,3244,3079,6323,善化,二等
2020-12-27,4170,3130,3240,6370,善化,二等
2020-12-28,4170,3469,3446,6915,善化,二等
2020-12-29,4170,3266,3320,6586,善化,二等
2020-12-30,4170,3413,3426,6839,善化,二等
2020-12-31,4170,4262,4128,8390,善化,二等
2020-01-01,4180,981,1122,2103,南科,簡易
2020-01-02,4180,1594,1542,3136,南科,簡易
2020-01-03,4180,1871,1549,3420,南科,簡易
2020-01-04,4180,1153,885,2038,南科,簡易
2020-01-05,4180,830,1212,2042,南科,簡易
2020-01-06,4180,1610,1524,3134,南科,簡易
2020-01-07,4180,1675,1567,3242,南科,簡易
2020-01-08,4180,1671,1599,3270,南科,簡易
2020-01-09,4180,1705,1588,3293,南科,簡易
2020-01-10,4180,2271,1608,3879,南科,簡易
2020-01-11,4180,1107,952,2059,南科,簡易
2020-01-12,4180,762,1412,2174,南科,簡易
2020-01-13,4180,1642,1601,3243,南科,簡易
2020-01-14,4180,1655,1596,3251,南科,簡易
2020-01-15,4180,1600,1536,3136,南科,簡易
2020-01-16,4180,2237,2136,4373,南科,簡易
2020-01-17,4180,2067,1743,3810,南科,簡易
2020-01-18,4180,1081,830,1911,南科,簡易
2020-01-19,4180,800,1128,1928,南科,簡易
2020-01-20,4180,1518,1475,2993,南科,簡易
2020-01-21,4180,1516,1433,2949,南科,簡易
2020-01-22,4180,1713,1409,3122,南科,簡易
2020-01-23,4180,1164,693,1857,南科,簡易
2020-01-24,4180,758,514,1272,南科,簡易
2020-01-25,4180,566,602,1168,南科,簡易
2020-01-26,4180,606,611,1217,南科,簡易
2020-01-27,4180,641,796,1437,南科,簡易
2020-01-28,4180,564,703,1267,南科,簡易
2020-01-29,4180,642,1081,1723,南科,簡易
2020-01-30,4180,1140,1137,2277,南科,簡易
2020-01-31,4180,1477,1232,2709,南科,簡易
2020-02-01,4180,829,721,1550,南科,簡易
2020-02-02,4180,680,941,1621,南科,簡易
2020-02-03,4180,1260,1288,2548,南科,簡易
2020-02-04,4180,1313,1234,2547,南科,簡易
2020-02-05,4180,1350,1298,2648,南科,簡易
2020-02-06,4180,1289,1246,2535,南科,簡易
2020-02-07,4180,1665,1297,2962,南科,簡易
2020-02-08,4180,789,629,1418,南科,簡易
2020-02-09,4180,620,923,1543,南科,簡易
2020-02-10,4180,1407,1397,2804,南科,簡易
2020-02-11,4180,1341,1300,2641,南科,簡易
2020-02-12,4180,1325,1238,2563,南科,簡易
2020-02-13,4180,1310,1229,2539,南科,簡易
2020-02-14,4180,1629,1356,2985,南科,簡易
2020-02-15,4180,1002,793,1795,南科,簡易
2020-02-16,4180,687,992,1679,南科,簡易
2020-02-17,4180,1277,1235,2512,南科,簡易
2020-02-18,4180,1273,1232,2505,南科,簡易
2020-02-19,4180,1280,1206,2486,南科,簡易
2020-02-20,4180,1273,1218,2491,南科,簡易
2020-02-21,4180,1593,1237,2830,南科,簡易
2020-02-22,4180,833,648,1481,南科,簡易
2020-02-23,4180,584,930,1514,南科,簡易
2020-02-24,4180,1284,1266,2550,南科,簡易
2020-02-25,4180,1492,1342,2834,南科,簡易
2020-02-26,4180,1470,1356,2826,南科,簡易
2020-02-27,4180,1848,1430,3278,南科,簡易
2020-02-28,4180,1010,770,1780,南科,簡易
2020-02-29,4180,687,667,1354,南科,簡易
2020-03-01,4180,594,1037,1631,南科,簡易
2020-03-02,4180,1457,1333,2790,南科,簡易
2020-03-03,4180,1464,1323,2787,南科,簡易
2020-03-04,4180,1455,1322,2777,南科,簡易
2020-03-05,4180,1567,1398,2965,南科,簡易
2020-03-06,4180,1843,1448,3291,南科,簡易
2020-03-07,4180,831,621,1452,南科,簡易
2020-03-08,4180,668,986,1654,南科,簡易
2020-03-09,4180,1490,1391,2881,南科,簡易
2020-03-10,4180,1526,1374,2900,南科,簡易
2020-03-11,4180,1507,1387,2894,南科,簡易
2020-03-12,4180,1528,1389,2917,南科,簡易
2020-03-13,4180,1805,1409,3214,南科,簡易
2020-03-14,4180,836,602,1438,南科,簡易
2020-03-15,4180,652,985,1637,南科,簡易
2020-03-16,4180,1477,1370,2847,南科,簡易
2020-03-17,4180,1442,1292,2734,南科,簡易
2020-03-18,4180,1425,1311,2736,南科,簡易
2020-03-19,4180,1407,1281,2688,南科,簡易
2020-03-20,4180,1714,1299,3013,南科,簡易
2020-03-21,4180,717,523,1240,南科,簡易
2020-03-22,4180,468,811,1279,南科,簡易
2020-03-23,4180,1358,1265,2623,南科,簡易
2020-03-24,4180,1331,1214,2545,南科,簡易
2020-03-25,4180,1369,1223,2592,南科,簡易
2020-03-26,4180,1289,1211,2500,南科,簡易
2020-03-27,4180,1568,1225,2793,南科,簡易
2020-03-28,4180,654,494,1148,南科,簡易
2020-03-29,4180,518,766,1284,南科,簡易
2020-03-30,4180,1338,1274,2612,南科,簡易
2020-03-31,4180,1274,1201,2475,南科,簡易
2020-04-01,4180,1605,1248,2853,南科,簡易
2020-04-02,4180,868,566,1434,南科,簡易
2020-04-03,4180,655,537,1192,南科,簡易
2020-04-04,4180,429,444,873,南科,簡易
2020-04-05,4180,464,922,1386,南科,簡易
2020-04-06,4180,1268,1194,2462,南科,簡易
2020-04-07,4180,1195,1088,2283,南科,簡易
2020-04-08,4180,1270,1164,2434,南科,簡易
2020-04-09,4180,1295,1168,2463,南科,簡易
2020-04-10,4180,1528,1232,2760,南科,簡易
2020-04-11,4180,690,507,1197,南科,簡易
2020-04-12,4180,508,736,1244,南科,簡易
2020-04-13,4180,1303,1220,2523,南科,簡易
2020-04-14,4180,1286,1174,2460,南科,簡易
2020-04-15,4180,1337,1203,2540,南科,簡易
2020-04-16,4180,1373,1206,2579,南科,簡易
2020-04-17,4180,1648,1247,2895,南科,簡易
2020-04-18,4180,698,546,1244,南科,簡易
2020-04-19,4180,528,839,1367,南科,簡易
2020-04-20,4180,1302,1193,2495,南科,簡易
2020-04-21,4180,1258,1143,2401,南科,簡易
2020-04-22,4180,1242,1130,2372,南科,簡易
2020-04-23,4180,1254,1103,2357,南科,簡易
2020-04-24,4180,1484,1191,2675,南科,簡易
2020-04-25,4180,625,444,1069,南科,簡易
2020-04-26,4180,465,727,1192,南科,簡易
2020-04-27,4180,1280,1188,2468,南科,簡易
2020-04-28,4180,1258,1146,2404,南科,簡易
2020-04-29,4180,1178,1085,2263,南科,簡易
2020-04-30,4180,1500,1153,2653,南科,簡易
2020-05-01,4180,1164,832,1996,南科,簡易
2020-05-02,4180,607,521,1128,南科,簡易
2020-05-03,4180,488,831,1319,南科,簡易
2020-05-04,4180,1329,1241,2570,南科,簡易
2020-05-05,4180,1283,1177,2460,南科,簡易
2020-05-06,4180,1369,1252,2621,南科,簡易
2020-05-07,4180,1430,1244,2674,南科,簡易
2020-05-08,4180,1744,1315,3059,南科,簡易
2020-05-09,4180,778,573,1351,南科,簡易
2020-05-10,4180,575,1028,1603,南科,簡易
2020-05-11,4180,1404,1293,2697,南科,簡易
2020-05-12,4180,1348,1223,2571,南科,簡易
2020-05-13,4180,1401,1291,2692,南科,簡易
2020-05-14,4180,1381,1245,2626,南科,簡易
2020-05-15,4180,1740,1448,3188,南科,簡易
2020-05-16,4180,726,542,1268,南科,簡易
2020-05-17,4180,576,829,1405,南科,簡易
2020-05-18,4180,1367,1276,2643,南科,簡易
2020-05-19,4180,1315,1192,2507,南科,簡易
2020-05-20,4180,1344,1230,2574,南科,簡易
2020-05-21,4180,1304,1196,2500,南科,簡易
2020-05-22,4180,1558,1203,2761,南科,簡易
2020-05-23,4180,739,513,1252,南科,簡易
2020-05-24,4180,578,915,1493,南科,簡易
2020-05-25,4180,1349,1274,2623,南科,簡易
2020-05-26,4180,1272,1160,2432,南科,簡易
2020-05-27,4180,1326,1179,2505,南科,簡易
2020-05-28,4180,1327,1242,2569,南科,簡易
2020-05-29,4180,1706,1354,3060,南科,簡易
2020-05-30,4180,886,707,1593,南科,簡易
2020-05-31,4180,657,973,1630,南科,簡易
2020-06-01,4180,1385,1274,2659,南科,簡易
2020-06-02,4180,1379,1281,2660,南科,簡易
2020-06-03,4180,1387,1264,2651,南科,簡易
2020-06-04,4180,1402,1253,2655,南科,簡易
2020-06-05,4180,1887,1364,3251,南科,簡易
2020-06-06,4180,905,690,1595,南科,簡易
2020-06-07,4180,682,1068,1750,南科,簡易
2020-06-08,4180,1422,1383,2805,南科,簡易
2020-06-09,4180,1491,1345,2836,南科,簡易
2020-06-10,4180,1533,1370,2903,南科,簡易
2020-06-11,4180,1421,1355,2776,南科,簡易
2020-06-12,4180,1775,1413,3188,南科,簡易
2020-06-13,4180,872,682,1554,南科,簡易
2020-06-14,4180,699,1044,1743,南科,簡易
2020-06-15,4180,1496,1399,2895,南科,簡易
2020-06-16,4180,1419,1290,2709,南科,簡易
2020-06-17,4180,1450,1336,2786,南科,簡易
2020-06-18,4180,1421,1279,2700,南科,簡易
2020-06-19,4180,1642,1347,2989,南科,簡易
2020-06-20,4180,1136,849,1985,南科,簡易
2020-06-21,4180,716,978,1694,南科,簡易
2020-06-22,4180,1437,1320,2757,南科,簡易
2020-06-23,4180,1428,1295,2723,南科,簡易
2020-06-24,4180,1864,1408,3272,南科,簡易
2020-06-25,4180,1058,751,1809,南科,簡易
2020-06-26,4180,857,747,1604,南科,簡易
2020-06-27,4180,667,651,1318,南科,簡易
2020-06-28,4180,629,1092,1721,南科,簡易
2020-06-29,4180,1425,1353,2778,南科,簡易
2020-06-30,4180,1429,1312,2741,南科,簡易
2020-07-01,4180,1420,1303,2723,南科,簡易
2020-07-02,4180,1362,1232,2594,南科,簡易
2020-07-03,4180,1703,1411,3114,南科,簡易
2020-07-04,4180,957,749,1706,南科,簡易
2020-07-05,4180,684,1009,1693,南科,簡易
2020-07-06,4180,1446,1362,2808,南科,簡易
2020-07-07,4180,1428,1351,2779,南科,簡易
2020-07-08,4180,1389,1303,2692,南科,簡易
2020-07-09,4180,1413,1315,2728,南科,簡易
2020-07-10,4180,1863,1464,3327,南科,簡易
2020-07-11,4180,967,763,1730,南科,簡易
2020-07-12,4180,756,1049,1805,南科,簡易
2020-07-13,4180,1336,1337,2673,南科,簡易
2020-07-14,4180,1660,1477,3137,南科,簡易
2020-07-15,4180,1359,1310,2669,南科,簡易
2020-07-16,4180,1322,1240,2562,南科,簡易
2020-07-17,4180,1681,1455,3136,南科,簡易
2020-07-18,4180,865,700,1565,南科,簡易
2020-07-19,4180,797,1115,1912,南科,簡易
2020-07-20,4180,1398,1348,2746,南科,簡易
2020-07-21,4180,1404,1397,2801,南科,簡易
2020-07-22,4180,1345,1298,2643,南科,簡易
2020-07-23,4180,1348,1299,2647,南科,簡易
2020-07-24,4180,1698,1345,3043,南科,簡易
2020-07-25,4180,1013,778,1791,南科,簡易
2020-07-26,4180,758,1054,1812,南科,簡易
2020-07-27,4180,1442,1327,2769,南科,簡易
2020-07-28,4180,1386,1315,2701,南科,簡易
2020-07-29,4180,1429,1353,2782,南科,簡易
2020-07-30,4180,1485,1350,2835,南科,簡易
2020-07-31,4180,1720,1406,3126,南科,簡易
2020-08-01,4180,900,685,1585,南科,簡易
2020-08-02,4180,646,1008,1654,南科,簡易
2020-08-03,4180,1365,1262,2627,南科,簡易
2020-08-04,4180,1416,1299,2715,南科,簡易
2020-08-05,4180,1600,1426,3026,南科,簡易
2020-08-06,4180,1641,1476,3117,南科,簡易
2020-08-07,4180,1969,1570,3539,南科,簡易
2020-08-08,4180,960,727,1687,南科,簡易
2020-08-09,4180,739,1176,1915,南科,簡易
2020-08-10,4180,1461,1406,2867,南科,簡易
2020-08-11,4180,1432,1310,2742,南科,簡易
2020-08-12,4180,1555,1441,2996,南科,簡易
2020-08-13,4180,1490,1410,2900,南科,簡易
2020-08-14,4180,1850,1461,3311,南科,簡易
2020-08-15,4180,1039,847,1886,南科,簡易
2020-08-16,4180,775,1138,1913,南科,簡易
2020-08-17,4180,1350,1413,2763,南科,簡易
2020-08-18,4180,1464,1326,2790,南科,簡易
2020-08-19,4180,1478,1389,2867,南科,簡易
2020-08-20,4180,1436,1353,2789,南科,簡易
2020-08-21,4180,1750,1411,3161,南科,簡易
2020-08-22,4180,993,730,1723,南科,簡易
2020-08-23,4180,680,1065,1745,南科,簡易
2020-08-24,4180,1458,1405,2863,南科,簡易
2020-08-25,4180,1509,1398,2907,南科,簡易
2020-08-26,4180,1246,1166,2412,南科,簡易
2020-08-27,4180,1291,1180,2471,南科,簡易
2020-08-28,4180,1589,1310,2899,南科,簡易
2020-08-29,4180,995,731,1726,南科,簡易
2020-08-30,4180,620,780,1400,南科,簡易
2020-08-31,4180,1508,1452,2960,南科,簡易
2020-09-01,4180,1518,1394,2912,南科,簡易
2020-09-02,4180,1458,1309,2767,南科,簡易
2020-09-03,4180,1510,1402,2912,南科,簡易
2020-09-04,4180,1978,1491,3469,南科,簡易
2020-09-05,4180,929,707,1636,南科,簡易
2020-09-06,4180,688,1075,1763,南科,簡易
2020-09-07,4180,1561,1457,3018,南科,簡易
2020-09-08,4180,1505,1386,2891,南科,簡易
2020-09-09,4180,1514,1421,2935,南科,簡易
2020-09-10,4180,1611,1443,3054,南科,簡易
2020-09-11,4180,1973,1562,3535,南科,簡易
2020-09-12,4180,951,732,1683,南科,簡易
2020-09-13,4180,703,1072,1775,南科,簡易
2020-09-14,4180,1555,1452,3007,南科,簡易
2020-09-15,4180,1511,1401,2912,南科,簡易
2020-09-16,4180,1554,1446,3000,南科,簡易
2020-09-17,4180,1545,1410,2955,南科,簡易
2020-09-18,4180,1889,1465,3354,南科,簡易
2020-09-19,4180,973,769,1742,南科,簡易
2020-09-20,4180,739,1076,1815,南科,簡易
2020-09-21,4180,1526,1430,2956,南科,簡易
2020-09-22,4180,1484,1364,2848,南科,簡易
2020-09-23,4180,1523,1407,2930,南科,簡易
2020-09-24,4180,1565,1471,3036,南科,簡易
2020-09-25,4180,1736,1513,3249,南科,簡易
2020-09-26,4180,1260,1013,2273,南科,簡易
2020-09-27,4180,708,975,1683,南科,簡易
2020-09-28,4180,1508,1438,2946,南科,簡易
2020-09-29,4180,1523,1367,2890,南科,簡易
2020-09-30,4180,1908,1534,3442,南科,簡易
2020-10-01,4180,1152,835,1987,南科,簡易
2020-10-02,4180,938,830,1768,南科,簡易
2020-10-03,4180,717,732,1449,南科,簡易
2020-10-04,4180,733,1204,1937,南科,簡易
2020-10-05,4180,1591,1451,3042,南科,簡易
2020-10-06,4180,1556,1402,2958,南科,簡易
2020-10-07,4180,1679,1474,3153,南科,簡易
2020-10-08,4180,1869,1562,3431,南科,簡易
2020-10-09,4180,1129,916,2045,南科,簡易
2020-10-10,4180,859,797,1656,南科,簡易
2020-10-11,4180,782,1075,1857,南科,簡易
2020-10-12,4180,1529,1405,2934,南科,簡易
2020-10-13,4180,1539,1383,2922,南科,簡易
2020-10-14,4180,1521,1377,2898,南科,簡易
2020-10-15,4180,1557,1419,2976,南科,簡易
2020-10-16,4180,1837,1478,3315,南科,簡易
2020-10-17,4180,1059,1235,2294,南科,簡易
2020-10-18,4180,835,1467,2302,南科,簡易
2020-10-19,4180,1562,1437,2999,南科,簡易
2020-10-20,4180,1481,1339,2820,南科,簡易
2020-10-21,4180,1511,1372,2883,南科,簡易
2020-10-22,4180,1499,1380,2879,南科,簡易
2020-10-23,4180,1877,1664,3541,南科,簡易
2020-10-24,4180,1017,761,1778,南科,簡易
2020-10-25,4180,713,1031,1744,南科,簡易
2020-10-26,4180,1571,1444,3015,南科,簡易
2020-10-27,4180,1484,1398,2882,南科,簡易
2020-10-28,4180,1468,1349,2817,南科,簡易
2020-10-29,4180,1453,1370,2823,南科,簡易
2020-10-30,4180,1826,1419,3245,南科,簡易
2020-10-31,4180,1095,853,1948,南科,簡易
2020-11-01,4180,736,1035,1771,南科,簡易
2020-11-02,4180,1442,1358,2800,南科,簡易
2020-11-03,4180,1481,1334,2815,南科,簡易
2020-11-04,4180,1529,1464,2993,南科,簡易
2020-11-05,4180,1549,1388,2937,南科,簡易
2020-11-06,4180,1852,1472,3324,南科,簡易
2020-11-07,4180,1003,714,1717,南科,簡易
2020-11-08,4180,801,1138,1939,南科,簡易
2020-11-09,4180,1497,1342,2839,南科,簡易
2020-11-10,4180,1538,1376,2914,南科,簡易
2020-11-11,4180,1539,1396,2935,南科,簡易
2020-11-12,4180,1576,1413,2989,南科,簡易
2020-11-13,4180,1927,1498,3425,南科,簡易
2020-11-14,4180,1019,851,1870,南科,簡易
2020-11-15,4180,716,1088,1804,南科,簡易
2020-11-16,4180,1491,1407,2898,南科,簡易
2020-11-17,4180,1509,1354,2863,南科,簡易
2020-11-18,4180,1473,1362,2835,南科,簡易
2020-11-19,4180,1559,1434,2993,南科,簡易
2020-11-20,4180,1883,1478,3361,南科,簡易
2020-11-21,4180,972,763,1735,南科,簡易
2020-11-22,4180,768,1084,1852,南科,簡易
2020-11-23,4180,1489,1387,2876,南科,簡易
2020-11-24,4180,1495,1357,2852,南科,簡易
2020-11-25,4180,1510,1361,2871,南科,簡易
2020-11-26,4180,1523,1365,2888,南科,簡易
2020-11-27,4180,1817,1418,3235,南科,簡易
2020-11-28,4180,992,826,1818,南科,簡易
2020-11-29,4180,749,1048,1797,南科,簡易
2020-11-30,4180,1437,1386,2823,南科,簡易
2020-12-01,4180,1462,1328,2790,南科,簡易
2020-12-02,4180,1425,1336,2761,南科,簡易
2020-12-03,4180,1422,1306,2728,南科,簡易
2020-12-04,4180,1867,1499,3366,南科,簡易
2020-12-05,4180,1463,1142,2605,南科,簡易
2020-12-06,4180,841,1167,2008,南科,簡易
2020-12-07,4180,1410,1326,2736,南科,簡易
2020-12-08,4180,1430,1360,2790,南科,簡易
2020-12-09,4180,1442,1376,2818,南科,簡易
2020-12-10,4180,1538,1430,2968,南科,簡易
2020-12-11,4180,1755,1396,3151,南科,簡易
2020-12-12,4180,1010,816,1826,南科,簡易
2020-12-13,4180,841,1066,1907,南科,簡易
2020-12-14,4180,1458,1389,2847,南科,簡易
2020-12-15,4180,1479,1337,2816,南科,簡易
2020-12-16,4180,1473,1368,2841,南科,簡易
2020-12-17,4180,1585,1440,3025,南科,簡易
2020-12-18,4180,1814,1432,3246,南科,簡易
2020-12-19,4180,1035,836,1871,南科,簡易
2020-12-20,4180,725,1071,1796,南科,簡易
2020-12-21,4180,1436,1353,2789,南科,簡易
2020-12-22,4180,1480,1364,2844,南科,簡易
2020-12-23,4180,1456,1338,2794,南科,簡易
2020-12-24,4180,1469,1335,2804,南科,簡易
2020-12-25,4180,1857,1478,3335,南科,簡易
2020-12-26,4180,927,721,1648,南科,簡易
2020-12-27,4180,685,973,1658,南科,簡易
2020-12-28,4180,1484,1355,2839,南科,簡易
2020-12-29,4180,1457,1292,2749,南科,簡易
2020-12-30,4180,1421,1316,2737,南科,簡易
2020-12-31,4180,1797,1331,3128,南科,簡易
2020-01-01,4190,2394,2777,5171,新市,三等
2020-01-02,4190,2632,2639,5271,新市,三等
2020-01-03,4190,3302,2907,6209,新市,三等
2020-01-04,4190,2590,2289,4879,新市,三等
2020-01-05,4190,2690,3190,5880,新市,三等
2020-01-06,4190,2791,2941,5732,新市,三等
2020-01-07,4190,2619,2682,5301,新市,三等
2020-01-08,4190,2638,2666,5304,新市,三等
2020-01-09,4190,2712,2663,5375,新市,三等
2020-01-10,4190,3954,3081,7035,新市,三等
2020-01-11,4190,2921,2526,5447,新市,三等
2020-01-12,4190,3860,4515,8375,新市,三等
2020-01-13,4190,2480,2664,5144,新市,三等
2020-01-14,4190,2348,2329,4677,新市,三等
2020-01-15,4190,2343,2261,4604,新市,三等
2020-01-16,4190,2737,2635,5372,新市,三等
2020-01-17,4190,2737,2588,5325,新市,三等
2020-01-18,4190,2668,2337,5005,新市,三等
2020-01-19,4190,2456,2805,5261,新市,三等
2020-01-20,4190,2336,2406,4742,新市,三等
2020-01-21,4190,2188,2263,4451,新市,三等
2020-01-22,4190,2727,2336,5063,新市,三等
2020-01-23,4190,2615,2040,4655,新市,三等
2020-01-24,4190,2421,1818,4239,新市,三等
2020-01-25,4190,2449,2266,4715,新市,三等
2020-01-26,4190,2351,2366,4717,新市,三等
2020-01-27,4190,2348,2562,4910,新市,三等
2020-01-28,4190,1882,2072,3954,新市,三等
2020-01-29,4190,1895,2337,4232,新市,三等
2020-01-30,4190,1878,1901,3779,新市,三等
2020-01-31,4190,2281,2065,4346,新市,三等
2020-02-01,4190,1807,1691,3498,新市,三等
2020-02-02,4190,1808,2019,3827,新市,三等
2020-02-03,4190,2095,2081,4176,新市,三等
2020-02-04,4190,1953,1958,3911,新市,三等
2020-02-05,4190,2203,2091,4294,新市,三等
2020-02-06,4190,2207,2176,4383,新市,三等
2020-02-07,4190,2601,2231,4832,新市,三等
2020-02-08,4190,2098,1894,3992,新市,三等
2020-02-09,4190,2189,2470,4659,新市,三等
2020-02-10,4190,2136,2183,4319,新市,三等
2020-02-11,4190,2098,2004,4102,新市,三等
2020-02-12,4190,2016,2071,4087,新市,三等
2020-02-13,4190,2042,1900,3942,新市,三等
2020-02-14,4190,2513,2232,4745,新市,三等
2020-02-15,4190,2273,1920,4193,新市,三等
2020-02-16,4190,2102,2478,4580,新市,三等
2020-02-17,4190,1894,1951,3845,新市,三等
2020-02-18,4190,1898,1897,3795,新市,三等
2020-02-19,4190,1991,1995,3986,新市,三等
2020-02-20,4190,1959,1896,3855,新市,三等
2020-02-21,4190,2491,2123,4614,新市,三等
2020-02-22,4190,1925,1668,3593,新市,三等
2020-02-23,4190,2000,2331,4331,新市,三等
2020-02-24,4190,2032,1991,4023,新市,三等
2020-02-25,4190,1944,1965,3909,新市,三等
2020-02-26,4190,2134,2100,4234,新市,三等
2020-02-27,4190,2764,2515,5279,新市,三等
2020-02-28,4190,2116,1732,3848,新市,三等
2020-02-29,4190,1792,1771,3563,新市,三等
2020-03-01,4190,2058,2604,4662,新市,三等
2020-03-02,4190,2411,2456,4867,新市,三等
2020-03-03,4190,2235,2225,4460,新市,三等
2020-03-04,4190,2161,2142,4303,新市,三等
2020-03-05,4190,2549,2346,4895,新市,三等
2020-03-06,4190,3158,2773,5931,新市,三等
2020-03-07,4190,2305,2003,4308,新市,三等
2020-03-08,4190,2215,2547,4762,新市,三等
2020-03-09,4190,2527,2614,5141,新市,三等
2020-03-10,4190,2323,2307,4630,新市,三等
2020-03-11,4190,2296,2313,4609,新市,三等
2020-03-12,4190,2456,2309,4765,新市,三等
2020-03-13,4190,2908,2619,5527,新市,三等
2020-03-14,4190,1947,1661,3608,新市,三等
2020-03-15,4190,2054,2532,4586,新市,三等
2020-03-16,4190,2388,2453,4841,新市,三等
2020-03-17,4190,2229,2251,4480,新市,三等
2020-03-18,4190,2169,2143,4312,新市,三等
2020-03-19,4190,2264,2157,4421,新市,三等
2020-03-20,4190,2751,2390,5141,新市,三等
2020-03-21,4190,1760,1600,3360,新市,三等
2020-03-22,4190,1637,2028,3665,新市,三等
2020-03-23,4190,2136,2225,4361,新市,三等
2020-03-24,4190,2033,2008,4041,新市,三等
2020-03-25,4190,1978,1987,3965,新市,三等
2020-03-26,4190,2194,2037,4231,新市,三等
2020-03-27,4190,2520,2180,4700,新市,三等
2020-03-28,4190,1700,1406,3106,新市,三等
2020-03-29,4190,1517,1969,3486,新市,三等
2020-03-30,4190,2083,2134,4217,新市,三等
2020-03-31,4190,2079,2091,4170,新市,三等
2020-04-01,4190,2765,2392,5157,新市,三等
2020-04-02,4190,2020,1632,3652,新市,三等
2020-04-03,4190,1746,1548,3294,新市,三等
2020-04-04,4190,1370,1319,2689,新市,三等
2020-04-05,4190,1744,2346,4090,新市,三等
2020-04-06,4190,2120,2207,4327,新市,三等
2020-04-07,4190,1969,1976,3945,新市,三等
2020-04-08,4190,2026,1984,4010,新市,三等
2020-04-09,4190,2110,1988,4098,新市,三等
2020-04-10,4190,2440,2054,4494,新市,三等
2020-04-11,4190,1727,1499,3226,新市,三等
2020-04-12,4190,1634,1941,3575,新市,三等
2020-04-13,4190,2138,2212,4350,新市,三等
2020-04-14,4190,2039,2020,4059,新市,三等
2020-04-15,4190,2038,2027,4065,新市,三等
2020-04-16,4190,2116,2040,4156,新市,三等
2020-04-17,4190,2648,2202,4850,新市,三等
2020-04-18,4190,1810,1563,3373,新市,三等
2020-04-19,4190,1626,2125,3751,新市,三等
2020-04-20,4190,2075,2117,4192,新市,三等
2020-04-21,4190,1926,1944,3870,新市,三等
2020-04-22,4190,1781,1818,3599,新市,三等
2020-04-23,4190,1939,1828,3767,新市,三等
2020-04-24,4190,2362,2072,4434,新市,三等
2020-04-25,4190,1436,1227,2663,新市,三等
2020-04-26,4190,1329,1651,2980,新市,三等
2020-04-27,4190,2054,2088,4142,新市,三等
2020-04-28,4190,1943,1955,3898,新市,三等
2020-04-29,4190,1764,1828,3592,新市,三等
2020-04-30,4190,2449,2007,4456,新市,三等
2020-05-01,4190,2360,2109,4469,新市,三等
2020-05-02,4190,1500,1423,2923,新市,三等
2020-05-03,4190,1569,2000,3569,新市,三等
2020-05-04,4190,2112,2181,4293,新市,三等
2020-05-05,4190,2178,2103,4281,新市,三等
2020-05-06,4190,2191,2115,4306,新市,三等
2020-05-07,4190,2331,2165,4496,新市,三等
2020-05-08,4190,3020,2543,5563,新市,三等
2020-05-09,4190,2105,1712,3817,新市,三等
2020-05-10,4190,1910,2490,4400,新市,三等
2020-05-11,4190,2287,2338,4625,新市,三等
2020-05-12,4190,2023,2074,4097,新市,三等
2020-05-13,4190,2157,2078,4235,新市,三等
2020-05-14,4190,2218,2156,4374,新市,三等
2020-05-15,4190,2824,2374,5198,新市,三等
2020-05-16,4190,1891,1653,3544,新市,三等
2020-05-17,4190,1840,2155,3995,新市,三等
2020-05-18,4190,2162,2309,4471,新市,三等
2020-05-19,4190,1933,1869,3802,新市,三等
2020-05-20,4190,2011,1937,3948,新市,三等
2020-05-21,4190,2070,1966,4036,新市,三等
2020-05-22,4190,2341,2013,4354,新市,三等
2020-05-23,4190,1881,1471,3352,新市,三等
2020-05-24,4190,1844,2318,4162,新市,三等
2020-05-25,4190,2236,2337,4573,新市,三等
2020-05-26,4190,1920,1902,3822,新市,三等
2020-05-27,4190,1945,1905,3850,新市,三等
2020-05-28,4190,2149,2014,4163,新市,三等
2020-05-29,4190,2735,2320,5055,新市,三等
2020-05-30,4190,2049,1742,3791,新市,三等
2020-05-31,4190,2016,2434,4450,新市,三等
2020-06-01,4190,2230,2299,4529,新市,三等
2020-06-02,4190,2127,2082,4209,新市,三等
2020-06-03,4190,2117,2124,4241,新市,三等
2020-06-04,4190,2287,2081,4368,新市,三等
2020-06-05,4190,3253,2546,5799,新市,三等
2020-06-06,4190,2438,2255,4693,新市,三等
2020-06-07,4190,2541,2962,5503,新市,三等
2020-06-08,4190,2321,2422,4743,新市,三等
2020-06-09,4190,2172,2175,4347,新市,三等
2020-06-10,4190,2215,2132,4347,新市,三等
2020-06-11,4190,2403,2287,4690,新市,三等
2020-06-12,4190,2890,2477,5367,新市,三等
2020-06-13,4190,2314,2022,4336,新市,三等
2020-06-14,4190,2314,2792,5106,新市,三等
2020-06-15,4190,2191,2366,4557,新市,三等
2020-06-16,4190,2247,2137,4384,新市,三等
2020-06-17,4190,2166,2098,4264,新市,三等
2020-06-18,4190,2154,2024,4178,新市,三等
2020-06-19,4190,2452,2267,4719,新市,三等
2020-06-20,4190,2248,1882,4130,新市,三等
2020-06-21,4190,1870,2231,4101,新市,三等
2020-06-22,4190,2259,2301,4560,新市,三等
2020-06-23,4190,2178,2118,4296,新市,三等
2020-06-24,4190,2969,2501,5470,新市,三等
2020-06-25,4190,2492,1889,4381,新市,三等
2020-06-26,4190,2101,2009,4110,新市,三等
2020-06-27,4190,1946,1975,3921,新市,三等
2020-06-28,4190,2050,2675,4725,新市,三等
2020-06-29,4190,2260,2279,4539,新市,三等
2020-06-30,4190,2130,2082,4212,新市,三等
2020-07-01,4190,2239,2079,4318,新市,三等
2020-07-02,4190,2086,2057,4143,新市,三等
2020-07-03,4190,2657,2426,5083,新市,三等
2020-07-04,4190,2311,1879,4190,新市,三等
2020-07-05,4190,2158,2383,4541,新市,三等
2020-07-06,4190,2234,2236,4470,新市,三等
2020-07-07,4190,2091,2059,4150,新市,三等
2020-07-08,4190,2056,1928,3984,新市,三等
2020-07-09,4190,2048,1975,4023,新市,三等
2020-07-10,4190,2624,2290,4914,新市,三等
2020-07-11,4190,2431,2066,4497,新市,三等
2020-07-12,4190,2233,2563,4796,新市,三等
2020-07-13,4190,2121,2216,4337,新市,三等
2020-07-14,4190,2150,2207,4357,新市,三等
2020-07-15,4190,1888,1820,3708,新市,三等
2020-07-16,4190,2055,1862,3917,新市,三等
2020-07-17,4190,2544,2206,4750,新市,三等
2020-07-18,4190,2249,1961,4210,新市,三等
2020-07-19,4190,2356,2706,5062,新市,三等
2020-07-20,4190,2169,2105,4274,新市,三等
2020-07-21,4190,2042,1996,4038,新市,三等
2020-07-22,4190,2067,1963,4030,新市,三等
2020-07-23,4190,1957,1892,3849,新市,三等
2020-07-24,4190,2638,2203,4841,新市,三等
2020-07-25,4190,2160,1865,4025,新市,三等
2020-07-26,4190,2177,2359,4536,新市,三等
2020-07-27,4190,2026,2034,4060,新市,三等
2020-07-28,4190,1958,1904,3862,新市,三等
2020-07-29,4190,1895,1809,3704,新市,三等
2020-07-30,4190,1985,1786,3771,新市,三等
2020-07-31,4190,2530,2164,4694,新市,三等
2020-08-01,4190,2172,1852,4024,新市,三等
2020-08-02,4190,2096,2519,4615,新市,三等
2020-08-03,4190,1912,1923,3835,新市,三等
2020-08-04,4190,1794,1763,3557,新市,三等
2020-08-05,4190,2207,2072,4279,新市,三等
2020-08-06,4190,2293,2211,4504,新市,三等
2020-08-07,4190,2912,2394,5306,新市,三等
2020-08-08,4190,2457,2098,4555,新市,三等
2020-08-09,4190,2370,2733,5103,新市,三等
2020-08-10,4190,2183,2236,4419,新市,三等
2020-08-11,4190,1937,1925,3862,新市,三等
2020-08-12,4190,2157,1985,4142,新市,三等
2020-08-13,4190,2124,2045,4169,新市,三等
2020-08-14,4190,2833,2434,5267,新市,三等
2020-08-15,4190,2548,2043,4591,新市,三等
2020-08-16,4190,2351,2766,5117,新市,三等
2020-08-17,4190,2168,2350,4518,新市,三等
2020-08-18,4190,2193,2105,4298,新市,三等
2020-08-19,4190,2028,2006,4034,新市,三等
2020-08-20,4190,2235,2163,4398,新市,三等
2020-08-21,4190,2620,2256,4876,新市,三等
2020-08-22,4190,2320,1952,4272,新市,三等
2020-08-23,4190,2133,2398,4531,新市,三等
2020-08-24,4190,2140,2196,4336,新市,三等
2020-08-25,4190,2101,2030,4131,新市,三等
2020-08-26,4190,1644,1638,3282,新市,三等
2020-08-27,4190,1683,1653,3336,新市,三等
2020-08-28,4190,2363,2044,4407,新市,三等
2020-08-29,4190,2132,1746,3878,新市,三等
2020-08-30,4190,1681,1824,3505,新市,三等
2020-08-31,4190,2133,2149,4282,新市,三等
2020-09-01,4190,2017,1865,3882,新市,三等
2020-09-02,4190,2021,1942,3963,新市,三等
2020-09-03,4190,2112,2046,4158,新市,三等
2020-09-04,4190,2904,2483,5387,新市,三等
2020-09-05,4190,2382,2062,4444,新市,三等
2020-09-06,4190,2197,2533,4730,新市,三等
2020-09-07,4190,2314,2358,4672,新市,三等
2020-09-08,4190,2156,2085,4241,新市,三等
2020-09-09,4190,2058,2111,4169,新市,三等
2020-09-10,4190,2154,2146,4300,新市,三等
2020-09-11,4190,2729,2435,5164,新市,三等
2020-09-12,4190,2413,2077,4490,新市,三等
2020-09-13,4190,2499,2836,5335,新市,三等
2020-09-14,4190,2441,2484,4925,新市,三等
2020-09-15,4190,2311,2298,4609,新市,三等
2020-09-16,4190,2297,2234,4531,新市,三等
2020-09-17,4190,2431,2271,4702,新市,三等
2020-09-18,4190,3074,2606,5680,新市,三等
2020-09-19,4190,2428,2203,4631,新市,三等
2020-09-20,4190,2231,2688,4919,新市,三等
2020-09-21,4190,2405,2378,4783,新市,三等
2020-09-22,4190,2387,2284,4671,新市,三等
2020-09-23,4190,2277,2258,4535,新市,三等
2020-09-24,4190,2481,2322,4803,新市,三等
2020-09-25,4190,2683,2459,5142,新市,三等
2020-09-26,4190,2461,2139,4600,新市,三等
2020-09-27,4190,2247,2674,4921,新市,三等
2020-09-28,4190,2321,2339,4660,新市,三等
2020-09-29,4190,2257,2234,4491,新市,三等
2020-09-30,4190,3342,2951,6293,新市,三等
2020-10-01,4190,2722,2206,4928,新市,三等
2020-10-02,4190,2631,2417,5048,新市,三等
2020-10-03,4190,2272,2319,4591,新市,三等
2020-10-04,4190,2428,2929,5357,新市,三等
2020-10-05,4190,2589,2566,5155,新市,三等
2020-10-06,4190,2393,2299,4692,新市,三等
2020-10-07,4190,2452,2380,4832,新市,三等
2020-10-08,4190,3148,2756,5904,新市,三等
2020-10-09,4190,2743,2325,5068,新市,三等
2020-10-10,4190,2353,2168,4521,新市,三等
2020-10-11,4190,2385,2827,5212,新市,三等
2020-10-12,4190,2466,2469,4935,新市,三等
2020-10-13,4190,2287,2260,4547,新市,三等
2020-10-14,4190,2296,2194,4490,新市,三等
2020-10-15,4190,2394,2345,4739,新市,三等
2020-10-16,4190,3019,2679,5698,新市,三等
2020-10-17,4190,2580,2296,4876,新市,三等
2020-10-18,4190,2563,2950,5513,新市,三等
2020-10-19,4190,2443,2506,4949,新市,三等
2020-10-20,4190,2379,2246,4625,新市,三等
2020-10-21,4190,2212,2241,4453,新市,三等
2020-10-22,4190,2487,2345,4832,新市,三等
2020-10-23,4190,3093,2696,5789,新市,三等
2020-10-24,4190,2620,2301,4921,新市,三等
2020-10-25,4190,2318,2819,5137,新市,三等
2020-10-26,4190,2442,2363,4805,新市,三等
2020-10-27,4190,2314,2275,4589,新市,三等
2020-10-28,4190,2202,2164,4366,新市,三等
2020-10-29,4190,2343,2189,4532,新市,三等
2020-10-30,4190,3055,2673,5728,新市,三等
2020-10-31,4190,2446,2138,4584,新市,三等
2020-11-01,4190,2443,2839,5282,新市,三等
2020-11-02,4190,2366,2414,4780,新市,三等
2020-11-03,4190,2285,2269,4554,新市,三等
2020-11-04,4190,2229,2198,4427,新市,三等
2020-11-05,4190,2545,2340,4885,新市,三等
2020-11-06,4190,3195,2709,5904,新市,三等
2020-11-07,4190,2395,2139,4534,新市,三等
2020-11-08,4190,2579,3032,5611,新市,三等
2020-11-09,4190,2406,2436,4842,新市,三等
2020-11-10,4190,2359,2319,4678,新市,三等
2020-11-11,4190,2319,2281,4600,新市,三等
2020-11-12,4190,2498,2315,4813,新市,三等
2020-11-13,4190,3116,2775,5891,新市,三等
2020-11-14,4190,2718,2449,5167,新市,三等
2020-11-15,4190,2724,3172,5896,新市,三等
2020-11-16,4190,2393,2429,4822,新市,三等
2020-11-17,4190,2392,2253,4645,新市,三等
2020-11-18,4190,2303,2257,4560,新市,三等
2020-11-19,4190,2489,2310,4799,新市,三等
2020-11-20,4190,3155,2763,5918,新市,三等
2020-11-21,4190,2365,2102,4467,新市,三等
2020-11-22,4190,2318,2824,5142,新市,三等
2020-11-23,4190,2449,2398,4847,新市,三等
2020-11-24,4190,2243,2273,4516,新市,三等
2020-11-25,4190,2275,2236,4511,新市,三等
2020-11-26,4190,2460,2249,4709,新市,三等
2020-11-27,4190,3153,2684,5837,新市,三等
2020-11-28,4190,2414,2106,4520,新市,三等
2020-11-29,4190,2332,2850,5182,新市,三等
2020-11-30,4190,2312,2389,4701,新市,三等
2020-12-01,4190,2262,2243,4505,新市,三等
2020-12-02,4190,2241,2187,4428,新市,三等
2020-12-03,4190,2330,2233,4563,新市,三等
2020-12-04,4190,3239,2839,6078,新市,三等
2020-12-05,4190,2820,2344,5164,新市,三等
2020-12-06,4190,2649,3237,5886,新市,三等
2020-12-07,4190,2579,2482,5061,新市,三等
2020-12-08,4190,2351,2301,4652,新市,三等
2020-12-09,4190,2348,2270,4618,新市,三等
2020-12-10,4190,2440,2362,4802,新市,三等
2020-12-11,4190,3253,2840,6093,新市,三等
2020-12-12,4190,2768,2356,5124,新市,三等
2020-12-13,4190,2821,3254,6075,新市,三等
2020-12-14,4190,2488,2512,5000,新市,三等
2020-12-15,4190,2352,2277,4629,新市,三等
2020-12-16,4190,2348,2325,4673,新市,三等
2020-12-17,4190,2527,2344,4871,新市,三等
2020-12-18,4190,3229,2807,6036,新市,三等
2020-12-19,4190,2671,2207,4878,新市,三等
2020-12-20,4190,2566,3138,5704,新市,三等
2020-12-21,4190,2426,2453,4879,新市,三等
2020-12-22,4190,2384,2392,4776,新市,三等
2020-12-23,4190,2274,2215,4489,新市,三等
2020-12-24,4190,2579,2378,4957,新市,三等
2020-12-25,4190,3185,2823,6008,新市,三等
2020-12-26,4190,2436,2167,4603,新市,三等
2020-12-27,4190,2230,2700,4930,新市,三等
2020-12-28,4190,2344,2368,4712,新市,三等
2020-12-29,4190,2268,2233,4501,新市,三等
2020-12-30,4190,2443,2319,4762,新市,三等
2020-12-31,4190,3414,2668,6082,新市,三等
2020-01-01,4200,5190,4283,9473,永康,二等
2020-01-02,4200,2930,3026,5956,永康,二等
2020-01-03,4200,3917,3389,7306,永康,二等
2020-01-04,4200,3197,3070,6267,永康,二等
2020-01-05,4200,3307,4064,7371,永康,二等
2020-01-06,4200,2949,3239,6188,永康,二等
2020-01-07,4200,2670,2841,5511,永康,二等
2020-01-08,4200,2910,2923,5833,永康,二等
2020-01-09,4200,2902,3008,5910,永康,二等
2020-01-10,4200,4984,3975,8959,永康,二等
2020-01-11,4200,4569,3965,8534,永康,二等
2020-01-12,4200,4194,4606,8800,永康,二等
2020-01-13,4200,2909,3400,6309,永康,二等
2020-01-14,4200,2581,2678,5259,永康,二等
2020-01-15,4200,2750,2743,5493,永康,二等
2020-01-16,4200,2883,2977,5860,永康,二等
2020-01-17,4200,4068,3117,7185,永康,二等
2020-01-18,4200,3255,3060,6315,永康,二等
2020-01-19,4200,3577,3604,7181,永康,二等
2020-01-20,4200,2849,3091,5940,永康,二等
2020-01-21,4200,2744,2723,5467,永康,二等
2020-01-22,4200,3471,3163,6634,永康,二等
2020-01-23,4200,3961,2922,6883,永康,二等
2020-01-24,4200,3997,3007,7004,永康,二等
2020-01-25,4200,3941,3652,7593,永康,二等
2020-01-26,4200,3737,3738,7475,永康,二等
2020-01-27,4200,3500,4026,7526,永康,二等
2020-01-28,4200,2712,3185,5897,永康,二等
2020-01-29,4200,2586,3038,5624,永康,二等
2020-01-30,4200,2362,2390,4752,永康,二等
2020-01-31,4200,2622,2437,5059,永康,二等
2020-02-01,4200,2221,2041,4262,永康,二等
2020-02-02,4200,2836,2827,5663,永康,二等
2020-02-03,4200,2348,2426,4774,永康,二等
2020-02-04,4200,2238,2073,4311,永康,二等
2020-02-05,4200,2431,2351,4782,永康,二等
2020-02-06,4200,2312,2301,4613,永康,二等
2020-02-07,4200,3937,2617,6554,永康,二等
2020-02-08,4200,9172,2775,11947,永康,二等
2020-02-09,4200,4073,3530,7603,永康,二等
2020-02-10,4200,2741,2690,5431,永康,二等
2020-02-11,4200,2590,2247,4837,永康,二等
2020-02-12,4200,2798,2205,5003,永康,二等
2020-02-13,4200,2603,2193,4796,永康,二等
2020-02-14,4200,3435,2619,6054,永康,二等
2020-02-15,4200,3121,2602,5723,永康,二等
2020-02-16,4200,3167,3475,6642,永康,二等
2020-02-17,4200,2231,2421,4652,永康,二等
2020-02-18,4200,2177,2078,4255,永康,二等
2020-02-19,4200,2174,2142,4316,永康,二等
2020-02-20,4200,2228,2198,4426,永康,二等
2020-02-21,4200,2819,2527,5346,永康,二等
2020-02-22,4200,2667,2434,5101,永康,二等
2020-02-23,4200,2930,3086,6016,永康,二等
2020-02-24,4200,2272,2427,4699,永康,二等
2020-02-25,4200,2405,2448,4853,永康,二等
2020-02-26,4200,2443,2501,4944,永康,二等
2020-02-27,4200,3219,3058,6277,永康,二等
2020-02-28,4200,3000,2592,5592,永康,二等
2020-02-29,4200,3026,2510,5536,永康,二等
2020-03-01,4200,2980,3580,6560,永康,二等
2020-03-02,4200,2549,2773,5322,永康,二等
2020-03-03,4200,2353,2410,4763,永康,二等
2020-03-04,4200,2423,2398,4821,永康,二等
2020-03-05,4200,2630,2592,5222,永康,二等
2020-03-06,4200,3900,3301,7201,永康,二等
2020-03-07,4200,2948,2611,5559,永康,二等
2020-03-08,4200,3264,3805,7069,永康,二等
2020-03-09,4200,2693,2997,5690,永康,二等
2020-03-10,4200,2373,2388,4761,永康,二等
2020-03-11,4200,2645,2593,5238,永康,二等
2020-03-12,4200,2648,2599,5247,永康,二等
2020-03-13,4200,3937,3301,7238,永康,二等
2020-03-14,4200,2561,2313,4874,永康,二等
2020-03-15,4200,3141,3676,6817,永康,二等
2020-03-16,4200,2663,2845,5508,永康,二等
2020-03-17,4200,2365,2450,4815,永康,二等
2020-03-18,4200,2358,2444,4802,永康,二等
2020-03-19,4200,2411,2375,4786,永康,二等
2020-03-20,4200,3589,3037,6626,永康,二等
2020-03-21,4200,2306,2008,4314,永康,二等
2020-03-22,4200,2454,3046,5500,永康,二等
2020-03-23,4200,2343,2560,4903,永康,二等
2020-03-24,4200,2167,2174,4341,永康,二等
2020-03-25,4200,2225,2328,4553,永康,二等
2020-03-26,4200,2245,2254,4499,永康,二等
2020-03-27,4200,3272,2759,6031,永康,二等
2020-03-28,4200,2108,1805,3913,永康,二等
2020-03-29,4200,2186,2647,4833,永康,二等
2020-03-30,4200,2228,2535,4763,永康,二等
2020-03-31,4200,2218,2232,4450,永康,二等
2020-04-01,4200,3502,2974,6476,永康,二等
2020-04-02,4200,2607,2022,4629,永康,二等
2020-04-03,4200,2267,1927,4194,永康,二等
2020-04-04,4200,1758,1738,3496,永康,二等
2020-04-05,4200,2333,3163,5496,永康,二等
2020-04-06,4200,2302,2645,4947,永康,二等
2020-04-07,4200,2061,2173,4234,永康,二等
2020-04-08,4200,2139,2197,4336,永康,二等
2020-04-09,4200,2156,2212,4368,永康,二等
2020-04-10,4200,3104,2572,5676,永康,二等
2020-04-11,4200,2103,1916,4019,永康,二等
2020-04-12,4200,2289,2692,4981,永康,二等
2020-04-13,4200,2271,2622,4893,永康,二等
2020-04-14,4200,2157,2228,4385,永康,二等
2020-04-15,4200,2195,2258,4453,永康,二等
2020-04-16,4200,2269,2331,4600,永康,二等
2020-04-17,4200,3298,2901,6199,永康,二等
2020-04-18,4200,2376,1990,4366,永康,二等
2020-04-19,4200,2393,2787,5180,永康,二等
2020-04-20,4200,2225,2482,4707,永康,二等
2020-04-21,4200,1963,2056,4019,永康,二等
2020-04-22,4200,1918,2084,4002,永康,二等
2020-04-23,4200,2066,2110,4176,永康,二等
2020-04-24,4200,3118,2601,5719,永康,二等
2020-04-25,4200,1733,1527,3260,永康,二等
2020-04-26,4200,1791,2367,4158,永康,二等
2020-04-27,4200,2115,2368,4483,永康,二等
2020-04-28,4200,2036,2099,4135,永康,二等
2020-04-29,4200,2023,2128,4151,永康,二等
2020-04-30,4200,2442,2300,4742,永康,二等
2020-05-01,4200,3419,2736,6155,永康,二等
2020-05-02,4200,1948,1915,3863,永康,二等
2020-05-03,4200,2285,2868,5153,永康,二等
2020-05-04,4200,2315,2558,4873,永康,二等
2020-05-05,4200,2244,2240,4484,永康,二等
2020-05-06,4200,2378,2403,4781,永康,二等
2020-05-07,4200,2554,2448,5002,永康,二等
2020-05-08,4200,4059,3284,7343,永康,二等
2020-05-09,4200,2805,2217,5022,永康,二等
2020-05-10,4200,2910,3780,6690,永康,二等
2020-05-11,4200,2476,2862,5338,永康,二等
2020-05-12,4200,2191,2329,4520,永康,二等
2020-05-13,4200,2317,2379,4696,永康,二等
2020-05-14,4200,2394,2456,4850,永康,二等
2020-05-15,4200,3467,2990,6457,永康,二等
2020-05-16,4200,2423,2278,4701,永康,二等
2020-05-17,4200,2690,3065,5755,永康,二等
2020-05-18,4200,2422,2662,5084,永康,二等
2020-05-19,4200,2165,2190,4355,永康,二等
2020-05-20,4200,4112,2442,6554,永康,二等
2020-05-21,4200,2356,2143,4499,永康,二等
2020-05-22,4200,3113,2654,5767,永康,二等
2020-05-23,4200,2361,2018,4379,永康,二等
2020-05-24,4200,2692,3222,5914,永康,二等
2020-05-25,4200,2528,2837,5365,永康,二等
2020-05-26,4200,2165,2196,4361,永康,二等
2020-05-27,4200,2199,2265,4464,永康,二等
2020-05-28,4200,2318,2359,4677,永康,二等
2020-05-29,4200,3630,3089,6719,永康,二等
2020-05-30,4200,2767,2363,5130,永康,二等
2020-05-31,4200,2879,3306,6185,永康,二等
2020-06-01,4200,2472,2856,5328,永康,二等
2020-06-02,4200,2242,2297,4539,永康,二等
2020-06-03,4200,2502,2358,4860,永康,二等
2020-06-04,4200,2264,2290,4554,永康,二等
2020-06-05,4200,4117,3213,7330,永康,二等
2020-06-06,4200,3386,2923,6309,永康,二等
2020-06-07,4200,3402,4119,7521,永康,二等
2020-06-08,4200,2537,3011,5548,永康,二等
2020-06-09,4200,2320,2404,4724,永康,二等
2020-06-10,4200,2447,2557,5004,永康,二等
2020-06-11,4200,2595,2554,5149,永康,二等
2020-06-12,4200,3876,3500,7376,永康,二等
2020-06-13,4200,3263,2730,5993,永康,二等
2020-06-14,4200,3312,3917,7229,永康,二等
2020-06-15,4200,2644,3067,5711,永康,二等
2020-06-16,4200,2380,2448,4828,永康,二等
2020-06-17,4200,2450,2471,4921,永康,二等
2020-06-18,4200,2507,2462,4969,永康,二等
2020-06-19,4200,3026,2817,5843,永康,二等
2020-06-20,4200,2905,2984,5889,永康,二等
2020-06-21,4200,3425,3155,6580,永康,二等
2020-06-22,4200,2481,2670,5151,永康,二等
2020-06-23,4200,2394,2365,4759,永康,二等
2020-06-24,4200,4052,3301,7353,永康,二等
2020-06-25,4200,3344,2844,6188,永康,二等
2020-06-26,4200,3118,2879,5997,永康,二等
2020-06-27,4200,3034,2991,6025,永康,二等
2020-06-28,4200,3162,3825,6987,永康,二等
2020-06-29,4200,2695,3004,5699,永康,二等
2020-06-30,4200,2256,2352,4608,永康,二等
2020-07-01,4200,2397,2439,4836,永康,二等
2020-07-02,4200,2230,2329,4559,永康,二等
2020-07-03,4200,3072,2923,5995,永康,二等
2020-07-04,4200,2891,2493,5384,永康,二等
2020-07-05,4200,3006,3257,6263,永康,二等
2020-07-06,4200,2597,2679,5276,永康,二等
2020-07-07,4200,2553,2619,5172,永康,二等
2020-07-08,4200,2602,2483,5085,永康,二等
2020-07-09,4200,2530,2579,5109,永康,二等
2020-07-10,4200,3186,2978,6164,永康,二等
2020-07-11,4200,3187,2803,5990,永康,二等
2020-07-12,4200,3431,3780,7211,永康,二等
2020-07-13,4200,2524,2466,4990,永康,二等
2020-07-14,4200,2501,2677,5178,永康,二等
2020-07-15,4200,2398,2235,4633,永康,二等
2020-07-16,4200,2359,2271,4630,永康,二等
2020-07-17,4200,3094,2903,5997,永康,二等
2020-07-18,4200,3052,2692,5744,永康,二等
2020-07-19,4200,3064,3498,6562,永康,二等
2020-07-20,4200,2513,2672,5185,永康,二等
2020-07-21,4200,2413,2380,4793,永康,二等
2020-07-22,4200,2578,2556,5134,永康,二等
2020-07-23,4200,2479,2455,4934,永康,二等
2020-07-24,4200,3236,2913,6149,永康,二等
2020-07-25,4200,2923,2593,5516,永康,二等
2020-07-26,4200,3022,3262,6284,永康,二等
2020-07-27,4200,2512,2733,5245,永康,二等
2020-07-28,4200,2291,2306,4597,永康,二等
2020-07-29,4200,2348,2357,4705,永康,二等
2020-07-30,4200,2232,2281,4513,永康,二等
2020-07-31,4200,2983,2890,5873,永康,二等
2020-08-01,4200,2766,2388,5154,永康,二等
2020-08-02,4200,2747,3111,5858,永康,二等
2020-08-03,4200,2370,2476,4846,永康,二等
2020-08-04,4200,2153,2238,4391,永康,二等
2020-08-05,4200,2571,2486,5057,永康,二等
2020-08-06,4200,2653,2623,5276,永康,二等
2020-08-07,4200,3470,3100,6570,永康,二等
2020-08-08,4200,3387,3093,6480,永康,二等
2020-08-09,4200,3614,3969,7583,永康,二等
2020-08-10,4200,2676,2964,5640,永康,二等
2020-08-11,4200,2339,2381,4720,永康,二等
2020-08-12,4200,2458,2539,4997,永康,二等
2020-08-13,4200,2592,2649,5241,永康,二等
2020-08-14,4200,3301,3078,6379,永康,二等
2020-08-15,4200,3292,2934,6226,永康,二等
2020-08-16,4200,3407,3838,7245,永康,二等
2020-08-17,4200,2617,2923,5540,永康,二等
2020-08-18,4200,2632,2576,5208,永康,二等
2020-08-19,4200,2530,2446,4976,永康,二等
2020-08-20,4200,2596,2624,5220,永康,二等
2020-08-21,4200,3152,2934,6086,永康,二等
2020-08-22,4200,3128,2733,5861,永康,二等
2020-08-23,4200,3072,3283,6355,永康,二等
2020-08-24,4200,2549,2781,5330,永康,二等
2020-08-25,4200,2465,2414,4879,永康,二等
2020-08-26,4200,1931,1983,3914,永康,二等
2020-08-27,4200,2027,2033,4060,永康,二等
2020-08-28,4200,2864,2639,5503,永康,二等
2020-08-29,4200,2830,2380,5210,永康,二等
2020-08-30,4200,2380,2642,5022,永康,二等
2020-08-31,4200,2636,2775,5411,永康,二等
2020-09-01,4200,2458,2541,4999,永康,二等
2020-09-02,4200,2481,2523,5004,永康,二等
2020-09-03,4200,2383,2526,4909,永康,二等
2020-09-04,4200,3672,3079,6751,永康,二等
2020-09-05,4200,3322,2740,6062,永康,二等
2020-09-06,4200,3204,3549,6753,永康,二等
2020-09-07,4200,2785,2986,5771,永康,二等
2020-09-08,4200,2704,2547,5251,永康,二等
2020-09-09,4200,3447,2920,6367,永康,二等
2020-09-10,4200,2799,2696,5495,永康,二等
2020-09-11,4200,3578,3326,6904,永康,二等
2020-09-12,4200,3201,2864,6065,永康,二等
2020-09-13,4200,3780,4126,7906,永康,二等
2020-09-14,4200,2712,3014,5726,永康,二等
2020-09-15,4200,2506,2604,5110,永康,二等
2020-09-16,4200,2628,2582,5210,永康,二等
2020-09-17,4200,2738,2693,5431,永康,二等
2020-09-18,4200,4108,3448,7556,永康,二等
2020-09-19,4200,3473,3039,6512,永康,二等
2020-09-20,4200,3697,4496,8193,永康,二等
2020-09-21,4200,2877,2996,5873,永康,二等
2020-09-22,4200,2614,2573,5187,永康,二等
2020-09-23,4200,2645,2659,5304,永康,二等
2020-09-24,4200,2630,2554,5184,永康,二等
2020-09-25,4200,3553,2875,6428,永康,二等
2020-09-26,4200,3109,2804,5913,永康,二等
2020-09-27,4200,2985,3704,6689,永康,二等
2020-09-28,4200,2726,2790,5516,永康,二等
2020-09-29,4200,2585,2574,5159,永康,二等
2020-09-30,4200,4634,3895,8529,永康,二等
2020-10-01,4200,4095,3069,7164,永康,二等
2020-10-02,4200,3500,3373,6873,永康,二等
2020-10-03,4200,3372,3407,6779,永康,二等
2020-10-04,4200,3571,4795,8366,永康,二等
2020-10-05,4200,2962,3213,6175,永康,二等
2020-10-06,4200,2634,2642,5276,永康,二等
2020-10-07,4200,2700,2696,5396,永康,二等
2020-10-08,4200,4216,3573,7789,永康,二等
2020-10-09,4200,3722,3290,7012,永康,二等
2020-10-10,4200,3576,3396,6972,永康,二等
2020-10-11,4200,3756,4591,8347,永康,二等
2020-10-12,4200,2974,2974,5948,永康,二等
2020-10-13,4200,2565,2638,5203,永康,二等
2020-10-14,4200,2582,2632,5214,永康,二等
2020-10-15,4200,2743,2743,5486,永康,二等
2020-10-16,4200,4067,3372,7439,永康,二等
2020-10-17,4200,3872,3745,7617,永康,二等
2020-10-18,4200,3751,4545,8296,永康,二等
2020-10-19,4200,2771,3078,5849,永康,二等
2020-10-20,4200,2638,2676,5314,永康,二等
2020-10-21,4200,2604,2602,5206,永康,二等
2020-10-22,4200,2649,2670,5319,永康,二等
2020-10-23,4200,3554,3467,7021,永康,二等
2020-10-24,4200,3603,3055,6658,永康,二等
2020-10-25,4200,3491,3992,7483,永康,二等
2020-10-26,4200,2797,2987,5784,永康,二等
2020-10-27,4200,2554,2554,5108,永康,二等
2020-10-28,4200,2520,2537,5057,永康,二等
2020-10-29,4200,2567,2546,5113,永康,二等
2020-10-30,4200,4147,3375,7522,永康,二等
2020-10-31,4200,3247,2710,5957,永康,二等
2020-11-01,4200,3303,4140,7443,永康,二等
2020-11-02,4200,2711,2966,5677,永康,二等
2020-11-03,4200,2334,2464,4798,永康,二等
2020-11-04,4200,2474,2394,4868,永康,二等
2020-11-05,4200,2748,2681,5429,永康,二等
2020-11-06,4200,4181,3462,7643,永康,二等
2020-11-07,4200,3070,3108,6178,永康,二等
2020-11-08,4200,3775,4592,8367,永康,二等
2020-11-09,4200,2710,2911,5621,永康,二等
2020-11-10,4200,2553,2584,5137,永康,二等
2020-11-11,4200,2628,2638,5266,永康,二等
2020-11-12,4200,2697,2750,5447,永康,二等
2020-11-13,4200,4358,3551,7909,永康,二等
2020-11-14,4200,3663,3181,6844,永康,二等
2020-11-15,4200,3801,4779,8580,永康,二等
2020-11-16,4200,2782,2966,5748,永康,二等
2020-11-17,4200,2649,2739,5388,永康,二等
2020-11-18,4200,2564,2642,5206,永康,二等
2020-11-19,4200,2633,2642,5275,永康,二等
2020-11-20,4200,4339,3616,7955,永康,二等
2020-11-21,4200,3353,3022,6375,永康,二等
2020-11-22,4200,3627,4277,7904,永康,二等
2020-11-23,4200,2890,3080,5970,永康,二等
2020-11-24,4200,2572,2636,5208,永康,二等
2020-11-25,4200,2635,2609,5244,永康,二等
2020-11-26,4200,2586,2671,5257,永康,二等
2020-11-27,4200,4237,3452,7689,永康,二等
2020-11-28,4200,3499,3772,7271,永康,二等
2020-11-29,4200,3347,4274,7621,永康,二等
2020-11-30,4200,2716,2968,5684,永康,二等
2020-12-01,4200,2499,2587,5086,永康,二等
2020-12-02,4200,2480,2491,4971,永康,二等
2020-12-03,4200,2538,2588,5126,永康,二等
2020-12-04,4200,4328,3651,7979,永康,二等
2020-12-05,4200,3848,3584,7432,永康,二等
2020-12-06,4200,4056,4759,8815,永康,二等
2020-12-07,4200,3053,3183,6236,永康,二等
2020-12-08,4200,2623,2697,5320,永康,二等
2020-12-09,4200,2597,2521,5118,永康,二等
2020-12-10,4200,2660,2642,5302,永康,二等
2020-12-11,4200,4172,3553,7725,永康,二等
2020-12-12,4200,3721,3201,6922,永康,二等
2020-12-13,4200,4018,4700,8718,永康,二等
2020-12-14,4200,3004,3263,6267,永康,二等
2020-12-15,4200,2637,2654,5291,永康,二等
2020-12-16,4200,2618,2650,5268,永康,二等
2020-12-17,4200,2722,2728,5450,永康,二等
2020-12-18,4200,4321,3618,7939,永康,二等
2020-12-19,4200,3500,3219,6719,永康,二等
2020-12-20,4200,3640,4500,8140,永康,二等
2020-12-21,4200,2838,2969,5807,永康,二等
2020-12-22,4200,2623,2646,5269,永康,二等
2020-12-23,4200,2574,2600,5174,永康,二等
2020-12-24,4200,2755,2816,5571,永康,二等
2020-12-25,4200,4077,3633,7710,永康,二等
2020-12-26,4200,3445,2976,6421,永康,二等
2020-12-27,4200,3343,4015,7358,永康,二等
2020-12-28,4200,2873,3098,5971,永康,二等
2020-12-29,4200,2808,2600,5408,永康,二等
2020-12-30,4200,3377,2586,5963,永康,二等
2020-12-31,4200,5025,4221,9246,永康,二等
2020-01-01,4210,2947,3767,6714,大橋,簡易
2020-01-02,4210,4090,3971,8061,大橋,簡易
2020-01-03,4210,4990,3938,8928,大橋,簡易
2020-01-04,4210,3577,2875,6452,大橋,簡易
2020-01-05,4210,2407,3445,5852,大橋,簡易
2020-01-06,4210,3901,4073,7974,大橋,簡易
2020-01-07,4210,3983,3832,7815,大橋,簡易
2020-01-08,4210,3893,3734,7627,大橋,簡易
2020-01-09,4210,4356,3900,8256,大橋,簡易
2020-01-10,4210,6930,4565,11495,大橋,簡易
2020-01-11,4210,4040,3333,7373,大橋,簡易
2020-01-12,4210,3133,3781,6914,大橋,簡易
2020-01-13,4210,3833,3849,7682,大橋,簡易
2020-01-14,4210,3542,3377,6919,大橋,簡易
2020-01-15,4210,3642,3357,6999,大橋,簡易
2020-01-16,4210,3760,3373,7133,大橋,簡易
2020-01-17,4210,3661,3325,6986,大橋,簡易
2020-01-18,4210,2843,2625,5468,大橋,簡易
2020-01-19,4210,2367,2583,4950,大橋,簡易
2020-01-20,4210,3223,3196,6419,大橋,簡易
2020-01-21,4210,3162,2969,6131,大橋,簡易
2020-01-22,4210,3301,3166,6467,大橋,簡易
2020-01-23,4210,3053,2241,5294,大橋,簡易
2020-01-24,4210,2285,1544,3829,大橋,簡易
2020-01-25,4210,1799,1816,3615,大橋,簡易
2020-01-26,4210,1822,1930,3752,大橋,簡易
2020-01-27,4210,2163,2474,4637,大橋,簡易
2020-01-28,4210,2056,2304,4360,大橋,簡易
2020-01-29,4210,2283,2590,4873,大橋,簡易
2020-01-30,4210,2418,2429,4847,大橋,簡易
2020-01-31,4210,2534,2520,5054,大橋,簡易
2020-02-01,4210,1952,1786,3738,大橋,簡易
2020-02-02,4210,1832,2111,3943,大橋,簡易
2020-02-03,4210,2756,2806,5562,大橋,簡易
2020-02-04,4210,2691,2694,5385,大橋,簡易
2020-02-05,4210,2707,2681,5388,大橋,簡易
2020-02-06,4210,2480,2548,5028,大橋,簡易
2020-02-07,4210,3096,2901,5997,大橋,簡易
2020-02-08,4210,2310,2015,4325,大橋,簡易
2020-02-09,4210,2006,2301,4307,大橋,簡易
2020-02-10,4210,2686,2792,5478,大橋,簡易
2020-02-11,4210,2618,2597,5215,大橋,簡易
2020-02-12,4210,2559,2595,5154,大橋,簡易
2020-02-13,4210,2484,2479,4963,大橋,簡易
2020-02-14,4210,2921,2773,5694,大橋,簡易
2020-02-15,4210,2462,2076,4538,大橋,簡易
2020-02-16,4210,1921,2277,4198,大橋,簡易
2020-02-17,4210,2518,2482,5000,大橋,簡易
2020-02-18,4210,2493,2519,5012,大橋,簡易
2020-02-19,4210,2463,2464,4927,大橋,簡易
2020-02-20,4210,2506,2516,5022,大橋,簡易
2020-02-21,4210,2986,2755,5741,大橋,簡易
2020-02-22,4210,2298,1988,4286,大橋,簡易
2020-02-23,4210,1890,2208,4098,大橋,簡易
2020-02-24,4210,2673,2777,5450,大橋,簡易
2020-02-25,4210,3028,2944,5972,大橋,簡易
2020-02-26,4210,3104,2939,6043,大橋,簡易
2020-02-27,4210,3758,3469,7227,大橋,簡易
2020-02-28,4210,2595,2174,4769,大橋,簡易
2020-02-29,4210,2016,2359,4375,大橋,簡易
2020-03-01,4210,2250,3515,5765,大橋,簡易
2020-03-02,4210,3625,3697,7322,大橋,簡易
2020-03-03,4210,3517,3399,6916,大橋,簡易
2020-03-04,4210,3546,3376,6922,大橋,簡易
2020-03-05,4210,3684,3270,6954,大橋,簡易
2020-03-06,4210,5414,3898,9312,大橋,簡易
2020-03-07,4210,2752,2351,5103,大橋,簡易
2020-03-08,4210,2252,3546,5798,大橋,簡易
2020-03-09,4210,3541,3785,7326,大橋,簡易
2020-03-10,4210,3491,3311,6802,大橋,簡易
2020-03-11,4210,3553,3423,6976,大橋,簡易
2020-03-12,4210,3650,3321,6971,大橋,簡易
2020-03-13,4210,5455,3848,9303,大橋,簡易
2020-03-14,4210,2504,2124,4628,大橋,簡易
2020-03-15,4210,2272,3754,6026,大橋,簡易
2020-03-16,4210,3547,3733,7280,大橋,簡易
2020-03-17,4210,3453,3292,6745,大橋,簡易
2020-03-18,4210,3438,3293,6731,大橋,簡易
2020-03-19,4210,3475,3157,6632,大橋,簡易
2020-03-20,4210,5020,3456,8476,大橋,簡易
2020-03-21,4210,2203,1907,4110,大橋,簡易
2020-03-22,4210,1817,3131,4948,大橋,簡易
2020-03-23,4210,3272,3516,6788,大橋,簡易
2020-03-24,4210,3204,3093,6297,大橋,簡易
2020-03-25,4210,3258,3100,6358,大橋,簡易
2020-03-26,4210,3315,3034,6349,大橋,簡易
2020-03-27,4210,4424,3332,7756,大橋,簡易
2020-03-28,4210,2148,1836,3984,大橋,簡易
2020-03-29,4210,1674,2562,4236,大橋,簡易
2020-03-30,4210,3257,3258,6515,大橋,簡易
2020-03-31,4210,4798,3000,7798,大橋,簡易
2020-04-01,4210,4104,3035,7139,大橋,簡易
2020-04-02,4210,2347,1790,4137,大橋,簡易
2020-04-03,4210,1998,1719,3717,大橋,簡易
2020-04-04,4210,1300,1436,2736,大橋,簡易
2020-04-05,4210,1591,3781,5372,大橋,簡易
2020-04-06,4210,3267,3630,6897,大橋,簡易
2020-04-07,4210,2973,2904,5877,大橋,簡易
2020-04-08,4210,3083,3015,6098,大橋,簡易
2020-04-09,4210,3222,2967,6189,大橋,簡易
2020-04-10,4210,4392,3186,7578,大橋,簡易
2020-04-11,4210,2131,1881,4012,大橋,簡易
2020-04-12,4210,1755,2706,4461,大橋,簡易
2020-04-13,4210,3154,3323,6477,大橋,簡易
2020-04-14,4210,3126,3038,6164,大橋,簡易
2020-04-15,4210,3146,3070,6216,大橋,簡易
2020-04-16,4210,3393,3078,6471,大橋,簡易
2020-04-17,4210,4994,3421,8415,大橋,簡易
2020-04-18,4210,2242,1893,4135,大橋,簡易
2020-04-19,4210,1730,3055,4785,大橋,簡易
2020-04-20,4210,3050,3325,6375,大橋,簡易
2020-04-21,4210,2941,2888,5829,大橋,簡易
2020-04-22,4210,2919,2802,5721,大橋,簡易
2020-04-23,4210,3039,2847,5886,大橋,簡易
2020-04-24,4210,4042,3042,7084,大橋,簡易
2020-04-25,4210,1842,1568,3410,大橋,簡易
2020-04-26,4210,1412,2207,3619,大橋,簡易
2020-04-27,4210,3095,3239,6334,大橋,簡易
2020-04-28,4210,3074,2984,6058,大橋,簡易
2020-04-29,4210,2596,2462,5058,大橋,簡易
2020-04-30,4210,3471,2993,6464,大橋,簡易
2020-05-01,4210,4557,2790,7347,大橋,簡易
2020-05-02,4210,2142,1822,3964,大橋,簡易
2020-05-03,4210,1844,3396,5240,大橋,簡易
2020-05-04,4210,3206,3521,6727,大橋,簡易
2020-05-05,4210,3164,3067,6231,大橋,簡易
2020-05-06,4210,3175,3074,6249,大橋,簡易
2020-05-07,4210,3507,3099,6606,大橋,簡易
2020-05-08,4210,5473,3538,9011,大橋,簡易
2020-05-09,4210,2673,1919,4592,大橋,簡易
2020-05-10,4210,1878,3868,5746,大橋,簡易
2020-05-11,4210,3368,3813,7181,大橋,簡易
2020-05-12,4210,3228,3212,6440,大橋,簡易
2020-05-13,4210,3309,3227,6536,大橋,簡易
2020-05-14,4210,3422,3237,6659,大橋,簡易
2020-05-15,4210,4942,3563,8505,大橋,簡易
2020-05-16,4210,2302,1993,4295,大橋,簡易
2020-05-17,4210,1851,3079,4930,大橋,簡易
2020-05-18,4210,3291,3579,6870,大橋,簡易
2020-05-19,4210,3061,3089,6150,大橋,簡易
2020-05-20,4210,3180,3075,6255,大橋,簡易
2020-05-21,4210,3369,3087,6456,大橋,簡易
2020-05-22,4210,4754,3105,7859,大橋,簡易
2020-05-23,4210,2273,1895,4168,大橋,簡易
2020-05-24,4210,2033,3411,5444,大橋,簡易
2020-05-25,4210,3334,3678,7012,大橋,簡易
2020-05-26,4210,3133,3111,6244,大橋,簡易
2020-05-27,4210,3211,3019,6230,大橋,簡易
2020-05-28,4210,3516,3194,6710,大橋,簡易
2020-05-29,4210,5298,3665,8963,大橋,簡易
2020-05-30,4210,2603,2144,4747,大橋,簡易
2020-05-31,4210,2037,3560,5597,大橋,簡易
2020-06-01,4210,3392,3656,7048,大橋,簡易
2020-06-02,4210,3245,3216,6461,大橋,簡易
2020-06-03,4210,3386,3290,6676,大橋,簡易
2020-06-04,4210,3447,3155,6602,大橋,簡易
2020-06-05,4210,5417,3587,9004,大橋,簡易
2020-06-06,4210,3022,2486,5508,大橋,簡易
2020-06-07,4210,2079,3728,5807,大橋,簡易
2020-06-08,4210,3355,3686,7041,大橋,簡易
2020-06-09,4210,3361,3361,6722,大橋,簡易
2020-06-10,4210,3527,3504,7031,大橋,簡易
2020-06-11,4210,3665,3425,7090,大橋,簡易
2020-06-12,4210,4990,3758,8748,大橋,簡易
2020-06-13,4210,2975,2671,5646,大橋,簡易
2020-06-14,4210,2315,3520,5835,大橋,簡易
2020-06-15,4210,3468,3766,7234,大橋,簡易
2020-06-16,4210,3314,3329,6643,大橋,簡易
2020-06-17,4210,3219,3259,6478,大橋,簡易
2020-06-18,4210,3379,3222,6601,大橋,簡易
2020-06-19,4210,3951,3472,7423,大橋,簡易
2020-06-20,4210,3560,2972,6532,大橋,簡易
2020-06-21,4210,2674,3345,6019,大橋,簡易
2020-06-22,4210,3365,3448,6813,大橋,簡易
2020-06-23,4210,3591,3304,6895,大橋,簡易
2020-06-24,4210,5415,3701,9116,大橋,簡易
2020-06-25,4210,3264,2539,5803,大橋,簡易
2020-06-26,4210,2737,2538,5275,大橋,簡易
2020-06-27,4210,2113,2437,4550,大橋,簡易
2020-06-28,4210,2059,3877,5936,大橋,簡易
2020-06-29,4210,3437,3744,7181,大橋,簡易
2020-06-30,4210,3207,3167,6374,大橋,簡易
2020-07-01,4210,3107,3133,6240,大橋,簡易
2020-07-02,4210,3347,3226,6573,大橋,簡易
2020-07-03,4210,4173,3420,7593,大橋,簡易
2020-07-04,4210,2862,2308,5170,大橋,簡易
2020-07-05,4210,2082,2246,4328,大橋,簡易
2020-07-06,4210,3081,3025,6106,大橋,簡易
2020-07-07,4210,3079,3053,6132,大橋,簡易
2020-07-08,4210,2960,2878,5838,大橋,簡易
2020-07-09,4210,2932,2793,5725,大橋,簡易
2020-07-10,4210,3504,3179,6683,大橋,簡易
2020-07-11,4210,2556,2228,4784,大橋,簡易
2020-07-12,4210,2128,2631,4759,大橋,簡易
2020-07-13,4210,3013,3125,6138,大橋,簡易
2020-07-14,4210,3034,3069,6103,大橋,簡易
2020-07-15,4210,2785,2758,5543,大橋,簡易
2020-07-16,4210,2876,2794,5670,大橋,簡易
2020-07-17,4210,3420,3139,6559,大橋,簡易
2020-07-18,4210,2601,2222,4823,大橋,簡易
2020-07-19,4210,2121,2614,4735,大橋,簡易
2020-07-20,4210,2790,2911,5701,大橋,簡易
2020-07-21,4210,2792,2792,5584,大橋,簡易
2020-07-22,4210,2767,2817,5584,大橋,簡易
2020-07-23,4210,2821,2851,5672,大橋,簡易
2020-07-24,4210,3368,3214,6582,大橋,簡易
2020-07-25,4210,2587,2291,4878,大橋,簡易
2020-07-26,4210,2267,2489,4756,大橋,簡易
2020-07-27,4210,2931,2971,5902,大橋,簡易
2020-07-28,4210,2801,2779,5580,大橋,簡易
2020-07-29,4210,2739,2811,5550,大橋,簡易
2020-07-30,4210,2891,2851,5742,大橋,簡易
2020-07-31,4210,3462,3161,6623,大橋,簡易
2020-08-01,4210,2542,2198,4740,大橋,簡易
2020-08-02,4210,2050,2305,4355,大橋,簡易
2020-08-03,4210,2835,2931,5766,大橋,簡易
2020-08-04,4210,2770,2739,5509,大橋,簡易
2020-08-05,4210,3094,2986,6080,大橋,簡易
2020-08-06,4210,3152,2955,6107,大橋,簡易
2020-08-07,4210,3870,3247,7117,大橋,簡易
2020-08-08,4210,2887,2290,5177,大橋,簡易
2020-08-09,4210,2038,2781,4819,大橋,簡易
2020-08-10,4210,3048,3117,6165,大橋,簡易
2020-08-11,4210,2877,2828,5705,大橋,簡易
2020-08-12,4210,2991,2886,5877,大橋,簡易
2020-08-13,4210,3070,3032,6102,大橋,簡易
2020-08-14,4210,3680,3200,6880,大橋,簡易
2020-08-15,4210,2812,2498,5310,大橋,簡易
2020-08-16,4210,2127,2493,4620,大橋,簡易
2020-08-17,4210,3113,3105,6218,大橋,簡易
2020-08-18,4210,3107,3100,6207,大橋,簡易
2020-08-19,4210,3123,2950,6073,大橋,簡易
2020-08-20,4210,3164,3025,6189,大橋,簡易
2020-08-21,4210,3684,3192,6876,大橋,簡易
2020-08-22,4210,2724,2396,5120,大橋,簡易
2020-08-23,4210,2092,2461,4553,大橋,簡易
2020-08-24,4210,2951,3005,5956,大橋,簡易
2020-08-25,4210,2834,2946,5780,大橋,簡易
2020-08-26,4210,2472,2464,4936,大橋,簡易
2020-08-27,4210,2479,2434,4913,大橋,簡易
2020-08-28,4210,3087,2846,5933,大橋,簡易
2020-08-29,4210,2472,2173,4645,大橋,簡易
2020-08-30,4210,1636,1861,3497,大橋,簡易
2020-08-31,4210,3100,3058,6158,大橋,簡易
2020-09-01,4210,2988,2847,5835,大橋,簡易
2020-09-02,4210,2846,2852,5698,大橋,簡易
2020-09-03,4210,3017,2972,5989,大橋,簡易
2020-09-04,4210,3700,3242,6942,大橋,簡易
2020-09-05,4210,2632,2349,4981,大橋,簡易
2020-09-06,4210,2216,2633,4849,大橋,簡易
2020-09-07,4210,3260,3328,6588,大橋,簡易
2020-09-08,4210,3131,3170,6301,大橋,簡易
2020-09-09,4210,3204,3761,6965,大橋,簡易
2020-09-10,4210,3830,3249,7079,大橋,簡易
2020-09-11,4210,4194,3476,7670,大橋,簡易
2020-09-12,4210,2986,2796,5782,大橋,簡易
2020-09-13,4210,2637,3966,6603,大橋,簡易
2020-09-14,4210,3746,3953,7699,大橋,簡易
2020-09-15,4210,3663,3587,7250,大橋,簡易
2020-09-16,4210,3825,3692,7517,大橋,簡易
2020-09-17,4210,3865,3574,7439,大橋,簡易
2020-09-18,4210,5986,3963,9949,大橋,簡易
2020-09-19,4210,3296,2702,5998,大橋,簡易
2020-09-20,4210,2503,4381,6884,大橋,簡易
2020-09-21,4210,3798,4031,7829,大橋,簡易
2020-09-22,4210,3597,3516,7113,大橋,簡易
2020-09-23,4210,3862,3724,7586,大橋,簡易
2020-09-24,4210,3811,3607,7418,大橋,簡易
2020-09-25,4210,4277,3757,8034,大橋,簡易
2020-09-26,4210,3929,2975,6904,大橋,簡易
2020-09-27,4210,2510,3402,5912,大橋,簡易
2020-09-28,4210,3730,3867,7597,大橋,簡易
2020-09-29,4210,4060,3623,7683,大橋,簡易
2020-09-30,4210,7053,4276,11329,大橋,簡易
2020-10-01,4210,3894,2746,6640,大橋,簡易
2020-10-02,4210,3005,2780,5785,大橋,簡易
2020-10-03,4210,2383,2533,4916,大橋,簡易
2020-10-04,4210,2539,5483,8022,大橋,簡易
2020-10-05,4210,3771,4271,8042,大橋,簡易
2020-10-06,4210,3695,3585,7280,大橋,簡易
2020-10-07,4210,3848,3663,7511,大橋,簡易
2020-10-08,4210,5976,4137,10113,大橋,簡易
2020-10-09,4210,4090,3075,7165,大橋,簡易
2020-10-10,4210,2402,2307,4709,大橋,簡易
2020-10-11,4210,2478,4461,6939,大橋,簡易
2020-10-12,4210,3788,4162,7950,大橋,簡易
2020-10-13,4210,3594,3510,7104,大橋,簡易
2020-10-14,4210,3752,3584,7336,大橋,簡易
2020-10-15,4210,3763,3578,7341,大橋,簡易
2020-10-16,4210,5886,4112,9998,大橋,簡易
2020-10-17,4210,3292,2860,6152,大橋,簡易
2020-10-18,4210,2682,4121,6803,大橋,簡易
2020-10-19,4210,3792,4033,7825,大橋,簡易
2020-10-20,4210,3659,3603,7262,大橋,簡易
2020-10-21,4210,3744,3640,7384,大橋,簡易
2020-10-22,4210,3904,3605,7509,大橋,簡易
2020-10-23,4210,6066,4137,10203,大橋,簡易
2020-10-24,4210,3327,2859,6186,大橋,簡易
2020-10-25,4210,2575,4256,6831,大橋,簡易
2020-10-26,4210,3774,4049,7823,大橋,簡易
2020-10-27,4210,3666,3653,7319,大橋,簡易
2020-10-28,4210,3683,3427,7110,大橋,簡易
2020-10-29,4210,3902,3618,7520,大橋,簡易
2020-10-30,4210,6045,4146,10191,大橋,簡易
2020-10-31,4210,3214,2687,5901,大橋,簡易
2020-11-01,4210,2650,4436,7086,大橋,簡易
2020-11-02,4210,3680,3989,7669,大橋,簡易
2020-11-03,4210,3549,3535,7084,大橋,簡易
2020-11-04,4210,3681,3629,7310,大橋,簡易
2020-11-05,4210,3810,3543,7353,大橋,簡易
2020-11-06,4210,5445,3971,9416,大橋,簡易
2020-11-07,4210,2860,2451,5311,大橋,簡易
2020-11-08,4210,2388,3739,6127,大橋,簡易
2020-11-09,4210,3673,3918,7591,大橋,簡易
2020-11-10,4210,3576,3591,7167,大橋,簡易
2020-11-11,4210,3699,3534,7233,大橋,簡易
2020-11-12,4210,3957,3596,7553,大橋,簡易
2020-11-13,4210,6410,4300,10710,大橋,簡易
2020-11-14,4210,3308,2857,6165,大橋,簡易
2020-11-15,4210,2516,4484,7000,大橋,簡易
2020-11-16,4210,3779,4198,7977,大橋,簡易
2020-11-17,4210,3718,3655,7373,大橋,簡易
2020-11-18,4210,3777,3653,7430,大橋,簡易
2020-11-19,4210,3868,3589,7457,大橋,簡易
2020-11-20,4210,5942,4250,10192,大橋,簡易
2020-11-21,4210,3376,2809,6185,大橋,簡易
2020-11-22,4210,2585,4246,6831,大橋,簡易
2020-11-23,4210,3667,3922,7589,大橋,簡易
2020-11-24,4210,3641,3627,7268,大橋,簡易
2020-11-25,4210,3752,3634,7386,大橋,簡易
2020-11-26,4210,3888,3721,7609,大橋,簡易
2020-11-27,4210,5968,4087,10055,大橋,簡易
2020-11-28,4210,3228,2796,6024,大橋,簡易
2020-11-29,4210,2621,4307,6928,大橋,簡易
2020-11-30,4210,3679,3961,7640,大橋,簡易
2020-12-01,4210,3560,3620,7180,大橋,簡易
2020-12-02,4210,3593,3519,7112,大橋,簡易
2020-12-03,4210,3947,3473,7420,大橋,簡易
2020-12-04,4210,5941,4060,10001,大橋,簡易
2020-12-05,4210,4148,3774,7922,大橋,簡易
2020-12-06,4210,3549,5227,8776,大橋,簡易
2020-12-07,4210,3694,4120,7814,大橋,簡易
2020-12-08,4210,3687,3594,7281,大橋,簡易
2020-12-09,4210,3730,3589,7319,大橋,簡易
2020-12-10,4210,3770,3511,7281,大橋,簡易
2020-12-11,4210,5120,4271,9391,大橋,簡易
2020-12-12,4210,3975,3053,7028,大橋,簡易
2020-12-13,4210,2788,4014,6802,大橋,簡易
2020-12-14,4210,3713,3981,7694,大橋,簡易
2020-12-15,4210,3652,3641,7293,大橋,簡易
2020-12-16,4210,3756,3707,7463,大橋,簡易
2020-12-17,4210,3985,3608,7593,大橋,簡易
2020-12-18,4210,6175,4144,10319,大橋,簡易
2020-12-19,4210,3392,2846,6238,大橋,簡易
2020-12-20,4210,2828,4604,7432,大橋,簡易
2020-12-21,4210,3657,4053,7710,大橋,簡易
2020-12-22,4210,3636,3654,7290,大橋,簡易
2020-12-23,4210,3651,3600,7251,大橋,簡易
2020-12-24,4210,3894,3663,7557,大橋,簡易
2020-12-25,4210,5589,4125,9714,大橋,簡易
2020-12-26,4210,3115,2718,5833,大橋,簡易
2020-12-27,4210,2524,4005,6529,大橋,簡易
2020-12-28,4210,3717,4006,7723,大橋,簡易
2020-12-29,4210,3651,3530,7181,大橋,簡易
2020-12-30,4210,4021,3681,7702,大橋,簡易
2020-12-31,4210,6307,4076,10383,大橋,簡易
2020-01-01,4220,30845,30978,61823,臺南,一等
2020-01-02,4220,23139,23437,46576,臺南,一等
2020-01-03,4220,27806,27710,55516,臺南,一等
2020-01-04,4220,26253,26467,52720,臺南,一等
2020-01-05,4220,28376,29041,57417,臺南,一等
2020-01-06,4220,23205,22809,46014,臺南,一等
2020-01-07,4220,20868,21196,42064,臺南,一等
2020-01-08,4220,21904,22081,43985,臺南,一等
2020-01-09,4220,24209,24832,49041,臺南,一等
2020-01-10,4220,38542,35771,74313,臺南,一等
2020-01-11,4220,32121,33091,65212,臺南,一等
2020-01-12,4220,33397,36653,70050,臺南,一等
2020-01-13,4220,27194,26416,53610,臺南,一等
2020-01-14,4220,23523,23678,47201,臺南,一等
2020-01-15,4220,23410,23433,46843,臺南,一等
2020-01-16,4220,26553,26345,52898,臺南,一等
2020-01-17,4220,29008,29383,58391,臺南,一等
2020-01-18,4220,28609,29518,58127,臺南,一等
2020-01-19,4220,29695,30217,59912,臺南,一等
2020-01-20,4220,26655,25946,52601,臺南,一等
2020-01-21,4220,26065,26912,52977,臺南,一等
2020-01-22,4220,29516,30743,60259,臺南,一等
2020-01-23,4220,29712,27257,56969,臺南,一等
2020-01-24,4220,23436,21082,44518,臺南,一等
2020-01-25,4220,26207,29373,55580,臺南,一等
2020-01-26,4220,30160,32118,62278,臺南,一等
2020-01-27,4220,33747,35472,69219,臺南,一等
2020-01-28,4220,28583,29415,57998,臺南,一等
2020-01-29,4220,26362,26882,53244,臺南,一等
2020-01-30,4220,22991,23950,46941,臺南,一等
2020-01-31,4220,23982,24571,48553,臺南,一等
2020-02-01,4220,21973,22315,44288,臺南,一等
2020-02-02,4220,23017,22526,45543,臺南,一等
2020-02-03,4220,21665,22359,44024,臺南,一等
2020-02-04,4220,20144,20611,40755,臺南,一等
2020-02-05,4220,21002,21565,42567,臺南,一等
2020-02-06,4220,21286,21795,43081,臺南,一等
2020-02-07,4220,25564,26365,51929,臺南,一等
2020-02-08,4220,23494,24813,48307,臺南,一等
2020-02-09,4220,27066,26735,53801,臺南,一等
2020-02-10,4220,23243,22740,45983,臺南,一等
2020-02-11,4220,21441,21277,42718,臺南,一等
2020-02-12,4220,20679,21153,41832,臺南,一等
2020-02-13,4220,20229,20785,41014,臺南,一等
2020-02-14,4220,24294,24717,49011,臺南,一等
2020-02-15,4220,23218,23448,46666,臺南,一等
2020-02-16,4220,25429,25949,51378,臺南,一等
2020-02-17,4220,20171,19766,39937,臺南,一等
2020-02-18,4220,18879,18960,37839,臺南,一等
2020-02-19,4220,19212,19640,38852,臺南,一等
2020-02-20,4220,19628,20109,39737,臺南,一等
2020-02-21,4220,23169,23918,47087,臺南,一等
2020-02-22,4220,21431,21958,43389,臺南,一等
2020-02-23,4220,23526,23290,46816,臺南,一等
2020-02-24,4220,20373,20133,40506,臺南,一等
2020-02-25,4220,18321,18681,37002,臺南,一等
2020-02-26,4220,19044,19724,38768,臺南,一等
2020-02-27,4220,24995,26796,51791,臺南,一等
2020-02-28,4220,24458,26481,50939,臺南,一等
2020-02-29,4220,22133,22233,44366,臺南,一等
2020-03-01,4220,26757,27372,54129,臺南,一等
2020-03-02,4220,19874,19580,39454,臺南,一等
2020-03-03,4220,17341,17380,34721,臺南,一等
2020-03-04,4220,17072,17477,34549,臺南,一等
2020-03-05,4220,18137,18835,36972,臺南,一等
2020-03-06,4220,26049,26337,52386,臺南,一等
2020-03-07,4220,21592,22236,43828,臺南,一等
2020-03-08,4220,25338,25750,51088,臺南,一等
2020-03-09,4220,19824,19834,39658,臺南,一等
2020-03-10,4220,17373,17588,34961,臺南,一等
2020-03-11,4220,18301,18522,36823,臺南,一等
2020-03-12,4220,18626,19305,37931,臺南,一等
2020-03-13,4220,27132,27617,54749,臺南,一等
2020-03-14,4220,20432,20919,41351,臺南,一等
2020-03-15,4220,25928,26646,52574,臺南,一等
2020-03-16,4220,20053,19879,39932,臺南,一等
2020-03-17,4220,17282,17501,34783,臺南,一等
2020-03-18,4220,17174,17241,34415,臺南,一等
2020-03-19,4220,16999,17376,34375,臺南,一等
2020-03-20,4220,23938,24284,48222,臺南,一等
2020-03-21,4220,17487,17515,35002,臺南,一等
2020-03-22,4220,19720,20817,40537,臺南,一等
2020-03-23,4220,17396,17662,35058,臺南,一等
2020-03-24,4220,15506,15492,30998,臺南,一等
2020-03-25,4220,15378,15521,30899,臺南,一等
2020-03-26,4220,15577,15498,31075,臺南,一等
2020-03-27,4220,21851,21928,43779,臺南,一等
2020-03-28,4220,15813,16320,32133,臺南,一等
2020-03-29,4220,17934,17787,35721,臺南,一等
2020-03-30,4220,17258,17382,34640,臺南,一等
2020-03-31,4220,16824,17386,34210,臺南,一等
2020-04-01,4220,24804,25159,49963,臺南,一等
2020-04-02,4220,20478,19884,40362,臺南,一等
2020-04-03,4220,17733,16556,34289,臺南,一等
2020-04-04,4220,15042,14221,29263,臺南,一等
2020-04-05,4220,19973,21233,41206,臺南,一等
2020-04-06,4220,18301,18783,37084,臺南,一等
2020-04-07,4220,14273,17169,31442,臺南,一等
2020-04-08,4220,14310,15345,29655,臺南,一等
2020-04-09,4220,14839,15335,30174,臺南,一等
2020-04-10,4220,19655,19589,39244,臺南,一等
2020-04-11,4220,15666,15887,31553,臺南,一等
2020-04-12,4220,17194,17644,34838,臺南,一等
2020-04-13,4220,16304,16413,32717,臺南,一等
2020-04-14,4220,14879,14889,29768,臺南,一等
2020-04-15,4220,15240,15363,30603,臺南,一等
2020-04-16,4220,15835,16510,32345,臺南,一等
2020-04-17,4220,22658,23066,45724,臺南,一等
2020-04-18,4220,17465,17682,35147,臺南,一等
2020-04-19,4220,19093,19688,38781,臺南,一等
2020-04-20,4220,16155,16455,32610,臺南,一等
2020-04-21,4220,13887,13976,27863,臺南,一等
2020-04-22,4220,13404,13492,26896,臺南,一等
2020-04-23,4220,14310,14499,28809,臺南,一等
2020-04-24,4220,20146,19995,40141,臺南,一等
2020-04-25,4220,13163,12953,26116,臺南,一等
2020-04-26,4220,14495,15501,29996,臺南,一等
2020-04-27,4220,15295,15698,30993,臺南,一等
2020-04-28,4220,14085,14441,28526,臺南,一等
2020-04-29,4220,13730,13886,27616,臺南,一等
2020-04-30,4220,16834,18195,35029,臺南,一等
2020-05-01,4220,22038,21559,43597,臺南,一等
2020-05-02,4220,15144,14865,30009,臺南,一等
2020-05-03,4220,18817,19910,38727,臺南,一等
2020-05-04,4220,16937,17272,34209,臺南,一等
2020-05-05,4220,15517,15899,31416,臺南,一等
2020-05-06,4220,15879,16140,32019,臺南,一等
2020-05-07,4220,17212,17445,34657,臺南,一等
2020-05-08,4220,27453,26383,53836,臺南,一等
2020-05-09,4220,20121,18780,38901,臺南,一等
2020-05-10,4220,21963,25525,47488,臺南,一等
2020-05-11,4220,19101,20106,39207,臺南,一等
2020-05-12,4220,16134,16277,32411,臺南,一等
2020-05-13,4220,16371,16560,32931,臺南,一等
2020-05-14,4220,16739,17346,34085,臺南,一等
2020-05-15,4220,24580,24840,49420,臺南,一等
2020-05-16,4220,18862,19349,38211,臺南,一等
2020-05-17,4220,21254,21948,43202,臺南,一等
2020-05-18,4220,18262,18141,36403,臺南,一等
2020-05-19,4220,14981,15212,30193,臺南,一等
2020-05-20,4220,15356,15730,31086,臺南,一等
2020-05-21,4220,15277,15589,30866,臺南,一等
2020-05-22,4220,20716,20878,41594,臺南,一等
2020-05-23,4220,17216,17552,34768,臺南,一等
2020-05-24,4220,23741,24850,48591,臺南,一等
2020-05-25,4220,18797,18730,37527,臺南,一等
2020-05-26,4220,15016,15600,30616,臺南,一等
2020-05-27,4220,15257,15273,30530,臺南,一等
2020-05-28,4220,16821,17174,33995,臺南,一等
2020-05-29,4220,25254,25372,50626,臺南,一等
2020-05-30,4220,22047,22547,44594,臺南,一等
2020-05-31,4220,24613,25544,50157,臺南,一等
2020-06-01,4220,19011,19212,38223,臺南,一等
2020-06-02,4220,16517,16893,33410,臺南,一等
2020-06-03,4220,16805,16938,33743,臺南,一等
2020-06-04,4220,17571,18053,35624,臺南,一等
2020-06-05,4220,27123,26208,53331,臺南,一等
2020-06-06,4220,25323,25976,51299,臺南,一等
2020-06-07,4220,26699,28765,55464,臺南,一等
2020-06-08,4220,20193,19840,40033,臺南,一等
2020-06-09,4220,17632,18073,35705,臺南,一等
2020-06-10,4220,18407,18418,36825,臺南,一等
2020-06-11,4220,18976,19445,38421,臺南,一等
2020-06-12,4220,25822,26844,52666,臺南,一等
2020-06-13,4220,25036,26155,51191,臺南,一等
2020-06-14,4220,28377,28796,57173,臺南,一等
2020-06-15,4220,21484,21015,42499,臺南,一等
2020-06-16,4220,18573,18681,37254,臺南,一等
2020-06-17,4220,18398,18722,37120,臺南,一等
2020-06-18,4220,19094,19451,38545,臺南,一等
2020-06-19,4220,22481,23508,45989,臺南,一等
2020-06-20,4220,22532,23557,46089,臺南,一等
2020-06-21,4220,25783,26006,51789,臺南,一等
2020-06-22,4220,20654,20535,41189,臺南,一等
2020-06-23,4220,19909,20385,40294,臺南,一等
2020-06-24,4220,28938,29559,58497,臺南,一等
2020-06-25,4220,27946,28964,56910,臺南,一等
2020-06-26,4220,29609,28763,58372,臺南,一等
2020-06-27,4220,27426,27596,55022,臺南,一等
2020-06-28,4220,28035,29320,57355,臺南,一等
2020-06-29,4220,22966,23071,46037,臺南,一等
2020-06-30,4220,19471,19509,38980,臺南,一等
2020-07-01,4220,19120,19145,38265,臺南,一等
2020-07-02,4220,19214,19604,38818,臺南,一等
2020-07-03,4220,24719,25392,50111,臺南,一等
2020-07-04,4220,23228,24021,47249,臺南,一等
2020-07-05,4220,24154,24583,48737,臺南,一等
2020-07-06,4220,21825,21327,43152,臺南,一等
2020-07-07,4220,20906,21107,42013,臺南,一等
2020-07-08,4220,20527,20896,41423,臺南,一等
2020-07-09,4220,20709,23475,44184,臺南,一等
2020-07-10,4220,28137,27388,55525,臺南,一等
2020-07-11,4220,25715,26329,52044,臺南,一等
2020-07-12,4220,28166,27632,55798,臺南,一等
2020-07-13,4220,21987,22343,44330,臺南,一等
2020-07-14,4220,23482,23314,46796,臺南,一等
2020-07-15,4220,21588,22140,43728,臺南,一等
2020-07-16,4220,21717,22543,44260,臺南,一等
2020-07-17,4220,27587,28382,55969,臺南,一等
2020-07-18,4220,25900,26834,52734,臺南,一等
2020-07-19,4220,29046,29280,58326,臺南,一等
2020-07-20,4220,23911,23691,47602,臺南,一等
2020-07-21,4220,22359,22165,44524,臺南,一等
2020-07-22,4220,22390,22842,45232,臺南,一等
2020-07-23,4220,22809,23557,46366,臺南,一等
2020-07-24,4220,27583,29682,57265,臺南,一等
2020-07-25,4220,26476,27824,54300,臺南,一等
2020-07-26,4220,28058,27985,56043,臺南,一等
2020-07-27,4220,23823,22642,46465,臺南,一等
2020-07-28,4220,21343,21351,42694,臺南,一等
2020-07-29,4220,21340,21306,42646,臺南,一等
2020-07-30,4220,21604,21878,43482,臺南,一等
2020-07-31,4220,25937,27243,53180,臺南,一等
2020-08-01,4220,24851,25472,50323,臺南,一等
2020-08-02,4220,25839,25195,51034,臺南,一等
2020-08-03,4220,20360,20295,40655,臺南,一等
2020-08-04,4220,18395,18859,37254,臺南,一等
2020-08-05,4220,21142,22031,43173,臺南,一等
2020-08-06,4220,21788,22272,44060,臺南,一等
2020-08-07,4220,28411,28168,56579,臺南,一等
2020-08-08,4220,24599,24235,48834,臺南,一等
2020-08-09,4220,28288,30539,58827,臺南,一等
2020-08-10,4220,23460,24007,47467,臺南,一等
2020-08-11,4220,20494,20543,41037,臺南,一等
2020-08-12,4220,22333,22810,45143,臺南,一等
2020-08-13,4220,23220,23450,46670,臺南,一等
2020-08-14,4220,28745,29457,58202,臺南,一等
2020-08-15,4220,29125,30388,59513,臺南,一等
2020-08-16,4220,32287,32378,64665,臺南,一等
2020-08-17,4220,25748,24865,50613,臺南,一等
2020-08-18,4220,23083,23556,46639,臺南,一等
2020-08-19,4220,21901,22810,44711,臺南,一等
2020-08-20,4220,23275,23905,47180,臺南,一等
2020-08-21,4220,28123,29176,57299,臺南,一等
2020-08-22,4220,26925,27646,54571,臺南,一等
2020-08-23,4220,28430,28231,56661,臺南,一等
2020-08-24,4220,24167,24308,48475,臺南,一等
2020-08-25,4220,23468,23945,47413,臺南,一等
2020-08-26,4220,19501,19633,39134,臺南,一等
2020-08-27,4220,20057,19987,40044,臺南,一等
2020-08-28,4220,25168,26720,51888,臺南,一等
2020-08-29,4220,24958,25731,50689,臺南,一等
2020-08-30,4220,21517,23101,44618,臺南,一等
2020-08-31,4220,21308,20854,42162,臺南,一等
2020-09-01,4220,19437,20105,39542,臺南,一等
2020-09-02,4220,18702,19690,38392,臺南,一等
2020-09-03,4220,20965,21938,42903,臺南,一等
2020-09-04,4220,26896,27079,53975,臺南,一等
2020-09-05,4220,26033,26471,52504,臺南,一等
2020-09-06,4220,28035,29972,58007,臺南,一等
2020-09-07,4220,22532,22610,45142,臺南,一等
2020-09-08,4220,20077,20892,40969,臺南,一等
2020-09-09,4220,20917,21445,42362,臺南,一等
2020-09-10,4220,21680,22202,43882,臺南,一等
2020-09-11,4220,28509,28495,57004,臺南,一等
2020-09-12,4220,27349,28124,55473,臺南,一等
2020-09-13,4220,32304,33273,65577,臺南,一等
2020-09-14,4220,21770,21071,42841,臺南,一等
2020-09-15,4220,18830,18875,37705,臺南,一等
2020-09-16,4220,19036,19427,38463,臺南,一等
2020-09-17,4220,19839,20176,40015,臺南,一等
2020-09-18,4220,29422,29719,59141,臺南,一等
2020-09-19,4220,28309,28878,57187,臺南,一等
2020-09-20,4220,31443,31848,63291,臺南,一等
2020-09-21,4220,21477,21708,43185,臺南,一等
2020-09-22,4220,19314,19422,38736,臺南,一等
2020-09-23,4220,19424,19857,39281,臺南,一等
2020-09-24,4220,20055,20358,40413,臺南,一等
2020-09-25,4220,23868,24362,48230,臺南,一等
2020-09-26,4220,24411,25489,49900,臺南,一等
2020-09-27,4220,28126,28348,56474,臺南,一等
2020-09-28,4220,20163,20667,40830,臺南,一等
2020-09-29,4220,19993,20651,40644,臺南,一等
2020-09-30,4220,34321,34051,68372,臺南,一等
2020-10-01,4220,30808,30170,60978,臺南,一等
2020-10-02,4220,28980,29092,58072,臺南,一等
2020-10-03,4220,29157,29022,58179,臺南,一等
2020-10-04,4220,31674,35615,67289,臺南,一等
2020-10-05,4220,22882,24178,47060,臺南,一等
2020-10-06,4220,19231,19725,38956,臺南,一等
2020-10-07,4220,19666,20425,40091,臺南,一等
2020-10-08,4220,29052,30921,59973,臺南,一等
2020-10-09,4220,30395,33442,63837,臺南,一等
2020-10-10,4220,31766,37155,68921,臺南,一等
2020-10-11,4220,37947,33178,71125,臺南,一等
2020-10-12,4220,22148,22179,44327,臺南,一等
2020-10-13,4220,19359,19510,38869,臺南,一等
2020-10-14,4220,19556,19942,39498,臺南,一等
2020-10-15,4220,20411,20885,41296,臺南,一等
2020-10-16,4220,29390,29526,58916,臺南,一等
2020-10-17,4220,28924,30681,59605,臺南,一等
2020-10-18,4220,33521,33853,67374,臺南,一等
2020-10-19,4220,21781,21538,43319,臺南,一等
2020-10-20,4220,19524,19732,39256,臺南,一等
2020-10-21,4220,19839,20151,39990,臺南,一等
2020-10-22,4220,20852,21405,42257,臺南,一等
2020-10-23,4220,29760,30124,59884,臺南,一等
2020-10-24,4220,28605,29277,57882,臺南,一等
2020-10-25,4220,30870,31959,62829,臺南,一等
2020-10-26,4220,21874,22128,44002,臺南,一等
2020-10-27,4220,19959,19586,39545,臺南,一等
2020-10-28,4220,19091,19447,38538,臺南,一等
2020-10-29,4220,19820,20638,40458,臺南,一等
2020-10-30,4220,29655,30909,60564,臺南,一等
2020-10-31,4220,28147,29714,57861,臺南,一等
2020-11-01,4220,30318,29091,59409,臺南,一等
2020-11-02,4220,20089,20594,40683,臺南,一等
2020-11-03,4220,18555,18992,37547,臺南,一等
2020-11-04,4220,19062,19920,38982,臺南,一等
2020-11-05,4220,20317,21245,41562,臺南,一等
2020-11-06,4220,28978,28934,57912,臺南,一等
2020-11-07,4220,26167,26357,52524,臺南,一等
2020-11-08,4220,30629,31679,62308,臺南,一等
2020-11-09,4220,20288,20824,41112,臺南,一等
2020-11-10,4220,19462,19732,39194,臺南,一等
2020-11-11,4220,20173,20619,40792,臺南,一等
2020-11-12,4220,20851,21541,42392,臺南,一等
2020-11-13,4220,31519,32423,63942,臺南,一等
2020-11-14,4220,30082,30842,60924,臺南,一等
2020-11-15,4220,34951,35438,70389,臺南,一等
2020-11-16,4220,22723,23138,45861,臺南,一等
2020-11-17,4220,20174,20263,40437,臺南,一等
2020-11-18,4220,19880,20303,40183,臺南,一等
2020-11-19,4220,20839,21670,42509,臺南,一等
2020-11-20,4220,31042,31224,62266,臺南,一等
2020-11-21,4220,28603,29614,58217,臺南,一等
2020-11-22,4220,33691,34095,67786,臺南,一等
2020-11-23,4220,22541,22781,45322,臺南,一等
2020-11-24,4220,19681,19605,39286,臺南,一等
2020-11-25,4220,19760,20231,39991,臺南,一等
2020-11-26,4220,20651,21753,42404,臺南,一等
2020-11-27,4220,31554,31933,63487,臺南,一等
2020-11-28,4220,30753,31842,62595,臺南,一等
2020-11-29,4220,34068,34159,68227,臺南,一等
2020-11-30,4220,21968,22100,44068,臺南,一等
2020-12-01,4220,18889,18799,37688,臺南,一等
2020-12-02,4220,18900,19083,37983,臺南,一等
2020-12-03,4220,19916,20559,40475,臺南,一等
2020-12-04,4220,30458,30533,60991,臺南,一等
2020-12-05,4220,30870,31626,62496,臺南,一等
2020-12-06,4220,34227,35104,69331,臺南,一等
2020-12-07,4220,22240,22872,45112,臺南,一等
2020-12-08,4220,19268,19721,38989,臺南,一等
2020-12-09,4220,19296,19769,39065,臺南,一等
2020-12-10,4220,20353,21093,41446,臺南,一等
2020-12-11,4220,31330,31451,62781,臺南,一等
2020-12-12,4220,30842,32617,63459,臺南,一等
2020-12-13,4220,35087,35587,70674,臺南,一等
2020-12-14,4220,23068,23549,46617,臺南,一等
2020-12-15,4220,19513,19485,38998,臺南,一等
2020-12-16,4220,19976,20478,40454,臺南,一等
2020-12-17,4220,20912,21613,42525,臺南,一等
2020-12-18,4220,31493,32231,63724,臺南,一等
2020-12-19,4220,31431,32099,63530,臺南,一等
2020-12-20,4220,34871,34527,69398,臺南,一等
2020-12-21,4220,21895,22246,44141,臺南,一等
2020-12-22,4220,19509,20101,39610,臺南,一等
2020-12-23,4220,20154,20672,40826,臺南,一等
2020-12-24,4220,21440,22229,43669,臺南,一等
2020-12-25,4220,30302,31297,61599,臺南,一等
2020-12-26,4220,27880,28997,56877,臺南,一等
2020-12-27,4220,30659,30135,60794,臺南,一等
2020-12-28,4220,21455,22126,43581,臺南,一等
2020-12-29,4220,19751,20084,39835,臺南,一等
2020-12-30,4220,21354,21903,43257,臺南,一等
2020-12-31,4220,32183,35163,67346,臺南,一等
2020-01-01,4250,2034,3993,6027,保安,三等
2020-01-02,4250,1592,1928,3520,保安,三等
2020-01-03,4250,2250,1662,3912,保安,三等
2020-01-04,4250,1411,1406,2817,保安,三等
2020-01-05,4250,1539,2096,3635,保安,三等
2020-01-06,4250,1328,1666,2994,保安,三等
2020-01-07,4250,1381,1389,2770,保安,三等
2020-01-08,4250,1370,1332,2702,保安,三等
2020-01-09,4250,1993,1530,3523,保安,三等
2020-01-10,4250,2723,1609,4332,保安,三等
2020-01-11,4250,1711,1616,3327,保安,三等
2020-01-12,4250,1694,1758,3452,保安,三等
2020-01-13,4250,1158,1346,2504,保安,三等
2020-01-14,4250,1153,1192,2345,保安,三等
2020-01-15,4250,1001,1065,2066,保安,三等
2020-01-16,4250,1230,1313,2543,保安,三等
2020-01-17,4250,1255,2055,3310,保安,三等
2020-01-18,4250,1236,1310,2546,保安,三等
2020-01-19,4250,1505,1608,3113,保安,三等
2020-01-20,4250,1159,1268,2427,保安,三等
2020-01-21,4250,1228,1248,2476,保安,三等
2020-01-22,4250,1183,1318,2501,保安,三等
2020-01-23,4250,1115,1088,2203,保安,三等
2020-01-24,4250,1244,1211,2455,保安,三等
2020-01-25,4250,1982,2171,4153,保安,三等
2020-01-26,4250,2110,2085,4195,保安,三等
2020-01-27,4250,2439,2486,4925,保安,三等
2020-01-28,4250,1527,1572,3099,保安,三等
2020-01-29,4250,1285,1403,2688,保安,三等
2020-01-30,4250,1058,1093,2151,保安,三等
2020-01-31,4250,1077,1213,2290,保安,三等
2020-02-01,4250,1019,1043,2062,保安,三等
2020-02-02,4250,1151,1379,2530,保安,三等
2020-02-03,4250,950,1021,1971,保安,三等
2020-02-04,4250,940,974,1914,保安,三等
2020-02-05,4250,875,939,1814,保安,三等
2020-02-06,4250,1052,1105,2157,保安,三等
2020-02-07,4250,1143,2105,3248,保安,三等
2020-02-08,4250,1103,7188,8291,保安,三等
2020-02-09,4250,1436,2157,3593,保安,三等
2020-02-10,4250,968,1427,2395,保安,三等
2020-02-11,4250,965,1232,2197,保安,三等
2020-02-12,4250,929,1456,2385,保安,三等
2020-02-13,4250,927,1323,2250,保安,三等
2020-02-14,4250,1203,1694,2897,保安,三等
2020-02-15,4250,1127,1236,2363,保安,三等
2020-02-16,4250,1542,1579,3121,保安,三等
2020-02-17,4250,871,1014,1885,保安,三等
2020-02-18,4250,913,976,1889,保安,三等
2020-02-19,4250,848,897,1745,保安,三等
2020-02-20,4250,1020,1063,2083,保安,三等
2020-02-21,4250,1108,1111,2219,保安,三等
2020-02-22,4250,1101,1238,2339,保安,三等
2020-02-23,4250,1186,1345,2531,保安,三等
2020-02-24,4250,952,1007,1959,保安,三等
2020-02-25,4250,907,907,1814,保安,三等
2020-02-26,4250,872,919,1791,保安,三等
2020-02-27,4250,1094,1170,2264,保安,三等
2020-02-28,4250,1196,1245,2441,保安,三等
2020-02-29,4250,1251,2120,3371,保安,三等
2020-03-01,4250,1387,2050,3437,保安,三等
2020-03-02,4250,1179,1472,2651,保安,三等
2020-03-03,4250,1176,1183,2359,保安,三等
2020-03-04,4250,1165,1147,2312,保安,三等
2020-03-05,4250,1417,1169,2586,保安,三等
2020-03-06,4250,2687,1447,4134,保安,三等
2020-03-07,4250,1370,1286,2656,保安,三等
2020-03-08,4250,1403,2293,3696,保安,三等
2020-03-09,4250,1188,1603,2791,保安,三等
2020-03-10,4250,1082,1154,2236,保安,三等
2020-03-11,4250,1288,1246,2534,保安,三等
2020-03-12,4250,1476,1235,2711,保安,三等
2020-03-13,4250,2741,1416,4157,保安,三等
2020-03-14,4250,1160,1108,2268,保安,三等
2020-03-15,4250,1398,2457,3855,保安,三等
2020-03-16,4250,1207,1651,2858,保安,三等
2020-03-17,4250,1113,1221,2334,保安,三等
2020-03-18,4250,1152,1137,2289,保安,三等
2020-03-19,4250,1359,1067,2426,保安,三等
2020-03-20,4250,2460,1258,3718,保安,三等
2020-03-21,4250,986,955,1941,保安,三等
2020-03-22,4250,1053,1879,2932,保安,三等
2020-03-23,4250,1068,1489,2557,保安,三等
2020-03-24,4250,1032,1076,2108,保安,三等
2020-03-25,4250,1011,1018,2029,保安,三等
2020-03-26,4250,1320,1064,2384,保安,三等
2020-03-27,4250,2141,1181,3322,保安,三等
2020-03-28,4250,975,1000,1975,保安,三等
2020-03-29,4250,982,1505,2487,保安,三等
2020-03-30,4250,1023,1363,2386,保安,三等
2020-03-31,4250,1140,1082,2222,保安,三等
2020-04-01,4250,2793,1116,3909,保安,三等
2020-04-02,4250,1304,939,2243,保安,三等
2020-04-03,4250,912,814,1726,保安,三等
2020-04-04,4250,689,817,1506,保安,三等
2020-04-05,4250,882,2347,3229,保安,三等
2020-04-06,4250,1062,1673,2735,保安,三等
2020-04-07,4250,924,1001,1925,保安,三等
2020-04-08,4250,979,989,1968,保安,三等
2020-04-09,4250,1188,947,2135,保安,三等
2020-04-10,4250,1960,1051,3011,保安,三等
2020-04-11,4250,910,927,1837,保安,三等
2020-04-12,4250,1031,1601,2632,保安,三等
2020-04-13,4250,960,1369,2329,保安,三等
2020-04-14,4250,1034,1024,2058,保安,三等
2020-04-15,4250,1030,1021,2051,保安,三等
2020-04-16,4250,1267,988,2255,保安,三等
2020-04-17,4250,2202,1211,3413,保安,三等
2020-04-18,4250,998,970,1968,保安,三等
2020-04-19,4250,1001,1727,2728,保安,三等
2020-04-20,4250,994,1358,2352,保安,三等
2020-04-21,4250,928,956,1884,保安,三等
2020-04-22,4250,939,884,1823,保安,三等
2020-04-23,4250,1144,911,2055,保安,三等
2020-04-24,4250,1694,1003,2697,保安,三等
2020-04-25,4250,624,609,1233,保安,三等
2020-04-26,4250,691,1197,1888,保安,三等
2020-04-27,4250,955,1238,2193,保安,三等
2020-04-28,4250,909,995,1904,保安,三等
2020-04-29,4250,917,885,1802,保安,三等
2020-04-30,4250,1429,919,2348,保安,三等
2020-05-01,4250,2264,1095,3359,保安,三等
2020-05-02,4250,999,926,1925,保安,三等
2020-05-03,4250,942,1861,2803,保安,三等
2020-05-04,4250,985,1549,2534,保安,三等
2020-05-05,4250,960,1020,1980,保安,三等
2020-05-06,4250,1047,1042,2089,保安,三等
2020-05-07,4250,1340,1120,2460,保安,三等
2020-05-08,4250,2750,1318,4068,保安,三等
2020-05-09,4250,1048,939,1987,保安,三等
2020-05-10,4250,1068,2106,3174,保安,三等
2020-05-11,4250,1050,1621,2671,保安,三等
2020-05-12,4250,1059,1112,2171,保安,三等
2020-05-13,4250,1007,1054,2061,保安,三等
2020-05-14,4250,1300,1081,2381,保安,三等
2020-05-15,4250,2020,1301,3321,保安,三等
2020-05-16,4250,1269,1081,2350,保安,三等
2020-05-17,4250,1079,1783,2862,保安,三等
2020-05-18,4250,1046,1493,2539,保安,三等
2020-05-19,4250,927,1087,2014,保安,三等
2020-05-20,4250,1119,2921,4040,保安,三等
2020-05-21,4250,1172,1137,2309,保安,三等
2020-05-22,4250,2113,1011,3124,保安,三等
2020-05-23,4250,1063,943,2006,保安,三等
2020-05-24,4250,1678,2445,4123,保安,三等
2020-05-25,4250,1031,1616,2647,保安,三等
2020-05-26,4250,973,1147,2120,保安,三等
2020-05-27,4250,949,1032,1981,保安,三等
2020-05-28,4250,1348,1093,2441,保安,三等
2020-05-29,4250,2568,1260,3828,保安,三等
2020-05-30,4250,1338,1340,2678,保安,三等
2020-05-31,4250,1197,2237,3434,保安,三等
2020-06-01,4250,1075,1513,2588,保安,三等
2020-06-02,4250,1017,1136,2153,保安,三等
2020-06-03,4250,1025,1295,2320,保安,三等
2020-06-04,4250,1272,1004,2276,保安,三等
2020-06-05,4250,1986,1420,3406,保安,三等
2020-06-06,4250,1647,1445,3092,保安,三等
2020-06-07,4250,1456,2040,3496,保安,三等
2020-06-08,4250,1087,1539,2626,保安,三等
2020-06-09,4250,1049,1170,2219,保安,三等
2020-06-10,4250,1019,1061,2080,保安,三等
2020-06-11,4250,1370,1201,2571,保安,三等
2020-06-12,4250,2599,1585,4184,保安,三等
2020-06-13,4250,1645,1730,3375,保安,三等
2020-06-14,4250,1693,2340,4033,保安,三等
2020-06-15,4250,1183,1662,2845,保安,三等
2020-06-16,4250,1060,1198,2258,保安,三等
2020-06-17,4250,1046,1089,2135,保安,三等
2020-06-18,4250,1284,1214,2498,保安,三等
2020-06-19,4250,1988,1190,3178,保安,三等
2020-06-20,4250,1392,1171,2563,保安,三等
2020-06-21,4250,1362,2244,3606,保安,三等
2020-06-22,4250,1143,1534,2677,保安,三等
2020-06-23,4250,1160,1243,2403,保安,三等
2020-06-24,4250,2536,1304,3840,保安,三等
2020-06-25,4250,1579,1223,2802,保安,三等
2020-06-26,4250,1540,1613,3153,保安,三等
2020-06-27,4250,1532,1592,3124,保安,三等
2020-06-28,4250,1295,2189,3484,保安,三等
2020-06-29,4250,1078,1541,2619,保安,三等
2020-06-30,4250,1031,1164,2195,保安,三等
2020-07-01,4250,1020,1023,2043,保安,三等
2020-07-02,4250,1283,1116,2399,保安,三等
2020-07-03,4250,1595,1316,2911,保安,三等
2020-07-04,4250,1370,1269,2639,保安,三等
2020-07-05,4250,1261,1263,2524,保安,三等
2020-07-06,4250,997,1110,2107,保安,三等
2020-07-07,4250,1076,1147,2223,保安,三等
2020-07-08,4250,872,1075,1947,保安,三等
2020-07-09,4250,955,1002,1957,保安,三等
2020-07-10,4250,1207,1206,2413,保安,三等
2020-07-11,4250,1170,1246,2416,保安,三等
2020-07-12,4250,1433,1543,2976,保安,三等
2020-07-13,4250,992,1131,2123,保安,三等
2020-07-14,4250,1020,1002,2022,保安,三等
2020-07-15,4250,921,966,1887,保安,三等
2020-07-16,4250,1132,1095,2227,保安,三等
2020-07-17,4250,1231,1136,2367,保安,三等
2020-07-18,4250,1183,1177,2360,保安,三等
2020-07-19,4250,1437,1486,2923,保安,三等
2020-07-20,4250,1069,1179,2248,保安,三等
2020-07-21,4250,1175,1193,2368,保安,三等
2020-07-22,4250,1070,1067,2137,保安,三等
2020-07-23,4250,1118,1230,2348,保安,三等
2020-07-24,4250,1402,1289,2691,保安,三等
2020-07-25,4250,1253,1164,2417,保安,三等
2020-07-26,4250,1282,1385,2667,保安,三等
2020-07-27,4250,962,1140,2102,保安,三等
2020-07-28,4250,980,1115,2095,保安,三等
2020-07-29,4250,872,953,1825,保安,三等
2020-07-30,4250,1001,1056,2057,保安,三等
2020-07-31,4250,1252,1147,2399,保安,三等
2020-08-01,4250,963,1014,1977,保安,三等
2020-08-02,4250,1090,1357,2447,保安,三等
2020-08-03,4250,916,1017,1933,保安,三等
2020-08-04,4250,882,896,1778,保安,三等
2020-08-05,4250,902,974,1876,保安,三等
2020-08-06,4250,1132,1119,2251,保安,三等
2020-08-07,4250,1285,1193,2478,保安,三等
2020-08-08,4250,1292,1164,2456,保安,三等
2020-08-09,4250,1304,1449,2753,保安,三等
2020-08-10,4250,1090,1181,2271,保安,三等
2020-08-11,4250,920,984,1904,保安,三等
2020-08-12,4250,884,933,1817,保安,三等
2020-08-13,4250,1138,1158,2296,保安,三等
2020-08-14,4250,1366,1261,2627,保安,三等
2020-08-15,4250,1214,1231,2445,保安,三等
2020-08-16,4250,1413,1505,2918,保安,三等
2020-08-17,4250,1131,1179,2310,保安,三等
2020-08-18,4250,1126,1279,2405,保安,三等
2020-08-19,4250,949,1020,1969,保安,三等
2020-08-20,4250,1079,1126,2205,保安,三等
2020-08-21,4250,1303,1261,2564,保安,三等
2020-08-22,4250,1092,1111,2203,保安,三等
2020-08-23,4250,1346,1443,2789,保安,三等
2020-08-24,4250,1019,1190,2209,保安,三等
2020-08-25,4250,1013,1115,2128,保安,三等
2020-08-26,4250,643,687,1330,保安,三等
2020-08-27,4250,859,912,1771,保安,三等
2020-08-28,4250,1170,1009,2179,保安,三等
2020-08-29,4250,1005,1025,2030,保安,三等
2020-08-30,4250,1021,1343,2364,保安,三等
2020-08-31,4250,962,1061,2023,保安,三等
2020-09-01,4250,878,990,1868,保安,三等
2020-09-02,4250,873,879,1752,保安,三等
2020-09-03,4250,1010,995,2005,保安,三等
2020-09-04,4250,1192,1215,2407,保安,三等
2020-09-05,4250,1159,1262,2421,保安,三等
2020-09-06,4250,1227,1343,2570,保安,三等
2020-09-07,4250,999,1146,2145,保安,三等
2020-09-08,4250,923,1195,2118,保安,三等
2020-09-09,4250,988,1809,2797,保安,三等
2020-09-10,4250,1128,1267,2395,保安,三等
2020-09-11,4250,1568,1293,2861,保安,三等
2020-09-12,4250,1334,1412,2746,保安,三等
2020-09-13,4250,1647,2240,3887,保安,三等
2020-09-14,4250,1197,1383,2580,保安,三等
2020-09-15,4250,1145,1184,2329,保安,三等
2020-09-16,4250,1233,1147,2380,保安,三等
2020-09-17,4250,1413,1260,2673,保安,三等
2020-09-18,4250,2847,1342,4189,保安,三等
2020-09-19,4250,1631,1605,3236,保安,三等
2020-09-20,4250,1588,2735,4323,保安,三等
2020-09-21,4250,1246,1574,2820,保安,三等
2020-09-22,4250,1112,1206,2318,保安,三等
2020-09-23,4250,1163,1221,2384,保安,三等
2020-09-24,4250,1365,1221,2586,保安,三等
2020-09-25,4250,1571,1319,2890,保安,三等
2020-09-26,4250,1635,1332,2967,保安,三等
2020-09-27,4250,1445,1899,3344,保安,三等
2020-09-28,4250,1177,1425,2602,保安,三等
2020-09-29,4250,1219,1168,2387,保安,三等
2020-09-30,4250,3601,1430,5031,保安,三等
2020-10-01,4250,1830,1310,3140,保安,三等
2020-10-02,4250,1527,1571,3098,保安,三等
2020-10-03,4250,1563,1731,3294,保安,三等
2020-10-04,4250,1339,2997,4336,保安,三等
2020-10-05,4250,1236,1753,2989,保安,三等
2020-10-06,4250,1269,1332,2601,保安,三等
2020-10-07,4250,1380,1335,2715,保安,三等
2020-10-08,4250,2886,1484,4370,保安,三等
2020-10-09,4250,1882,1439,3321,保安,三等
2020-10-10,4250,1713,1819,3532,保安,三等
2020-10-11,4250,1799,2977,4776,保安,三等
2020-10-12,4250,1248,1694,2942,保安,三等
2020-10-13,4250,1216,1230,2446,保安,三等
2020-10-14,4250,1163,1191,2354,保安,三等
2020-10-15,4250,1420,1257,2677,保安,三等
2020-10-16,4250,2584,1448,4032,保安,三等
2020-10-17,4250,3576,2177,5753,保安,三等
2020-10-18,4250,2000,2764,4764,保安,三等
2020-10-19,4250,1283,1544,2827,保安,三等
2020-10-20,4250,1200,1240,2440,保安,三等
2020-10-21,4250,1250,1245,2495,保安,三等
2020-10-22,4250,1479,1307,2786,保安,三等
2020-10-23,4250,2635,1398,4033,保安,三等
2020-10-24,4250,1642,1524,3166,保安,三等
2020-10-25,4250,1466,2451,3917,保安,三等
2020-10-26,4250,1321,1631,2952,保安,三等
2020-10-27,4250,1205,1256,2461,保安,三等
2020-10-28,4250,1163,1183,2346,保安,三等
2020-10-29,4250,1461,1199,2660,保安,三等
2020-10-30,4250,2485,1471,3956,保安,三等
2020-10-31,4250,1389,1567,2956,保安,三等
2020-11-01,4250,1419,2186,3605,保安,三等
2020-11-02,4250,1169,1477,2646,保安,三等
2020-11-03,4250,1070,1117,2187,保安,三等
2020-11-04,4250,1124,1117,2241,保安,三等
2020-11-05,4250,1356,1192,2548,保安,三等
2020-11-06,4250,2106,1344,3450,保安,三等
2020-11-07,4250,1451,1152,2603,保安,三等
2020-11-08,4250,1475,2151,3626,保安,三等
2020-11-09,4250,1163,1324,2487,保安,三等
2020-11-10,4250,1121,1163,2284,保安,三等
2020-11-11,4250,1260,1149,2409,保安,三等
2020-11-12,4250,1709,1252,2961,保安,三等
2020-11-13,4250,2907,1417,4324,保安,三等
2020-11-14,4250,1530,1577,3107,保安,三等
2020-11-15,4250,1667,2964,4631,保安,三等
2020-11-16,4250,1295,1788,3083,保安,三等
2020-11-17,4250,1153,1190,2343,保安,三等
2020-11-18,4250,1239,1235,2474,保安,三等
2020-11-19,4250,1447,1243,2690,保安,三等
2020-11-20,4250,2756,1601,4357,保安,三等
2020-11-21,4250,1656,1594,3250,保安,三等
2020-11-22,4250,1764,2686,4450,保安,三等
2020-11-23,4250,1230,1656,2886,保安,三等
2020-11-24,4250,1185,1275,2460,保安,三等
2020-11-25,4250,1224,1269,2493,保安,三等
2020-11-26,4250,1552,1268,2820,保安,三等
2020-11-27,4250,2748,1522,4270,保安,三等
2020-11-28,4250,1536,1497,3033,保安,三等
2020-11-29,4250,1497,2388,3885,保安,三等
2020-11-30,4250,1272,1640,2912,保安,三等
2020-12-01,4250,1130,1204,2334,保安,三等
2020-12-02,4250,1136,1152,2288,保安,三等
2020-12-03,4250,1430,1215,2645,保安,三等
2020-12-04,4250,2809,1507,4316,保安,三等
2020-12-05,4250,1793,1579,3372,保安,三等
2020-12-06,4250,1681,2536,4217,保安,三等
2020-12-07,4250,1224,1682,2906,保安,三等
2020-12-08,4250,1135,1264,2399,保安,三等
2020-12-09,4250,1173,1167,2340,保安,三等
2020-12-10,4250,1521,1242,2763,保安,三等
2020-12-11,4250,2754,1491,4245,保安,三等
2020-12-12,4250,2153,2178,4331,保安,三等
2020-12-13,4250,2174,3167,5341,保安,三等
2020-12-14,4250,1383,1753,3136,保安,三等
2020-12-15,4250,1207,1238,2445,保安,三等
2020-12-16,4250,1276,1219,2495,保安,三等
2020-12-17,4250,1496,1286,2782,保安,三等
2020-12-18,4250,2747,1583,4330,保安,三等
2020-12-19,4250,2286,2274,4560,保安,三等
2020-12-20,4250,2454,3319,5773,保安,三等
2020-12-21,4250,1192,1643,2835,保安,三等
2020-12-22,4250,1225,1298,2523,保安,三等
2020-12-23,4250,1181,1206,2387,保安,三等
2020-12-24,4250,1586,1422,3008,保安,三等
2020-12-25,4250,2778,1693,4471,保安,三等
2020-12-26,4250,1605,1586,3191,保安,三等
2020-12-27,4250,1544,2391,3935,保安,三等
2020-12-28,4250,1373,1692,3065,保安,三等
2020-12-29,4250,1267,1599,2866,保安,三等
2020-12-30,4250,1375,1865,3240,保安,三等
2020-12-31,4250,3636,1999,5635,保安,三等
2020-01-01,4260,1006,1129,2135,仁德,簡易
2020-01-02,4260,757,835,1592,仁德,簡易
2020-01-03,4260,1003,916,1919,仁德,簡易
2020-01-04,4260,920,890,1810,仁德,簡易
2020-01-05,4260,1091,1154,2245,仁德,簡易
2020-01-06,4260,828,896,1724,仁德,簡易
2020-01-07,4260,760,792,1552,仁德,簡易
2020-01-08,4260,777,779,1556,仁德,簡易
2020-01-09,4260,840,807,1647,仁德,簡易
2020-01-10,4260,1230,1146,2376,仁德,簡易
2020-01-11,4260,1171,1058,2229,仁德,簡易
2020-01-12,4260,1261,1332,2593,仁德,簡易
2020-01-13,4260,811,869,1680,仁德,簡易
2020-01-14,4260,715,693,1408,仁德,簡易
2020-01-15,4260,748,797,1545,仁德,簡易
2020-01-16,4260,729,747,1476,仁德,簡易
2020-01-17,4260,803,870,1673,仁德,簡易
2020-01-18,4260,913,769,1682,仁德,簡易
2020-01-19,4260,1071,1058,2129,仁德,簡易
2020-01-20,4260,784,845,1629,仁德,簡易
2020-01-21,4260,735,731,1466,仁德,簡易
2020-01-22,4260,916,951,1867,仁德,簡易
2020-01-23,4260,1063,886,1949,仁德,簡易
2020-01-24,4260,1000,935,1935,仁德,簡易
2020-01-25,4260,1309,1128,2437,仁德,簡易
2020-01-26,4260,1018,1095,2113,仁德,簡易
2020-01-27,4260,1076,1153,2229,仁德,簡易
2020-01-28,4260,887,837,1724,仁德,簡易
2020-01-29,4260,817,834,1651,仁德,簡易
2020-01-30,4260,681,679,1360,仁德,簡易
2020-01-31,4260,724,742,1466,仁德,簡易
2020-02-01,4260,636,664,1300,仁德,簡易
2020-02-02,4260,759,769,1528,仁德,簡易
2020-02-03,4260,647,652,1299,仁德,簡易
2020-02-04,4260,608,583,1191,仁德,簡易
2020-02-05,4260,657,673,1330,仁德,簡易
2020-02-06,4260,700,679,1379,仁德,簡易
2020-02-07,4260,823,833,1656,仁德,簡易
2020-02-08,4260,803,815,1618,仁德,簡易
2020-02-09,4260,1025,1066,2091,仁德,簡易
2020-02-10,4260,729,764,1493,仁德,簡易
2020-02-11,4260,646,610,1256,仁德,簡易
2020-02-12,4260,650,641,1291,仁德,簡易
2020-02-13,4260,636,664,1300,仁德,簡易
2020-02-14,4260,794,738,1532,仁德,簡易
2020-02-15,4260,801,725,1526,仁德,簡易
2020-02-16,4260,926,999,1925,仁德,簡易
2020-02-17,4260,669,718,1387,仁德,簡易
2020-02-18,4260,606,614,1220,仁德,簡易
2020-02-19,4260,654,629,1283,仁德,簡易
2020-02-20,4260,622,667,1289,仁德,簡易
2020-02-21,4260,791,792,1583,仁德,簡易
2020-02-22,4260,793,765,1558,仁德,簡易
2020-02-23,4260,942,912,1854,仁德,簡易
2020-02-24,4260,672,682,1354,仁德,簡易
2020-02-25,4260,672,696,1368,仁德,簡易
2020-02-26,4260,595,671,1266,仁德,簡易
2020-02-27,4260,771,844,1615,仁德,簡易
2020-02-28,4260,813,748,1561,仁德,簡易
2020-02-29,4260,718,680,1398,仁德,簡易
2020-03-01,4260,919,952,1871,仁德,簡易
2020-03-02,4260,713,771,1484,仁德,簡易
2020-03-03,4260,650,678,1328,仁德,簡易
2020-03-04,4260,672,691,1363,仁德,簡易
2020-03-05,4260,744,737,1481,仁德,簡易
2020-03-06,4260,1070,993,2063,仁德,簡易
2020-03-07,4260,790,756,1546,仁德,簡易
2020-03-08,4260,970,1154,2124,仁德,簡易
2020-03-09,4260,748,810,1558,仁德,簡易
2020-03-10,4260,702,737,1439,仁德,簡易
2020-03-11,4260,691,680,1371,仁德,簡易
2020-03-12,4260,729,712,1441,仁德,簡易
2020-03-13,4260,1044,1008,2052,仁德,簡易
2020-03-14,4260,788,742,1530,仁德,簡易
2020-03-15,4260,1073,1165,2238,仁德,簡易
2020-03-16,4260,766,875,1641,仁德,簡易
2020-03-17,4260,677,689,1366,仁德,簡易
2020-03-18,4260,661,686,1347,仁德,簡易
2020-03-19,4260,703,680,1383,仁德,簡易
2020-03-20,4260,1005,912,1917,仁德,簡易
2020-03-21,4260,704,644,1348,仁德,簡易
2020-03-22,4260,828,918,1746,仁德,簡易
2020-03-23,4260,676,735,1411,仁德,簡易
2020-03-24,4260,590,630,1220,仁德,簡易
2020-03-25,4260,617,628,1245,仁德,簡易
2020-03-26,4260,660,660,1320,仁德,簡易
2020-03-27,4260,897,830,1727,仁德,簡易
2020-03-28,4260,650,627,1277,仁德,簡易
2020-03-29,4260,709,761,1470,仁德,簡易
2020-03-30,4260,617,715,1332,仁德,簡易
2020-03-31,4260,608,670,1278,仁德,簡易
2020-04-01,4260,874,805,1679,仁德,簡易
2020-04-02,4260,727,567,1294,仁德,簡易
2020-04-03,4260,596,533,1129,仁德,簡易
2020-04-04,4260,484,526,1010,仁德,簡易
2020-04-05,4260,737,909,1646,仁德,簡易
2020-04-06,4260,652,762,1414,仁德,簡易
2020-04-07,4260,565,566,1131,仁德,簡易
2020-04-08,4260,572,589,1161,仁德,簡易
2020-04-09,4260,617,635,1252,仁德,簡易
2020-04-10,4260,801,679,1480,仁德,簡易
2020-04-11,4260,685,660,1345,仁德,簡易
2020-04-12,4260,801,812,1613,仁德,簡易
2020-04-13,4260,623,724,1347,仁德,簡易
2020-04-14,4260,612,648,1260,仁德,簡易
2020-04-15,4260,586,608,1194,仁德,簡易
2020-04-16,4260,626,602,1228,仁德,簡易
2020-04-17,4260,842,828,1670,仁德,簡易
2020-04-18,4260,719,705,1424,仁德,簡易
2020-04-19,4260,816,845,1661,仁德,簡易
2020-04-20,4260,629,684,1313,仁德,簡易
2020-04-21,4260,527,566,1093,仁德,簡易
2020-04-22,4260,497,520,1017,仁德,簡易
2020-04-23,4260,596,549,1145,仁德,簡易
2020-04-24,4260,706,701,1407,仁德,簡易
2020-04-25,4260,463,463,926,仁德,簡易
2020-04-26,4260,516,616,1132,仁德,簡易
2020-04-27,4260,604,634,1238,仁德,簡易
2020-04-28,4260,560,557,1117,仁德,簡易
2020-04-29,4260,511,503,1014,仁德,簡易
2020-04-30,4260,681,650,1331,仁德,簡易
2020-05-01,4260,906,771,1677,仁德,簡易
2020-05-02,4260,647,612,1259,仁德,簡易
2020-05-03,4260,675,815,1490,仁德,簡易
2020-05-04,4260,629,727,1356,仁德,簡易
2020-05-05,4260,596,601,1197,仁德,簡易
2020-05-06,4260,615,627,1242,仁德,簡易
2020-05-07,4260,679,652,1331,仁德,簡易
2020-05-08,4260,1038,941,1979,仁德,簡易
2020-05-09,4260,893,766,1659,仁德,簡易
2020-05-10,4260,926,1078,2004,仁德,簡易
2020-05-11,4260,691,809,1500,仁德,簡易
2020-05-12,4260,588,648,1236,仁德,簡易
2020-05-13,4260,587,605,1192,仁德,簡易
2020-05-14,4260,621,635,1256,仁德,簡易
2020-05-15,4260,935,876,1811,仁德,簡易
2020-05-16,4260,712,593,1305,仁德,簡易
2020-05-17,4260,820,860,1680,仁德,簡易
2020-05-18,4260,676,660,1336,仁德,簡易
2020-05-19,4260,542,582,1124,仁德,簡易
2020-05-20,4260,577,573,1150,仁德,簡易
2020-05-21,4260,603,591,1194,仁德,簡易
2020-05-22,4260,758,734,1492,仁德,簡易
2020-05-23,4260,704,629,1333,仁德,簡易
2020-05-24,4260,963,1083,2046,仁德,簡易
2020-05-25,4260,634,773,1407,仁德,簡易
2020-05-26,4260,575,559,1134,仁德,簡易
2020-05-27,4260,566,562,1128,仁德,簡易
2020-05-28,4260,626,537,1163,仁德,簡易
2020-05-29,4260,994,888,1882,仁德,簡易
2020-05-30,4260,780,694,1474,仁德,簡易
2020-05-31,4260,861,964,1825,仁德,簡易
2020-06-01,4260,734,817,1551,仁德,簡易
2020-06-02,4260,602,616,1218,仁德,簡易
2020-06-03,4260,641,614,1255,仁德,簡易
2020-06-04,4260,641,642,1283,仁德,簡易
2020-06-05,4260,960,856,1816,仁德,簡易
2020-06-06,4260,858,854,1712,仁德,簡易
2020-06-07,4260,977,978,1955,仁德,簡易
2020-06-08,4260,656,757,1413,仁德,簡易
2020-06-09,4260,598,645,1243,仁德,簡易
2020-06-10,4260,619,501,1120,仁德,簡易
2020-06-11,4260,682,683,1365,仁德,簡易
2020-06-12,4260,946,924,1870,仁德,簡易
2020-06-13,4260,952,774,1726,仁德,簡易
2020-06-14,4260,1078,1169,2247,仁德,簡易
2020-06-15,4260,670,733,1403,仁德,簡易
2020-06-16,4260,623,647,1270,仁德,簡易
2020-06-17,4260,598,600,1198,仁德,簡易
2020-06-18,4260,637,617,1254,仁德,簡易
2020-06-19,4260,769,752,1521,仁德,簡易
2020-06-20,4260,796,725,1521,仁德,簡易
2020-06-21,4260,800,886,1686,仁德,簡易
2020-06-22,4260,657,713,1370,仁德,簡易
2020-06-23,4260,631,682,1313,仁德,簡易
2020-06-24,4260,959,824,1783,仁德,簡易
2020-06-25,4260,911,796,1707,仁德,簡易
2020-06-26,4260,876,834,1710,仁德,簡易
2020-06-27,4260,850,906,1756,仁德,簡易
2020-06-28,4260,981,1126,2107,仁德,簡易
2020-06-29,4260,732,772,1504,仁德,簡易
2020-06-30,4260,578,613,1191,仁德,簡易
2020-07-01,4260,628,611,1239,仁德,簡易
2020-07-02,4260,625,594,1219,仁德,簡易
2020-07-03,4260,803,787,1590,仁德,簡易
2020-07-04,4260,800,715,1515,仁德,簡易
2020-07-05,4260,870,895,1765,仁德,簡易
2020-07-06,4260,671,707,1378,仁德,簡易
2020-07-07,4260,639,648,1287,仁德,簡易
2020-07-08,4260,617,670,1287,仁德,簡易
2020-07-09,4260,602,641,1243,仁德,簡易
2020-07-10,4260,746,781,1527,仁德,簡易
2020-07-11,4260,914,853,1767,仁德,簡易
2020-07-12,4260,1006,1061,2067,仁德,簡易
2020-07-13,4260,640,735,1375,仁德,簡易
2020-07-14,4260,647,697,1344,仁德,簡易
2020-07-15,4260,600,576,1176,仁德,簡易
2020-07-16,4260,613,634,1247,仁德,簡易
2020-07-17,4260,844,809,1653,仁德,簡易
2020-07-18,4260,876,746,1622,仁德,簡易
2020-07-19,4260,928,1068,1996,仁德,簡易
2020-07-20,4260,695,684,1379,仁德,簡易
2020-07-21,4260,689,673,1362,仁德,簡易
2020-07-22,4260,681,672,1353,仁德,簡易
2020-07-23,4260,621,662,1283,仁德,簡易
2020-07-24,4260,824,797,1621,仁德,簡易
2020-07-25,4260,799,851,1650,仁德,簡易
2020-07-26,4260,959,987,1946,仁德,簡易
2020-07-27,4260,659,718,1377,仁德,簡易
2020-07-28,4260,589,596,1185,仁德,簡易
2020-07-29,4260,611,622,1233,仁德,簡易
2020-07-30,4260,636,638,1274,仁德,簡易
2020-07-31,4260,787,759,1546,仁德,簡易
2020-08-01,4260,830,773,1603,仁德,簡易
2020-08-02,4260,864,855,1719,仁德,簡易
2020-08-03,4260,609,639,1248,仁德,簡易
2020-08-04,4260,550,585,1135,仁德,簡易
2020-08-05,4260,659,666,1325,仁德,簡易
2020-08-06,4260,660,679,1339,仁德,簡易
2020-08-07,4260,835,797,1632,仁德,簡易
2020-08-08,4260,943,842,1785,仁德,簡易
2020-08-09,4260,1149,1133,2282,仁德,簡易
2020-08-10,4260,688,712,1400,仁德,簡易
2020-08-11,4260,625,596,1221,仁德,簡易
2020-08-12,4260,664,652,1316,仁德,簡易
2020-08-13,4260,652,710,1362,仁德,簡易
2020-08-14,4260,820,814,1634,仁德,簡易
2020-08-15,4260,894,864,1758,仁德,簡易
2020-08-16,4260,1043,1017,2060,仁德,簡易
2020-08-17,4260,688,752,1440,仁德,簡易
2020-08-18,4260,678,663,1341,仁德,簡易
2020-08-19,4260,673,646,1319,仁德,簡易
2020-08-20,4260,641,658,1299,仁德,簡易
2020-08-21,4260,856,794,1650,仁德,簡易
2020-08-22,4260,905,853,1758,仁德,簡易
2020-08-23,4260,957,1050,2007,仁德,簡易
2020-08-24,4260,696,712,1408,仁德,簡易
2020-08-25,4260,687,664,1351,仁德,簡易
2020-08-26,4260,510,502,1012,仁德,簡易
2020-08-27,4260,591,570,1161,仁德,簡易
2020-08-28,4260,777,758,1535,仁德,簡易
2020-08-29,4260,823,784,1607,仁德,簡易
2020-08-30,4260,710,654,1364,仁德,簡易
2020-08-31,4260,663,680,1343,仁德,簡易
2020-09-01,4260,595,631,1226,仁德,簡易
2020-09-02,4260,580,656,1236,仁德,簡易
2020-09-03,4260,597,659,1256,仁德,簡易
2020-09-04,4260,772,809,1581,仁德,簡易
2020-09-05,4260,928,814,1742,仁德,簡易
2020-09-06,4260,1041,1052,2093,仁德,簡易
2020-09-07,4260,717,740,1457,仁德,簡易
2020-09-08,4260,666,717,1383,仁德,簡易
2020-09-09,4260,680,722,1402,仁德,簡易
2020-09-10,4260,708,729,1437,仁德,簡易
2020-09-11,4260,923,899,1822,仁德,簡易
2020-09-12,4260,1018,969,1987,仁德,簡易
2020-09-13,4260,1157,1183,2340,仁德,簡易
2020-09-14,4260,708,780,1488,仁德,簡易
2020-09-15,4260,674,714,1388,仁德,簡易
2020-09-16,4260,659,689,1348,仁德,簡易
2020-09-17,4260,737,723,1460,仁德,簡易
2020-09-18,4260,1073,967,2040,仁德,簡易
2020-09-19,4260,944,860,1804,仁德,簡易
2020-09-20,4260,1054,1229,2283,仁德,簡易
2020-09-21,4260,728,785,1513,仁德,簡易
2020-09-22,4260,710,740,1450,仁德,簡易
2020-09-23,4260,670,699,1369,仁德,簡易
2020-09-24,4260,741,679,1420,仁德,簡易
2020-09-25,4260,781,761,1542,仁德,簡易
2020-09-26,4260,892,835,1727,仁德,簡易
2020-09-27,4260,948,1047,1995,仁德,簡易
2020-09-28,4260,737,772,1509,仁德,簡易
2020-09-29,4260,734,680,1414,仁德,簡易
2020-09-30,4260,1188,1038,2226,仁德,簡易
2020-10-01,4260,1009,947,1956,仁德,簡易
2020-10-02,4260,976,963,1939,仁德,簡易
2020-10-03,4260,949,870,1819,仁德,簡易
2020-10-04,4260,1072,1281,2353,仁德,簡易
2020-10-05,4260,796,867,1663,仁德,簡易
2020-10-06,4260,701,697,1398,仁德,簡易
2020-10-07,4260,679,730,1409,仁德,簡易
2020-10-08,4260,1100,1011,2111,仁德,簡易
2020-10-09,4260,1027,874,1901,仁德,簡易
2020-10-10,4260,951,1011,1962,仁德,簡易
2020-10-11,4260,1203,1311,2514,仁德,簡易
2020-10-12,4260,763,826,1589,仁德,簡易
2020-10-13,4260,703,703,1406,仁德,簡易
2020-10-14,4260,658,726,1384,仁德,簡易
2020-10-15,4260,729,696,1425,仁德,簡易
2020-10-16,4260,1032,955,1987,仁德,簡易
2020-10-17,4260,980,937,1917,仁德,簡易
2020-10-18,4260,1043,1193,2236,仁德,簡易
2020-10-19,4260,733,808,1541,仁德,簡易
2020-10-20,4260,679,715,1394,仁德,簡易
2020-10-21,4260,649,703,1352,仁德,簡易
2020-10-22,4260,720,740,1460,仁德,簡易
2020-10-23,4260,1036,944,1980,仁德,簡易
2020-10-24,4260,935,843,1778,仁德,簡易
2020-10-25,4260,995,1149,2144,仁德,簡易
2020-10-26,4260,703,743,1446,仁德,簡易
2020-10-27,4260,681,755,1436,仁德,簡易
2020-10-28,4260,668,671,1339,仁德,簡易
2020-10-29,4260,713,669,1382,仁德,簡易
2020-10-30,4260,969,955,1924,仁德,簡易
2020-10-31,4260,887,881,1768,仁德,簡易
2020-11-01,4260,925,990,1915,仁德,簡易
2020-11-02,4260,676,739,1415,仁德,簡易
2020-11-03,4260,662,731,1393,仁德,簡易
2020-11-04,4260,684,679,1363,仁德,簡易
2020-11-05,4260,744,726,1470,仁德,簡易
2020-11-06,4260,989,940,1929,仁德,簡易
2020-11-07,4260,933,819,1752,仁德,簡易
2020-11-08,4260,1033,1147,2180,仁德,簡易
2020-11-09,4260,707,766,1473,仁德,簡易
2020-11-10,4260,697,692,1389,仁德,簡易
2020-11-11,4260,680,677,1357,仁德,簡易
2020-11-12,4260,804,776,1580,仁德,簡易
2020-11-13,4260,1110,1045,2155,仁德,簡易
2020-11-14,4260,1061,967,2028,仁德,簡易
2020-11-15,4260,1179,1313,2492,仁德,簡易
2020-11-16,4260,765,821,1586,仁德,簡易
2020-11-17,4260,720,744,1464,仁德,簡易
2020-11-18,4260,685,738,1423,仁德,簡易
2020-11-19,4260,785,731,1516,仁德,簡易
2020-11-20,4260,1102,1039,2141,仁德,簡易
2020-11-21,4260,952,836,1788,仁德,簡易
2020-11-22,4260,1076,1062,2138,仁德,簡易
2020-11-23,4260,759,795,1554,仁德,簡易
2020-11-24,4260,675,699,1374,仁德,簡易
2020-11-25,4260,659,691,1350,仁德,簡易
2020-11-26,4260,797,740,1537,仁德,簡易
2020-11-27,4260,1122,1007,2129,仁德,簡易
2020-11-28,4260,1645,914,2559,仁德,簡易
2020-11-29,4260,1078,1100,2178,仁德,簡易
2020-11-30,4260,799,837,1636,仁德,簡易
2020-12-01,4260,703,709,1412,仁德,簡易
2020-12-02,4260,721,743,1464,仁德,簡易
2020-12-03,4260,774,739,1513,仁德,簡易
2020-12-04,4260,1111,1034,2145,仁德,簡易
2020-12-05,4260,1107,1105,2212,仁德,簡易
2020-12-06,4260,1175,1269,2444,仁德,簡易
2020-12-07,4260,769,809,1578,仁德,簡易
2020-12-08,4260,680,708,1388,仁德,簡易
2020-12-09,4260,702,731,1433,仁德,簡易
2020-12-10,4260,743,760,1503,仁德,簡易
2020-12-11,4260,1149,1009,2158,仁德,簡易
2020-12-12,4260,987,924,1911,仁德,簡易
2020-12-13,4260,1172,1198,2370,仁德,簡易
2020-12-14,4260,805,835,1640,仁德,簡易
2020-12-15,4260,700,713,1413,仁德,簡易
2020-12-16,4260,705,659,1364,仁德,簡易
2020-12-17,4260,753,719,1472,仁德,簡易
2020-12-18,4260,1086,1029,2115,仁德,簡易
2020-12-19,4260,952,938,1890,仁德,簡易
2020-12-20,4260,1194,1175,2369,仁德,簡易
2020-12-21,4260,732,841,1573,仁德,簡易
2020-12-22,4260,697,698,1395,仁德,簡易
2020-12-23,4260,710,718,1428,仁德,簡易
2020-12-24,4260,762,732,1494,仁德,簡易
2020-12-25,4260,1049,972,2021,仁德,簡易
2020-12-26,4260,887,894,1781,仁德,簡易
2020-12-27,4260,1080,1107,2187,仁德,簡易
2020-12-28,4260,747,807,1554,仁德,簡易
2020-12-29,4260,680,698,1378,仁德,簡易
2020-12-30,4260,727,719,1446,仁德,簡易
2020-12-31,4260,1198,1051,2249,仁德,簡易
2020-01-01,4270,380,509,889,中洲,二等
2020-01-02,4270,409,429,838,中洲,二等
2020-01-03,4270,538,412,950,中洲,二等
2020-01-04,4270,399,352,751,中洲,二等
2020-01-05,4270,363,444,807,中洲,二等
2020-01-06,4270,384,444,828,中洲,二等
2020-01-07,4270,375,390,765,中洲,二等
2020-01-08,4270,397,390,787,中洲,二等
2020-01-09,4270,474,384,858,中洲,二等
2020-01-10,4270,623,529,1152,中洲,二等
2020-01-11,4270,417,438,855,中洲,二等
2020-01-12,4270,410,452,862,中洲,二等
2020-01-13,4270,419,434,853,中洲,二等
2020-01-14,4270,393,400,793,中洲,二等
2020-01-15,4270,391,371,762,中洲,二等
2020-01-16,4270,412,397,809,中洲,二等
2020-01-17,4270,430,406,836,中洲,二等
2020-01-18,4270,351,356,707,中洲,二等
2020-01-19,4270,423,449,872,中洲,二等
2020-01-20,4270,379,375,754,中洲,二等
2020-01-21,4270,362,342,704,中洲,二等
2020-01-22,4270,386,379,765,中洲,二等
2020-01-23,4270,349,325,674,中洲,二等
2020-01-24,4270,301,277,578,中洲,二等
2020-01-25,4270,356,343,699,中洲,二等
2020-01-26,4270,334,365,699,中洲,二等
2020-01-27,4270,333,370,703,中洲,二等
2020-01-28,4270,292,306,598,中洲,二等
2020-01-29,4270,317,303,620,中洲,二等
2020-01-30,4270,320,334,654,中洲,二等
2020-01-31,4270,555,325,880,中洲,二等
2020-02-01,4270,267,258,525,中洲,二等
2020-02-02,4270,335,342,677,中洲,二等
2020-02-03,4270,287,290,577,中洲,二等
2020-02-04,4270,304,295,599,中洲,二等
2020-02-05,4270,313,322,635,中洲,二等
2020-02-06,4270,295,296,591,中洲,二等
2020-02-07,4270,368,356,724,中洲,二等
2020-02-08,4270,316,337,653,中洲,二等
2020-02-09,4270,317,362,679,中洲,二等
2020-02-10,4270,325,323,648,中洲,二等
2020-02-11,4270,317,317,634,中洲,二等
2020-02-12,4270,324,294,618,中洲,二等
2020-02-13,4270,292,276,568,中洲,二等
2020-02-14,4270,362,341,703,中洲,二等
2020-02-15,4270,318,301,619,中洲,二等
2020-02-16,4270,287,309,596,中洲,二等
2020-02-17,4270,338,320,658,中洲,二等
2020-02-18,4270,339,328,667,中洲,二等
2020-02-19,4270,345,311,656,中洲,二等
2020-02-20,4270,327,342,669,中洲,二等
2020-02-21,4270,366,332,698,中洲,二等
2020-02-22,4270,309,320,629,中洲,二等
2020-02-23,4270,324,342,666,中洲,二等
2020-02-24,4270,319,327,646,中洲,二等
2020-02-25,4270,334,343,677,中洲,二等
2020-02-26,4270,373,340,713,中洲,二等
2020-02-27,4270,405,389,794,中洲,二等
2020-02-28,4270,332,295,627,中洲,二等
2020-02-29,4270,419,331,750,中洲,二等
2020-03-01,4270,326,384,710,中洲,二等
2020-03-02,4270,360,362,722,中洲,二等
2020-03-03,4270,341,324,665,中洲,二等
2020-03-04,4270,337,333,670,中洲,二等
2020-03-05,4270,359,326,685,中洲,二等
2020-03-06,4270,518,407,925,中洲,二等
2020-03-07,4270,404,356,760,中洲,二等
2020-03-08,4270,384,488,872,中洲,二等
2020-03-09,4270,360,405,765,中洲,二等
2020-03-10,4270,331,328,659,中洲,二等
2020-03-11,4270,350,346,696,中洲,二等
2020-03-12,4270,360,353,713,中洲,二等
2020-03-13,4270,598,442,1040,中洲,二等
2020-03-14,4270,389,330,719,中洲,二等
2020-03-15,4270,404,481,885,中洲,二等
2020-03-16,4270,384,451,835,中洲,二等
2020-03-17,4270,349,369,718,中洲,二等
2020-03-18,4270,382,356,738,中洲,二等
2020-03-19,4270,379,374,753,中洲,二等
2020-03-20,4270,566,427,993,中洲,二等
2020-03-21,4270,338,285,623,中洲,二等
2020-03-22,4270,300,403,703,中洲,二等
2020-03-23,4270,361,400,761,中洲,二等
2020-03-24,4270,331,320,651,中洲,二等
2020-03-25,4270,359,352,711,中洲,二等
2020-03-26,4270,334,330,664,中洲,二等
2020-03-27,4270,509,353,862,中洲,二等
2020-03-28,4270,298,279,577,中洲,二等
2020-03-29,4270,256,372,628,中洲,二等
2020-03-30,4270,355,410,765,中洲,二等
2020-03-31,4270,470,315,785,中洲,二等
2020-04-01,4270,520,390,910,中洲,二等
2020-04-02,4270,361,276,637,中洲,二等
2020-04-03,4270,243,226,469,中洲,二等
2020-04-04,4270,227,227,454,中洲,二等
2020-04-05,4270,301,403,704,中洲,二等
2020-04-06,4270,326,386,712,中洲,二等
2020-04-07,4270,307,306,613,中洲,二等
2020-04-08,4270,314,318,632,中洲,二等
2020-04-09,4270,326,323,649,中洲,二等
2020-04-10,4270,450,333,783,中洲,二等
2020-04-11,4270,289,269,558,中洲,二等
2020-04-12,4270,317,354,671,中洲,二等
2020-04-13,4270,330,371,701,中洲,二等
2020-04-14,4270,306,306,612,中洲,二等
2020-04-15,4270,377,359,736,中洲,二等
2020-04-16,4270,372,336,708,中洲,二等
2020-04-17,4270,479,403,882,中洲,二等
2020-04-18,4270,333,312,645,中洲,二等
2020-04-19,4270,287,337,624,中洲,二等
2020-04-20,4270,309,358,667,中洲,二等
2020-04-21,4270,296,300,596,中洲,二等
2020-04-22,4270,300,276,576,中洲,二等
2020-04-23,4270,305,283,588,中洲,二等
2020-04-24,4270,460,362,822,中洲,二等
2020-04-25,4270,223,239,462,中洲,二等
2020-04-26,4270,234,285,519,中洲,二等
2020-04-27,4270,303,314,617,中洲,二等
2020-04-28,4270,291,287,578,中洲,二等
2020-04-29,4270,308,337,645,中洲,二等
2020-04-30,4270,422,300,722,中洲,二等
2020-05-01,4270,447,360,807,中洲,二等
2020-05-02,4270,267,284,551,中洲,二等
2020-05-03,4270,293,424,717,中洲,二等
2020-05-04,4270,334,376,710,中洲,二等
2020-05-05,4270,315,283,598,中洲,二等
2020-05-06,4270,336,335,671,中洲,二等
2020-05-07,4270,357,324,681,中洲,二等
2020-05-08,4270,610,417,1027,中洲,二等
2020-05-09,4270,379,312,691,中洲,二等
2020-05-10,4270,324,454,778,中洲,二等
2020-05-11,4270,343,411,754,中洲,二等
2020-05-12,4270,340,326,666,中洲,二等
2020-05-13,4270,346,324,670,中洲,二等
2020-05-14,4270,357,329,686,中洲,二等
2020-05-15,4270,507,403,910,中洲,二等
2020-05-16,4270,316,303,619,中洲,二等
2020-05-17,4270,340,393,733,中洲,二等
2020-05-18,4270,345,368,713,中洲,二等
2020-05-19,4270,319,314,633,中洲,二等
2020-05-20,4270,362,343,705,中洲,二等
2020-05-21,4270,349,301,650,中洲,二等
2020-05-22,4270,468,373,841,中洲,二等
2020-05-23,4270,380,322,702,中洲,二等
2020-05-24,4270,359,438,797,中洲,二等
2020-05-25,4270,350,397,747,中洲,二等
2020-05-26,4270,326,337,663,中洲,二等
2020-05-27,4270,313,288,601,中洲,二等
2020-05-28,4270,354,352,706,中洲,二等
2020-05-29,4270,579,374,953,中洲,二等
2020-05-30,4270,340,320,660,中洲,二等
2020-05-31,4270,335,446,781,中洲,二等
2020-06-01,4270,363,407,770,中洲,二等
2020-06-02,4270,331,330,661,中洲,二等
2020-06-03,4270,362,333,695,中洲,二等
2020-06-04,4270,374,340,714,中洲,二等
2020-06-05,4270,591,448,1039,中洲,二等
2020-06-06,4270,446,385,831,中洲,二等
2020-06-07,4270,362,497,859,中洲,二等
2020-06-08,4270,387,425,812,中洲,二等
2020-06-09,4270,348,336,684,中洲,二等
2020-06-10,4270,360,351,711,中洲,二等
2020-06-11,4270,397,347,744,中洲,二等
2020-06-12,4270,529,403,932,中洲,二等
2020-06-13,4270,418,387,805,中洲,二等
2020-06-14,4270,382,500,882,中洲,二等
2020-06-15,4270,397,448,845,中洲,二等
2020-06-16,4270,369,347,716,中洲,二等
2020-06-17,4270,367,349,716,中洲,二等
2020-06-18,4270,402,371,773,中洲,二等
2020-06-19,4270,472,373,845,中洲,二等
2020-06-20,4270,389,325,714,中洲,二等
2020-06-21,4270,331,462,793,中洲,二等
2020-06-22,4270,367,375,742,中洲,二等
2020-06-23,4270,365,367,732,中洲,二等
2020-06-24,4270,558,406,964,中洲,二等
2020-06-25,4270,466,339,805,中洲,二等
2020-06-26,4270,391,385,776,中洲,二等
2020-06-27,4270,352,385,737,中洲,二等
2020-06-28,4270,317,482,799,中洲,二等
2020-06-29,4270,318,379,697,中洲,二等
2020-06-30,4270,339,322,661,中洲,二等
2020-07-01,4270,352,314,666,中洲,二等
2020-07-02,4270,341,330,671,中洲,二等
2020-07-03,4270,466,415,881,中洲,二等
2020-07-04,4270,361,338,699,中洲,二等
2020-07-05,4270,321,355,676,中洲,二等
2020-07-06,4270,389,376,765,中洲,二等
2020-07-07,4270,343,347,690,中洲,二等
2020-07-08,4270,370,361,731,中洲,二等
2020-07-09,4270,377,381,758,中洲,二等
2020-07-10,4270,429,386,815,中洲,二等
2020-07-11,4270,360,340,700,中洲,二等
2020-07-12,4270,340,366,706,中洲,二等
2020-07-13,4270,343,365,708,中洲,二等
2020-07-14,4270,332,357,689,中洲,二等
2020-07-15,4270,361,306,667,中洲,二等
2020-07-16,4270,335,341,676,中洲,二等
2020-07-17,4270,432,396,828,中洲,二等
2020-07-18,4270,383,351,734,中洲,二等
2020-07-19,4270,374,430,804,中洲,二等
2020-07-20,4270,376,360,736,中洲,二等
2020-07-21,4270,341,353,694,中洲,二等
2020-07-22,4270,354,357,711,中洲,二等
2020-07-23,4270,326,325,651,中洲,二等
2020-07-24,4270,412,379,791,中洲,二等
2020-07-25,4270,345,336,681,中洲,二等
2020-07-26,4270,300,361,661,中洲,二等
2020-07-27,4270,361,359,720,中洲,二等
2020-07-28,4270,395,387,782,中洲,二等
2020-07-29,4270,338,346,684,中洲,二等
2020-07-30,4270,306,327,633,中洲,二等
2020-07-31,4270,417,359,776,中洲,二等
2020-08-01,4270,324,292,616,中洲,二等
2020-08-02,4270,328,343,671,中洲,二等
2020-08-03,4270,339,346,685,中洲,二等
2020-08-04,4270,333,319,652,中洲,二等
2020-08-05,4270,359,360,719,中洲,二等
2020-08-06,4270,364,363,727,中洲,二等
2020-08-07,4270,414,378,792,中洲,二等
2020-08-08,4270,338,323,661,中洲,二等
2020-08-09,4270,361,392,753,中洲,二等
2020-08-10,4270,362,400,762,中洲,二等
2020-08-11,4270,308,315,623,中洲,二等
2020-08-12,4270,342,352,694,中洲,二等
2020-08-13,4270,346,352,698,中洲,二等
2020-08-14,4270,382,364,746,中洲,二等
2020-08-15,4270,362,355,717,中洲,二等
2020-08-16,4270,378,391,769,中洲,二等
2020-08-17,4270,354,348,702,中洲,二等
2020-08-18,4270,362,367,729,中洲,二等
2020-08-19,4270,337,339,676,中洲,二等
2020-08-20,4270,345,341,686,中洲,二等
2020-08-21,4270,362,339,701,中洲,二等
2020-08-22,4270,314,320,634,中洲,二等
2020-08-23,4270,339,349,688,中洲,二等
2020-08-24,4270,356,352,708,中洲,二等
2020-08-25,4270,347,339,686,中洲,二等
2020-08-26,4270,304,303,607,中洲,二等
2020-08-27,4270,278,304,582,中洲,二等
2020-08-28,4270,346,351,697,中洲,二等
2020-08-29,4270,307,296,603,中洲,二等
2020-08-30,4270,281,740,1021,中洲,二等
2020-08-31,4270,442,383,825,中洲,二等
2020-09-01,4270,377,333,710,中洲,二等
2020-09-02,4270,318,311,629,中洲,二等
2020-09-03,4270,359,351,710,中洲,二等
2020-09-04,4270,388,388,776,中洲,二等
2020-09-05,4270,338,364,702,中洲,二等
2020-09-06,4270,407,404,811,中洲,二等
2020-09-07,4270,354,347,701,中洲,二等
2020-09-08,4270,345,348,693,中洲,二等
2020-09-09,4270,354,345,699,中洲,二等
2020-09-10,4270,392,385,777,中洲,二等
2020-09-11,4270,449,440,889,中洲,二等
2020-09-12,4270,391,347,738,中洲,二等
2020-09-13,4270,413,514,927,中洲,二等
2020-09-14,4270,397,410,807,中洲,二等
2020-09-15,4270,352,364,716,中洲,二等
2020-09-16,4270,360,330,690,中洲,二等
2020-09-17,4270,384,371,755,中洲,二等
2020-09-18,4270,616,451,1067,中洲,二等
2020-09-19,4270,415,350,765,中洲,二等
2020-09-20,4270,416,535,951,中洲,二等
2020-09-21,4270,418,425,843,中洲,二等
2020-09-22,4270,358,364,722,中洲,二等
2020-09-23,4270,365,363,728,中洲,二等
2020-09-24,4270,404,367,771,中洲,二等
2020-09-25,4270,503,405,908,中洲,二等
2020-09-26,4270,432,387,819,中洲,二等
2020-09-27,4270,371,459,830,中洲,二等
2020-09-28,4270,397,419,816,中洲,二等
2020-09-29,4270,394,387,781,中洲,二等
2020-09-30,4270,604,478,1082,中洲,二等
2020-10-01,4270,479,392,871,中洲,二等
2020-10-02,4270,383,362,745,中洲,二等
2020-10-03,4270,312,333,645,中洲,二等
2020-10-04,4270,352,563,915,中洲,二等
2020-10-05,4270,366,389,755,中洲,二等
2020-10-06,4270,368,351,719,中洲,二等
2020-10-07,4270,359,328,687,中洲,二等
2020-10-08,4270,571,485,1056,中洲,二等
2020-10-09,4270,518,434,952,中洲,二等
2020-10-10,4270,362,379,741,中洲,二等
2020-10-11,4270,459,554,1013,中洲,二等
2020-10-12,4270,387,431,818,中洲,二等
2020-10-13,4270,367,371,738,中洲,二等
2020-10-14,4270,357,357,714,中洲,二等
2020-10-15,4270,394,358,752,中洲,二等
2020-10-16,4270,578,454,1032,中洲,二等
2020-10-17,4270,454,415,869,中洲,二等
2020-10-18,4270,400,525,925,中洲,二等
2020-10-19,4270,405,431,836,中洲,二等
2020-10-20,4270,367,346,713,中洲,二等
2020-10-21,4270,361,351,712,中洲,二等
2020-10-22,4270,369,379,748,中洲,二等
2020-10-23,4270,566,423,989,中洲,二等
2020-10-24,4270,398,357,755,中洲,二等
2020-10-25,4270,356,487,843,中洲,二等
2020-10-26,4270,364,391,755,中洲,二等
2020-10-27,4270,346,345,691,中洲,二等
2020-10-28,4270,346,318,664,中洲,二等
2020-10-29,4270,362,376,738,中洲,二等
2020-10-30,4270,583,435,1018,中洲,二等
2020-10-31,4270,382,370,752,中洲,二等
2020-11-01,4270,380,486,866,中洲,二等
2020-11-02,4270,361,395,756,中洲,二等
2020-11-03,4270,340,327,667,中洲,二等
2020-11-04,4270,329,341,670,中洲,二等
2020-11-05,4270,351,334,685,中洲,二等
2020-11-06,4270,529,442,971,中洲,二等
2020-11-07,4270,379,303,682,中洲,二等
2020-11-08,4270,362,438,800,中洲,二等
2020-11-09,4270,361,398,759,中洲,二等
2020-11-10,4270,369,347,716,中洲,二等
2020-11-11,4270,340,321,661,中洲,二等
2020-11-12,4270,362,335,697,中洲,二等
2020-11-13,4270,597,463,1060,中洲,二等
2020-11-14,4270,395,342,737,中洲,二等
2020-11-15,4270,387,574,961,中洲,二等
2020-11-16,4270,414,444,858,中洲,二等
2020-11-17,4270,365,364,729,中洲,二等
2020-11-18,4270,377,358,735,中洲,二等
2020-11-19,4270,380,354,734,中洲,二等
2020-11-20,4270,560,442,1002,中洲,二等
2020-11-21,4270,427,350,777,中洲,二等
2020-11-22,4270,347,389,736,中洲,二等
2020-11-23,4270,394,490,884,中洲,二等
2020-11-24,4270,356,373,729,中洲,二等
2020-11-25,4270,373,383,756,中洲,二等
2020-11-26,4270,381,357,738,中洲,二等
2020-11-27,4270,628,474,1102,中洲,二等
2020-11-28,4270,472,438,910,中洲,二等
2020-11-29,4270,363,486,849,中洲,二等
2020-11-30,4270,353,415,768,中洲,二等
2020-12-01,4270,367,370,737,中洲,二等
2020-12-02,4270,364,350,714,中洲,二等
2020-12-03,4270,384,362,746,中洲,二等
2020-12-04,4270,539,450,989,中洲,二等
2020-12-05,4270,457,400,857,中洲,二等
2020-12-06,4270,441,553,994,中洲,二等
2020-12-07,4270,388,410,798,中洲,二等
2020-12-08,4270,354,362,716,中洲,二等
2020-12-09,4270,391,358,749,中洲,二等
2020-12-10,4270,382,360,742,中洲,二等
2020-12-11,4270,620,447,1067,中洲,二等
2020-12-12,4270,428,421,849,中洲,二等
2020-12-13,4270,436,533,969,中洲,二等
2020-12-14,4270,376,439,815,中洲,二等
2020-12-15,4270,358,352,710,中洲,二等
2020-12-16,4270,349,357,706,中洲,二等
2020-12-17,4270,375,347,722,中洲,二等
2020-12-18,4270,600,479,1079,中洲,二等
2020-12-19,4270,400,342,742,中洲,二等
2020-12-20,4270,399,532,931,中洲,二等
2020-12-21,4270,353,409,762,中洲,二等
2020-12-22,4270,355,362,717,中洲,二等
2020-12-23,4270,359,365,724,中洲,二等
2020-12-24,4270,501,346,847,中洲,二等
2020-12-25,4270,535,465,1000,中洲,二等
2020-12-26,4270,346,356,702,中洲,二等
2020-12-27,4270,376,498,874,中洲,二等
2020-12-28,4270,355,424,779,中洲,二等
2020-12-29,4270,364,359,723,中洲,二等
2020-12-30,4270,395,348,743,中洲,二等
2020-12-31,4270,582,430,1012,中洲,二等
2020-01-01,4271,701,1139,1840,長榮大學,簡易
2020-01-02,4271,914,1107,2021,長榮大學,簡易
2020-01-03,4271,1593,977,2570,長榮大學,簡易
2020-01-04,4271,658,578,1236,長榮大學,簡易
2020-01-05,4271,433,821,1254,長榮大學,簡易
2020-01-06,4271,847,1124,1971,長榮大學,簡易
2020-01-07,4271,912,948,1860,長榮大學,簡易
2020-01-08,4271,1165,1117,2282,長榮大學,簡易
2020-01-09,4271,1814,1195,3009,長榮大學,簡易
2020-01-10,4271,1593,735,2328,長榮大學,簡易
2020-01-11,4271,476,339,815,長榮大學,簡易
2020-01-12,4271,351,381,732,長榮大學,簡易
2020-01-13,4271,443,512,955,長榮大學,簡易
2020-01-14,4271,438,469,907,長榮大學,簡易
2020-01-15,4271,414,420,834,長榮大學,簡易
2020-01-16,4271,404,367,771,長榮大學,簡易
2020-01-17,4271,490,400,890,長榮大學,簡易
2020-01-18,4271,292,246,538,長榮大學,簡易
2020-01-19,4271,250,255,505,長榮大學,簡易
2020-01-20,4271,364,335,699,長榮大學,簡易
2020-01-21,4271,378,352,730,長榮大學,簡易
2020-01-22,4271,377,329,706,長榮大學,簡易
2020-01-23,4271,267,175,442,長榮大學,簡易
2020-01-24,4271,103,94,197,長榮大學,簡易
2020-01-25,4271,182,181,363,長榮大學,簡易
2020-01-26,4271,116,125,241,長榮大學,簡易
2020-01-27,4271,115,121,236,長榮大學,簡易
2020-01-28,4271,147,179,326,長榮大學,簡易
2020-01-29,4271,200,214,414,長榮大學,簡易
2020-01-30,4271,268,323,591,長榮大學,簡易
2020-01-31,4271,268,299,567,長榮大學,簡易
2020-02-01,4271,248,257,505,長榮大學,簡易
2020-02-02,4271,212,217,429,長榮大學,簡易
2020-02-03,4271,298,362,660,長榮大學,簡易
2020-02-04,4271,300,287,587,長榮大學,簡易
2020-02-05,4271,292,317,609,長榮大學,簡易
2020-02-06,4271,269,269,538,長榮大學,簡易
2020-02-07,4271,351,298,649,長榮大學,簡易
2020-02-08,4271,208,198,406,長榮大學,簡易
2020-02-09,4271,223,251,474,長榮大學,簡易
2020-02-10,4271,321,331,652,長榮大學,簡易
2020-02-11,4271,277,291,568,長榮大學,簡易
2020-02-12,4271,289,288,577,長榮大學,簡易
2020-02-13,4271,286,289,575,長榮大學,簡易
2020-02-14,4271,360,346,706,長榮大學,簡易
2020-02-15,4271,276,251,527,長榮大學,簡易
2020-02-16,4271,212,201,413,長榮大學,簡易
2020-02-17,4271,289,323,612,長榮大學,簡易
2020-02-18,4271,283,289,572,長榮大學,簡易
2020-02-19,4271,300,329,629,長榮大學,簡易
2020-02-20,4271,302,295,597,長榮大學,簡易
2020-02-21,4271,307,265,572,長榮大學,簡易
2020-02-22,4271,210,214,424,長榮大學,簡易
2020-02-23,4271,158,201,359,長榮大學,簡易
2020-02-24,4271,342,372,714,長榮大學,簡易
2020-02-25,4271,315,352,667,長榮大學,簡易
2020-02-26,4271,341,344,685,長榮大學,簡易
2020-02-27,4271,384,351,735,長榮大學,簡易
2020-02-28,4271,242,248,490,長榮大學,簡易
2020-02-29,4271,324,494,818,長榮大學,簡易
2020-03-01,4271,560,1134,1694,長榮大學,簡易
2020-03-02,4271,835,1131,1966,長榮大學,簡易
2020-03-03,4271,932,953,1885,長榮大學,簡易
2020-03-04,4271,910,939,1849,長榮大學,簡易
2020-03-05,4271,1124,1002,2126,長榮大學,簡易
2020-03-06,4271,1764,851,2615,長榮大學,簡易
2020-03-07,4271,718,525,1243,長榮大學,簡易
2020-03-08,4271,432,972,1404,長榮大學,簡易
2020-03-09,4271,811,1208,2019,長榮大學,簡易
2020-03-10,4271,900,904,1804,長榮大學,簡易
2020-03-11,4271,931,929,1860,長榮大學,簡易
2020-03-12,4271,1054,897,1951,長榮大學,簡易
2020-03-13,4271,1821,866,2687,長榮大學,簡易
2020-03-14,4271,675,519,1194,長榮大學,簡易
2020-03-15,4271,428,1029,1457,長榮大學,簡易
2020-03-16,4271,804,1283,2087,長榮大學,簡易
2020-03-17,4271,901,949,1850,長榮大學,簡易
2020-03-18,4271,936,941,1877,長榮大學,簡易
2020-03-19,4271,1004,890,1894,長榮大學,簡易
2020-03-20,4271,1609,767,2376,長榮大學,簡易
2020-03-21,4271,515,405,920,長榮大學,簡易
2020-03-22,4271,329,823,1152,長榮大學,簡易
2020-03-23,4271,741,1133,1874,長榮大學,簡易
2020-03-24,4271,759,810,1569,長榮大學,簡易
2020-03-25,4271,782,807,1589,長榮大學,簡易
2020-03-26,4271,876,837,1713,長榮大學,簡易
2020-03-27,4271,1451,779,2230,長榮大學,簡易
2020-03-28,4271,620,510,1130,長榮大學,簡易
2020-03-29,4271,320,735,1055,長榮大學,簡易
2020-03-30,4271,739,1068,1807,長榮大學,簡易
2020-03-31,4271,899,806,1705,長榮大學,簡易
2020-04-01,4271,2011,727,2738,長榮大學,簡易
2020-04-02,4271,808,220,1028,長榮大學,簡易
2020-04-03,4271,283,226,509,長榮大學,簡易
2020-04-04,4271,170,203,373,長榮大學,簡易
2020-04-05,4271,195,1178,1373,長榮大學,簡易
2020-04-06,4271,636,1303,1939,長榮大學,簡易
2020-04-07,4271,727,834,1561,長榮大學,簡易
2020-04-08,4271,762,762,1524,長榮大學,簡易
2020-04-09,4271,896,772,1668,長榮大學,簡易
2020-04-10,4271,1337,714,2051,長榮大學,簡易
2020-04-11,4271,542,426,968,長榮大學,簡易
2020-04-12,4271,325,662,987,長榮大學,簡易
2020-04-13,4271,645,1023,1668,長榮大學,簡易
2020-04-14,4271,735,747,1482,長榮大學,簡易
2020-04-15,4271,770,767,1537,長榮大學,簡易
2020-04-16,4271,1068,777,1845,長榮大學,簡易
2020-04-17,4271,1763,1134,2897,長榮大學,簡易
2020-04-18,4271,932,819,1751,長榮大學,簡易
2020-04-19,4271,467,885,1352,長榮大學,簡易
2020-04-20,4271,644,1033,1677,長榮大學,簡易
2020-04-21,4271,714,777,1491,長榮大學,簡易
2020-04-22,4271,717,681,1398,長榮大學,簡易
2020-04-23,4271,827,719,1546,長榮大學,簡易
2020-04-24,4271,1148,673,1821,長榮大學,簡易
2020-04-25,4271,411,342,753,長榮大學,簡易
2020-04-26,4271,216,487,703,長榮大學,簡易
2020-04-27,4271,590,896,1486,長榮大學,簡易
2020-04-28,4271,718,744,1462,長榮大學,簡易
2020-04-29,4271,767,714,1481,長榮大學,簡易
2020-04-30,4271,1753,707,2460,長榮大學,簡易
2020-05-01,4271,722,342,1064,長榮大學,簡易
2020-05-02,4271,360,315,675,長榮大學,簡易
2020-05-03,4271,239,951,1190,長榮大學,簡易
2020-05-04,4271,662,1255,1917,長榮大學,簡易
2020-05-05,4271,727,813,1540,長榮大學,簡易
2020-05-06,4271,795,791,1586,長榮大學,簡易
2020-05-07,4271,1034,808,1842,長榮大學,簡易
2020-05-08,4271,1712,698,2410,長榮大學,簡易
2020-05-09,4271,503,326,829,長榮大學,簡易
2020-05-10,4271,236,912,1148,長榮大學,簡易
2020-05-11,4271,669,1187,1856,長榮大學,簡易
2020-05-12,4271,716,776,1492,長榮大學,簡易
2020-05-13,4271,856,864,1720,長榮大學,簡易
2020-05-14,4271,972,855,1827,長榮大學,簡易
2020-05-15,4271,1483,777,2260,長榮大學,簡易
2020-05-16,4271,606,475,1081,長榮大學,簡易
2020-05-17,4271,338,722,1060,長榮大學,簡易
2020-05-18,4271,696,1103,1799,長榮大學,簡易
2020-05-19,4271,803,844,1647,長榮大學,簡易
2020-05-20,4271,905,876,1781,長榮大學,簡易
2020-05-21,4271,994,882,1876,長榮大學,簡易
2020-05-22,4271,1434,658,2092,長榮大學,簡易
2020-05-23,4271,631,467,1098,長榮大學,簡易
2020-05-24,4271,377,864,1241,長榮大學,簡易
2020-05-25,4271,668,1099,1767,長榮大學,簡易
2020-05-26,4271,806,793,1599,長榮大學,簡易
2020-05-27,4271,861,862,1723,長榮大學,簡易
2020-05-28,4271,1060,918,1978,長榮大學,簡易
2020-05-29,4271,1665,764,2429,長榮大學,簡易
2020-05-30,4271,680,493,1173,長榮大學,簡易
2020-05-31,4271,384,914,1298,長榮大學,簡易
2020-06-01,4271,731,1191,1922,長榮大學,簡易
2020-06-02,4271,821,875,1696,長榮大學,簡易
2020-06-03,4271,880,910,1790,長榮大學,簡易
2020-06-04,4271,1037,898,1935,長榮大學,簡易
2020-06-05,4271,1401,895,2296,長榮大學,簡易
2020-06-06,4271,993,774,1767,長榮大學,簡易
2020-06-07,4271,467,813,1280,長榮大學,簡易
2020-06-08,4271,705,1089,1794,長榮大學,簡易
2020-06-09,4271,922,953,1875,長榮大學,簡易
2020-06-10,4271,917,903,1820,長榮大學,簡易
2020-06-11,4271,1037,862,1899,長榮大學,簡易
2020-06-12,4271,1572,825,2397,長榮大學,簡易
2020-06-13,4271,655,522,1177,長榮大學,簡易
2020-06-14,4271,389,893,1282,長榮大學,簡易
2020-06-15,4271,735,1130,1865,長榮大學,簡易
2020-06-16,4271,831,874,1705,長榮大學,簡易
2020-06-17,4271,848,850,1698,長榮大學,簡易
2020-06-18,4271,972,842,1814,長榮大學,簡易
2020-06-19,4271,1362,832,2194,長榮大學,簡易
2020-06-20,4271,663,513,1176,長榮大學,簡易
2020-06-21,4271,436,770,1206,長榮大學,簡易
2020-06-22,4271,711,999,1710,長榮大學,簡易
2020-06-23,4271,843,843,1686,長榮大學,簡易
2020-06-24,4271,1866,784,2650,長榮大學,簡易
2020-06-25,4271,683,334,1017,長榮大學,簡易
2020-06-26,4271,371,331,702,長榮大學,簡易
2020-06-27,4271,329,442,771,長榮大學,簡易
2020-06-28,4271,252,978,1230,長榮大學,簡易
2020-06-29,4271,670,1133,1803,長榮大學,簡易
2020-06-30,4271,764,785,1549,長榮大學,簡易
2020-07-01,4271,800,807,1607,長榮大學,簡易
2020-07-02,4271,932,877,1809,長榮大學,簡易
2020-07-03,4271,1212,906,2118,長榮大學,簡易
2020-07-04,4271,694,455,1149,長榮大學,簡易
2020-07-05,4271,401,307,708,長榮大學,簡易
2020-07-06,4271,478,445,923,長榮大學,簡易
2020-07-07,4271,401,383,784,長榮大學,簡易
2020-07-08,4271,388,390,778,長榮大學,簡易
2020-07-09,4271,367,369,736,長榮大學,簡易
2020-07-10,4271,436,357,793,長榮大學,簡易
2020-07-11,4271,262,223,485,長榮大學,簡易
2020-07-12,4271,226,275,501,長榮大學,簡易
2020-07-13,4271,383,407,790,長榮大學,簡易
2020-07-14,4271,345,361,706,長榮大學,簡易
2020-07-15,4271,413,418,831,長榮大學,簡易
2020-07-16,4271,406,377,783,長榮大學,簡易
2020-07-17,4271,442,431,873,長榮大學,簡易
2020-07-18,4271,258,212,470,長榮大學,簡易
2020-07-19,4271,208,261,469,長榮大學,簡易
2020-07-20,4271,434,444,878,長榮大學,簡易
2020-07-21,4271,359,363,722,長榮大學,簡易
2020-07-22,4271,400,405,805,長榮大學,簡易
2020-07-23,4271,385,372,757,長榮大學,簡易
2020-07-24,4271,402,360,762,長榮大學,簡易
2020-07-25,4271,260,214,474,長榮大學,簡易
2020-07-26,4271,179,218,397,長榮大學,簡易
2020-07-27,4271,355,366,721,長榮大學,簡易
2020-07-28,4271,332,365,697,長榮大學,簡易
2020-07-29,4271,348,367,715,長榮大學,簡易
2020-07-30,4271,361,347,708,長榮大學,簡易
2020-07-31,4271,397,329,726,長榮大學,簡易
2020-08-01,4271,230,214,444,長榮大學,簡易
2020-08-02,4271,194,231,425,長榮大學,簡易
2020-08-03,4271,358,369,727,長榮大學,簡易
2020-08-04,4271,320,345,665,長榮大學,簡易
2020-08-05,4271,430,455,885,長榮大學,簡易
2020-08-06,4271,329,304,633,長榮大學,簡易
2020-08-07,4271,393,322,715,長榮大學,簡易
2020-08-08,4271,224,171,395,長榮大學,簡易
2020-08-09,4271,158,230,388,長榮大學,簡易
2020-08-10,4271,322,350,672,長榮大學,簡易
2020-08-11,4271,332,345,677,長榮大學,簡易
2020-08-12,4271,371,362,733,長榮大學,簡易
2020-08-13,4271,383,356,739,長榮大學,簡易
2020-08-14,4271,381,361,742,長榮大學,簡易
2020-08-15,4271,223,218,441,長榮大學,簡易
2020-08-16,4271,588,608,1196,長榮大學,簡易
2020-08-17,4271,380,344,724,長榮大學,簡易
2020-08-18,4271,292,315,607,長榮大學,簡易
2020-08-19,4271,352,353,705,長榮大學,簡易
2020-08-20,4271,326,355,681,長榮大學,簡易
2020-08-21,4271,359,341,700,長榮大學,簡易
2020-08-22,4271,267,224,491,長榮大學,簡易
2020-08-23,4271,228,225,453,長榮大學,簡易
2020-08-24,4271,329,373,702,長榮大學,簡易
2020-08-25,4271,352,334,686,長榮大學,簡易
2020-08-26,4271,333,332,665,長榮大學,簡易
2020-08-27,4271,330,311,641,長榮大學,簡易
2020-08-28,4271,353,295,648,長榮大學,簡易
2020-08-29,4271,223,203,426,長榮大學,簡易
2020-08-30,4271,199,149,348,長榮大學,簡易
2020-08-31,4271,369,393,762,長榮大學,簡易
2020-09-01,4271,374,399,773,長榮大學,簡易
2020-09-02,4271,346,336,682,長榮大學,簡易
2020-09-03,4271,391,414,805,長榮大學,簡易
2020-09-04,4271,441,388,829,長榮大學,簡易
2020-09-05,4271,506,515,1021,長榮大學,簡易
2020-09-06,4271,768,900,1668,長榮大學,簡易
2020-09-07,4271,680,697,1377,長榮大學,簡易
2020-09-08,4271,598,591,1189,長榮大學,簡易
2020-09-09,4271,993,962,1955,長榮大學,簡易
2020-09-10,4271,1236,588,1824,長榮大學,簡易
2020-09-11,4271,805,537,1342,長榮大學,簡易
2020-09-12,4271,503,480,983,長榮大學,簡易
2020-09-13,4271,639,1405,2044,長榮大學,簡易
2020-09-14,4271,982,1168,2150,長榮大學,簡易
2020-09-15,4271,981,975,1956,長榮大學,簡易
2020-09-16,4271,1010,969,1979,長榮大學,簡易
2020-09-17,4271,1031,978,2009,長榮大學,簡易
2020-09-18,4271,2031,907,2938,長榮大學,簡易
2020-09-19,4271,927,747,1674,長榮大學,簡易
2020-09-20,4271,572,1315,1887,長榮大學,簡易
2020-09-21,4271,891,1240,2131,長榮大學,簡易
2020-09-22,4271,942,946,1888,長榮大學,簡易
2020-09-23,4271,925,937,1862,長榮大學,簡易
2020-09-24,4271,1016,956,1972,長榮大學,簡易
2020-09-25,4271,1755,961,2716,長榮大學,簡易
2020-09-26,4271,852,821,1673,長榮大學,簡易
2020-09-27,4271,579,1017,1596,長榮大學,簡易
2020-09-28,4271,867,1180,2047,長榮大學,簡易
2020-09-29,4271,943,894,1837,長榮大學,簡易
2020-09-30,4271,2478,865,3343,長榮大學,簡易
2020-10-01,4271,1058,366,1424,長榮大學,簡易
2020-10-02,4271,341,301,642,長榮大學,簡易
2020-10-03,4271,262,334,596,長榮大學,簡易
2020-10-04,4271,346,1659,2005,長榮大學,簡易
2020-10-05,4271,887,1584,2471,長榮大學,簡易
2020-10-06,4271,963,957,1920,長榮大學,簡易
2020-10-07,4271,1058,997,2055,長榮大學,簡易
2020-10-08,4271,2043,890,2933,長榮大學,簡易
2020-10-09,4271,904,489,1393,長榮大學,簡易
2020-10-10,4271,516,474,990,長榮大學,簡易
2020-10-11,4271,501,1419,1920,長榮大學,簡易
2020-10-12,4271,809,1306,2115,長榮大學,簡易
2020-10-13,4271,867,924,1791,長榮大學,簡易
2020-10-14,4271,918,888,1806,長榮大學,簡易
2020-10-15,4271,1001,955,1956,長榮大學,簡易
2020-10-16,4271,1797,903,2700,長榮大學,簡易
2020-10-17,4271,821,733,1554,長榮大學,簡易
2020-10-18,4271,566,1095,1661,長榮大學,簡易
2020-10-19,4271,842,1161,2003,長榮大學,簡易
2020-10-20,4271,932,951,1883,長榮大學,簡易
2020-10-21,4271,896,894,1790,長榮大學,簡易
2020-10-22,4271,993,893,1886,長榮大學,簡易
2020-10-23,4271,1988,915,2903,長榮大學,簡易
2020-10-24,4271,822,642,1464,長榮大學,簡易
2020-10-25,4271,452,1075,1527,長榮大學,簡易
2020-10-26,4271,814,1204,2018,長榮大學,簡易
2020-10-27,4271,834,947,1781,長榮大學,簡易
2020-10-28,4271,910,907,1817,長榮大學,簡易
2020-10-29,4271,1026,923,1949,長榮大學,簡易
2020-10-30,4271,1975,911,2886,長榮大學,簡易
2020-10-31,4271,684,507,1191,長榮大學,簡易
2020-11-01,4271,458,1076,1534,長榮大學,簡易
2020-11-02,4271,821,1224,2045,長榮大學,簡易
2020-11-03,4271,824,853,1677,長榮大學,簡易
2020-11-04,4271,873,856,1729,長榮大學,簡易
2020-11-05,4271,914,819,1733,長榮大學,簡易
2020-11-06,4271,1538,821,2359,長榮大學,簡易
2020-11-07,4271,581,513,1094,長榮大學,簡易
2020-11-08,4271,331,783,1114,長榮大學,簡易
2020-11-09,4271,749,1061,1810,長榮大學,簡易
2020-11-10,4271,803,792,1595,長榮大學,簡易
2020-11-11,4271,856,834,1690,長榮大學,簡易
2020-11-12,4271,893,824,1717,長榮大學,簡易
2020-11-13,4271,2071,909,2980,長榮大學,簡易
2020-11-14,4271,754,588,1342,長榮大學,簡易
2020-11-15,4271,548,1220,1768,長榮大學,簡易
2020-11-16,4271,836,1286,2122,長榮大學,簡易
2020-11-17,4271,912,931,1843,長榮大學,簡易
2020-11-18,4271,1000,966,1966,長榮大學,簡易
2020-11-19,4271,1092,962,2054,長榮大學,簡易
2020-11-20,4271,2154,832,2986,長榮大學,簡易
2020-11-21,4271,736,439,1175,長榮大學,簡易
2020-11-22,4271,433,608,1041,長榮大學,簡易
2020-11-23,4271,661,1689,2350,長榮大學,簡易
2020-11-24,4271,896,1234,2130,長榮大學,簡易
2020-11-25,4271,1079,1069,2148,長榮大學,簡易
2020-11-26,4271,1001,949,1950,長榮大學,簡易
2020-11-27,4271,1845,958,2803,長榮大學,簡易
2020-11-28,4271,822,693,1515,長榮大學,簡易
2020-11-29,4271,506,1054,1560,長榮大學,簡易
2020-11-30,4271,900,1265,2165,長榮大學,簡易
2020-12-01,4271,894,892,1786,長榮大學,簡易
2020-12-02,4271,974,970,1944,長榮大學,簡易
2020-12-03,4271,1066,930,1996,長榮大學,簡易
2020-12-04,4271,1928,859,2787,長榮大學,簡易
2020-12-05,4271,765,612,1377,長榮大學,簡易
2020-12-06,4271,479,1090,1569,長榮大學,簡易
2020-12-07,4271,849,1352,2201,長榮大學,簡易
2020-12-08,4271,887,925,1812,長榮大學,簡易
2020-12-09,4271,940,913,1853,長榮大學,簡易
2020-12-10,4271,1010,904,1914,長榮大學,簡易
2020-12-11,4271,1898,917,2815,長榮大學,簡易
2020-12-12,4271,820,618,1438,長榮大學,簡易
2020-12-13,4271,495,1138,1633,長榮大學,簡易
2020-12-14,4271,823,1233,2056,長榮大學,簡易
2020-12-15,4271,899,932,1831,長榮大學,簡易
2020-12-16,4271,1048,1041,2089,長榮大學,簡易
2020-12-17,4271,1063,939,2002,長榮大學,簡易
2020-12-18,4271,1865,917,2782,長榮大學,簡易
2020-12-19,4271,881,690,1571,長榮大學,簡易
2020-12-20,4271,584,1139,1723,長榮大學,簡易
2020-12-21,4271,843,1286,2129,長榮大學,簡易
2020-12-22,4271,941,955,1896,長榮大學,簡易
2020-12-23,4271,1029,961,1990,長榮大學,簡易
2020-12-24,4271,2061,854,2915,長榮大學,簡易
2020-12-25,4271,1039,604,1643,長榮大學,簡易
2020-12-26,4271,496,511,1007,長榮大學,簡易
2020-12-27,4271,422,1257,1679,長榮大學,簡易
2020-12-28,4271,817,1341,2158,長榮大學,簡易
2020-12-29,4271,903,892,1795,長榮大學,簡易
2020-12-30,4271,1115,978,2093,長榮大學,簡易
2020-12-31,4271,2331,855,3186,長榮大學,簡易
2020-01-01,4272,2787,2493,5280,沙崙,乙簡
2020-01-02,4272,2212,1917,4129,沙崙,乙簡
2020-01-03,4272,2424,2538,4962,沙崙,乙簡
2020-01-04,4272,2421,2346,4767,沙崙,乙簡
2020-01-05,4272,2940,2499,5439,沙崙,乙簡
2020-01-06,4272,1797,1717,3514,沙崙,乙簡
2020-01-07,4272,1523,1385,2908,沙崙,乙簡
2020-01-08,4272,1689,1692,3381,沙崙,乙簡
2020-01-09,4272,2277,2614,4891,沙崙,乙簡
2020-01-10,4272,5022,5023,10045,沙崙,乙簡
2020-01-11,4272,4214,3470,7684,沙崙,乙簡
2020-01-12,4272,3887,4176,8063,沙崙,乙簡
2020-01-13,4272,2464,2673,5137,沙崙,乙簡
2020-01-14,4272,1954,1937,3891,沙崙,乙簡
2020-01-15,4272,1904,1878,3782,沙崙,乙簡
2020-01-16,4272,1856,1975,3831,沙崙,乙簡
2020-01-17,4272,2855,2561,5416,沙崙,乙簡
2020-01-18,4272,2977,2521,5498,沙崙,乙簡
2020-01-19,4272,2876,2792,5668,沙崙,乙簡
2020-01-20,4272,2318,2277,4595,沙崙,乙簡
2020-01-21,4272,2471,1937,4408,沙崙,乙簡
2020-01-22,4272,4303,1848,6151,沙崙,乙簡
2020-01-23,4272,4259,2537,6796,沙崙,乙簡
2020-01-24,4272,2797,1754,4551,沙崙,乙簡
2020-01-25,4272,3113,1734,4847,沙崙,乙簡
2020-01-26,4272,3490,2570,6060,沙崙,乙簡
2020-01-27,4272,3595,3562,7157,沙崙,乙簡
2020-01-28,4272,3012,4041,7053,沙崙,乙簡
2020-01-29,4272,3038,3832,6870,沙崙,乙簡
2020-01-30,4272,2113,1621,3734,沙崙,乙簡
2020-01-31,4272,2030,2039,4069,沙崙,乙簡
2020-02-01,4272,2015,2157,4172,沙崙,乙簡
2020-02-02,4272,2199,2266,4465,沙崙,乙簡
2020-02-03,4272,1881,1451,3332,沙崙,乙簡
2020-02-04,4272,1467,1340,2807,沙崙,乙簡
2020-02-05,4272,1564,1287,2851,沙崙,乙簡
2020-02-06,4272,1641,1351,2992,沙崙,乙簡
2020-02-07,4272,2607,2033,4640,沙崙,乙簡
2020-02-08,4272,2200,1658,3858,沙崙,乙簡
2020-02-09,4272,2651,2592,5243,沙崙,乙簡
2020-02-10,4272,1909,1865,3774,沙崙,乙簡
2020-02-11,4272,1609,1490,3099,沙崙,乙簡
2020-02-12,4272,1577,1466,3043,沙崙,乙簡
2020-02-13,4272,1594,1444,3038,沙崙,乙簡
2020-02-14,4272,2176,1879,4055,沙崙,乙簡
2020-02-15,4272,1937,1730,3667,沙崙,乙簡
2020-02-16,4272,2080,2002,4082,沙崙,乙簡
2020-02-17,4272,1543,1535,3078,沙崙,乙簡
2020-02-18,4272,1292,1228,2520,沙崙,乙簡
2020-02-19,4272,1348,1049,2397,沙崙,乙簡
2020-02-20,4272,1415,1289,2704,沙崙,乙簡
2020-02-21,4272,2250,1835,4085,沙崙,乙簡
2020-02-22,4272,2008,1605,3613,沙崙,乙簡
2020-02-23,4272,1971,2179,4150,沙崙,乙簡
2020-02-24,4272,1724,1609,3333,沙崙,乙簡
2020-02-25,4272,1469,1179,2648,沙崙,乙簡
2020-02-26,4272,1634,1366,3000,沙崙,乙簡
2020-02-27,4272,3245,2254,5499,沙崙,乙簡
2020-02-28,4272,3958,1856,5814,沙崙,乙簡
2020-02-29,4272,2250,2010,4260,沙崙,乙簡
2020-03-01,4272,3852,3907,7759,沙崙,乙簡
2020-03-02,4272,1755,1596,3351,沙崙,乙簡
2020-03-03,4272,1033,1053,2086,沙崙,乙簡
2020-03-04,4272,1089,959,2048,沙崙,乙簡
2020-03-05,4272,1195,1200,2395,沙崙,乙簡
2020-03-06,4272,2053,2106,4159,沙崙,乙簡
2020-03-07,4272,1480,1376,2856,沙崙,乙簡
2020-03-08,4272,1977,1906,3883,沙崙,乙簡
2020-03-09,4272,1484,1262,2746,沙崙,乙簡
2020-03-10,4272,1098,971,2069,沙崙,乙簡
2020-03-11,4272,1146,1090,2236,沙崙,乙簡
2020-03-12,4272,1290,1274,2564,沙崙,乙簡
2020-03-13,4272,2427,2428,4855,沙崙,乙簡
2020-03-14,4272,1810,1428,3238,沙崙,乙簡
2020-03-15,4272,2374,2160,4534,沙崙,乙簡
2020-03-16,4272,1592,1469,3061,沙崙,乙簡
2020-03-17,4272,1147,1013,2160,沙崙,乙簡
2020-03-18,4272,1038,977,2015,沙崙,乙簡
2020-03-19,4272,1042,1164,2206,沙崙,乙簡
2020-03-20,4272,1998,2040,4038,沙崙,乙簡
2020-03-21,4272,1343,1147,2490,沙崙,乙簡
2020-03-22,4272,1861,1618,3479,沙崙,乙簡
2020-03-23,4272,1398,1205,2603,沙崙,乙簡
2020-03-24,4272,968,911,1879,沙崙,乙簡
2020-03-25,4272,877,809,1686,沙崙,乙簡
2020-03-26,4272,1019,1086,2105,沙崙,乙簡
2020-03-27,4272,1742,1760,3502,沙崙,乙簡
2020-03-28,4272,1313,962,2275,沙崙,乙簡
2020-03-29,4272,1530,1441,2971,沙崙,乙簡
2020-03-30,4272,1283,1176,2459,沙崙,乙簡
2020-03-31,4272,1259,1497,2756,沙崙,乙簡
2020-04-01,4272,2737,3440,6177,沙崙,乙簡
2020-04-02,4272,3193,2098,5291,沙崙,乙簡
2020-04-03,4272,1306,1280,2586,沙崙,乙簡
2020-04-04,4272,1044,1880,2924,沙崙,乙簡
2020-04-05,4272,3463,2638,6101,沙崙,乙簡
2020-04-06,4272,2083,1628,3711,沙崙,乙簡
2020-04-07,4272,1732,811,2543,沙崙,乙簡
2020-04-08,4272,993,776,1769,沙崙,乙簡
2020-04-09,4272,877,803,1680,沙崙,乙簡
2020-04-10,4272,2174,1769,3943,沙崙,乙簡
2020-04-11,4272,1024,911,1935,沙崙,乙簡
2020-04-12,4272,1366,1243,2609,沙崙,乙簡
2020-04-13,4272,1187,997,2184,沙崙,乙簡
2020-04-14,4272,757,753,1510,沙崙,乙簡
2020-04-15,4272,828,762,1590,沙崙,乙簡
2020-04-16,4272,966,1057,2023,沙崙,乙簡
2020-04-17,4272,1910,1895,3805,沙崙,乙簡
2020-04-18,4272,1348,1210,2558,沙崙,乙簡
2020-04-19,4272,1830,1579,3409,沙崙,乙簡
2020-04-20,4272,1217,1060,2277,沙崙,乙簡
2020-04-21,4272,851,779,1630,沙崙,乙簡
2020-04-22,4272,799,754,1553,沙崙,乙簡
2020-04-23,4272,965,970,1935,沙崙,乙簡
2020-04-24,4272,1614,1724,3338,沙崙,乙簡
2020-04-25,4272,1129,1032,2161,沙崙,乙簡
2020-04-26,4272,1488,1118,2606,沙崙,乙簡
2020-04-27,4272,1104,988,2092,沙崙,乙簡
2020-04-28,4272,900,769,1669,沙崙,乙簡
2020-04-29,4272,790,835,1625,沙崙,乙簡
2020-04-30,4272,1635,1720,3355,沙崙,乙簡
2020-05-01,4272,1916,1861,3777,沙崙,乙簡
2020-05-02,4272,983,965,1948,沙崙,乙簡
2020-05-03,4272,2399,2014,4413,沙崙,乙簡
2020-05-04,4272,1627,1162,2789,沙崙,乙簡
2020-05-05,4272,936,845,1781,沙崙,乙簡
2020-05-06,4272,933,894,1827,沙崙,乙簡
2020-05-07,4272,1160,1348,2508,沙崙,乙簡
2020-05-08,4272,2352,2767,5119,沙崙,乙簡
2020-05-09,4272,1480,1347,2827,沙崙,乙簡
2020-05-10,4272,3062,1822,4884,沙崙,乙簡
2020-05-11,4272,1976,1378,3354,沙崙,乙簡
2020-05-12,4272,1101,978,2079,沙崙,乙簡
2020-05-13,4272,1049,922,1971,沙崙,乙簡
2020-05-14,4272,1264,1164,2428,沙崙,乙簡
2020-05-15,4272,2033,2225,4258,沙崙,乙簡
2020-05-16,4272,1533,1213,2746,沙崙,乙簡
2020-05-17,4272,2148,1816,3964,沙崙,乙簡
2020-05-18,4272,1518,1299,2817,沙崙,乙簡
2020-05-19,4272,1015,807,1822,沙崙,乙簡
2020-05-20,4272,964,887,1851,沙崙,乙簡
2020-05-21,4272,1095,1147,2242,沙崙,乙簡
2020-05-22,4272,1874,2028,3902,沙崙,乙簡
2020-05-23,4272,1362,1182,2544,沙崙,乙簡
2020-05-24,4272,2162,1746,3908,沙崙,乙簡
2020-05-25,4272,1577,1212,2789,沙崙,乙簡
2020-05-26,4272,976,929,1905,沙崙,乙簡
2020-05-27,4272,1011,943,1954,沙崙,乙簡
2020-05-28,4272,1179,1225,2404,沙崙,乙簡
2020-05-29,4272,2252,2456,4708,沙崙,乙簡
2020-05-30,4272,1790,1531,3321,沙崙,乙簡
2020-05-31,4272,2401,2113,4514,沙崙,乙簡
2020-06-01,4272,1683,1364,3047,沙崙,乙簡
2020-06-02,4272,1108,998,2106,沙崙,乙簡
2020-06-03,4272,1118,1081,2199,沙崙,乙簡
2020-06-04,4272,1296,1198,2494,沙崙,乙簡
2020-06-05,4272,2521,2244,4765,沙崙,乙簡
2020-06-06,4272,2201,1825,4026,沙崙,乙簡
2020-06-07,4272,2511,2497,5008,沙崙,乙簡
2020-06-08,4272,1683,1569,3252,沙崙,乙簡
2020-06-09,4272,1256,1124,2380,沙崙,乙簡
2020-06-10,4272,1197,1153,2350,沙崙,乙簡
2020-06-11,4272,1332,1289,2621,沙崙,乙簡
2020-06-12,4272,2538,2110,4648,沙崙,乙簡
2020-06-13,4272,2334,1646,3980,沙崙,乙簡
2020-06-14,4272,2754,2548,5302,沙崙,乙簡
2020-06-15,4272,1754,1704,3458,沙崙,乙簡
2020-06-16,4272,1287,1196,2483,沙崙,乙簡
2020-06-17,4272,1335,1116,2451,沙崙,乙簡
2020-06-18,4272,1402,1326,2728,沙崙,乙簡
2020-06-19,4272,2020,1781,3801,沙崙,乙簡
2020-06-20,4272,2121,1623,3744,沙崙,乙簡
2020-06-21,4272,2297,2177,4474,沙崙,乙簡
2020-06-22,4272,1678,1537,3215,沙崙,乙簡
2020-06-23,4272,1716,1510,3226,沙崙,乙簡
2020-06-24,4272,3793,3389,7182,沙崙,乙簡
2020-06-25,4272,4858,2695,7553,沙崙,乙簡
2020-06-26,4272,2674,2486,5160,沙崙,乙簡
2020-06-27,4272,2414,3374,5788,沙崙,乙簡
2020-06-28,4272,4203,3942,8145,沙崙,乙簡
2020-06-29,4272,2201,2342,4543,沙崙,乙簡
2020-06-30,4272,1512,1456,2968,沙崙,乙簡
2020-07-01,4272,1378,1334,2712,沙崙,乙簡
2020-07-02,4272,1497,1497,2994,沙崙,乙簡
2020-07-03,4272,2343,2217,4560,沙崙,乙簡
2020-07-04,4272,2032,1853,3885,沙崙,乙簡
2020-07-05,4272,2281,2294,4575,沙崙,乙簡
2020-07-06,4272,1677,1823,3500,沙崙,乙簡
2020-07-07,4272,1450,1330,2780,沙崙,乙簡
2020-07-08,4272,1465,1389,2854,沙崙,乙簡
2020-07-09,4272,2045,1321,3366,沙崙,乙簡
2020-07-10,4272,2735,2524,5259,沙崙,乙簡
2020-07-11,4272,2233,1990,4223,沙崙,乙簡
2020-07-12,4272,2515,2617,5132,沙崙,乙簡
2020-07-13,4272,1766,1801,3567,沙崙,乙簡
2020-07-14,4272,1705,1629,3334,沙崙,乙簡
2020-07-15,4272,1814,1548,3362,沙崙,乙簡
2020-07-16,4272,1795,1597,3392,沙崙,乙簡
2020-07-17,4272,3006,2392,5398,沙崙,乙簡
2020-07-18,4272,2540,2135,4675,沙崙,乙簡
2020-07-19,4272,2785,2792,5577,沙崙,乙簡
2020-07-20,4272,1908,2068,3976,沙崙,乙簡
2020-07-21,4272,1669,1680,3349,沙崙,乙簡
2020-07-22,4272,1878,1712,3590,沙崙,乙簡
2020-07-23,4272,2038,1750,3788,沙崙,乙簡
2020-07-24,4272,3532,2584,6116,沙崙,乙簡
2020-07-25,4272,2996,2161,5157,沙崙,乙簡
2020-07-26,4272,2721,3181,5902,沙崙,乙簡
2020-07-27,4272,1956,1980,3936,沙崙,乙簡
2020-07-28,4272,1632,1592,3224,沙崙,乙簡
2020-07-29,4272,1661,1567,3228,沙崙,乙簡
2020-07-30,4272,1890,1794,3684,沙崙,乙簡
2020-07-31,4272,2816,2489,5305,沙崙,乙簡
2020-08-01,4272,2507,1983,4490,沙崙,乙簡
2020-08-02,4272,2587,2810,5397,沙崙,乙簡
2020-08-03,4272,1710,1727,3437,沙崙,乙簡
2020-08-04,4272,1472,1401,2873,沙崙,乙簡
2020-08-05,4272,1682,1536,3218,沙崙,乙簡
2020-08-06,4272,1654,1493,3147,沙崙,乙簡
2020-08-07,4272,3037,2705,5742,沙崙,乙簡
2020-08-08,4272,2192,1804,3996,沙崙,乙簡
2020-08-09,4272,2919,2620,5539,沙崙,乙簡
2020-08-10,4272,2145,2056,4201,沙崙,乙簡
2020-08-11,4272,1649,1581,3230,沙崙,乙簡
2020-08-12,4272,1869,1671,3540,沙崙,乙簡
2020-08-13,4272,2012,1827,3839,沙崙,乙簡
2020-08-14,4272,3167,2596,5763,沙崙,乙簡
2020-08-15,4272,3209,2416,5625,沙崙,乙簡
2020-08-16,4272,3177,3359,6536,沙崙,乙簡
2020-08-17,4272,2059,2385,4444,沙崙,乙簡
2020-08-18,4272,1704,1629,3333,沙崙,乙簡
2020-08-19,4272,1767,1670,3437,沙崙,乙簡
2020-08-20,4272,2012,1762,3774,沙崙,乙簡
2020-08-21,4272,3077,2737,5814,沙崙,乙簡
2020-08-22,4272,2686,2468,5154,沙崙,乙簡
2020-08-23,4272,3091,2917,6008,沙崙,乙簡
2020-08-24,4272,2061,2044,4105,沙崙,乙簡
2020-08-25,4272,1814,1714,3528,沙崙,乙簡
2020-08-26,4272,1777,1682,3459,沙崙,乙簡
2020-08-27,4272,1883,1741,3624,沙崙,乙簡
2020-08-28,4272,2988,2297,5285,沙崙,乙簡
2020-08-29,4272,2617,2037,4654,沙崙,乙簡
2020-08-30,4272,1503,1318,2821,沙崙,乙簡
2020-08-31,4272,1673,1903,3576,沙崙,乙簡
2020-09-01,4272,1576,1363,2939,沙崙,乙簡
2020-09-02,4272,1647,1392,3039,沙崙,乙簡
2020-09-03,4272,1732,1591,3323,沙崙,乙簡
2020-09-04,4272,2792,2283,5075,沙崙,乙簡
2020-09-05,4272,2645,2019,4664,沙崙,乙簡
2020-09-06,4272,3056,2208,5264,沙崙,乙簡
2020-09-07,4272,1951,1848,3799,沙崙,乙簡
2020-09-08,4272,1568,1380,2948,沙崙,乙簡
2020-09-09,4272,1951,1768,3719,沙崙,乙簡
2020-09-10,4272,1854,1876,3730,沙崙,乙簡
2020-09-11,4272,2855,2553,5408,沙崙,乙簡
2020-09-12,4272,2626,2205,4831,沙崙,乙簡
2020-09-13,4272,3492,3081,6573,沙崙,乙簡
2020-09-14,4272,1729,1644,3373,沙崙,乙簡
2020-09-15,4272,1273,1220,2493,沙崙,乙簡
2020-09-16,4272,1368,1205,2573,沙崙,乙簡
2020-09-17,4272,1550,1459,3009,沙崙,乙簡
2020-09-18,4272,2849,2969,5818,沙崙,乙簡
2020-09-19,4272,2992,2432,5424,沙崙,乙簡
2020-09-20,4272,3465,3204,6669,沙崙,乙簡
2020-09-21,4272,1968,1803,3771,沙崙,乙簡
2020-09-22,4272,1433,1501,2934,沙崙,乙簡
2020-09-23,4272,1454,1492,2946,沙崙,乙簡
2020-09-24,4272,1686,1633,3319,沙崙,乙簡
2020-09-25,4272,2375,2163,4538,沙崙,乙簡
2020-09-26,4272,2358,1884,4242,沙崙,乙簡
2020-09-27,4272,2605,2427,5032,沙崙,乙簡
2020-09-28,4272,1737,1571,3308,沙崙,乙簡
2020-09-29,4272,1947,1686,3633,沙崙,乙簡
2020-09-30,4272,4530,4762,9292,沙崙,乙簡
2020-10-01,4272,4966,3056,8022,沙崙,乙簡
2020-10-02,4272,2707,2121,4828,沙崙,乙簡
2020-10-03,4272,2278,3600,5878,沙崙,乙簡
2020-10-04,4272,6531,4162,10693,沙崙,乙簡
2020-10-05,4272,2687,2322,5009,沙崙,乙簡
2020-10-06,4272,1366,1379,2745,沙崙,乙簡
2020-10-07,4272,1529,1229,2758,沙崙,乙簡
2020-10-08,4272,3168,3224,6392,沙崙,乙簡
2020-10-09,4272,4378,2292,6670,沙崙,乙簡
2020-10-10,4272,2766,2112,4878,沙崙,乙簡
2020-10-11,4272,4348,5167,9515,沙崙,乙簡
2020-10-12,4272,2029,1967,3996,沙崙,乙簡
2020-10-13,4272,1420,1335,2755,沙崙,乙簡
2020-10-14,4272,1393,1311,2704,沙崙,乙簡
2020-10-15,4272,1683,1555,3238,沙崙,乙簡
2020-10-16,4272,2908,2915,5823,沙崙,乙簡
2020-10-17,4272,3105,2437,5542,沙崙,乙簡
2020-10-18,4272,3472,3308,6780,沙崙,乙簡
2020-10-19,4272,1869,1920,3789,沙崙,乙簡
2020-10-20,4272,1355,1407,2762,沙崙,乙簡
2020-10-21,4272,1560,1336,2896,沙崙,乙簡
2020-10-22,4272,1832,1757,3589,沙崙,乙簡
2020-10-23,4272,2899,3338,6237,沙崙,乙簡
2020-10-24,4272,3063,2268,5331,沙崙,乙簡
2020-10-25,4272,3580,3189,6769,沙崙,乙簡
2020-10-26,4272,1976,1845,3821,沙崙,乙簡
2020-10-27,4272,1511,1521,3032,沙崙,乙簡
2020-10-28,4272,1489,1349,2838,沙崙,乙簡
2020-10-29,4272,1771,1569,3340,沙崙,乙簡
2020-10-30,4272,3304,3223,6527,沙崙,乙簡
2020-10-31,4272,3199,2465,5664,沙崙,乙簡
2020-11-01,4272,3263,3676,6939,沙崙,乙簡
2020-11-02,4272,1827,1581,3408,沙崙,乙簡
2020-11-03,4272,1288,1255,2543,沙崙,乙簡
2020-11-04,4272,1403,1272,2675,沙崙,乙簡
2020-11-05,4272,1661,1541,3202,沙崙,乙簡
2020-11-06,4272,2992,3238,6230,沙崙,乙簡
2020-11-07,4272,2720,2200,4920,沙崙,乙簡
2020-11-08,4272,3577,3058,6635,沙崙,乙簡
2020-11-09,4272,1849,1651,3500,沙崙,乙簡
2020-11-10,4272,1388,1421,2809,沙崙,乙簡
2020-11-11,4272,1496,1373,2869,沙崙,乙簡
2020-11-12,4272,1726,1758,3484,沙崙,乙簡
2020-11-13,4272,3255,3548,6803,沙崙,乙簡
2020-11-14,4272,3050,2470,5520,沙崙,乙簡
2020-11-15,4272,4157,3635,7792,沙崙,乙簡
2020-11-16,4272,2226,1903,4129,沙崙,乙簡
2020-11-17,4272,1558,1475,3033,沙崙,乙簡
2020-11-18,4272,1611,1464,3075,沙崙,乙簡
2020-11-19,4272,1908,1783,3691,沙崙,乙簡
2020-11-20,4272,3404,3399,6803,沙崙,乙簡
2020-11-21,4272,3135,2460,5595,沙崙,乙簡
2020-11-22,4272,3902,3860,7762,沙崙,乙簡
2020-11-23,4272,2326,2049,4375,沙崙,乙簡
2020-11-24,4272,1570,1443,3013,沙崙,乙簡
2020-11-25,4272,1565,1438,3003,沙崙,乙簡
2020-11-26,4272,1921,1634,3555,沙崙,乙簡
2020-11-27,4272,3665,3465,7130,沙崙,乙簡
2020-11-28,4272,3204,2798,6002,沙崙,乙簡
2020-11-29,4272,3952,3930,7882,沙崙,乙簡
2020-11-30,4272,2042,1974,4016,沙崙,乙簡
2020-12-01,4272,1370,1332,2702,沙崙,乙簡
2020-12-02,4272,1436,1399,2835,沙崙,乙簡
2020-12-03,4272,1879,1701,3580,沙崙,乙簡
2020-12-04,4272,3290,3515,6805,沙崙,乙簡
2020-12-05,4272,3082,2701,5783,沙崙,乙簡
2020-12-06,4272,4112,3538,7650,沙崙,乙簡
2020-12-07,4272,2361,1931,4292,沙崙,乙簡
2020-12-08,4272,1474,1196,2670,沙崙,乙簡
2020-12-09,4272,1527,1376,2903,沙崙,乙簡
2020-12-10,4272,1852,1682,3534,沙崙,乙簡
2020-12-11,4272,3474,3643,7117,沙崙,乙簡
2020-12-12,4272,3431,2704,6135,沙崙,乙簡
2020-12-13,4272,4355,3871,8226,沙崙,乙簡
2020-12-14,4272,2345,2073,4418,沙崙,乙簡
2020-12-15,4272,1524,1605,3129,沙崙,乙簡
2020-12-16,4272,1578,1469,3047,沙崙,乙簡
2020-12-17,4272,1920,1831,3751,沙崙,乙簡
2020-12-18,4272,3581,3677,7258,沙崙,乙簡
2020-12-19,4272,3159,2808,5967,沙崙,乙簡
2020-12-20,4272,4173,3804,7977,沙崙,乙簡
2020-12-21,4272,2300,2075,4375,沙崙,乙簡
2020-12-22,4272,1547,1439,2986,沙崙,乙簡
2020-12-23,4272,1635,1479,3114,沙崙,乙簡
2020-12-24,4272,1861,2009,3870,沙崙,乙簡
2020-12-25,4272,2998,2787,5785,沙崙,乙簡
2020-12-26,4272,2805,2238,5043,沙崙,乙簡
2020-12-27,4272,3581,3189,6770,沙崙,乙簡
2020-12-28,4272,2165,1801,3966,沙崙,乙簡
2020-12-29,4272,1444,1422,2866,沙崙,乙簡
2020-12-30,4272,2023,1911,3934,沙崙,乙簡
2020-12-31,4272,4916,4546,9462,沙崙,乙簡
2020-01-01,4290,1596,2142,3738,大湖,三等
2020-01-02,4290,2258,2211,4469,大湖,三等
2020-01-03,4290,2905,2294,5199,大湖,三等
2020-01-04,4290,1223,1285,2508,大湖,三等
2020-01-05,4290,1182,1388,2570,大湖,三等
2020-01-06,4290,2561,2186,4747,大湖,三等
2020-01-07,4290,2659,2156,4815,大湖,三等
2020-01-08,4290,1706,1692,3398,大湖,三等
2020-01-09,4290,2541,1709,4250,大湖,三等
2020-01-10,4290,4211,2651,6862,大湖,三等
2020-01-11,4290,1349,1294,2643,大湖,三等
2020-01-12,4290,1386,1971,3357,大湖,三等
2020-01-13,4290,2151,2007,4158,大湖,三等
2020-01-14,4290,2090,1964,4054,大湖,三等
2020-01-15,4290,2105,1874,3979,大湖,三等
2020-01-16,4290,1988,1853,3841,大湖,三等
2020-01-17,4290,2376,1875,4251,大湖,三等
2020-01-18,4290,1209,1154,2363,大湖,三等
2020-01-19,4290,947,970,1917,大湖,三等
2020-01-20,4290,1137,1127,2264,大湖,三等
2020-01-21,4290,1198,1185,2383,大湖,三等
2020-01-22,4290,1200,1287,2487,大湖,三等
2020-01-23,4290,1029,1021,2050,大湖,三等
2020-01-24,4290,781,842,1623,大湖,三等
2020-01-25,4290,1018,883,1901,大湖,三等
2020-01-26,4290,964,1025,1989,大湖,三等
2020-01-27,4290,1148,1115,2263,大湖,三等
2020-01-28,4290,870,841,1711,大湖,三等
2020-01-29,4290,838,814,1652,大湖,三等
2020-01-30,4290,878,811,1689,大湖,三等
2020-01-31,4290,843,896,1739,大湖,三等
2020-02-01,4290,704,731,1435,大湖,三等
2020-02-02,4290,803,787,1590,大湖,三等
2020-02-03,4290,903,938,1841,大湖,三等
2020-02-04,4290,902,880,1782,大湖,三等
2020-02-05,4290,965,1000,1965,大湖,三等
2020-02-06,4290,977,923,1900,大湖,三等
2020-02-07,4290,1112,1127,2239,大湖,三等
2020-02-08,4290,950,963,1913,大湖,三等
2020-02-09,4290,1013,936,1949,大湖,三等
2020-02-10,4290,999,1000,1999,大湖,三等
2020-02-11,4290,873,880,1753,大湖,三等
2020-02-12,4290,934,954,1888,大湖,三等
2020-02-13,4290,922,936,1858,大湖,三等
2020-02-14,4290,1031,984,2015,大湖,三等
2020-02-15,4290,855,878,1733,大湖,三等
2020-02-16,4290,869,945,1814,大湖,三等
2020-02-17,4290,969,890,1859,大湖,三等
2020-02-18,4290,910,863,1773,大湖,三等
2020-02-19,4290,883,883,1766,大湖,三等
2020-02-20,4290,890,931,1821,大湖,三等
2020-02-21,4290,976,969,1945,大湖,三等
2020-02-22,4290,762,827,1589,大湖,三等
2020-02-23,4290,1000,993,1993,大湖,三等
2020-02-24,4290,1389,1633,3022,大湖,三等
2020-02-25,4290,1639,1633,3272,大湖,三等
2020-02-26,4290,1852,1705,3557,大湖,三等
2020-02-27,4290,2931,1840,4771,大湖,三等
2020-02-28,4290,1128,1061,2189,大湖,三等
2020-02-29,4290,798,805,1603,大湖,三等
2020-03-01,4290,972,1704,2676,大湖,三等
2020-03-02,4290,2006,1958,3964,大湖,三等
2020-03-03,4290,2023,1905,3928,大湖,三等
2020-03-04,4290,1989,1864,3853,大湖,三等
2020-03-05,4290,2033,1965,3998,大湖,三等
2020-03-06,4290,3279,2317,5596,大湖,三等
2020-03-07,4290,1261,1197,2458,大湖,三等
2020-03-08,4290,1184,1744,2928,大湖,三等
2020-03-09,4290,2058,1968,4026,大湖,三等
2020-03-10,4290,2050,1919,3969,大湖,三等
2020-03-11,4290,2062,1903,3965,大湖,三等
2020-03-12,4290,2099,1972,4071,大湖,三等
2020-03-13,4290,3162,2148,5310,大湖,三等
2020-03-14,4290,1151,1123,2274,大湖,三等
2020-03-15,4290,1105,1720,2825,大湖,三等
2020-03-16,4290,2099,1992,4091,大湖,三等
2020-03-17,4290,2057,1948,4005,大湖,三等
2020-03-18,4290,2030,1870,3900,大湖,三等
2020-03-19,4290,2013,1891,3904,大湖,三等
2020-03-20,4290,2945,1670,4615,大湖,三等
2020-03-21,4290,1119,1043,2162,大湖,三等
2020-03-22,4290,915,1444,2359,大湖,三等
2020-03-23,4290,1972,1919,3891,大湖,三等
2020-03-24,4290,1974,1844,3818,大湖,三等
2020-03-25,4290,1979,1831,3810,大湖,三等
2020-03-26,4290,1945,1839,3784,大湖,三等
2020-03-27,4290,2878,2101,4979,大湖,三等
2020-03-28,4290,1080,1076,2156,大湖,三等
2020-03-29,4290,947,1336,2283,大湖,三等
2020-03-30,4290,1937,1848,3785,大湖,三等
2020-03-31,4290,1923,1765,3688,大湖,三等
2020-04-01,4290,3088,1940,5028,大湖,三等
2020-04-02,4290,994,878,1872,大湖,三等
2020-04-03,4290,825,808,1633,大湖,三等
2020-04-04,4290,552,585,1137,大湖,三等
2020-04-05,4290,744,1509,2253,大湖,三等
2020-04-06,4290,2034,1894,3928,大湖,三等
2020-04-07,4290,1979,1755,3734,大湖,三等
2020-04-08,4290,1939,1796,3735,大湖,三等
2020-04-09,4290,1961,1795,3756,大湖,三等
2020-04-10,4290,2292,1805,4097,大湖,三等
2020-04-11,4290,1081,1102,2183,大湖,三等
2020-04-12,4290,861,1231,2092,大湖,三等
2020-04-13,4290,1926,1808,3734,大湖,三等
2020-04-14,4290,1941,1787,3728,大湖,三等
2020-04-15,4290,2009,1801,3810,大湖,三等
2020-04-16,4290,1877,1785,3662,大湖,三等
2020-04-17,4290,2404,2067,4471,大湖,三等
2020-04-18,4290,951,968,1919,大湖,三等
2020-04-19,4290,797,912,1709,大湖,三等
2020-04-20,4290,2073,1802,3875,大湖,三等
2020-04-21,4290,2136,1742,3878,大湖,三等
2020-04-22,4290,1332,1331,2663,大湖,三等
2020-04-23,4290,2006,1700,3706,大湖,三等
2020-04-24,4290,3351,1889,5240,大湖,三等
2020-04-25,4290,729,734,1463,大湖,三等
2020-04-26,4290,671,1349,2020,大湖,三等
2020-04-27,4290,1853,1822,3675,大湖,三等
2020-04-28,4290,1878,1744,3622,大湖,三等
2020-04-29,4290,1752,1707,3459,大湖,三等
2020-04-30,4290,1874,1747,3621,大湖,三等
2020-05-01,4290,2585,1855,4440,大湖,三等
2020-05-02,4290,1009,967,1976,大湖,三等
2020-05-03,4290,861,1300,2161,大湖,三等
2020-05-04,4290,1958,1877,3835,大湖,三等
2020-05-05,4290,1944,1764,3708,大湖,三等
2020-05-06,4290,1905,1779,3684,大湖,三等
2020-05-07,4290,1960,1819,3779,大湖,三等
2020-05-08,4290,3032,1973,5005,大湖,三等
2020-05-09,4290,1070,1014,2084,大湖,三等
2020-05-10,4290,924,1442,2366,大湖,三等
2020-05-11,4290,1947,1901,3848,大湖,三等
2020-05-12,4290,1946,1781,3727,大湖,三等
2020-05-13,4290,1937,1782,3719,大湖,三等
2020-05-14,4290,1958,1805,3763,大湖,三等
2020-05-15,4290,2841,2065,4906,大湖,三等
2020-05-16,4290,958,908,1866,大湖,三等
2020-05-17,4290,934,1369,2303,大湖,三等
2020-05-18,4290,1981,1921,3902,大湖,三等
2020-05-19,4290,1894,1772,3666,大湖,三等
2020-05-20,4290,1875,1725,3600,大湖,三等
2020-05-21,4290,1852,1747,3599,大湖,三等
2020-05-22,4290,2461,1699,4160,大湖,三等
2020-05-23,4290,999,938,1937,大湖,三等
2020-05-24,4290,1192,1645,2837,大湖,三等
2020-05-25,4290,1999,1963,3962,大湖,三等
2020-05-26,4290,1933,1813,3746,大湖,三等
2020-05-27,4290,1846,1713,3559,大湖,三等
2020-05-28,4290,1924,1790,3714,大湖,三等
2020-05-29,4290,2806,2010,4816,大湖,三等
2020-05-30,4290,1388,1331,2719,大湖,三等
2020-05-31,4290,1077,1497,2574,大湖,三等
2020-06-01,4290,2023,1955,3978,大湖,三等
2020-06-02,4290,1925,1767,3692,大湖,三等
2020-06-03,4290,2022,1837,3859,大湖,三等
2020-06-04,4290,1942,1806,3748,大湖,三等
2020-06-05,4290,2947,2086,5033,大湖,三等
2020-06-06,4290,1237,1163,2400,大湖,三等
2020-06-07,4290,1123,1626,2749,大湖,三等
2020-06-08,4290,1931,1895,3826,大湖,三等
2020-06-09,4290,1947,1801,3748,大湖,三等
2020-06-10,4290,2323,1992,4315,大湖,三等
2020-06-11,4290,1964,1834,3798,大湖,三等
2020-06-12,4290,2493,2053,4546,大湖,三等
2020-06-13,4290,1641,1561,3202,大湖,三等
2020-06-14,4290,1407,1616,3023,大湖,三等
2020-06-15,4290,1926,1844,3770,大湖,三等
2020-06-16,4290,2007,1857,3864,大湖,三等
2020-06-17,4290,1968,1771,3739,大湖,三等
2020-06-18,4290,1852,1755,3607,大湖,三等
2020-06-19,4290,2086,1851,3937,大湖,三等
2020-06-20,4290,1944,1568,3512,大湖,三等
2020-06-21,4290,934,1023,1957,大湖,三等
2020-06-22,4290,2159,1782,3941,大湖,三等
2020-06-23,4290,2142,1759,3901,大湖,三等
2020-06-24,4290,3127,2111,5238,大湖,三等
2020-06-25,4290,1116,1012,2128,大湖,三等
2020-06-26,4290,1100,1100,2200,大湖,三等
2020-06-27,4290,843,909,1752,大湖,三等
2020-06-28,4290,903,1001,1904,大湖,三等
2020-06-29,4290,1565,1624,3189,大湖,三等
2020-06-30,4290,1760,1731,3491,大湖,三等
2020-07-01,4290,1710,1647,3357,大湖,三等
2020-07-02,4290,1737,1678,3415,大湖,三等
2020-07-03,4290,1879,1608,3487,大湖,三等
2020-07-04,4290,841,750,1591,大湖,三等
2020-07-05,4290,815,890,1705,大湖,三等
2020-07-06,4290,1536,1568,3104,大湖,三等
2020-07-07,4290,1605,1512,3117,大湖,三等
2020-07-08,4290,1250,1233,2483,大湖,三等
2020-07-09,4290,1594,1606,3200,大湖,三等
2020-07-10,4290,1823,1658,3481,大湖,三等
2020-07-11,4290,954,857,1811,大湖,三等
2020-07-12,4290,1044,1057,2101,大湖,三等
2020-07-13,4290,1175,1281,2456,大湖,三等
2020-07-14,4290,1236,1401,2637,大湖,三等
2020-07-15,4290,1490,1414,2904,大湖,三等
2020-07-16,4290,1435,1376,2811,大湖,三等
2020-07-17,4290,1701,1481,3182,大湖,三等
2020-07-18,4290,924,894,1818,大湖,三等
2020-07-19,4290,947,1035,1982,大湖,三等
2020-07-20,4290,1388,1404,2792,大湖,三等
2020-07-21,4290,1413,1380,2793,大湖,三等
2020-07-22,4290,1469,1417,2886,大湖,三等
2020-07-23,4290,1347,1307,2654,大湖,三等
2020-07-24,4290,1539,1411,2950,大湖,三等
2020-07-25,4290,876,825,1701,大湖,三等
2020-07-26,4290,926,936,1862,大湖,三等
2020-07-27,4290,1398,1389,2787,大湖,三等
2020-07-28,4290,1430,1426,2856,大湖,三等
2020-07-29,4290,1346,1329,2675,大湖,三等
2020-07-30,4290,1215,1165,2380,大湖,三等
2020-07-31,4290,1156,1157,2313,大湖,三等
2020-08-01,4290,823,805,1628,大湖,三等
2020-08-02,4290,812,862,1674,大湖,三等
2020-08-03,4290,1288,1252,2540,大湖,三等
2020-08-04,4290,1210,1212,2422,大湖,三等
2020-08-05,4290,1310,1263,2573,大湖,三等
2020-08-06,4290,1375,1317,2692,大湖,三等
2020-08-07,4290,1247,1206,2453,大湖,三等
2020-08-08,4290,768,877,1645,大湖,三等
2020-08-09,4290,989,991,1980,大湖,三等
2020-08-10,4290,1358,1377,2735,大湖,三等
2020-08-11,4290,1236,1241,2477,大湖,三等
2020-08-12,4290,1341,1321,2662,大湖,三等
2020-08-13,4290,1358,1298,2656,大湖,三等
2020-08-14,4290,1241,1193,2434,大湖,三等
2020-08-15,4290,1022,992,2014,大湖,三等
2020-08-16,4290,976,1023,1999,大湖,三等
2020-08-17,4290,1243,1232,2475,大湖,三等
2020-08-18,4290,1228,1247,2475,大湖,三等
2020-08-19,4290,1124,1113,2237,大湖,三等
2020-08-20,4290,1263,1222,2485,大湖,三等
2020-08-21,4290,1171,1160,2331,大湖,三等
2020-08-22,4290,882,784,1666,大湖,三等
2020-08-23,4290,882,898,1780,大湖,三等
2020-08-24,4290,1181,1195,2376,大湖,三等
2020-08-25,4290,1314,1305,2619,大湖,三等
2020-08-26,4290,1030,1037,2067,大湖,三等
2020-08-27,4290,994,1021,2015,大湖,三等
2020-08-28,4290,1165,1118,2283,大湖,三等
2020-08-29,4290,742,771,1513,大湖,三等
2020-08-30,4290,679,777,1456,大湖,三等
2020-08-31,4290,1137,1106,2243,大湖,三等
2020-09-01,4290,1122,1125,2247,大湖,三等
2020-09-02,4290,1113,1140,2253,大湖,三等
2020-09-03,4290,1152,1116,2268,大湖,三等
2020-09-04,4290,1162,1106,2268,大湖,三等
2020-09-05,4290,833,851,1684,大湖,三等
2020-09-06,4290,995,945,1940,大湖,三等
2020-09-07,4290,1286,1373,2659,大湖,三等
2020-09-08,4290,1422,1385,2807,大湖,三等
2020-09-09,4290,1415,1429,2844,大湖,三等
2020-09-10,4290,1790,1459,3249,大湖,三等
2020-09-11,4290,1521,1388,2909,大湖,三等
2020-09-12,4290,1006,1057,2063,大湖,三等
2020-09-13,4290,1227,1569,2796,大湖,三等
2020-09-14,4290,2049,2031,4080,大湖,三等
2020-09-15,4290,1988,1895,3883,大湖,三等
2020-09-16,4290,2038,1879,3917,大湖,三等
2020-09-17,4290,1921,1850,3771,大湖,三等
2020-09-18,4290,3116,2072,5188,大湖,三等
2020-09-19,4290,1369,1326,2695,大湖,三等
2020-09-20,4290,1277,2000,3277,大湖,三等
2020-09-21,4290,2031,2000,4031,大湖,三等
2020-09-22,4290,1988,1877,3865,大湖,三等
2020-09-23,4290,1939,1829,3768,大湖,三等
2020-09-24,4290,1922,1847,3769,大湖,三等
2020-09-25,4290,1985,1966,3951,大湖,三等
2020-09-26,4290,2186,1827,4013,大湖,三等
2020-09-27,4290,1566,1623,3189,大湖,三等
2020-09-28,4290,2002,1902,3904,大湖,三等
2020-09-29,4290,2028,1919,3947,大湖,三等
2020-09-30,4290,3259,2180,5439,大湖,三等
2020-10-01,4290,1405,1283,2688,大湖,三等
2020-10-02,4290,1312,1240,2552,大湖,三等
2020-10-03,4290,1030,1084,2114,大湖,三等
2020-10-04,4290,1090,2016,3106,大湖,三等
2020-10-05,4290,2066,1965,4031,大湖,三等
2020-10-06,4290,2026,1862,3888,大湖,三等
2020-10-07,4290,2000,1855,3855,大湖,三等
2020-10-08,4290,3244,2107,5351,大湖,三等
2020-10-09,4290,1499,1324,2823,大湖,三等
2020-10-10,4290,991,977,1968,大湖,三等
2020-10-11,4290,1148,1980,3128,大湖,三等
2020-10-12,4290,2061,1926,3987,大湖,三等
2020-10-13,4290,1997,1859,3856,大湖,三等
2020-10-14,4290,1983,1833,3816,大湖,三等
2020-10-15,4290,1966,1825,3791,大湖,三等
2020-10-16,4290,3035,2147,5182,大湖,三等
2020-10-17,4290,1608,1481,3089,大湖,三等
2020-10-18,4290,1366,1851,3217,大湖,三等
2020-10-19,4290,2034,1951,3985,大湖,三等
2020-10-20,4290,2025,1790,3815,大湖,三等
2020-10-21,4290,2029,1880,3909,大湖,三等
2020-10-22,4290,1954,1822,3776,大湖,三等
2020-10-23,4290,3205,2057,5262,大湖,三等
2020-10-24,4290,1296,1377,2673,大湖,三等
2020-10-25,4290,1183,1883,3066,大湖,三等
2020-10-26,4290,1989,1867,3856,大湖,三等
2020-10-27,4290,2006,1812,3818,大湖,三等
2020-10-28,4290,2012,1791,3803,大湖,三等
2020-10-29,4290,2017,1804,3821,大湖,三等
2020-10-30,4290,3076,1995,5071,大湖,三等
2020-10-31,4290,1163,1244,2407,大湖,三等
2020-11-01,4290,1136,1713,2849,大湖,三等
2020-11-02,4290,2019,1879,3898,大湖,三等
2020-11-03,4290,2009,1848,3857,大湖,三等
2020-11-04,4290,2108,1801,3909,大湖,三等
2020-11-05,4290,1922,1828,3750,大湖,三等
2020-11-06,4290,2530,2110,4640,大湖,三等
2020-11-07,4290,1123,1189,2312,大湖,三等
2020-11-08,4290,1149,1330,2479,大湖,三等
2020-11-09,4290,2318,1896,4214,大湖,三等
2020-11-10,4290,2486,1923,4409,大湖,三等
2020-11-11,4290,1408,1443,2851,大湖,三等
2020-11-12,4290,2202,1778,3980,大湖,三等
2020-11-13,4290,4320,2241,6561,大湖,三等
2020-11-14,4290,1210,1234,2444,大湖,三等
2020-11-15,4290,1196,2036,3232,大湖,三等
2020-11-16,4290,2044,1937,3981,大湖,三等
2020-11-17,4290,2025,1900,3925,大湖,三等
2020-11-18,4290,2039,1858,3897,大湖,三等
2020-11-19,4290,2013,1858,3871,大湖,三等
2020-11-20,4290,3156,2119,5275,大湖,三等
2020-11-21,4290,1438,1426,2864,大湖,三等
2020-11-22,4290,1299,1915,3214,大湖,三等
2020-11-23,4290,2059,1928,3987,大湖,三等
2020-11-24,4290,2118,1943,4061,大湖,三等
2020-11-25,4290,2031,1868,3899,大湖,三等
2020-11-26,4290,2018,1930,3948,大湖,三等
2020-11-27,4290,3242,2106,5348,大湖,三等
2020-11-28,4290,1394,1393,2787,大湖,三等
2020-11-29,4290,1196,1871,3067,大湖,三等
2020-11-30,4290,2019,1969,3988,大湖,三等
2020-12-01,4290,2117,1896,4013,大湖,三等
2020-12-02,4290,1978,1807,3785,大湖,三等
2020-12-03,4290,2034,1903,3937,大湖,三等
2020-12-04,4290,2336,2257,4593,大湖,三等
2020-12-05,4290,3675,3176,6851,大湖,三等
2020-12-06,4290,1819,1957,3776,大湖,三等
2020-12-07,4290,2018,1942,3960,大湖,三等
2020-12-08,4290,2052,1898,3950,大湖,三等
2020-12-09,4290,2031,1907,3938,大湖,三等
2020-12-10,4290,1956,1872,3828,大湖,三等
2020-12-11,4290,3385,2127,5512,大湖,三等
2020-12-12,4290,1355,1351,2706,大湖,三等
2020-12-13,4290,1343,2143,3486,大湖,三等
2020-12-14,4290,2114,1992,4106,大湖,三等
2020-12-15,4290,2052,1903,3955,大湖,三等
2020-12-16,4290,2047,1927,3974,大湖,三等
2020-12-17,4290,2073,1917,3990,大湖,三等
2020-12-18,4290,3100,2183,5283,大湖,三等
2020-12-19,4290,1615,1482,3097,大湖,三等
2020-12-20,4290,1311,1896,3207,大湖,三等
2020-12-21,4290,2035,1947,3982,大湖,三等
2020-12-22,4290,2053,1866,3919,大湖,三等
2020-12-23,4290,2296,1961,4257,大湖,三等
2020-12-24,4290,2071,1921,3992,大湖,三等
2020-12-25,4290,3336,2157,5493,大湖,三等
2020-12-26,4290,1153,1114,2267,大湖,三等
2020-12-27,4290,1083,1735,2818,大湖,三等
2020-12-28,4290,2061,1904,3965,大湖,三等
2020-12-29,4290,2076,1891,3967,大湖,三等
2020-12-30,4290,2137,1928,4065,大湖,三等
2020-12-31,4290,3520,2114,5634,大湖,三等
2020-01-01,4300,1847,2113,3960,路竹,三等
2020-01-02,4300,1616,1724,3340,路竹,三等
2020-01-03,4300,1814,1935,3749,路竹,三等
2020-01-04,4300,1768,1855,3623,路竹,三等
2020-01-05,4300,1932,1823,3755,路竹,三等
2020-01-06,4300,1773,1898,3671,路竹,三等
2020-01-07,4300,1720,1769,3489,路竹,三等
2020-01-08,4300,1705,1790,3495,路竹,三等
2020-01-09,4300,1659,1772,3431,路竹,三等
2020-01-10,4300,2197,2431,4628,路竹,三等
2020-01-11,4300,2193,2105,4298,路竹,三等
2020-01-12,4300,2256,2226,4482,路竹,三等
2020-01-13,4300,1760,1866,3626,路竹,三等
2020-01-14,4300,1616,1617,3233,路竹,三等
2020-01-15,4300,1667,1738,3405,路竹,三等
2020-01-16,4300,1695,1848,3543,路竹,三等
2020-01-17,4300,1818,1913,3731,路竹,三等
2020-01-18,4300,1860,1806,3666,路竹,三等
2020-01-19,4300,1808,1779,3587,路竹,三等
2020-01-20,4300,1744,1867,3611,路竹,三等
2020-01-21,4300,1642,1682,3324,路竹,三等
2020-01-22,4300,1865,1977,3842,路竹,三等
2020-01-23,4300,1909,1762,3671,路竹,三等
2020-01-24,4300,1728,1611,3339,路竹,三等
2020-01-25,4300,1979,1852,3831,路竹,三等
2020-01-26,4300,1929,1947,3876,路竹,三等
2020-01-27,4300,1986,1999,3985,路竹,三等
2020-01-28,4300,1410,1522,2932,路竹,三等
2020-01-29,4300,1485,1495,2980,路竹,三等
2020-01-30,4300,1487,1440,2927,路竹,三等
2020-01-31,4300,1562,1549,3111,路竹,三等
2020-02-01,4300,1205,1258,2463,路竹,三等
2020-02-02,4300,1387,1327,2714,路竹,三等
2020-02-03,4300,1472,1491,2963,路竹,三等
2020-02-04,4300,1418,1448,2866,路竹,三等
2020-02-05,4300,1464,1470,2934,路竹,三等
2020-02-06,4300,1438,1468,2906,路竹,三等
2020-02-07,4300,1574,1624,3198,路竹,三等
2020-02-08,4300,1548,1429,2977,路竹,三等
2020-02-09,4300,1633,1623,3256,路竹,三等
2020-02-10,4300,1573,1645,3218,路竹,三等
2020-02-11,4300,1376,1364,2740,路竹,三等
2020-02-12,4300,1459,1436,2895,路竹,三等
2020-02-13,4300,1371,1365,2736,路竹,三等
2020-02-14,4300,1488,1575,3063,路竹,三等
2020-02-15,4300,1401,1351,2752,路竹,三等
2020-02-16,4300,1665,1727,3392,路竹,三等
2020-02-17,4300,1383,1439,2822,路竹,三等
2020-02-18,4300,1384,1394,2778,路竹,三等
2020-02-19,4300,1395,1429,2824,路竹,三等
2020-02-20,4300,1426,1408,2834,路竹,三等
2020-02-21,4300,1533,1557,3090,路竹,三等
2020-02-22,4300,1398,1354,2752,路竹,三等
2020-02-23,4300,1448,1551,2999,路竹,三等
2020-02-24,4300,1494,1534,3028,路竹,三等
2020-02-25,4300,1510,1547,3057,路竹,三等
2020-02-26,4300,1549,1596,3145,路竹,三等
2020-02-27,4300,1710,1794,3504,路竹,三等
2020-02-28,4300,1385,1365,2750,路竹,三等
2020-02-29,4300,1243,1255,2498,路竹,三等
2020-03-01,4300,1399,1446,2845,路竹,三等
2020-03-02,4300,1534,1581,3115,路竹,三等
2020-03-03,4300,1446,1525,2971,路竹,三等
2020-03-04,4300,1423,1511,2934,路竹,三等
2020-03-05,4300,1477,1563,3040,路竹,三等
2020-03-06,4300,1696,1891,3587,路竹,三等
2020-03-07,4300,1477,1434,2911,路竹,三等
2020-03-08,4300,1551,1527,3078,路竹,三等
2020-03-09,4300,1521,1612,3133,路竹,三等
2020-03-10,4300,1484,1539,3023,路竹,三等
2020-03-11,4300,1527,1624,3151,路竹,三等
2020-03-12,4300,1486,1523,3009,路竹,三等
2020-03-13,4300,1742,1898,3640,路竹,三等
2020-03-14,4300,1293,1293,2586,路竹,三等
2020-03-15,4300,1522,1539,3061,路竹,三等
2020-03-16,4300,1534,1637,3171,路竹,三等
2020-03-17,4300,1464,1495,2959,路竹,三等
2020-03-18,4300,1451,1534,2985,路竹,三等
2020-03-19,4300,1439,1503,2942,路竹,三等
2020-03-20,4300,1599,1701,3300,路竹,三等
2020-03-21,4300,1042,1156,2198,路竹,三等
2020-03-22,4300,1169,1172,2341,路竹,三等
2020-03-23,4300,1513,1484,2997,路竹,三等
2020-03-24,4300,1382,1425,2807,路竹,三等
2020-03-25,4300,1459,1474,2933,路竹,三等
2020-03-26,4300,1347,1426,2773,路竹,三等
2020-03-27,4300,1474,1670,3144,路竹,三等
2020-03-28,4300,950,1029,1979,路竹,三等
2020-03-29,4300,1039,1045,2084,路竹,三等
2020-03-30,4300,1396,1442,2838,路竹,三等
2020-03-31,4300,1339,1494,2833,路竹,三等
2020-04-01,4300,1584,1748,3332,路竹,三等
2020-04-02,4300,1119,1127,2246,路竹,三等
2020-04-03,4300,1100,1160,2260,路竹,三等
2020-04-04,4300,888,894,1782,路竹,三等
2020-04-05,4300,1206,1170,2376,路竹,三等
2020-04-06,4300,1477,1458,2935,路竹,三等
2020-04-07,4300,1333,1362,2695,路竹,三等
2020-04-08,4300,1326,1366,2692,路竹,三等
2020-04-09,4300,1345,1386,2731,路竹,三等
2020-04-10,4300,1347,1358,2705,路竹,三等
2020-04-11,4300,1070,1099,2169,路竹,三等
2020-04-12,4300,1186,1174,2360,路竹,三等
2020-04-13,4300,1393,1451,2844,路竹,三等
2020-04-14,4300,1306,1384,2690,路竹,三等
2020-04-15,4300,1372,1375,2747,路竹,三等
2020-04-16,4300,1328,1406,2734,路竹,三等
2020-04-17,4300,1511,1630,3141,路竹,三等
2020-04-18,4300,1124,1138,2262,路竹,三等
2020-04-19,4300,1091,1104,2195,路竹,三等
2020-04-20,4300,1400,1456,2856,路竹,三等
2020-04-21,4300,1272,1347,2619,路竹,三等
2020-04-22,4300,1287,1299,2586,路竹,三等
2020-04-23,4300,1230,1265,2495,路竹,三等
2020-04-24,4300,1396,1533,2929,路竹,三等
2020-04-25,4300,864,906,1770,路竹,三等
2020-04-26,4300,876,912,1788,路竹,三等
2020-04-27,4300,1379,1384,2763,路竹,三等
2020-04-28,4300,1292,1365,2657,路竹,三等
2020-04-29,4300,1239,1265,2504,路竹,三等
2020-04-30,4300,1347,1376,2723,路竹,三等
2020-05-01,4300,1428,1510,2938,路竹,三等
2020-05-02,4300,1087,1050,2137,路竹,三等
2020-05-03,4300,1023,1099,2122,路竹,三等
2020-05-04,4300,1470,1459,2929,路竹,三等
2020-05-05,4300,1353,1419,2772,路竹,三等
2020-05-06,4300,1401,1468,2869,路竹,三等
2020-05-07,4300,1374,1436,2810,路竹,三等
2020-05-08,4300,1567,1803,3370,路竹,三等
2020-05-09,4300,1359,1334,2693,路竹,三等
2020-05-10,4300,1473,1412,2885,路竹,三等
2020-05-11,4300,1483,1541,3024,路竹,三等
2020-05-12,4300,1390,1390,2780,路竹,三等
2020-05-13,4300,1361,1421,2782,路竹,三等
2020-05-14,4300,1366,1424,2790,路竹,三等
2020-05-15,4300,1607,1786,3393,路竹,三等
2020-05-16,4300,1167,1217,2384,路竹,三等
2020-05-17,4300,1213,1281,2494,路竹,三等
2020-05-18,4300,1423,1488,2911,路竹,三等
2020-05-19,4300,1314,1374,2688,路竹,三等
2020-05-20,4300,1414,1436,2850,路竹,三等
2020-05-21,4300,1290,1312,2602,路竹,三等
2020-05-22,4300,1309,1445,2754,路竹,三等
2020-05-23,4300,1192,1195,2387,路竹,三等
2020-05-24,4300,1478,1483,2961,路竹,三等
2020-05-25,4300,1457,1516,2973,路竹,三等
2020-05-26,4300,1345,1393,2738,路竹,三等
2020-05-27,4300,1276,1332,2608,路竹,三等
2020-05-28,4300,1340,1401,2741,路竹,三等
2020-05-29,4300,1585,1675,3260,路竹,三等
2020-05-30,4300,1308,1333,2641,路竹,三等
2020-05-31,4300,1342,1388,2730,路竹,三等
2020-06-01,4300,1453,1481,2934,路竹,三等
2020-06-02,4300,1357,1440,2797,路竹,三等
2020-06-03,4300,1379,1424,2803,路竹,三等
2020-06-04,4300,1382,1400,2782,路竹,三等
2020-06-05,4300,1639,1952,3591,路竹,三等
2020-06-06,4300,1710,1700,3410,路竹,三等
2020-06-07,4300,1718,1586,3304,路竹,三等
2020-06-08,4300,1514,1529,3043,路竹,三等
2020-06-09,4300,1407,1468,2875,路竹,三等
2020-06-10,4300,1488,1505,2993,路竹,三等
2020-06-11,4300,1466,1437,2903,路竹,三等
2020-06-12,4300,1642,1750,3392,路竹,三等
2020-06-13,4300,1563,1558,3121,路竹,三等
2020-06-14,4300,1634,1637,3271,路竹,三等
2020-06-15,4300,1554,1616,3170,路竹,三等
2020-06-16,4300,1486,1578,3064,路竹,三等
2020-06-17,4300,1456,1480,2936,路竹,三等
2020-06-18,4300,1437,1480,2917,路竹,三等
2020-06-19,4300,1738,1749,3487,路竹,三等
2020-06-20,4300,1525,1536,3061,路竹,三等
2020-06-21,4300,1333,1414,2747,路竹,三等
2020-06-22,4300,1508,1588,3096,路竹,三等
2020-06-23,4300,1452,1451,2903,路竹,三等
2020-06-24,4300,1717,1817,3534,路竹,三等
2020-06-25,4300,1585,1502,3087,路竹,三等
2020-06-26,4300,1721,1690,3411,路竹,三等
2020-06-27,4300,1545,1457,3002,路竹,三等
2020-06-28,4300,1471,1535,3006,路竹,三等
2020-06-29,4300,1577,1629,3206,路竹,三等
2020-06-30,4300,1433,1405,2838,路竹,三等
2020-07-01,4300,1361,1425,2786,路竹,三等
2020-07-02,4300,1343,1372,2715,路竹,三等
2020-07-03,4300,1525,1589,3114,路竹,三等
2020-07-04,4300,1355,1237,2592,路竹,三等
2020-07-05,4300,1337,1392,2729,路竹,三等
2020-07-06,4300,1529,1557,3086,路竹,三等
2020-07-07,4300,1389,1441,2830,路竹,三等
2020-07-08,4300,1410,1401,2811,路竹,三等
2020-07-09,4300,1388,1402,2790,路竹,三等
2020-07-10,4300,1660,1720,3380,路竹,三等
2020-07-11,4300,1565,1464,3029,路竹,三等
2020-07-12,4300,1638,1619,3257,路竹,三等
2020-07-13,4300,1530,1579,3109,路竹,三等
2020-07-14,4300,1466,1617,3083,路竹,三等
2020-07-15,4300,1409,1424,2833,路竹,三等
2020-07-16,4300,1529,1461,2990,路竹,三等
2020-07-17,4300,1587,1642,3229,路竹,三等
2020-07-18,4300,1682,1586,3268,路竹,三等
2020-07-19,4300,1647,1596,3243,路竹,三等
2020-07-20,4300,1540,1580,3120,路竹,三等
2020-07-21,4300,1471,1450,2921,路竹,三等
2020-07-22,4300,1471,1502,2973,路竹,三等
2020-07-23,4300,1425,1454,2879,路竹,三等
2020-07-24,4300,1610,1606,3216,路竹,三等
2020-07-25,4300,1537,1467,3004,路竹,三等
2020-07-26,4300,1434,1351,2785,路竹,三等
2020-07-27,4300,1475,1465,2940,路竹,三等
2020-07-28,4300,1373,1382,2755,路竹,三等
2020-07-29,4300,1486,1475,2961,路竹,三等
2020-07-30,4300,1489,1471,2960,路竹,三等
2020-07-31,4300,1576,1629,3205,路竹,三等
2020-08-01,4300,1337,1361,2698,路竹,三等
2020-08-02,4300,1369,1387,2756,路竹,三等
2020-08-03,4300,1329,1335,2664,路竹,三等
2020-08-04,4300,1227,1251,2478,路竹,三等
2020-08-05,4300,1422,1489,2911,路竹,三等
2020-08-06,4300,1431,1452,2883,路竹,三等
2020-08-07,4300,1685,1732,3417,路竹,三等
2020-08-08,4300,1590,1511,3101,路竹,三等
2020-08-09,4300,1696,1731,3427,路竹,三等
2020-08-10,4300,1615,1595,3210,路竹,三等
2020-08-11,4300,1295,1348,2643,路竹,三等
2020-08-12,4300,1545,1538,3083,路竹,三等
2020-08-13,4300,1505,1496,3001,路竹,三等
2020-08-14,4300,1700,1774,3474,路竹,三等
2020-08-15,4300,1628,1549,3177,路竹,三等
2020-08-16,4300,1691,1702,3393,路竹,三等
2020-08-17,4300,1683,1672,3355,路竹,三等
2020-08-18,4300,1539,1484,3023,路竹,三等
2020-08-19,4300,1391,1440,2831,路竹,三等
2020-08-20,4300,1468,1433,2901,路竹,三等
2020-08-21,4300,1669,1654,3323,路竹,三等
2020-08-22,4300,1508,1407,2915,路竹,三等
2020-08-23,4300,1379,1513,2892,路竹,三等
2020-08-24,4300,1513,1495,3008,路竹,三等
2020-08-25,4300,1551,1524,3075,路竹,三等
2020-08-26,4300,1201,1246,2447,路竹,三等
2020-08-27,4300,1253,1261,2514,路竹,三等
2020-08-28,4300,1529,1583,3112,路竹,三等
2020-08-29,4300,1381,1331,2712,路竹,三等
2020-08-30,4300,1159,1171,2330,路竹,三等
2020-08-31,4300,1472,1528,3000,路竹,三等
2020-09-01,4300,1398,1419,2817,路竹,三等
2020-09-02,4300,1350,1394,2744,路竹,三等
2020-09-03,4300,1441,1446,2887,路竹,三等
2020-09-04,4300,1736,1732,3468,路竹,三等
2020-09-05,4300,1476,1466,2942,路竹,三等
2020-09-06,4300,1566,1611,3177,路竹,三等
2020-09-07,4300,1533,1541,3074,路竹,三等
2020-09-08,4300,1460,1500,2960,路竹,三等
2020-09-09,4300,1479,1532,3011,路竹,三等
2020-09-10,4300,1485,1493,2978,路竹,三等
2020-09-11,4300,1762,1848,3610,路竹,三等
2020-09-12,4300,1641,1512,3153,路竹,三等
2020-09-13,4300,1810,1779,3589,路竹,三等
2020-09-14,4300,1570,1631,3201,路竹,三等
2020-09-15,4300,1488,1523,3011,路竹,三等
2020-09-16,4300,1506,1546,3052,路竹,三等
2020-09-17,4300,1523,1527,3050,路竹,三等
2020-09-18,4300,1789,1922,3711,路竹,三等
2020-09-19,4300,1549,1576,3125,路竹,三等
2020-09-20,4300,1592,1609,3201,路竹,三等
2020-09-21,4300,1636,1632,3268,路竹,三等
2020-09-22,4300,1538,1561,3099,路竹,三等
2020-09-23,4300,1557,1608,3165,路竹,三等
2020-09-24,4300,1550,1585,3135,路竹,三等
2020-09-25,4300,1585,1712,3297,路竹,三等
2020-09-26,4300,1393,1409,2802,路竹,三等
2020-09-27,4300,1437,1507,2944,路竹,三等
2020-09-28,4300,1600,1615,3215,路竹,三等
2020-09-29,4300,1491,1551,3042,路竹,三等
2020-09-30,4300,1850,2131,3981,路竹,三等
2020-10-01,4300,1681,1802,3483,路竹,三等
2020-10-02,4300,1826,1753,3579,路竹,三等
2020-10-03,4300,1746,1775,3521,路竹,三等
2020-10-04,4300,1774,1727,3501,路竹,三等
2020-10-05,4300,1637,1531,3168,路竹,三等
2020-10-06,4300,1581,1583,3164,路竹,三等
2020-10-07,4300,1571,1584,3155,路竹,三等
2020-10-08,4300,1795,1930,3725,路竹,三等
2020-10-09,4300,1800,1706,3506,路竹,三等
2020-10-10,4300,1710,1645,3355,路竹,三等
2020-10-11,4300,1576,1708,3284,路竹,三等
2020-10-12,4300,1644,1614,3258,路竹,三等
2020-10-13,4300,1494,1515,3009,路竹,三等
2020-10-14,4300,1552,1602,3154,路竹,三等
2020-10-15,4300,1541,1602,3143,路竹,三等
2020-10-16,4300,1775,1952,3727,路竹,三等
2020-10-17,4300,1570,1515,3085,路竹,三等
2020-10-18,4300,1642,1682,3324,路竹,三等
2020-10-19,4300,1645,1613,3258,路竹,三等
2020-10-20,4300,1494,1537,3031,路竹,三等
2020-10-21,4300,1652,1679,3331,路竹,三等
2020-10-22,4300,1630,1684,3314,路竹,三等
2020-10-23,4300,1761,1911,3672,路竹,三等
2020-10-24,4300,1651,1679,3330,路竹,三等
2020-10-25,4300,1523,1520,3043,路竹,三等
2020-10-26,4300,1610,1534,3144,路竹,三等
2020-10-27,4300,1529,1558,3087,路竹,三等
2020-10-28,4300,1483,1554,3037,路竹,三等
2020-10-29,4300,1554,1544,3098,路竹,三等
2020-10-30,4300,1680,1861,3541,路竹,三等
2020-10-31,4300,1651,1592,3243,路竹,三等
2020-11-01,4300,1538,1647,3185,路竹,三等
2020-11-02,4300,1645,1611,3256,路竹,三等
2020-11-03,4300,1537,1577,3114,路竹,三等
2020-11-04,4300,1603,1583,3186,路竹,三等
2020-11-05,4300,1588,1633,3221,路竹,三等
2020-11-06,4300,1722,1908,3630,路竹,三等
2020-11-07,4300,1847,1582,3429,路竹,三等
2020-11-08,4300,1900,1910,3810,路竹,三等
2020-11-09,4300,1603,1598,3201,路竹,三等
2020-11-10,4300,1561,1557,3118,路竹,三等
2020-11-11,4300,1593,1644,3237,路竹,三等
2020-11-12,4300,1588,1587,3175,路竹,三等
2020-11-13,4300,1839,1995,3834,路竹,三等
2020-11-14,4300,1759,1725,3484,路竹,三等
2020-11-15,4300,1791,1833,3624,路竹,三等
2020-11-16,4300,1690,1633,3323,路竹,三等
2020-11-17,4300,1551,1599,3150,路竹,三等
2020-11-18,4300,1628,1651,3279,路竹,三等
2020-11-19,4300,1626,1654,3280,路竹,三等
2020-11-20,4300,1789,1975,3764,路竹,三等
2020-11-21,4300,1609,1578,3187,路竹,三等
2020-11-22,4300,1608,1659,3267,路竹,三等
2020-11-23,4300,1576,1579,3155,路竹,三等
2020-11-24,4300,1480,1520,3000,路竹,三等
2020-11-25,4300,1606,1648,3254,路竹,三等
2020-11-26,4300,1575,1594,3169,路竹,三等
2020-11-27,4300,1796,1937,3733,路竹,三等
2020-11-28,4300,1524,1484,3008,路竹,三等
2020-11-29,4300,1601,1680,3281,路竹,三等
2020-11-30,4300,1718,1668,3386,路竹,三等
2020-12-01,4300,1468,1493,2961,路竹,三等
2020-12-02,4300,1544,1592,3136,路竹,三等
2020-12-03,4300,1557,1651,3208,路竹,三等
2020-12-04,4300,1782,1989,3771,路竹,三等
2020-12-05,4300,1882,1806,3688,路竹,三等
2020-12-06,4300,1802,1779,3581,路竹,三等
2020-12-07,4300,1630,1618,3248,路竹,三等
2020-12-08,4300,1547,1580,3127,路竹,三等
2020-12-09,4300,1519,1574,3093,路竹,三等
2020-12-10,4300,1566,1576,3142,路竹,三等
2020-12-11,4300,1780,1947,3727,路竹,三等
2020-12-12,4300,1851,1882,3733,路竹,三等
2020-12-13,4300,2008,2005,4013,路竹,三等
2020-12-14,4300,1709,1703,3412,路竹,三等
2020-12-15,4300,1492,1536,3028,路竹,三等
2020-12-16,4300,1582,1628,3210,路竹,三等
2020-12-17,4300,1607,1627,3234,路竹,三等
2020-12-18,4300,1838,1923,3761,路竹,三等
2020-12-19,4300,1758,1691,3449,路竹,三等
2020-12-20,4300,1706,1797,3503,路竹,三等
2020-12-21,4300,1575,1612,3187,路竹,三等
2020-12-22,4300,1520,1542,3062,路竹,三等
2020-12-23,4300,1520,1612,3132,路竹,三等
2020-12-24,4300,1645,1648,3293,路竹,三等
2020-12-25,4300,1830,1939,3769,路竹,三等
2020-12-26,4300,1522,1490,3012,路竹,三等
2020-12-27,4300,1534,1498,3032,路竹,三等
2020-12-28,4300,1570,1580,3150,路竹,三等
2020-12-29,4300,1531,1547,3078,路竹,三等
2020-12-30,4300,1514,1591,3105,路竹,三等
2020-12-31,4300,2053,1979,4032,路竹,三等
2020-01-01,4310,3149,3433,6582,岡山,一等
2020-01-02,4310,2596,2582,5178,岡山,一等
2020-01-03,4310,3040,3077,6117,岡山,一等
2020-01-04,4310,2781,2783,5564,岡山,一等
2020-01-05,4310,2945,3824,6769,岡山,一等
2020-01-06,4310,2753,2773,5526,岡山,一等
2020-01-07,4310,2540,2594,5134,岡山,一等
2020-01-08,4310,2495,2498,4993,岡山,一等
2020-01-09,4310,2548,2718,5266,岡山,一等
2020-01-10,4310,3840,4024,7864,岡山,一等
2020-01-11,4310,3362,3479,6841,岡山,一等
2020-01-12,4310,4007,4347,8354,岡山,一等
2020-01-13,4310,2968,2943,5911,岡山,一等
2020-01-14,4310,2509,2494,5003,岡山,一等
2020-01-15,4310,2555,2616,5171,岡山,一等
2020-01-16,4310,2717,2658,5375,岡山,一等
2020-01-17,4310,3429,2925,6354,岡山,一等
2020-01-18,4310,2888,2885,5773,岡山,一等
2020-01-19,4310,3004,3241,6245,岡山,一等
2020-01-20,4310,2582,2769,5351,岡山,一等
2020-01-21,4310,2646,2725,5371,岡山,一等
2020-01-22,4310,3233,3071,6304,岡山,一等
2020-01-23,4310,2994,3259,6253,岡山,一等
2020-01-24,4310,2983,3436,6419,岡山,一等
2020-01-25,4310,4236,4317,8553,岡山,一等
2020-01-26,4310,5480,5146,10626,岡山,一等
2020-01-27,4310,4331,3972,8303,岡山,一等
2020-01-28,4310,3011,2939,5950,岡山,一等
2020-01-29,4310,2791,3118,5909,岡山,一等
2020-01-30,4310,2393,2176,4569,岡山,一等
2020-01-31,4310,2665,2276,4941,岡山,一等
2020-02-01,4310,2051,2072,4123,岡山,一等
2020-02-02,4310,2415,3103,5518,岡山,一等
2020-02-03,4310,2208,2178,4386,岡山,一等
2020-02-04,4310,2089,2086,4175,岡山,一等
2020-02-05,4310,2165,2109,4274,岡山,一等
2020-02-06,4310,2136,2081,4217,岡山,一等
2020-02-07,4310,2870,2458,5328,岡山,一等
2020-02-08,4310,2725,2348,5073,岡山,一等
2020-02-09,4310,2987,3484,6471,岡山,一等
2020-02-10,4310,2337,2366,4703,岡山,一等
2020-02-11,4310,2084,2086,4170,岡山,一等
2020-02-12,4310,2109,2090,4199,岡山,一等
2020-02-13,4310,2022,2092,4114,岡山,一等
2020-02-14,4310,2537,2405,4942,岡山,一等
2020-02-15,4310,2634,2419,5053,岡山,一等
2020-02-16,4310,3126,3435,6561,岡山,一等
2020-02-17,4310,2017,2135,4152,岡山,一等
2020-02-18,4310,1961,1959,3920,岡山,一等
2020-02-19,4310,2131,2128,4259,岡山,一等
2020-02-20,4310,2006,2022,4028,岡山,一等
2020-02-21,4310,2811,2444,5255,岡山,一等
2020-02-22,4310,2495,2247,4742,岡山,一等
2020-02-23,4310,2635,3134,5769,岡山,一等
2020-02-24,4310,2289,2219,4508,岡山,一等
2020-02-25,4310,2180,2197,4377,岡山,一等
2020-02-26,4310,2220,2296,4516,岡山,一等
2020-02-27,4310,3321,2755,6076,岡山,一等
2020-02-28,4310,2299,2347,4646,岡山,一等
2020-02-29,4310,1984,2049,4033,岡山,一等
2020-03-01,4310,2742,3250,5992,岡山,一等
2020-03-02,4310,2416,2412,4828,岡山,一等
2020-03-03,4310,2146,2169,4315,岡山,一等
2020-03-04,4310,2048,2085,4133,岡山,一等
2020-03-05,4310,2177,2224,4401,岡山,一等
2020-03-06,4310,3193,3005,6198,岡山,一等
2020-03-07,4310,2178,2129,4307,岡山,一等
2020-03-08,4310,2649,2951,5600,岡山,一等
2020-03-09,4310,2394,2366,4760,岡山,一等
2020-03-10,4310,2159,2195,4354,岡山,一等
2020-03-11,4310,2196,2215,4411,岡山,一等
2020-03-12,4310,2388,2287,4675,岡山,一等
2020-03-13,4310,3209,3044,6253,岡山,一等
2020-03-14,4310,2054,2038,4092,岡山,一等
2020-03-15,4310,2840,3313,6153,岡山,一等
2020-03-16,4310,2397,2432,4829,岡山,一等
2020-03-17,4310,2183,2188,4371,岡山,一等
2020-03-18,4310,2096,2122,4218,岡山,一等
2020-03-19,4310,2116,2128,4244,岡山,一等
2020-03-20,4310,2868,2833,5701,岡山,一等
2020-03-21,4310,2021,1919,3940,岡山,一等
2020-03-22,4310,2258,2577,4835,岡山,一等
2020-03-23,4310,2186,2182,4368,岡山,一等
2020-03-24,4310,2055,2013,4068,岡山,一等
2020-03-25,4310,2012,2022,4034,岡山,一等
2020-03-26,4310,1984,2029,4013,岡山,一等
2020-03-27,4310,2688,2590,5278,岡山,一等
2020-03-28,4310,1859,1697,3556,岡山,一等
2020-03-29,4310,1917,2342,4259,岡山,一等
2020-03-30,4310,2135,2255,4390,岡山,一等
2020-03-31,4310,1992,2152,4144,岡山,一等
2020-04-01,4310,2924,2743,5667,岡山,一等
2020-04-02,4310,1724,1899,3623,岡山,一等
2020-04-03,4310,1710,1813,3523,岡山,一等
2020-04-04,4310,1529,1533,3062,岡山,一等
2020-04-05,4310,2378,2576,4954,岡山,一等
2020-04-06,4310,2198,2047,4245,岡山,一等
2020-04-07,4310,1866,1857,3723,岡山,一等
2020-04-08,4310,1827,1868,3695,岡山,一等
2020-04-09,4310,1897,1983,3880,岡山,一等
2020-04-10,4310,2529,2595,5124,岡山,一等
2020-04-11,4310,2035,1786,3821,岡山,一等
2020-04-12,4310,2230,2630,4860,岡山,一等
2020-04-13,4310,2051,2050,4101,岡山,一等
2020-04-14,4310,1917,1928,3845,岡山,一等
2020-04-15,4310,2025,1978,4003,岡山,一等
2020-04-16,4310,1998,1987,3985,岡山,一等
2020-04-17,4310,2682,2603,5285,岡山,一等
2020-04-18,4310,2222,1982,4204,岡山,一等
2020-04-19,4310,2226,2682,4908,岡山,一等
2020-04-20,4310,2028,2035,4063,岡山,一等
2020-04-21,4310,1836,1885,3721,岡山,一等
2020-04-22,4310,1735,1771,3506,岡山,一等
2020-04-23,4310,1819,1895,3714,岡山,一等
2020-04-24,4310,2734,2157,4891,岡山,一等
2020-04-25,4310,1547,1531,3078,岡山,一等
2020-04-26,4310,1654,2039,3693,岡山,一等
2020-04-27,4310,1938,2035,3973,岡山,一等
2020-04-28,4310,1891,1930,3821,岡山,一等
2020-04-29,4310,1797,1850,3647,岡山,一等
2020-04-30,4310,1975,1880,3855,岡山,一等
2020-05-01,4310,2593,2596,5189,岡山,一等
2020-05-02,4310,1829,1694,3523,岡山,一等
2020-05-03,4310,2108,2323,4431,岡山,一等
2020-05-04,4310,2135,2070,4205,岡山,一等
2020-05-05,4310,1952,1997,3949,岡山,一等
2020-05-06,4310,1973,2025,3998,岡山,一等
2020-05-07,4310,2012,2102,4114,岡山,一等
2020-05-08,4310,3087,2979,6066,岡山,一等
2020-05-09,4310,2040,2227,4267,岡山,一等
2020-05-10,4310,2670,2933,5603,岡山,一等
2020-05-11,4310,2302,2249,4551,岡山,一等
2020-05-12,4310,1937,2006,3943,岡山,一等
2020-05-13,4310,1959,2042,4001,岡山,一等
2020-05-14,4310,1979,2075,4054,岡山,一等
2020-05-15,4310,2872,2790,5662,岡山,一等
2020-05-16,4310,2062,2106,4168,岡山,一等
2020-05-17,4310,2392,2701,5093,岡山,一等
2020-05-18,4310,2155,2168,4323,岡山,一等
2020-05-19,4310,1867,1942,3809,岡山,一等
2020-05-20,4310,1943,1959,3902,岡山,一等
2020-05-21,4310,1893,1938,3831,岡山,一等
2020-05-22,4310,2313,2294,4607,岡山,一等
2020-05-23,4310,2060,1891,3951,岡山,一等
2020-05-24,4310,2765,3088,5853,岡山,一等
2020-05-25,4310,2170,2245,4415,岡山,一等
2020-05-26,4310,2023,2077,4100,岡山,一等
2020-05-27,4310,1814,1905,3719,岡山,一等
2020-05-28,4310,1996,2071,4067,岡山,一等
2020-05-29,4310,2712,2779,5491,岡山,一等
2020-05-30,4310,2458,2189,4647,岡山,一等
2020-05-31,4310,2509,2766,5275,岡山,一等
2020-06-01,4310,2194,2214,4408,岡山,一等
2020-06-02,4310,2047,2091,4138,岡山,一等
2020-06-03,4310,1948,2077,4025,岡山,一等
2020-06-04,4310,2064,2117,4181,岡山,一等
2020-06-05,4310,2806,3184,5990,岡山,一等
2020-06-06,4310,2783,2711,5494,岡山,一等
2020-06-07,4310,3255,3097,6352,岡山,一等
2020-06-08,4310,2284,2251,4535,岡山,一等
2020-06-09,4310,2105,2067,4172,岡山,一等
2020-06-10,4310,2062,2145,4207,岡山,一等
2020-06-11,4310,2177,2243,4420,岡山,一等
2020-06-12,4310,2812,2761,5573,岡山,一等
2020-06-13,4310,2763,2454,5217,岡山,一等
2020-06-14,4310,2903,3324,6227,岡山,一等
2020-06-15,4310,2350,2337,4687,岡山,一等
2020-06-16,4310,2151,2171,4322,岡山,一等
2020-06-17,4310,1982,2045,4027,岡山,一等
2020-06-18,4310,2138,2143,4281,岡山,一等
2020-06-19,4310,2417,2448,4865,岡山,一等
2020-06-20,4310,2483,2452,4935,岡山,一等
2020-06-21,4310,2668,2565,5233,岡山,一等
2020-06-22,4310,2266,2337,4603,岡山,一等
2020-06-23,4310,2213,2249,4462,岡山,一等
2020-06-24,4310,3151,3104,6255,岡山,一等
2020-06-25,4310,2495,2495,4990,岡山,一等
2020-06-26,4310,2637,2767,5404,岡山,一等
2020-06-27,4310,2636,2670,5306,岡山,一等
2020-06-28,4310,3242,3161,6403,岡山,一等
2020-06-29,4310,2520,2520,5040,岡山,一等
2020-06-30,4310,2108,2147,4255,岡山,一等
2020-07-01,4310,2024,2129,4153,岡山,一等
2020-07-02,4310,2164,2166,4330,岡山,一等
2020-07-03,4310,2763,2561,5324,岡山,一等
2020-07-04,4310,2241,2203,4444,岡山,一等
2020-07-05,4310,2573,2742,5315,岡山,一等
2020-07-06,4310,2418,2387,4805,岡山,一等
2020-07-07,4310,2158,2215,4373,岡山,一等
2020-07-08,4310,2149,2170,4319,岡山,一等
2020-07-09,4310,2175,2142,4317,岡山,一等
2020-07-10,4310,3014,2836,5850,岡山,一等
2020-07-11,4310,2607,2454,5061,岡山,一等
2020-07-12,4310,3122,3502,6624,岡山,一等
2020-07-13,4310,2209,2284,4493,岡山,一等
2020-07-14,4310,2369,2343,4712,岡山,一等
2020-07-15,4310,2146,2187,4333,岡山,一等
2020-07-16,4310,2270,2149,4419,岡山,一等
2020-07-17,4310,2886,2678,5564,岡山,一等
2020-07-18,4310,2684,2568,5252,岡山,一等
2020-07-19,4310,3038,3504,6542,岡山,一等
2020-07-20,4310,2504,2495,4999,岡山,一等
2020-07-21,4310,2216,2328,4544,岡山,一等
2020-07-22,4310,2349,2264,4613,岡山,一等
2020-07-23,4310,2327,2302,4629,岡山,一等
2020-07-24,4310,3281,2717,5998,岡山,一等
2020-07-25,4310,2550,2587,5137,岡山,一等
2020-07-26,4310,2844,3378,6222,岡山,一等
2020-07-27,4310,2313,2422,4735,岡山,一等
2020-07-28,4310,2120,2194,4314,岡山,一等
2020-07-29,4310,2188,2220,4408,岡山,一等
2020-07-30,4310,2222,2217,4439,岡山,一等
2020-07-31,4310,2953,2605,5558,岡山,一等
2020-08-01,4310,2351,2274,4625,岡山,一等
2020-08-02,4310,2424,2899,5323,岡山,一等
2020-08-03,4310,2175,2053,4228,岡山,一等
2020-08-04,4310,2016,2007,4023,岡山,一等
2020-08-05,4310,2392,2235,4627,岡山,一等
2020-08-06,4310,2393,2330,4723,岡山,一等
2020-08-07,4310,3305,2875,6180,岡山,一等
2020-08-08,4310,2520,2610,5130,岡山,一等
2020-08-09,4310,3445,3834,7279,岡山,一等
2020-08-10,4310,2468,2433,4901,岡山,一等
2020-08-11,4310,2075,2095,4170,岡山,一等
2020-08-12,4310,2293,2345,4638,岡山,一等
2020-08-13,4310,2400,2433,4833,岡山,一等
2020-08-14,4310,2971,2812,5783,岡山,一等
2020-08-15,4310,2980,2724,5704,岡山,一等
2020-08-16,4310,3198,3562,6760,岡山,一等
2020-08-17,4310,2452,2433,4885,岡山,一等
2020-08-18,4310,2338,2397,4735,岡山,一等
2020-08-19,4310,2345,2232,4577,岡山,一等
2020-08-20,4310,2262,2266,4528,岡山,一等
2020-08-21,4310,2950,2576,5526,岡山,一等
2020-08-22,4310,2432,2297,4729,岡山,一等
2020-08-23,4310,2648,3123,5771,岡山,一等
2020-08-24,4310,2315,2356,4671,岡山,一等
2020-08-25,4310,2307,2263,4570,岡山,一等
2020-08-26,4310,1747,1830,3577,岡山,一等
2020-08-27,4310,1915,1988,3903,岡山,一等
2020-08-28,4310,2890,2441,5331,岡山,一等
2020-08-29,4310,2597,2335,4932,岡山,一等
2020-08-30,4310,2299,3085,5384,岡山,一等
2020-08-31,4310,2146,2252,4398,岡山,一等
2020-09-01,4310,1979,2032,4011,岡山,一等
2020-09-02,4310,2342,2084,4426,岡山,一等
2020-09-03,4310,2328,2446,4774,岡山,一等
2020-09-04,4310,2871,2752,5623,岡山,一等
2020-09-05,4310,2887,2422,5309,岡山,一等
2020-09-06,4310,2948,3621,6569,岡山,一等
2020-09-07,4310,2425,2472,4897,岡山,一等
2020-09-08,4310,2243,2320,4563,岡山,一等
2020-09-09,4310,2265,2305,4570,岡山,一等
2020-09-10,4310,2281,2302,4583,岡山,一等
2020-09-11,4310,3303,2802,6105,岡山,一等
2020-09-12,4310,2935,2733,5668,岡山,一等
2020-09-13,4310,3612,4039,7651,岡山,一等
2020-09-14,4310,2415,2519,4934,岡山,一等
2020-09-15,4310,2184,2258,4442,岡山,一等
2020-09-16,4310,2288,2337,4625,岡山,一等
2020-09-17,4310,2183,2243,4426,岡山,一等
2020-09-18,4310,3054,3079,6133,岡山,一等
2020-09-19,4310,2892,2572,5464,岡山,一等
2020-09-20,4310,3057,3651,6708,岡山,一等
2020-09-21,4310,2422,2378,4800,岡山,一等
2020-09-22,4310,2241,2251,4492,岡山,一等
2020-09-23,4310,2201,2234,4435,岡山,一等
2020-09-24,4310,2205,2306,4511,岡山,一等
2020-09-25,4310,2421,2575,4996,岡山,一等
2020-09-26,4310,2650,2580,5230,岡山,一等
2020-09-27,4310,2804,2727,5531,岡山,一等
2020-09-28,4310,2336,2367,4703,岡山,一等
2020-09-29,4310,2330,2504,4834,岡山,一等
2020-09-30,4310,3829,3988,7817,岡山,一等
2020-10-01,4310,2930,3134,6064,岡山,一等
2020-10-02,4310,2987,2838,5825,岡山,一等
2020-10-03,4310,2847,2928,5775,岡山,一等
2020-10-04,4310,3441,3858,7299,岡山,一等
2020-10-05,4310,2679,2355,5034,岡山,一等
2020-10-06,4310,2230,2280,4510,岡山,一等
2020-10-07,4310,2256,2225,4481,岡山,一等
2020-10-08,4310,3491,3190,6681,岡山,一等
2020-10-09,4310,2742,2888,5630,岡山,一等
2020-10-10,4310,2918,2968,5886,岡山,一等
2020-10-11,4310,3574,4147,7721,岡山,一等
2020-10-12,4310,2573,2475,5048,岡山,一等
2020-10-13,4310,2228,2240,4468,岡山,一等
2020-10-14,4310,2244,2261,4505,岡山,一等
2020-10-15,4310,2225,2287,4512,岡山,一等
2020-10-16,4310,2989,3030,6019,岡山,一等
2020-10-17,4310,3173,2754,5927,岡山,一等
2020-10-18,4310,3287,3750,7037,岡山,一等
2020-10-19,4310,2491,2347,4838,岡山,一等
2020-10-20,4310,2216,2313,4529,岡山,一等
2020-10-21,4310,2261,2307,4568,岡山,一等
2020-10-22,4310,2300,2396,4696,岡山,一等
2020-10-23,4310,2936,2955,5891,岡山,一等
2020-10-24,4310,3131,2684,5815,岡山,一等
2020-10-25,4310,3014,3516,6530,岡山,一等
2020-10-26,4310,2452,2217,4669,岡山,一等
2020-10-27,4310,2239,2224,4463,岡山,一等
2020-10-28,4310,2221,2238,4459,岡山,一等
2020-10-29,4310,2205,2293,4498,岡山,一等
2020-10-30,4310,3137,3208,6345,岡山,一等
2020-10-31,4310,3386,3078,6464,岡山,一等
2020-11-01,4310,3134,3445,6579,岡山,一等
2020-11-02,4310,2374,2281,4655,岡山,一等
2020-11-03,4310,2173,2185,4358,岡山,一等
2020-11-04,4310,2191,2255,4446,岡山,一等
2020-11-05,4310,2392,2419,4811,岡山,一等
2020-11-06,4310,3036,3017,6053,岡山,一等
2020-11-07,4310,2882,2622,5504,岡山,一等
2020-11-08,4310,3289,3542,6831,岡山,一等
2020-11-09,4310,2422,2503,4925,岡山,一等
2020-11-10,4310,2257,2310,4567,岡山,一等
2020-11-11,4310,2182,2307,4489,岡山,一等
2020-11-12,4310,2447,2489,4936,岡山,一等
2020-11-13,4310,3714,3362,7076,岡山,一等
2020-11-14,4310,2856,2945,5801,岡山,一等
2020-11-15,4310,3528,3994,7522,岡山,一等
2020-11-16,4310,2567,2371,4938,岡山,一等
2020-11-17,4310,2290,2338,4628,岡山,一等
2020-11-18,4310,2232,2297,4529,岡山,一等
2020-11-19,4310,2271,2384,4655,岡山,一等
2020-11-20,4310,3183,3199,6382,岡山,一等
2020-11-21,4310,3048,2748,5796,岡山,一等
2020-11-22,4310,3188,3540,6728,岡山,一等
2020-11-23,4310,2504,2368,4872,岡山,一等
2020-11-24,4310,2318,2319,4637,岡山,一等
2020-11-25,4310,2235,2402,4637,岡山,一等
2020-11-26,4310,2418,2516,4934,岡山,一等
2020-11-27,4310,3104,3128,6232,岡山,一等
2020-11-28,4310,3028,2750,5778,岡山,一等
2020-11-29,4310,3068,3460,6528,岡山,一等
2020-11-30,4310,2472,2293,4765,岡山,一等
2020-12-01,4310,2162,2149,4311,岡山,一等
2020-12-02,4310,2194,2189,4383,岡山,一等
2020-12-03,4310,2251,2312,4563,岡山,一等
2020-12-04,4310,3015,3099,6114,岡山,一等
2020-12-05,4310,3322,3038,6360,岡山,一等
2020-12-06,4310,3296,3525,6821,岡山,一等
2020-12-07,4310,2434,2438,4872,岡山,一等
2020-12-08,4310,2385,2322,4707,岡山,一等
2020-12-09,4310,2303,2360,4663,岡山,一等
2020-12-10,4310,2392,2381,4773,岡山,一等
2020-12-11,4310,3256,3112,6368,岡山,一等
2020-12-12,4310,3083,2985,6068,岡山,一等
2020-12-13,4310,3711,4072,7783,岡山,一等
2020-12-14,4310,2511,2346,4857,岡山,一等
2020-12-15,4310,2196,2195,4391,岡山,一等
2020-12-16,4310,2278,2285,4563,岡山,一等
2020-12-17,4310,2387,2374,4761,岡山,一等
2020-12-18,4310,3424,3214,6638,岡山,一等
2020-12-19,4310,2610,2701,5311,岡山,一等
2020-12-20,4310,3472,3719,7191,岡山,一等
2020-12-21,4310,2365,2350,4715,岡山,一等
2020-12-22,4310,2221,2308,4529,岡山,一等
2020-12-23,4310,2310,2356,4666,岡山,一等
2020-12-24,4310,2381,2369,4750,岡山,一等
2020-12-25,4310,3213,3241,6454,岡山,一等
2020-12-26,4310,2832,2691,5523,岡山,一等
2020-12-27,4310,3077,3191,6268,岡山,一等
2020-12-28,4310,2407,2357,4764,岡山,一等
2020-12-29,4310,2129,2199,4328,岡山,一等
2020-12-30,4310,2281,2452,4733,岡山,一等
2020-12-31,4310,3549,3337,6886,岡山,一等
2020-01-01,4320,1803,1670,3473,橋頭,三等
2020-01-02,4320,1320,1468,2788,橋頭,三等
2020-01-03,4320,1448,1582,3030,橋頭,三等
2020-01-04,4320,1428,1541,2969,橋頭,三等
2020-01-05,4320,1460,1614,3074,橋頭,三等
2020-01-06,4320,1265,1527,2792,橋頭,三等
2020-01-07,4320,1299,1431,2730,橋頭,三等
2020-01-08,4320,1183,1320,2503,橋頭,三等
2020-01-09,4320,1225,1469,2694,橋頭,三等
2020-01-10,4320,1952,2356,4308,橋頭,三等
2020-01-11,4320,1573,1765,3338,橋頭,三等
2020-01-12,4320,1552,1798,3350,橋頭,三等
2020-01-13,4320,1247,1481,2728,橋頭,三等
2020-01-14,4320,1263,1380,2643,橋頭,三等
2020-01-15,4320,1214,1439,2653,橋頭,三等
2020-01-16,4320,1373,1484,2857,橋頭,三等
2020-01-17,4320,1442,1614,3056,橋頭,三等
2020-01-18,4320,1394,1513,2907,橋頭,三等
2020-01-19,4320,1350,1585,2935,橋頭,三等
2020-01-20,4320,1257,1429,2686,橋頭,三等
2020-01-21,4320,1256,1414,2670,橋頭,三等
2020-01-22,4320,1319,1464,2783,橋頭,三等
2020-01-23,4320,1160,1353,2513,橋頭,三等
2020-01-24,4320,1010,1186,2196,橋頭,三等
2020-01-25,4320,1720,1920,3640,橋頭,三等
2020-01-26,4320,1408,1429,2837,橋頭,三等
2020-01-27,4320,1581,1756,3337,橋頭,三等
2020-01-28,4320,1118,1242,2360,橋頭,三等
2020-01-29,4320,1052,1153,2205,橋頭,三等
2020-01-30,4320,950,1137,2087,橋頭,三等
2020-01-31,4320,1146,1214,2360,橋頭,三等
2020-02-01,4320,1023,1062,2085,橋頭,三等
2020-02-02,4320,1035,1090,2125,橋頭,三等
2020-02-03,4320,991,1122,2113,橋頭,三等
2020-02-04,4320,981,1075,2056,橋頭,三等
2020-02-05,4320,1051,1183,2234,橋頭,三等
2020-02-06,4320,985,1096,2081,橋頭,三等
2020-02-07,4320,1164,1265,2429,橋頭,三等
2020-02-08,4320,1147,1228,2375,橋頭,三等
2020-02-09,4320,1178,1328,2506,橋頭,三等
2020-02-10,4320,999,1165,2164,橋頭,三等
2020-02-11,4320,1032,1093,2125,橋頭,三等
2020-02-12,4320,998,1052,2050,橋頭,三等
2020-02-13,4320,989,1036,2025,橋頭,三等
2020-02-14,4320,1114,1183,2297,橋頭,三等
2020-02-15,4320,1149,1253,2402,橋頭,三等
2020-02-16,4320,1290,1320,2610,橋頭,三等
2020-02-17,4320,963,1116,2079,橋頭,三等
2020-02-18,4320,1010,1055,2065,橋頭,三等
2020-02-19,4320,966,1026,1992,橋頭,三等
2020-02-20,4320,870,1007,1877,橋頭,三等
2020-02-21,4320,1150,1231,2381,橋頭,三等
2020-02-22,4320,1102,1217,2319,橋頭,三等
2020-02-23,4320,1164,1230,2394,橋頭,三等
2020-02-24,4320,1038,1236,2274,橋頭,三等
2020-02-25,4320,1030,1150,2180,橋頭,三等
2020-02-26,4320,1068,1207,2275,橋頭,三等
2020-02-27,4320,1377,1397,2774,橋頭,三等
2020-02-28,4320,1159,1190,2349,橋頭,三等
2020-02-29,4320,991,1128,2119,橋頭,三等
2020-03-01,4320,1119,1275,2394,橋頭,三等
2020-03-02,4320,1115,1293,2408,橋頭,三等
2020-03-03,4320,1097,1204,2301,橋頭,三等
2020-03-04,4320,1054,1159,2213,橋頭,三等
2020-03-05,4320,1098,1221,2319,橋頭,三等
2020-03-06,4320,1473,1609,3082,橋頭,三等
2020-03-07,4320,1140,1225,2365,橋頭,三等
2020-03-08,4320,1178,1427,2605,橋頭,三等
2020-03-09,4320,1216,1322,2538,橋頭,三等
2020-03-10,4320,1089,1189,2278,橋頭,三等
2020-03-11,4320,1103,1215,2318,橋頭,三等
2020-03-12,4320,1074,1205,2279,橋頭,三等
2020-03-13,4320,1482,1550,3032,橋頭,三等
2020-03-14,4320,1021,1041,2062,橋頭,三等
2020-03-15,4320,1258,1371,2629,橋頭,三等
2020-03-16,4320,1173,1267,2440,橋頭,三等
2020-03-17,4320,1066,1168,2234,橋頭,三等
2020-03-18,4320,1044,1152,2196,橋頭,三等
2020-03-19,4320,1045,1181,2226,橋頭,三等
2020-03-20,4320,1311,1455,2766,橋頭,三等
2020-03-21,4320,940,973,1913,橋頭,三等
2020-03-22,4320,982,1096,2078,橋頭,三等
2020-03-23,4320,1089,1251,2340,橋頭,三等
2020-03-24,4320,1000,1099,2099,橋頭,三等
2020-03-25,4320,1006,1086,2092,橋頭,三等
2020-03-26,4320,973,1087,2060,橋頭,三等
2020-03-27,4320,1255,1340,2595,橋頭,三等
2020-03-28,4320,879,922,1801,橋頭,三等
2020-03-29,4320,874,952,1826,橋頭,三等
2020-03-30,4320,1046,1145,2191,橋頭,三等
2020-03-31,4320,1102,1189,2291,橋頭,三等
2020-04-01,4320,1225,1341,2566,橋頭,三等
2020-04-02,4320,843,902,1745,橋頭,三等
2020-04-03,4320,797,834,1631,橋頭,三等
2020-04-04,4320,645,732,1377,橋頭,三等
2020-04-05,4320,878,1011,1889,橋頭,三等
2020-04-06,4320,1014,1116,2130,橋頭,三等
2020-04-07,4320,929,1015,1944,橋頭,三等
2020-04-08,4320,942,1007,1949,橋頭,三等
2020-04-09,4320,931,1041,1972,橋頭,三等
2020-04-10,4320,4308,7589,11897,橋頭,三等
2020-04-11,4320,889,896,1785,橋頭,三等
2020-04-12,4320,880,1034,1914,橋頭,三等
2020-04-13,4320,978,1129,2107,橋頭,三等
2020-04-14,4320,959,1095,2054,橋頭,三等
2020-04-15,4320,962,1022,1984,橋頭,三等
2020-04-16,4320,958,1078,2036,橋頭,三等
2020-04-17,4320,1287,1364,2651,橋頭,三等
2020-04-18,4320,886,890,1776,橋頭,三等
2020-04-19,4320,842,1015,1857,橋頭,三等
2020-04-20,4320,1006,1151,2157,橋頭,三等
2020-04-21,4320,945,1045,1990,橋頭,三等
2020-04-22,4320,836,893,1729,橋頭,三等
2020-04-23,4320,899,1002,1901,橋頭,三等
2020-04-24,4320,1171,1268,2439,橋頭,三等
2020-04-25,4320,633,650,1283,橋頭,三等
2020-04-26,4320,699,784,1483,橋頭,三等
2020-04-27,4320,967,1071,2038,橋頭,三等
2020-04-28,4320,921,1016,1937,橋頭,三等
2020-04-29,4320,880,914,1794,橋頭,三等
2020-04-30,4320,939,1045,1984,橋頭,三等
2020-05-01,4320,1141,1198,2339,橋頭,三等
2020-05-02,4320,818,877,1695,橋頭,三等
2020-05-03,4320,858,973,1831,橋頭,三等
2020-05-04,4320,1012,1116,2128,橋頭,三等
2020-05-05,4320,956,1036,1992,橋頭,三等
2020-05-06,4320,980,1045,2025,橋頭,三等
2020-05-07,4320,976,1099,2075,橋頭,三等
2020-05-08,4320,1439,1436,2875,橋頭,三等
2020-05-09,4320,880,944,1824,橋頭,三等
2020-05-10,4320,987,1235,2222,橋頭,三等
2020-05-11,4320,1082,1195,2277,橋頭,三等
2020-05-12,4320,1001,1063,2064,橋頭,三等
2020-05-13,4320,958,1051,2009,橋頭,三等
2020-05-14,4320,988,1066,2054,橋頭,三等
2020-05-15,4320,1394,1475,2869,橋頭,三等
2020-05-16,4320,884,871,1755,橋頭,三等
2020-05-17,4320,1034,1165,2199,橋頭,三等
2020-05-18,4320,1075,1175,2250,橋頭,三等
2020-05-19,4320,946,1048,1994,橋頭,三等
2020-05-20,4320,946,1030,1976,橋頭,三等
2020-05-21,4320,928,1005,1933,橋頭,三等
2020-05-22,4320,1064,1427,2491,橋頭,三等
2020-05-23,4320,873,917,1790,橋頭,三等
2020-05-24,4320,1095,1235,2330,橋頭,三等
2020-05-25,4320,1099,1223,2322,橋頭,三等
2020-05-26,4320,1007,1047,2054,橋頭,三等
2020-05-27,4320,919,1039,1958,橋頭,三等
2020-05-28,4320,986,1061,2047,橋頭,三等
2020-05-29,4320,1380,1490,2870,橋頭,三等
2020-05-30,4320,1219,1342,2561,橋頭,三等
2020-05-31,4320,1189,1283,2472,橋頭,三等
2020-06-01,4320,1154,1234,2388,橋頭,三等
2020-06-02,4320,1009,1087,2096,橋頭,三等
2020-06-03,4320,1020,1098,2118,橋頭,三等
2020-06-04,4320,1065,1218,2283,橋頭,三等
2020-06-05,4320,1373,1652,3025,橋頭,三等
2020-06-06,4320,1286,1392,2678,橋頭,三等
2020-06-07,4320,1310,1426,2736,橋頭,三等
2020-06-08,4320,1147,1200,2347,橋頭,三等
2020-06-09,4320,1047,1111,2158,橋頭,三等
2020-06-10,4320,1095,1212,2307,橋頭,三等
2020-06-11,4320,1064,1218,2282,橋頭,三等
2020-06-12,4320,1367,1459,2826,橋頭,三等
2020-06-13,4320,1396,1551,2947,橋頭,三等
2020-06-14,4320,1384,1605,2989,橋頭,三等
2020-06-15,4320,1169,1321,2490,橋頭,三等
2020-06-16,4320,1123,1211,2334,橋頭,三等
2020-06-17,4320,1056,1202,2258,橋頭,三等
2020-06-18,4320,1067,1157,2224,橋頭,三等
2020-06-19,4320,1201,1434,2635,橋頭,三等
2020-06-20,4320,1237,1347,2584,橋頭,三等
2020-06-21,4320,1136,1227,2363,橋頭,三等
2020-06-22,4320,1114,1292,2406,橋頭,三等
2020-06-23,4320,1100,1224,2324,橋頭,三等
2020-06-24,4320,1384,1571,2955,橋頭,三等
2020-06-25,4320,1234,1403,2637,橋頭,三等
2020-06-26,4320,1449,1571,3020,橋頭,三等
2020-06-27,4320,1280,1344,2624,橋頭,三等
2020-06-28,4320,1245,1380,2625,橋頭,三等
2020-06-29,4320,1118,1243,2361,橋頭,三等
2020-06-30,4320,1093,1174,2267,橋頭,三等
2020-07-01,4320,1020,1138,2158,橋頭,三等
2020-07-02,4320,1064,1164,2228,橋頭,三等
2020-07-03,4320,1200,1327,2527,橋頭,三等
2020-07-04,4320,1101,1259,2360,橋頭,三等
2020-07-05,4320,1023,1136,2159,橋頭,三等
2020-07-06,4320,1080,1222,2302,橋頭,三等
2020-07-07,4320,1033,1103,2136,橋頭,三等
2020-07-08,4320,1032,1109,2141,橋頭,三等
2020-07-09,4320,1061,1158,2219,橋頭,三等
2020-07-10,4320,1348,1445,2793,橋頭,三等
2020-07-11,4320,1300,1423,2723,橋頭,三等
2020-07-12,4320,1250,1377,2627,橋頭,三等
2020-07-13,4320,1048,1198,2246,橋頭,三等
2020-07-14,4320,1055,1214,2269,橋頭,三等
2020-07-15,4320,1047,1159,2206,橋頭,三等
2020-07-16,4320,1152,1242,2394,橋頭,三等
2020-07-17,4320,1342,1527,2869,橋頭,三等
2020-07-18,4320,1315,1504,2819,橋頭,三等
2020-07-19,4320,1409,1461,2870,橋頭,三等
2020-07-20,4320,1086,1242,2328,橋頭,三等
2020-07-21,4320,1174,1309,2483,橋頭,三等
2020-07-22,4320,1154,1270,2424,橋頭,三等
2020-07-23,4320,1168,1246,2414,橋頭,三等
2020-07-24,4320,1338,1511,2849,橋頭,三等
2020-07-25,4320,1309,1407,2716,橋頭,三等
2020-07-26,4320,1275,1470,2745,橋頭,三等
2020-07-27,4320,1114,1235,2349,橋頭,三等
2020-07-28,4320,1151,1255,2406,橋頭,三等
2020-07-29,4320,1003,1112,2115,橋頭,三等
2020-07-30,4320,1005,1119,2124,橋頭,三等
2020-07-31,4320,1299,1353,2652,橋頭,三等
2020-08-01,4320,1128,1379,2507,橋頭,三等
2020-08-02,4320,1104,1179,2283,橋頭,三等
2020-08-03,4320,936,1105,2041,橋頭,三等
2020-08-04,4320,939,1009,1948,橋頭,三等
2020-08-05,4320,1046,1178,2224,橋頭,三等
2020-08-06,4320,1170,1277,2447,橋頭,三等
2020-08-07,4320,1322,1378,2700,橋頭,三等
2020-08-08,4320,1201,1352,2553,橋頭,三等
2020-08-09,4320,1326,1529,2855,橋頭,三等
2020-08-10,4320,1093,1198,2291,橋頭,三等
2020-08-11,4320,1007,1121,2128,橋頭,三等
2020-08-12,4320,1144,1194,2338,橋頭,三等
2020-08-13,4320,1169,1271,2440,橋頭,三等
2020-08-14,4320,1341,1520,2861,橋頭,三等
2020-08-15,4320,1273,1550,2823,橋頭,三等
2020-08-16,4320,1398,1460,2858,橋頭,三等
2020-08-17,4320,1179,1276,2455,橋頭,三等
2020-08-18,4320,1292,1410,2702,橋頭,三等
2020-08-19,4320,1093,1266,2359,橋頭,三等
2020-08-20,4320,1158,1250,2408,橋頭,三等
2020-08-21,4320,1426,1464,2890,橋頭,三等
2020-08-22,4320,1277,1471,2748,橋頭,三等
2020-08-23,4320,1125,1270,2395,橋頭,三等
2020-08-24,4320,1219,1316,2535,橋頭,三等
2020-08-25,4320,1075,1230,2305,橋頭,三等
2020-08-26,4320,847,1000,1847,橋頭,三等
2020-08-27,4320,941,999,1940,橋頭,三等
2020-08-28,4320,1184,1256,2440,橋頭,三等
2020-08-29,4320,1152,1304,2456,橋頭,三等
2020-08-30,4320,1058,1180,2238,橋頭,三等
2020-08-31,4320,1043,1174,2217,橋頭,三等
2020-09-01,4320,994,1099,2093,橋頭,三等
2020-09-02,4320,968,1065,2033,橋頭,三等
2020-09-03,4320,1017,1173,2190,橋頭,三等
2020-09-04,4320,1197,1375,2572,橋頭,三等
2020-09-05,4320,1185,1277,2462,橋頭,三等
2020-09-06,4320,1288,1424,2712,橋頭,三等
2020-09-07,4320,1199,1294,2493,橋頭,三等
2020-09-08,4320,1111,1239,2350,橋頭,三等
2020-09-09,4320,1180,1242,2422,橋頭,三等
2020-09-10,4320,1134,1212,2346,橋頭,三等
2020-09-11,4320,1350,1458,2808,橋頭,三等
2020-09-12,4320,1351,1511,2862,橋頭,三等
2020-09-13,4320,1418,1753,3171,橋頭,三等
2020-09-14,4320,1229,1325,2554,橋頭,三等
2020-09-15,4320,1122,1198,2320,橋頭,三等
2020-09-16,4320,1200,1292,2492,橋頭,三等
2020-09-17,4320,1220,1325,2545,橋頭,三等
2020-09-18,4320,1526,1716,3242,橋頭,三等
2020-09-19,4320,1421,1563,2984,橋頭,三等
2020-09-20,4320,1408,1621,3029,橋頭,三等
2020-09-21,4320,1197,1342,2539,橋頭,三等
2020-09-22,4320,1222,1316,2538,橋頭,三等
2020-09-23,4320,1195,1297,2492,橋頭,三等
2020-09-24,4320,1216,1275,2491,橋頭,三等
2020-09-25,4320,1256,1418,2674,橋頭,三等
2020-09-26,4320,1405,1487,2892,橋頭,三等
2020-09-27,4320,1410,1517,2927,橋頭,三等
2020-09-28,4320,1173,1329,2502,橋頭,三等
2020-09-29,4320,1195,1229,2424,橋頭,三等
2020-09-30,4320,1619,1760,3379,橋頭,三等
2020-10-01,4320,1353,1433,2786,橋頭,三等
2020-10-02,4320,1309,1554,2863,橋頭,三等
2020-10-03,4320,1409,1708,3117,橋頭,三等
2020-10-04,4320,1318,1632,2950,橋頭,三等
2020-10-05,4320,1284,1413,2697,橋頭,三等
2020-10-06,4320,1299,1361,2660,橋頭,三等
2020-10-07,4320,1268,1449,2717,橋頭,三等
2020-10-08,4320,1588,1632,3220,橋頭,三等
2020-10-09,4320,1448,1578,3026,橋頭,三等
2020-10-10,4320,1501,1534,3035,橋頭,三等
2020-10-11,4320,1317,1697,3014,橋頭,三等
2020-10-12,4320,1255,1387,2642,橋頭,三等
2020-10-13,4320,1156,1332,2488,橋頭,三等
2020-10-14,4320,1149,1314,2463,橋頭,三等
2020-10-15,4320,1173,1326,2499,橋頭,三等
2020-10-16,4320,1547,1710,3257,橋頭,三等
2020-10-17,4320,1612,1944,3556,橋頭,三等
2020-10-18,4320,1642,1852,3494,橋頭,三等
2020-10-19,4320,1279,1342,2621,橋頭,三等
2020-10-20,4320,1202,1332,2534,橋頭,三等
2020-10-21,4320,1202,1293,2495,橋頭,三等
2020-10-22,4320,1202,1319,2521,橋頭,三等
2020-10-23,4320,1586,1720,3306,橋頭,三等
2020-10-24,4320,1361,1553,2914,橋頭,三等
2020-10-25,4320,1386,1592,2978,橋頭,三等
2020-10-26,4320,1231,1364,2595,橋頭,三等
2020-10-27,4320,1183,1322,2505,橋頭,三等
2020-10-28,4320,1138,1322,2460,橋頭,三等
2020-10-29,4320,1200,1370,2570,橋頭,三等
2020-10-30,4320,1489,1717,3206,橋頭,三等
2020-10-31,4320,1347,1442,2789,橋頭,三等
2020-11-01,4320,1318,1549,2867,橋頭,三等
2020-11-02,4320,1221,1335,2556,橋頭,三等
2020-11-03,4320,1191,1298,2489,橋頭,三等
2020-11-04,4320,1111,1256,2367,橋頭,三等
2020-11-05,4320,1095,1264,2359,橋頭,三等
2020-11-06,4320,1476,1576,3052,橋頭,三等
2020-11-07,4320,1260,1415,2675,橋頭,三等
2020-11-08,4320,1422,1638,3060,橋頭,三等
2020-11-09,4320,1225,1410,2635,橋頭,三等
2020-11-10,4320,1191,1393,2584,橋頭,三等
2020-11-11,4320,1151,1216,2367,橋頭,三等
2020-11-12,4320,1166,1344,2510,橋頭,三等
2020-11-13,4320,1623,1838,3461,橋頭,三等
2020-11-14,4320,1486,1643,3129,橋頭,三等
2020-11-15,4320,1428,1786,3214,橋頭,三等
2020-11-16,4320,1171,1370,2541,橋頭,三等
2020-11-17,4320,1151,1288,2439,橋頭,三等
2020-11-18,4320,1219,1279,2498,橋頭,三等
2020-11-19,4320,1180,1347,2527,橋頭,三等
2020-11-20,4320,1623,1743,3366,橋頭,三等
2020-11-21,4320,1509,1734,3243,橋頭,三等
2020-11-22,4320,1495,1807,3302,橋頭,三等
2020-11-23,4320,1294,1450,2744,橋頭,三等
2020-11-24,4320,1196,1323,2519,橋頭,三等
2020-11-25,4320,1187,1283,2470,橋頭,三等
2020-11-26,4320,1224,1376,2600,橋頭,三等
2020-11-27,4320,1610,1842,3452,橋頭,三等
2020-11-28,4320,1612,1761,3373,橋頭,三等
2020-11-29,4320,1599,1855,3454,橋頭,三等
2020-11-30,4320,1309,1430,2739,橋頭,三等
2020-12-01,4320,1191,1280,2471,橋頭,三等
2020-12-02,4320,1151,1269,2420,橋頭,三等
2020-12-03,4320,1192,1285,2477,橋頭,三等
2020-12-04,4320,1586,1786,3372,橋頭,三等
2020-12-05,4320,1812,2193,4005,橋頭,三等
2020-12-06,4320,1740,1975,3715,橋頭,三等
2020-12-07,4320,1205,1393,2598,橋頭,三等
2020-12-08,4320,1232,1368,2600,橋頭,三等
2020-12-09,4320,1236,1371,2607,橋頭,三等
2020-12-10,4320,1265,1353,2618,橋頭,三等
2020-12-11,4320,1595,1730,3325,橋頭,三等
2020-12-12,4320,1594,1748,3342,橋頭,三等
2020-12-13,4320,1680,1962,3642,橋頭,三等
2020-12-14,4320,1420,1575,2995,橋頭,三等
2020-12-15,4320,1272,1443,2715,橋頭,三等
2020-12-16,4320,1223,1400,2623,橋頭,三等
2020-12-17,4320,1322,1424,2746,橋頭,三等
2020-12-18,4320,1645,1812,3457,橋頭,三等
2020-12-19,4320,1497,1745,3242,橋頭,三等
2020-12-20,4320,1678,2044,3722,橋頭,三等
2020-12-21,4320,1215,1384,2599,橋頭,三等
2020-12-22,4320,1202,1299,2501,橋頭,三等
2020-12-23,4320,1189,1318,2507,橋頭,三等
2020-12-24,4320,1224,1387,2611,橋頭,三等
2020-12-25,4320,1612,1762,3374,橋頭,三等
2020-12-26,4320,1424,1486,2910,橋頭,三等
2020-12-27,4320,1398,1610,3008,橋頭,三等
2020-12-28,4320,1206,1409,2615,橋頭,三等
2020-12-29,4320,1148,1236,2384,橋頭,三等
2020-12-30,4320,1189,1281,2470,橋頭,三等
2020-12-31,4320,1718,1991,3709,橋頭,三等
2020-01-01,4330,2586,2618,5204,楠梓,二等
2020-01-02,4330,2427,2388,4815,楠梓,二等
2020-01-03,4330,3089,2626,5715,楠梓,二等
2020-01-04,4330,2405,2201,4606,楠梓,二等
2020-01-05,4330,2574,2753,5327,楠梓,二等
2020-01-06,4330,2387,2593,4980,楠梓,二等
2020-01-07,4330,2261,2202,4463,楠梓,二等
2020-01-08,4330,2177,2164,4341,楠梓,二等
2020-01-09,4330,2403,2333,4736,楠梓,二等
2020-01-10,4330,3929,3156,7085,楠梓,二等
2020-01-11,4330,3147,2714,5861,楠梓,二等
2020-01-12,4330,2807,2944,5751,楠梓,二等
2020-01-13,4330,2574,2558,5132,楠梓,二等
2020-01-14,4330,2222,2241,4463,楠梓,二等
2020-01-15,4330,2176,2181,4357,楠梓,二等
2020-01-16,4330,2205,2297,4502,楠梓,二等
2020-01-17,4330,2514,2449,4963,楠梓,二等
2020-01-18,4330,2163,2177,4340,楠梓,二等
2020-01-19,4330,2464,2332,4796,楠梓,二等
2020-01-20,4330,2385,2323,4708,楠梓,二等
2020-01-21,4330,2254,2230,4484,楠梓,二等
2020-01-22,4330,2556,2468,5024,楠梓,二等
2020-01-23,4330,2391,1957,4348,楠梓,二等
2020-01-24,4330,2385,2073,4458,楠梓,二等
2020-01-25,4330,2633,2538,5171,楠梓,二等
2020-01-26,4330,2623,2648,5271,楠梓,二等
2020-01-27,4330,2748,2833,5581,楠梓,二等
2020-01-28,4330,2051,2037,4088,楠梓,二等
2020-01-29,4330,2093,2043,4136,楠梓,二等
2020-01-30,4330,1953,1963,3916,楠梓,二等
2020-01-31,4330,2029,2000,4029,楠梓,二等
2020-02-01,4330,1769,1773,3542,楠梓,二等
2020-02-02,4330,1845,1797,3642,楠梓,二等
2020-02-03,4330,1971,1891,3862,楠梓,二等
2020-02-04,4330,1870,1897,3767,楠梓,二等
2020-02-05,4330,1944,1886,3830,楠梓,二等
2020-02-06,4330,1899,1929,3828,楠梓,二等
2020-02-07,4330,2320,2292,4612,楠梓,二等
2020-02-08,4330,2080,1902,3982,楠梓,二等
2020-02-09,4330,2202,2176,4378,楠梓,二等
2020-02-10,4330,2077,2097,4174,楠梓,二等
2020-02-11,4330,1923,1928,3851,楠梓,二等
2020-02-12,4330,1917,1881,3798,楠梓,二等
2020-02-13,4330,1887,1799,3686,楠梓,二等
2020-02-14,4330,2216,2151,4367,楠梓,二等
2020-02-15,4330,2033,2026,4059,楠梓,二等
2020-02-16,4330,2198,2181,4379,楠梓,二等
2020-02-17,4330,1924,1835,3759,楠梓,二等
2020-02-18,4330,1844,1785,3629,楠梓,二等
2020-02-19,4330,1853,1741,3594,楠梓,二等
2020-02-20,4330,1849,1789,3638,楠梓,二等
2020-02-21,4330,2126,2107,4233,楠梓,二等
2020-02-22,4330,1944,1812,3756,楠梓,二等
2020-02-23,4330,2063,2049,4112,楠梓,二等
2020-02-24,4330,2018,1979,3997,楠梓,二等
2020-02-25,4330,1959,1918,3877,楠梓,二等
2020-02-26,4330,2001,1995,3996,楠梓,二等
2020-02-27,4330,2407,2474,4881,楠梓,二等
2020-02-28,4330,2116,2031,4147,楠梓,二等
2020-02-29,4330,1793,1898,3691,楠梓,二等
2020-03-01,4330,2132,2668,4800,楠梓,二等
2020-03-02,4330,2155,2262,4417,楠梓,二等
2020-03-03,4330,1989,1977,3966,楠梓,二等
2020-03-04,4330,2014,1988,4002,楠梓,二等
2020-03-05,4330,2153,2022,4175,楠梓,二等
2020-03-06,4330,3247,2604,5851,楠梓,二等
2020-03-07,4330,2160,1939,4099,楠梓,二等
2020-03-08,4330,2224,2703,4927,楠梓,二等
2020-03-09,4330,2218,2318,4536,楠梓,二等
2020-03-10,4330,2034,2062,4096,楠梓,二等
2020-03-11,4330,2108,2069,4177,楠梓,二等
2020-03-12,4330,2133,2095,4228,楠梓,二等
2020-03-13,4330,3287,2643,5930,楠梓,二等
2020-03-14,4330,2040,1869,3909,楠梓,二等
2020-03-15,4330,2420,2855,5275,楠梓,二等
2020-03-16,4330,2188,2315,4503,楠梓,二等
2020-03-17,4330,1976,1981,3957,楠梓,二等
2020-03-18,4330,1988,1976,3964,楠梓,二等
2020-03-19,4330,1981,1940,3921,楠梓,二等
2020-03-20,4330,2948,2421,5369,楠梓,二等
2020-03-21,4330,1998,1797,3795,楠梓,二等
2020-03-22,4330,1886,2322,4208,楠梓,二等
2020-03-23,4330,2044,2141,4185,楠梓,二等
2020-03-24,4330,1960,1920,3880,楠梓,二等
2020-03-25,4330,1916,1879,3795,楠梓,二等
2020-03-26,4330,1896,1868,3764,楠梓,二等
2020-03-27,4330,2687,2395,5082,楠梓,二等
2020-03-28,4330,1693,1483,3176,楠梓,二等
2020-03-29,4330,1747,2056,3803,楠梓,二等
2020-03-30,4330,1970,2086,4056,楠梓,二等
2020-03-31,4330,2043,1899,3942,楠梓,二等
2020-04-01,4330,3203,2262,5465,楠梓,二等
2020-04-02,4330,2133,1527,3660,楠梓,二等
2020-04-03,4330,1545,1475,3020,楠梓,二等
2020-04-04,4330,1317,1329,2646,楠梓,二等
2020-04-05,4330,1801,2837,4638,楠梓,二等
2020-04-06,4330,1973,2252,4225,楠梓,二等
2020-04-07,4330,1800,1790,3590,楠梓,二等
2020-04-08,4330,1796,1724,3520,楠梓,二等
2020-04-09,4330,1832,1791,3623,楠梓,二等
2020-04-10,4330,1138,1098,2236,楠梓,二等
2020-04-11,4330,1617,1497,3114,楠梓,二等
2020-04-12,4330,1755,1876,3631,楠梓,二等
2020-04-13,4330,1864,1972,3836,楠梓,二等
2020-04-14,4330,1780,1802,3582,楠梓,二等
2020-04-15,4330,1812,1789,3601,楠梓,二等
2020-04-16,4330,2049,1828,3877,楠梓,二等
2020-04-17,4330,2797,2385,5182,楠梓,二等
2020-04-18,4330,1922,1704,3626,楠梓,二等
2020-04-19,4330,1887,2210,4097,楠梓,二等
2020-04-20,4330,1848,2032,3880,楠梓,二等
2020-04-21,4330,1680,1702,3382,楠梓,二等
2020-04-22,4330,1646,1641,3287,楠梓,二等
2020-04-23,4330,1636,1661,3297,楠梓,二等
2020-04-24,4330,2134,2083,4217,楠梓,二等
2020-04-25,4330,1432,1330,2762,楠梓,二等
2020-04-26,4330,1426,1512,2938,楠梓,二等
2020-04-27,4330,1802,1828,3630,楠梓,二等
2020-04-28,4330,1656,1677,3333,楠梓,二等
2020-04-29,4330,1645,1572,3217,楠梓,二等
2020-04-30,4330,1945,1860,3805,楠梓,二等
2020-05-01,4330,2668,2049,4717,楠梓,二等
2020-05-02,4330,1649,1485,3134,楠梓,二等
2020-05-03,4330,1709,2129,3838,楠梓,二等
2020-05-04,4330,1916,2102,4018,楠梓,二等
2020-05-05,4330,1790,1788,3578,楠梓,二等
2020-05-06,4330,1829,1858,3687,楠梓,二等
2020-05-07,4330,1997,1865,3862,楠梓,二等
2020-05-08,4330,3363,2480,5843,楠梓,二等
2020-05-09,4330,2139,1844,3983,楠梓,二等
2020-05-10,4330,2098,2696,4794,楠梓,二等
2020-05-11,4330,2088,2419,4507,楠梓,二等
2020-05-12,4330,1878,1909,3787,楠梓,二等
2020-05-13,4330,1909,1873,3782,楠梓,二等
2020-05-14,4330,1898,1870,3768,楠梓,二等
2020-05-15,4330,2831,2350,5181,楠梓,二等
2020-05-16,4330,2023,1868,3891,楠梓,二等
2020-05-17,4330,2006,2325,4331,楠梓,二等
2020-05-18,4330,1996,2198,4194,楠梓,二等
2020-05-19,4330,1717,1750,3467,楠梓,二等
2020-05-20,4330,1885,1807,3692,楠梓,二等
2020-05-21,4330,1777,1745,3522,楠梓,二等
2020-05-22,4330,2308,1957,4265,楠梓,二等
2020-05-23,4330,1771,1532,3303,楠梓,二等
2020-05-24,4330,2176,2429,4605,楠梓,二等
2020-05-25,4330,2083,2275,4358,楠梓,二等
2020-05-26,4330,1863,1847,3710,楠梓,二等
2020-05-27,4330,1774,1780,3554,楠梓,二等
2020-05-28,4330,1897,1876,3773,楠梓,二等
2020-05-29,4330,3051,2458,5509,楠梓,二等
2020-05-30,4330,2023,2006,4029,楠梓,二等
2020-05-31,4330,2185,2499,4684,楠梓,二等
2020-06-01,4330,2093,2280,4373,楠梓,二等
2020-06-02,4330,1882,1915,3797,楠梓,二等
2020-06-03,4330,1944,1932,3876,楠梓,二等
2020-06-04,4330,1962,1954,3916,楠梓,二等
2020-06-05,4330,2981,2767,5748,楠梓,二等
2020-06-06,4330,2432,2194,4626,楠梓,二等
2020-06-07,4330,2450,2623,5073,楠梓,二等
2020-06-08,4330,2166,2241,4407,楠梓,二等
2020-06-09,4330,1997,1989,3986,楠梓,二等
2020-06-10,4330,1978,1993,3971,楠梓,二等
2020-06-11,4330,2083,1998,4081,楠梓,二等
2020-06-12,4330,2918,2528,5446,楠梓,二等
2020-06-13,4330,2383,2174,4557,楠梓,二等
2020-06-14,4330,2590,2799,5389,楠梓,二等
2020-06-15,4330,2162,2281,4443,楠梓,二等
2020-06-16,4330,2036,2030,4066,楠梓,二等
2020-06-17,4330,2003,2004,4007,楠梓,二等
2020-06-18,4330,2042,2011,4053,楠梓,二等
2020-06-19,4330,2470,2263,4733,楠梓,二等
2020-06-20,4330,2310,2125,4435,楠梓,二等
2020-06-21,4330,2247,2369,4616,楠梓,二等
2020-06-22,4330,2114,2244,4358,楠梓,二等
2020-06-23,4330,2028,1994,4022,楠梓,二等
2020-06-24,4330,2978,2518,5496,楠梓,二等
2020-06-25,4330,2598,2060,4658,楠梓,二等
2020-06-26,4330,2380,2286,4666,楠梓,二等
2020-06-27,4330,2221,2176,4397,楠梓,二等
2020-06-28,4330,2302,2571,4873,楠梓,二等
2020-06-29,4330,2170,2286,4456,楠梓,二等
2020-06-30,4330,1983,2003,3986,楠梓,二等
2020-07-01,4330,2034,1998,4032,楠梓,二等
2020-07-02,4330,1989,1897,3886,楠梓,二等
2020-07-03,4330,2413,2330,4743,楠梓,二等
2020-07-04,4330,1991,1884,3875,楠梓,二等
2020-07-05,4330,2160,2066,4226,楠梓,二等
2020-07-06,4330,2146,2139,4285,楠梓,二等
2020-07-07,4330,2107,2130,4237,楠梓,二等
2020-07-08,4330,2038,2023,4061,楠梓,二等
2020-07-09,4330,2115,2036,4151,楠梓,二等
2020-07-10,4330,2419,2366,4785,楠梓,二等
2020-07-11,4330,2177,2146,4323,楠梓,二等
2020-07-12,4330,2334,2316,4650,楠梓,二等
2020-07-13,4330,2137,2148,4285,楠梓,二等
2020-07-14,4330,2050,2117,4167,楠梓,二等
2020-07-15,4330,1981,1919,3900,楠梓,二等
2020-07-16,4330,2068,2015,4083,楠梓,二等
2020-07-17,4330,2522,2406,4928,楠梓,二等
2020-07-18,4330,2173,2059,4232,楠梓,二等
2020-07-19,4330,2381,2435,4816,楠梓,二等
2020-07-20,4330,2203,2240,4443,楠梓,二等
2020-07-21,4330,2037,1950,3987,楠梓,二等
2020-07-22,4330,2184,2038,4222,楠梓,二等
2020-07-23,4330,2159,2059,4218,楠梓,二等
2020-07-24,4330,2413,2415,4828,楠梓,二等
2020-07-25,4330,2195,1959,4154,楠梓,二等
2020-07-26,4330,2220,2221,4441,楠梓,二等
2020-07-27,4330,2118,2080,4198,楠梓,二等
2020-07-28,4330,2013,1978,3991,楠梓,二等
2020-07-29,4330,2070,1986,4056,楠梓,二等
2020-07-30,4330,2013,1940,3953,楠梓,二等
2020-07-31,4330,2275,2238,4513,楠梓,二等
2020-08-01,4330,2074,1922,3996,楠梓,二等
2020-08-02,4330,2004,2021,4025,楠梓,二等
2020-08-03,4330,1805,1888,3693,楠梓,二等
2020-08-04,4330,1689,1716,3405,楠梓,二等
2020-08-05,4330,1998,1930,3928,楠梓,二等
2020-08-06,4330,2056,2051,4107,楠梓,二等
2020-08-07,4330,2453,2288,4741,楠梓,二等
2020-08-08,4330,2154,2054,4208,楠梓,二等
2020-08-09,4330,2355,2441,4796,楠梓,二等
2020-08-10,4330,2105,2132,4237,楠梓,二等
2020-08-11,4330,1753,1719,3472,楠梓,二等
2020-08-12,4330,2096,2012,4108,楠梓,二等
2020-08-13,4330,2174,2060,4234,楠梓,二等
2020-08-14,4330,2345,2468,4813,楠梓,二等
2020-08-15,4330,2351,2305,4656,楠梓,二等
2020-08-16,4330,2429,2400,4829,楠梓,二等
2020-08-17,4330,2238,2252,4490,楠梓,二等
2020-08-18,4330,2174,2050,4224,楠梓,二等
2020-08-19,4330,2047,1931,3978,楠梓,二等
2020-08-20,4330,1990,2033,4023,楠梓,二等
2020-08-21,4330,2479,2431,4910,楠梓,二等
2020-08-22,4330,2117,1952,4069,楠梓,二等
2020-08-23,4330,2062,2024,4086,楠梓,二等
2020-08-24,4330,1998,2014,4012,楠梓,二等
2020-08-25,4330,2053,1979,4032,楠梓,二等
2020-08-26,4330,1686,1634,3320,楠梓,二等
2020-08-27,4330,1705,1627,3332,楠梓,二等
2020-08-28,4330,2290,2194,4484,楠梓,二等
2020-08-29,4330,2126,2016,4142,楠梓,二等
2020-08-30,4330,1869,1854,3723,楠梓,二等
2020-08-31,4330,1988,1971,3959,楠梓,二等
2020-09-01,4330,1899,1861,3760,楠梓,二等
2020-09-02,4330,1861,1934,3795,楠梓,二等
2020-09-03,4330,1942,1910,3852,楠梓,二等
2020-09-04,4330,2363,2294,4657,楠梓,二等
2020-09-05,4330,2228,2121,4349,楠梓,二等
2020-09-06,4330,2303,2376,4679,楠梓,二等
2020-09-07,4330,2176,2208,4384,楠梓,二等
2020-09-08,4330,2061,2034,4095,楠梓,二等
2020-09-09,4330,2389,2061,4450,楠梓,二等
2020-09-10,4330,2396,2118,4514,楠梓,二等
2020-09-11,4330,2635,2547,5182,楠梓,二等
2020-09-12,4330,2417,2381,4798,楠梓,二等
2020-09-13,4330,2653,3213,5866,楠梓,二等
2020-09-14,4330,2246,2389,4635,楠梓,二等
2020-09-15,4330,2108,2057,4165,楠梓,二等
2020-09-16,4330,2128,2063,4191,楠梓,二等
2020-09-17,4330,2180,2118,4298,楠梓,二等
2020-09-18,4330,3528,2696,6224,楠梓,二等
2020-09-19,4330,2541,2344,4885,楠梓,二等
2020-09-20,4330,2645,3161,5806,楠梓,二等
2020-09-21,4330,2250,2400,4650,楠梓,二等
2020-09-22,4330,2051,2012,4063,楠梓,二等
2020-09-23,4330,2040,2022,4062,楠梓,二等
2020-09-24,4330,2164,2078,4242,楠梓,二等
2020-09-25,4330,2414,2220,4634,楠梓,二等
2020-09-26,4330,2464,2251,4715,楠梓,二等
2020-09-27,4330,2242,2398,4640,楠梓,二等
2020-09-28,4330,2152,2200,4352,楠梓,二等
2020-09-29,4330,2196,2026,4222,楠梓,二等
2020-09-30,4330,4277,2872,7149,楠梓,二等
2020-10-01,4330,3126,2236,5362,楠梓,二等
2020-10-02,4330,2463,2371,4834,楠梓,二等
2020-10-03,4330,2372,2532,4904,楠梓,二等
2020-10-04,4330,2638,3905,6543,楠梓,二等
2020-10-05,4330,2240,2469,4709,楠梓,二等
2020-10-06,4330,2141,2154,4295,楠梓,二等
2020-10-07,4330,2098,1960,4058,楠梓,二等
2020-10-08,4330,3484,2699,6183,楠梓,二等
2020-10-09,4330,2987,2365,5352,楠梓,二等
2020-10-10,4330,2656,2301,4957,楠梓,二等
2020-10-11,4330,2572,3534,6106,楠梓,二等
2020-10-12,4330,2203,2448,4651,楠梓,二等
2020-10-13,4330,2034,2040,4074,楠梓,二等
2020-10-14,4330,1987,1997,3984,楠梓,二等
2020-10-15,4330,2173,2098,4271,楠梓,二等
2020-10-16,4330,3152,2616,5768,楠梓,二等
2020-10-17,4330,2480,2279,4759,楠梓,二等
2020-10-18,4330,2592,2876,5468,楠梓,二等
2020-10-19,4330,2261,2334,4595,楠梓,二等
2020-10-20,4330,2066,2038,4104,楠梓,二等
2020-10-21,4330,2001,1969,3970,楠梓,二等
2020-10-22,4330,2146,2016,4162,楠梓,二等
2020-10-23,4330,3416,2659,6075,楠梓,二等
2020-10-24,4330,2580,2303,4883,楠梓,二等
2020-10-25,4330,2654,3146,5800,楠梓,二等
2020-10-26,4330,2124,2316,4440,楠梓,二等
2020-10-27,4330,1985,2024,4009,楠梓,二等
2020-10-28,4330,2110,2045,4155,楠梓,二等
2020-10-29,4330,2172,2050,4222,楠梓,二等
2020-10-30,4330,3279,2604,5883,楠梓,二等
2020-10-31,4330,2355,2066,4421,楠梓,二等
2020-11-01,4330,2516,2944,5460,楠梓,二等
2020-11-02,4330,2162,2246,4408,楠梓,二等
2020-11-03,4330,2054,2034,4088,楠梓,二等
2020-11-04,4330,2085,2025,4110,楠梓,二等
2020-11-05,4330,2106,2080,4186,楠梓,二等
2020-11-06,4330,3109,2652,5761,楠梓,二等
2020-11-07,4330,2184,2032,4216,楠梓,二等
2020-11-08,4330,2483,2898,5381,楠梓,二等
2020-11-09,4330,2210,2333,4543,楠梓,二等
2020-11-10,4330,2025,2040,4065,楠梓,二等
2020-11-11,4330,2043,1969,4012,楠梓,二等
2020-11-12,4330,2224,2105,4329,楠梓,二等
2020-11-13,4330,3814,2842,6656,楠梓,二等
2020-11-14,4330,2692,2448,5140,楠梓,二等
2020-11-15,4330,2693,3321,6014,楠梓,二等
2020-11-16,4330,2300,2501,4801,楠梓,二等
2020-11-17,4330,2128,2050,4178,楠梓,二等
2020-11-18,4330,2013,2074,4087,楠梓,二等
2020-11-19,4330,2212,2119,4331,楠梓,二等
2020-11-20,4330,3468,2773,6241,楠梓,二等
2020-11-21,4330,2487,2360,4847,楠梓,二等
2020-11-22,4330,2557,3045,5602,楠梓,二等
2020-11-23,4330,2279,2434,4713,楠梓,二等
2020-11-24,4330,2097,2092,4189,楠梓,二等
2020-11-25,4330,2118,2110,4228,楠梓,二等
2020-11-26,4330,2232,2104,4336,楠梓,二等
2020-11-27,4330,3531,2731,6262,楠梓,二等
2020-11-28,4330,2449,2227,4676,楠梓,二等
2020-11-29,4330,2581,3213,5794,楠梓,二等
2020-11-30,4330,2276,2445,4721,楠梓,二等
2020-12-01,4330,1973,1997,3970,楠梓,二等
2020-12-02,4330,1981,1945,3926,楠梓,二等
2020-12-03,4330,2173,2081,4254,楠梓,二等
2020-12-04,4330,3366,2668,6034,楠梓,二等
2020-12-05,4330,2687,2601,5288,楠梓,二等
2020-12-06,4330,2739,3182,5921,楠梓,二等
2020-12-07,4330,2387,2588,4975,楠梓,二等
2020-12-08,4330,2053,2092,4145,楠梓,二等
2020-12-09,4330,2052,2003,4055,楠梓,二等
2020-12-10,4330,2192,2113,4305,楠梓,二等
2020-12-11,4330,3463,2694,6157,楠梓,二等
2020-12-12,4330,2583,2383,4966,楠梓,二等
2020-12-13,4330,2764,3380,6144,楠梓,二等
2020-12-14,4330,2222,2483,4705,楠梓,二等
2020-12-15,4330,2028,2134,4162,楠梓,二等
2020-12-16,4330,2083,2060,4143,楠梓,二等
2020-12-17,4330,2163,2107,4270,楠梓,二等
2020-12-18,4330,3672,2776,6448,楠梓,二等
2020-12-19,4330,2606,2312,4918,楠梓,二等
2020-12-20,4330,2719,3294,6013,楠梓,二等
2020-12-21,4330,2217,2431,4648,楠梓,二等
2020-12-22,4330,2019,2018,4037,楠梓,二等
2020-12-23,4330,2033,2048,4081,楠梓,二等
2020-12-24,4330,2178,2113,4291,楠梓,二等
2020-12-25,4330,3331,2797,6128,楠梓,二等
2020-12-26,4330,2373,2206,4579,楠梓,二等
2020-12-27,4330,2441,2805,5246,楠梓,二等
2020-12-28,4330,2254,2444,4698,楠梓,二等
2020-12-29,4330,2146,2031,4177,楠梓,二等
2020-12-30,4330,2406,2133,4539,楠梓,二等
2020-12-31,4330,3688,2930,6618,楠梓,二等
2020-01-01,4340,12669,11500,24169,新左營,一等
2020-01-02,4340,9262,9044,18306,新左營,一等
2020-01-03,4340,11653,11627,23280,新左營,一等
2020-01-04,4340,10530,10478,21008,新左營,一等
2020-01-05,4340,11845,12533,24378,新左營,一等
2020-01-06,4340,8875,9041,17916,新左營,一等
2020-01-07,4340,8123,8346,16469,新左營,一等
2020-01-08,4340,8485,8377,16862,新左營,一等
2020-01-09,4340,10933,9961,20894,新左營,一等
2020-01-10,4340,21027,16938,37965,新左營,一等
2020-01-11,4340,15955,14467,30422,新左營,一等
2020-01-12,4340,14673,19468,34141,新左營,一等
2020-01-13,4340,10972,12042,23014,新左營,一等
2020-01-14,4340,8971,9559,18530,新左營,一等
2020-01-15,4340,9135,9448,18583,新左營,一等
2020-01-16,4340,9815,10053,19868,新左營,一等
2020-01-17,4340,12740,12397,25137,新左營,一等
2020-01-18,4340,12388,12145,24533,新左營,一等
2020-01-19,4340,12343,12265,24608,新左營,一等
2020-01-20,4340,10935,10092,21027,新左營,一等
2020-01-21,4340,12290,10406,22696,新左營,一等
2020-01-22,4340,18125,12596,30721,新左營,一等
2020-01-23,4340,18280,11004,29284,新左營,一等
2020-01-24,4340,13470,8068,21538,新左營,一等
2020-01-25,4340,16894,14045,30939,新左營,一等
2020-01-26,4340,16696,15630,32326,新左營,一等
2020-01-27,4340,15215,18894,34109,新左營,一等
2020-01-28,4340,12672,19099,31771,新左營,一等
2020-01-29,4340,12050,18892,30942,新左營,一等
2020-01-30,4340,9620,12092,21712,新左營,一等
2020-01-31,4340,9749,10448,20197,新左營,一等
2020-02-01,4340,8822,9280,18102,新左營,一等
2020-02-02,4340,9556,11053,20609,新左營,一等
2020-02-03,4340,8684,8875,17559,新左營,一等
2020-02-04,4340,8110,8474,16584,新左營,一等
2020-02-05,4340,8406,8009,16415,新左營,一等
2020-02-06,4340,8452,8278,16730,新左營,一等
2020-02-07,4340,11123,10826,21949,新左營,一等
2020-02-08,4340,9707,8569,18276,新左營,一等
2020-02-09,4340,10098,11332,21430,新左營,一等
2020-02-10,4340,8715,9191,17906,新左營,一等
2020-02-11,4340,7609,7670,15279,新左營,一等
2020-02-12,4340,7563,7564,15127,新左營,一等
2020-02-13,4340,7984,7950,15934,新左營,一等
2020-02-14,4340,9741,9496,19237,新左營,一等
2020-02-15,4340,8968,8619,17587,新左營,一等
2020-02-16,4340,9451,9716,19167,新左營,一等
2020-02-17,4340,7618,7820,15438,新左營,一等
2020-02-18,4340,7130,7320,14450,新左營,一等
2020-02-19,4340,7321,7399,14720,新左營,一等
2020-02-20,4340,7891,7705,15596,新左營,一等
2020-02-21,4340,10522,9693,20215,新左營,一等
2020-02-22,4340,9127,8757,17884,新左營,一等
2020-02-23,4340,9477,10048,19525,新左營,一等
2020-02-24,4340,8089,8576,16665,新左營,一等
2020-02-25,4340,6906,7526,14432,新左營,一等
2020-02-26,4340,7529,7572,15101,新左營,一等
2020-02-27,4340,13212,11361,24573,新左營,一等
2020-02-28,4340,11742,9670,21412,新左營,一等
2020-02-29,4340,8778,8825,17603,新左營,一等
2020-03-01,4340,12455,15370,27825,新左營,一等
2020-03-02,4340,7735,8336,16071,新左營,一等
2020-03-03,4340,6487,6742,13229,新左營,一等
2020-03-04,4340,6314,6766,13080,新左營,一等
2020-03-05,4340,7111,6923,14034,新左營,一等
2020-03-06,4340,11389,10718,22107,新左營,一等
2020-03-07,4340,8212,7678,15890,新左營,一等
2020-03-08,4340,9387,10303,19690,新左營,一等
2020-03-09,4340,7618,7792,15410,新左營,一等
2020-03-10,4340,6273,6621,12894,新左營,一等
2020-03-11,4340,6522,6642,13164,新左營,一等
2020-03-12,4340,7216,7311,14527,新左營,一等
2020-03-13,4340,12135,11581,23716,新左營,一等
2020-03-14,4340,8152,7437,15589,新左營,一等
2020-03-15,4340,10036,11526,21562,新左營,一等
2020-03-16,4340,7634,7968,15602,新左營,一等
2020-03-17,4340,6419,6762,13181,新左營,一等
2020-03-18,4340,6377,6493,12870,新左營,一等
2020-03-19,4340,6923,6823,13746,新左營,一等
2020-03-20,4340,11086,10167,21253,新左營,一等
2020-03-21,4340,7745,6726,14471,新左營,一等
2020-03-22,4340,8053,9645,17698,新左營,一等
2020-03-23,4340,6861,7040,13901,新左營,一等
2020-03-24,4340,5697,5900,11597,新左營,一等
2020-03-25,4340,5980,5827,11807,新左營,一等
2020-03-26,4340,6278,6070,12348,新左營,一等
2020-03-27,4340,10182,9340,19522,新左營,一等
2020-03-28,4340,6856,6269,13125,新左營,一等
2020-03-29,4340,7388,8737,16125,新左營,一等
2020-03-30,4340,6679,6972,13651,新左營,一等
2020-03-31,4340,7399,6843,14242,新左營,一等
2020-04-01,4340,15116,11775,26891,新左營,一等
2020-04-02,4340,11629,7704,19333,新左營,一等
2020-04-03,4340,7143,6417,13560,新左營,一等
2020-04-04,4340,5419,6823,12242,新左營,一等
2020-04-05,4340,10471,15611,26082,新左營,一等
2020-04-06,4340,8222,9068,17290,新左營,一等
2020-04-07,4340,5432,5637,11069,新左營,一等
2020-04-08,4340,5232,5418,10650,新左營,一等
2020-04-09,4340,5439,5600,11039,新左營,一等
2020-04-10,4340,5983,6577,12560,新左營,一等
2020-04-11,4340,5875,5436,11311,新左營,一等
2020-04-12,4340,6331,7147,13478,新左營,一等
2020-04-13,4340,6154,6266,12420,新左營,一等
2020-04-14,4340,5465,5450,10915,新左營,一等
2020-04-15,4340,5707,5730,11437,新左營,一等
2020-04-16,4340,6556,6088,12644,新左營,一等
2020-04-17,4340,10090,9703,19793,新左營,一等
2020-04-18,4340,6739,6375,13114,新左營,一等
2020-04-19,4340,7711,8628,16339,新左營,一等
2020-04-20,4340,6254,6471,12725,新左營,一等
2020-04-21,4340,4918,5139,10057,新左營,一等
2020-04-22,4340,4904,4891,9795,新左營,一等
2020-04-23,4340,5335,5373,10708,新左營,一等
2020-04-24,4340,8271,8034,16305,新左營,一等
2020-04-25,4340,4666,4382,9048,新左營,一等
2020-04-26,4340,5943,6398,12341,新左營,一等
2020-04-27,4340,5766,5981,11747,新左營,一等
2020-04-28,4340,5248,5471,10719,新左營,一等
2020-04-29,4340,5157,5183,10340,新左營,一等
2020-04-30,4340,7709,7046,14755,新左營,一等
2020-05-01,4340,9913,8584,18497,新左營,一等
2020-05-02,4340,5846,5461,11307,新左營,一等
2020-05-03,4340,8189,10311,18500,新左營,一等
2020-05-04,4340,6818,7292,14110,新左營,一等
2020-05-05,4340,5616,5808,11424,新左營,一等
2020-05-06,4340,6017,6189,12206,新左營,一等
2020-05-07,4340,7004,6784,13788,新左營,一等
2020-05-08,4340,13463,11439,24902,新左營,一等
2020-05-09,4340,8472,7038,15510,新左營,一等
2020-05-10,4340,10020,12298,22318,新左營,一等
2020-05-11,4340,7799,8840,16639,新左營,一等
2020-05-12,4340,6176,6377,12553,新左營,一等
2020-05-13,4340,6174,6322,12496,新左營,一等
2020-05-14,4340,6683,6561,13244,新左營,一等
2020-05-15,4340,11000,10549,21549,新左營,一等
2020-05-16,4340,7473,6826,14299,新左營,一等
2020-05-17,4340,8712,9707,18419,新左營,一等
2020-05-18,4340,7266,7455,14721,新左營,一等
2020-05-19,4340,5922,6116,12038,新左營,一等
2020-05-20,4340,6238,6246,12484,新左營,一等
2020-05-21,4340,6597,6435,13032,新左營,一等
2020-05-22,4340,10102,9653,19755,新左營,一等
2020-05-23,4340,7151,6714,13865,新左營,一等
2020-05-24,4340,9175,10096,19271,新左營,一等
2020-05-25,4340,7444,7653,15097,新左營,一等
2020-05-26,4340,6265,6195,12460,新左營,一等
2020-05-27,4340,6034,5909,11943,新左營,一等
2020-05-28,4340,7151,6943,14094,新左營,一等
2020-05-29,4340,11538,10852,22390,新左營,一等
2020-05-30,4340,8984,8611,17595,新左營,一等
2020-05-31,4340,10133,11341,21474,新左營,一等
2020-06-01,4340,7636,7778,15414,新左營,一等
2020-06-02,4340,6645,6655,13300,新左營,一等
2020-06-03,4340,6788,7889,14677,新左營,一等
2020-06-04,4340,7366,7455,14821,新左營,一等
2020-06-05,4340,12841,13124,25965,新左營,一等
2020-06-06,4340,10678,9926,20604,新左營,一等
2020-06-07,4340,12046,12679,24725,新左營,一等
2020-06-08,4340,8465,8646,17111,新左營,一等
2020-06-09,4340,6943,7041,13984,新左營,一等
2020-06-10,4340,7027,7213,14240,新左營,一等
2020-06-11,4340,7883,7669,15552,新左營,一等
2020-06-12,4340,12244,11524,23768,新左營,一等
2020-06-13,4340,10518,10218,20736,新左營,一等
2020-06-14,4340,11880,12309,24189,新左營,一等
2020-06-15,4340,8538,8637,17175,新左營,一等
2020-06-16,4340,7365,7335,14700,新左營,一等
2020-06-17,4340,7504,7437,14941,新左營,一等
2020-06-18,4340,7872,7969,15841,新左營,一等
2020-06-19,4340,9909,9586,19495,新左營,一等
2020-06-20,4340,9542,9310,18852,新左營,一等
2020-06-21,4340,10545,10303,20848,新左營,一等
2020-06-22,4340,8335,8617,16952,新左營,一等
2020-06-23,4340,8849,8486,17335,新左營,一等
2020-06-24,4340,16943,13708,30651,新左營,一等
2020-06-25,4340,15818,11622,27440,新左營,一等
2020-06-26,4340,11604,11291,22895,新左營,一等
2020-06-27,4340,10887,12795,23682,新左營,一等
2020-06-28,4340,13885,18369,32254,新左營,一等
2020-06-29,4340,10014,11460,21474,新左營,一等
2020-06-30,4340,8188,8524,16712,新左營,一等
2020-07-01,4340,8233,8277,16510,新左營,一等
2020-07-02,4340,8239,8114,16353,新左營,一等
2020-07-03,4340,11720,11477,23197,新左營,一等
2020-07-04,4340,9881,9529,19410,新左營,一等
2020-07-05,4340,10497,9903,20400,新左營,一等
2020-07-06,4340,9257,9250,18507,新左營,一等
2020-07-07,4340,8725,8571,17296,新左營,一等
2020-07-08,4340,8794,8760,17554,新左營,一等
2020-07-09,4340,9354,10289,19643,新左營,一等
2020-07-10,4340,12674,11955,24629,新左營,一等
2020-07-11,4340,12197,10813,23010,新左營,一等
2020-07-12,4340,12253,13593,25846,新左營,一等
2020-07-13,4340,9678,8563,18241,新左營,一等
2020-07-14,4340,9380,9367,18747,新左營,一等
2020-07-15,4340,9737,9522,19259,新左營,一等
2020-07-16,4340,10372,9828,20200,新左營,一等
2020-07-17,4340,14312,13621,27933,新左營,一等
2020-07-18,4340,12827,11637,24464,新左營,一等
2020-07-19,4340,13520,14119,27639,新左營,一等
2020-07-20,4340,10994,11160,22154,新左營,一等
2020-07-21,4340,9648,10158,19806,新左營,一等
2020-07-22,4340,9996,10149,20145,新左營,一等
2020-07-23,4340,10698,10510,21208,新左營,一等
2020-07-24,4340,13896,13568,27464,新左營,一等
2020-07-25,4340,12758,12437,25195,新左營,一等
2020-07-26,4340,13122,13918,27040,新左營,一等
2020-07-27,4340,10745,10817,21562,新左營,一等
2020-07-28,4340,9726,9841,19567,新左營,一等
2020-07-29,4340,9923,9549,19472,新左營,一等
2020-07-30,4340,9762,9635,19397,新左營,一等
2020-07-31,4340,13397,12456,25853,新左營,一等
2020-08-01,4340,11877,11200,23077,新左營,一等
2020-08-02,4340,12148,13216,25364,新左營,一等
2020-08-03,4340,9371,9793,19164,新左營,一等
2020-08-04,4340,8196,8409,16605,新左營,一等
2020-08-05,4340,9065,8972,18037,新左營,一等
2020-08-06,4340,10182,9694,19876,新左營,一等
2020-08-07,4340,14918,13214,28132,新左營,一等
2020-08-08,4340,11997,10651,22648,新左營,一等
2020-08-09,4340,13204,15578,28782,新左營,一等
2020-08-10,4340,10642,11222,21864,新左營,一等
2020-08-11,4340,9087,8466,17553,新左營,一等
2020-08-12,4340,9745,9567,19312,新左營,一等
2020-08-13,4340,10569,10406,20975,新左營,一等
2020-08-14,4340,14790,14046,28836,新左營,一等
2020-08-15,4340,13347,13213,26560,新左營,一等
2020-08-16,4340,15102,15630,30732,新左營,一等
2020-08-17,4340,11161,11604,22765,新左營,一等
2020-08-18,4340,10596,10689,21285,新左營,一等
2020-08-19,4340,9689,10177,19866,新左營,一等
2020-08-20,4340,10497,10205,20702,新左營,一等
2020-08-21,4340,14208,13823,28031,新左營,一等
2020-08-22,4340,12734,12507,25241,新左營,一等
2020-08-23,4340,13340,14178,27518,新左營,一等
2020-08-24,4340,11097,11122,22219,新左營,一等
2020-08-25,4340,9971,10160,20131,新左營,一等
2020-08-26,4340,8755,8822,17577,新左營,一等
2020-08-27,4340,9323,9083,18406,新左營,一等
2020-08-28,4340,12690,12094,24784,新左營,一等
2020-08-29,4340,11449,11158,22607,新左營,一等
2020-08-30,4340,11111,12387,23498,新左營,一等
2020-08-31,4340,9192,9325,18517,新左營,一等
2020-09-01,4340,8140,7757,15897,新左營,一等
2020-09-02,4340,8115,7844,15959,新左營,一等
2020-09-03,4340,8702,8977,17679,新左營,一等
2020-09-04,4340,11958,11517,23475,新左營,一等
2020-09-05,4340,11462,11534,22996,新左營,一等
2020-09-06,4340,12467,13754,26221,新左營,一等
2020-09-07,4340,9354,9038,18392,新左營,一等
2020-09-08,4340,8265,8605,16870,新左營,一等
2020-09-09,4340,8953,8527,17480,新左營,一等
2020-09-10,4340,9607,8890,18497,新左營,一等
2020-09-11,4340,12872,12539,25411,新左營,一等
2020-09-12,4340,11381,10965,22346,新左營,一等
2020-09-13,4340,13547,14618,28165,新左營,一等
2020-09-14,4340,8964,8830,17794,新左營,一等
2020-09-15,4340,7368,7573,14941,新左營,一等
2020-09-16,4340,7586,7580,15166,新左營,一等
2020-09-17,4340,8173,8094,16267,新左營,一等
2020-09-18,4340,14029,13566,27595,新左營,一等
2020-09-19,4340,12708,11605,24313,新左營,一等
2020-09-20,4340,13705,14569,28274,新左營,一等
2020-09-21,4340,9473,9454,18927,新左營,一等
2020-09-22,4340,7994,8391,16385,新左營,一等
2020-09-23,4340,8172,8184,16356,新左營,一等
2020-09-24,4340,8353,8485,16838,新左營,一等
2020-09-25,4340,10441,10418,20859,新左營,一等
2020-09-26,4340,10495,10503,20998,新左營,一等
2020-09-27,4340,11822,11799,23621,新左營,一等
2020-09-28,4340,8630,8681,17311,新左營,一等
2020-09-29,4340,9330,8446,17776,新左營,一等
2020-09-30,4340,21513,16817,38330,新左營,一等
2020-10-01,4340,18916,13628,32544,新左營,一等
2020-10-02,4340,12244,11881,24125,新左營,一等
2020-10-03,4340,12158,15347,27505,新左營,一等
2020-10-04,4340,18296,23899,42195,新左營,一等
2020-10-05,4340,9947,11748,21695,新左營,一等
2020-10-06,4340,7784,8009,15793,新左營,一等
2020-10-07,4340,8464,8744,17208,新左營,一等
2020-10-08,4340,15843,14258,30101,新左營,一等
2020-10-09,4340,14532,13054,27586,新左營,一等
2020-10-10,4340,11657,11386,23043,新左營,一等
2020-10-11,4340,15465,18333,33798,新左營,一等
2020-10-12,4340,9239,9983,19222,新左營,一等
2020-10-13,4340,7873,8041,15914,新左營,一等
2020-10-14,4340,7915,8021,15936,新左營,一等
2020-10-15,4340,8964,8868,17832,新左營,一等
2020-10-16,4340,13480,13150,26630,新左營,一等
2020-10-17,4340,12521,11842,24363,新左營,一等
2020-10-18,4340,14163,14595,28758,新左營,一等
2020-10-19,4340,9245,9447,18692,新左營,一等
2020-10-20,4340,8426,8404,16830,新左營,一等
2020-10-21,4340,8067,8461,16528,新左營,一等
2020-10-22,4340,8864,8888,17752,新左營,一等
2020-10-23,4340,14330,13356,27686,新左營,一等
2020-10-24,4340,12290,11454,23744,新左營,一等
2020-10-25,4340,13224,14624,27848,新左營,一等
2020-10-26,4340,9056,9608,18664,新左營,一等
2020-10-27,4340,8023,8271,16294,新左營,一等
2020-10-28,4340,8268,8139,16407,新左營,一等
2020-10-29,4340,8702,8674,17376,新左營,一等
2020-10-30,4340,13689,13411,27100,新左營,一等
2020-10-31,4340,11580,10851,22431,新左營,一等
2020-11-01,4340,12858,13812,26670,新左營,一等
2020-11-02,4340,8736,8666,17402,新左營,一等
2020-11-03,4340,7738,7628,15366,新左營,一等
2020-11-04,4340,8035,7964,15999,新左營,一等
2020-11-05,4340,8709,8456,17165,新左營,一等
2020-11-06,4340,13985,12984,26969,新左營,一等
2020-11-07,4340,10810,10420,21230,新左營,一等
2020-11-08,4340,13532,14472,28004,新左營,一等
2020-11-09,4340,8719,9247,17966,新左營,一等
2020-11-10,4340,7777,8014,15791,新左營,一等
2020-11-11,4340,8108,7955,16063,新左營,一等
2020-11-12,4340,8985,9017,18002,新左營,一等
2020-11-13,4340,15862,14844,30706,新左營,一等
2020-11-14,4340,12932,11872,24804,新左營,一等
2020-11-15,4340,15062,16213,31275,新左營,一等
2020-11-16,4340,9995,10034,20029,新左營,一等
2020-11-17,4340,8358,8525,16883,新左營,一等
2020-11-18,4340,8665,8294,16959,新左營,一等
2020-11-19,4340,9094,9068,18162,新左營,一等
2020-11-20,4340,15416,14597,30013,新左營,一等
2020-11-21,4340,12347,11920,24267,新左營,一等
2020-11-22,4340,14550,15549,30099,新左營,一等
2020-11-23,4340,9775,10297,20072,新左營,一等
2020-11-24,4340,8154,8284,16438,新左營,一等
2020-11-25,4340,8249,8141,16390,新左營,一等
2020-11-26,4340,9272,9153,18425,新左營,一等
2020-11-27,4340,15252,14309,29561,新左營,一等
2020-11-28,4340,13277,12529,25806,新左營,一等
2020-11-29,4340,14540,16237,30777,新左營,一等
2020-11-30,4340,9592,10159,19751,新左營,一等
2020-12-01,4340,7685,7819,15504,新左營,一等
2020-12-02,4340,7853,7677,15530,新左營,一等
2020-12-03,4340,8662,8571,17233,新左營,一等
2020-12-04,4340,14823,14297,29120,新左營,一等
2020-12-05,4340,13585,13305,26890,新左營,一等
2020-12-06,4340,15995,16297,32292,新左營,一等
2020-12-07,4340,9876,10193,20069,新左營,一等
2020-12-08,4340,8209,8334,16543,新左營,一等
2020-12-09,4340,8199,8289,16488,新左營,一等
2020-12-10,4340,8927,8762,17689,新左營,一等
2020-12-11,4340,15573,14450,30023,新左營,一等
2020-12-12,4340,13398,12925,26323,新左營,一等
2020-12-13,4340,15445,15869,31314,新左營,一等
2020-12-14,4340,10582,10568,21150,新左營,一等
2020-12-15,4340,8147,8415,16562,新左營,一等
2020-12-16,4340,8442,8703,17145,新左營,一等
2020-12-17,4340,9199,9085,18284,新左營,一等
2020-12-18,4340,15510,14407,29917,新左營,一等
2020-12-19,4340,14416,13287,27703,新左營,一等
2020-12-20,4340,15102,16139,31241,新左營,一等
2020-12-21,4340,9667,9738,19405,新左營,一等
2020-12-22,4340,8110,8361,16471,新左營,一等
2020-12-23,4340,8385,8419,16804,新左營,一等
2020-12-24,4340,9770,9219,18989,新左營,一等
2020-12-25,4340,13909,13774,27683,新左營,一等
2020-12-26,4340,12055,11673,23728,新左營,一等
2020-12-27,4340,13593,14691,28284,新左營,一等
2020-12-28,4340,9353,9430,18783,新左營,一等
2020-12-29,4340,8464,8409,16873,新左營,一等
2020-12-30,4340,11231,9787,21018,新左營,一等
2020-12-31,4340,17708,16769,34477,新左營,一等
2020-01-01,4350,873,859,1732,左營,簡易
2020-01-02,4350,807,833,1640,左營,簡易
2020-01-03,4350,912,1017,1929,左營,簡易
2020-01-04,4350,731,766,1497,左營,簡易
2020-01-05,4350,708,728,1436,左營,簡易
2020-01-06,4350,830,767,1597,左營,簡易
2020-01-07,4350,750,737,1487,左營,簡易
2020-01-08,4350,762,758,1520,左營,簡易
2020-01-09,4350,774,783,1557,左營,簡易
2020-01-10,4350,880,996,1876,左營,簡易
2020-01-11,4350,725,811,1536,左營,簡易
2020-01-12,4350,762,818,1580,左營,簡易
2020-01-13,4350,922,875,1797,左營,簡易
2020-01-14,4350,817,774,1591,左營,簡易
2020-01-15,4350,817,819,1636,左營,簡易
2020-01-16,4350,849,808,1657,左營,簡易
2020-01-17,4350,762,819,1581,左營,簡易
2020-01-18,4350,683,695,1378,左營,簡易
2020-01-19,4350,714,786,1500,左營,簡易
2020-01-20,4350,807,762,1569,左營,簡易
2020-01-21,4350,792,785,1577,左營,簡易
2020-01-22,4350,813,823,1636,左營,簡易
2020-01-23,4350,668,694,1362,左營,簡易
2020-01-24,4350,672,723,1395,左營,簡易
2020-01-25,4350,1532,1699,3231,左營,簡易
2020-01-26,4350,1249,1216,2465,左營,簡易
2020-01-27,4350,1322,1482,2804,左營,簡易
2020-01-28,4350,707,778,1485,左營,簡易
2020-01-29,4350,750,782,1532,左營,簡易
2020-01-30,4350,599,608,1207,左營,簡易
2020-01-31,4350,645,651,1296,左營,簡易
2020-02-01,4350,437,463,900,左營,簡易
2020-02-02,4350,543,581,1124,左營,簡易
2020-02-03,4350,541,562,1103,左營,簡易
2020-02-04,4350,560,593,1153,左營,簡易
2020-02-05,4350,532,553,1085,左營,簡易
2020-02-06,4350,580,612,1192,左營,簡易
2020-02-07,4350,575,592,1167,左營,簡易
2020-02-08,4350,559,566,1125,左營,簡易
2020-02-09,4350,536,636,1172,左營,簡易
2020-02-10,4350,559,601,1160,左營,簡易
2020-02-11,4350,521,532,1053,左營,簡易
2020-02-12,4350,505,525,1030,左營,簡易
2020-02-13,4350,596,572,1168,左營,簡易
2020-02-14,4350,649,655,1304,左營,簡易
2020-02-15,4350,560,590,1150,左營,簡易
2020-02-16,4350,590,648,1238,左營,簡易
2020-02-17,4350,625,586,1211,左營,簡易
2020-02-18,4350,602,582,1184,左營,簡易
2020-02-19,4350,591,572,1163,左營,簡易
2020-02-20,4350,663,586,1249,左營,簡易
2020-02-21,4350,659,653,1312,左營,簡易
2020-02-22,4350,535,526,1061,左營,簡易
2020-02-23,4350,477,531,1008,左營,簡易
2020-02-24,4350,587,598,1185,左營,簡易
2020-02-25,4350,705,671,1376,左營,簡易
2020-02-26,4350,711,645,1356,左營,簡易
2020-02-27,4350,758,736,1494,左營,簡易
2020-02-28,4350,486,531,1017,左營,簡易
2020-02-29,4350,507,485,992,左營,簡易
2020-03-01,4350,526,491,1017,左營,簡易
2020-03-02,4350,700,663,1363,左營,簡易
2020-03-03,4350,691,627,1318,左營,簡易
2020-03-04,4350,695,642,1337,左營,簡易
2020-03-05,4350,722,678,1400,左營,簡易
2020-03-06,4350,770,785,1555,左營,簡易
2020-03-07,4350,419,465,884,左營,簡易
2020-03-08,4350,499,506,1005,左營,簡易
2020-03-09,4350,715,669,1384,左營,簡易
2020-03-10,4350,679,615,1294,左營,簡易
2020-03-11,4350,702,688,1390,左營,簡易
2020-03-12,4350,714,671,1385,左營,簡易
2020-03-13,4350,762,797,1559,左營,簡易
2020-03-14,4350,411,393,804,左營,簡易
2020-03-15,4350,588,536,1124,左營,簡易
2020-03-16,4350,747,675,1422,左營,簡易
2020-03-17,4350,674,618,1292,左營,簡易
2020-03-18,4350,686,638,1324,左營,簡易
2020-03-19,4350,701,660,1361,左營,簡易
2020-03-20,4350,672,670,1342,左營,簡易
2020-03-21,4350,370,462,832,左營,簡易
2020-03-22,4350,461,453,914,左營,簡易
2020-03-23,4350,591,602,1193,左營,簡易
2020-03-24,4350,564,567,1131,左營,簡易
2020-03-25,4350,573,568,1141,左營,簡易
2020-03-26,4350,560,549,1109,左營,簡易
2020-03-27,4350,624,659,1283,左營,簡易
2020-03-28,4350,381,418,799,左營,簡易
2020-03-29,4350,432,418,850,左營,簡易
2020-03-30,4350,623,583,1206,左營,簡易
2020-03-31,4350,554,555,1109,左營,簡易
2020-04-01,4350,579,622,1201,左營,簡易
2020-04-02,4350,440,481,921,左營,簡易
2020-04-03,4350,435,405,840,左營,簡易
2020-04-04,4350,394,345,739,左營,簡易
2020-04-05,4350,375,393,768,左營,簡易
2020-04-06,4350,650,599,1249,左營,簡易
2020-04-07,4350,605,538,1143,左營,簡易
2020-04-08,4350,598,555,1153,左營,簡易
2020-04-09,4350,585,564,1149,左營,簡易
2020-04-10,4350,525,392,917,左營,簡易
2020-04-11,4350,336,358,694,左營,簡易
2020-04-12,4350,364,365,729,左營,簡易
2020-04-13,4350,640,562,1202,左營,簡易
2020-04-14,4350,591,540,1131,左營,簡易
2020-04-15,4350,612,592,1204,左營,簡易
2020-04-16,4350,620,583,1203,左營,簡易
2020-04-17,4350,655,665,1320,左營,簡易
2020-04-18,4350,438,459,897,左營,簡易
2020-04-19,4350,395,376,771,左營,簡易
2020-04-20,4350,535,503,1038,左營,簡易
2020-04-21,4350,540,510,1050,左營,簡易
2020-04-22,4350,541,498,1039,左營,簡易
2020-04-23,4350,546,498,1044,左營,簡易
2020-04-24,4350,594,574,1168,左營,簡易
2020-04-25,4350,316,300,616,左營,簡易
2020-04-26,4350,303,310,613,左營,簡易
2020-04-27,4350,584,510,1094,左營,簡易
2020-04-28,4350,583,550,1133,左營,簡易
2020-04-29,4350,558,477,1035,左營,簡易
2020-04-30,4350,549,538,1087,左營,簡易
2020-05-01,4350,590,566,1156,左營,簡易
2020-05-02,4350,323,362,685,左營,簡易
2020-05-03,4350,354,349,703,左營,簡易
2020-05-04,4350,621,540,1161,左營,簡易
2020-05-05,4350,596,555,1151,左營,簡易
2020-05-06,4350,612,567,1179,左營,簡易
2020-05-07,4350,607,568,1175,左營,簡易
2020-05-08,4350,621,662,1283,左營,簡易
2020-05-09,4350,458,444,902,左營,簡易
2020-05-10,4350,445,447,892,左營,簡易
2020-05-11,4350,675,624,1299,左營,簡易
2020-05-12,4350,638,598,1236,左營,簡易
2020-05-13,4350,592,557,1149,左營,簡易
2020-05-14,4350,645,593,1238,左營,簡易
2020-05-15,4350,678,709,1387,左營,簡易
2020-05-16,4350,400,385,785,左營,簡易
2020-05-17,4350,446,425,871,左營,簡易
2020-05-18,4350,659,635,1294,左營,簡易
2020-05-19,4350,581,533,1114,左營,簡易
2020-05-20,4350,590,548,1138,左營,簡易
2020-05-21,4350,567,541,1108,左營,簡易
2020-05-22,4350,565,602,1167,左營,簡易
2020-05-23,4350,393,465,858,左營,簡易
2020-05-24,4350,607,570,1177,左營,簡易
2020-05-25,4350,650,569,1219,左營,簡易
2020-05-26,4350,613,544,1157,左營,簡易
2020-05-27,4350,548,500,1048,左營,簡易
2020-05-28,4350,566,560,1126,左營,簡易
2020-05-29,4350,677,703,1380,左營,簡易
2020-05-30,4350,443,456,899,左營,簡易
2020-05-31,4350,492,552,1044,左營,簡易
2020-06-01,4350,672,596,1268,左營,簡易
2020-06-02,4350,634,575,1209,左營,簡易
2020-06-03,4350,625,595,1220,左營,簡易
2020-06-04,4350,648,659,1307,左營,簡易
2020-06-05,4350,663,718,1381,左營,簡易
2020-06-06,4350,528,538,1066,左營,簡易
2020-06-07,4350,581,543,1124,左營,簡易
2020-06-08,4350,680,610,1290,左營,簡易
2020-06-09,4350,616,568,1184,左營,簡易
2020-06-10,4350,575,566,1141,左營,簡易
2020-06-11,4350,648,656,1304,左營,簡易
2020-06-12,4350,663,675,1338,左營,簡易
2020-06-13,4350,526,595,1121,左營,簡易
2020-06-14,4350,600,588,1188,左營,簡易
2020-06-15,4350,629,643,1272,左營,簡易
2020-06-16,4350,578,546,1124,左營,簡易
2020-06-17,4350,544,531,1075,左營,簡易
2020-06-18,4350,574,543,1117,左營,簡易
2020-06-19,4350,579,657,1236,左營,簡易
2020-06-20,4350,578,580,1158,左營,簡易
2020-06-21,4350,494,535,1029,左營,簡易
2020-06-22,4350,607,542,1149,左營,簡易
2020-06-23,4350,584,581,1165,左營,簡易
2020-06-24,4350,656,721,1377,左營,簡易
2020-06-25,4350,550,612,1162,左營,簡易
2020-06-26,4350,576,686,1262,左營,簡易
2020-06-27,4350,595,588,1183,左營,簡易
2020-06-28,4350,553,583,1136,左營,簡易
2020-06-29,4350,568,568,1136,左營,簡易
2020-06-30,4350,537,549,1086,左營,簡易
2020-07-01,4350,534,536,1070,左營,簡易
2020-07-02,4350,556,581,1137,左營,簡易
2020-07-03,4350,615,652,1267,左營,簡易
2020-07-04,4350,494,536,1030,左營,簡易
2020-07-05,4350,511,567,1078,左營,簡易
2020-07-06,4350,562,612,1174,左營,簡易
2020-07-07,4350,595,589,1184,左營,簡易
2020-07-08,4350,571,558,1129,左營,簡易
2020-07-09,4350,577,551,1128,左營,簡易
2020-07-10,4350,659,685,1344,左營,簡易
2020-07-11,4350,563,619,1182,左營,簡易
2020-07-12,4350,555,656,1211,左營,簡易
2020-07-13,4350,553,579,1132,左營,簡易
2020-07-14,4350,551,568,1119,左營,簡易
2020-07-15,4350,617,646,1263,左營,簡易
2020-07-16,4350,550,578,1128,左營,簡易
2020-07-17,4350,585,644,1229,左營,簡易
2020-07-18,4350,589,619,1208,左營,簡易
2020-07-19,4350,642,699,1341,左營,簡易
2020-07-20,4350,586,694,1280,左營,簡易
2020-07-21,4350,540,599,1139,左營,簡易
2020-07-22,4350,597,632,1229,左營,簡易
2020-07-23,4350,575,569,1144,左營,簡易
2020-07-24,4350,572,648,1220,左營,簡易
2020-07-25,4350,559,585,1144,左營,簡易
2020-07-26,4350,546,590,1136,左營,簡易
2020-07-27,4350,593,614,1207,左營,簡易
2020-07-28,4350,592,608,1200,左營,簡易
2020-07-29,4350,548,559,1107,左營,簡易
2020-07-30,4350,560,594,1154,左營,簡易
2020-07-31,4350,569,617,1186,左營,簡易
2020-08-01,4350,528,597,1125,左營,簡易
2020-08-02,4350,421,540,961,左營,簡易
2020-08-03,4350,488,487,975,左營,簡易
2020-08-04,4350,475,459,934,左營,簡易
2020-08-05,4350,610,603,1213,左營,簡易
2020-08-06,4350,579,602,1181,左營,簡易
2020-08-07,4350,635,648,1283,左營,簡易
2020-08-08,4350,548,604,1152,左營,簡易
2020-08-09,4350,615,678,1293,左營,簡易
2020-08-10,4350,641,701,1342,左營,簡易
2020-08-11,4350,621,576,1197,左營,簡易
2020-08-12,4350,679,647,1326,左營,簡易
2020-08-13,4350,637,642,1279,左營,簡易
2020-08-14,4350,720,768,1488,左營,簡易
2020-08-15,4350,565,654,1219,左營,簡易
2020-08-16,4350,622,692,1314,左營,簡易
2020-08-17,4350,690,742,1432,左營,簡易
2020-08-18,4350,685,654,1339,左營,簡易
2020-08-19,4350,640,632,1272,左營,簡易
2020-08-20,4350,651,651,1302,左營,簡易
2020-08-21,4350,715,749,1464,左營,簡易
2020-08-22,4350,562,588,1150,左營,簡易
2020-08-23,4350,540,632,1172,左營,簡易
2020-08-24,4350,576,585,1161,左營,簡易
2020-08-25,4350,601,609,1210,左營,簡易
2020-08-26,4350,531,508,1039,左營,簡易
2020-08-27,4350,602,559,1161,左營,簡易
2020-08-28,4350,729,703,1432,左營,簡易
2020-08-29,4350,509,590,1099,左營,簡易
2020-08-30,4350,436,477,913,左營,簡易
2020-08-31,4350,631,649,1280,左營,簡易
2020-09-01,4350,656,624,1280,左營,簡易
2020-09-02,4350,675,590,1265,左營,簡易
2020-09-03,4350,655,666,1321,左營,簡易
2020-09-04,4350,709,698,1407,左營,簡易
2020-09-05,4350,565,569,1134,左營,簡易
2020-09-06,4350,490,557,1047,左營,簡易
2020-09-07,4350,658,674,1332,左營,簡易
2020-09-08,4350,664,636,1300,左營,簡易
2020-09-09,4350,649,632,1281,左營,簡易
2020-09-10,4350,627,639,1266,左營,簡易
2020-09-11,4350,655,699,1354,左營,簡易
2020-09-12,4350,531,591,1122,左營,簡易
2020-09-13,4350,655,692,1347,左營,簡易
2020-09-14,4350,673,628,1301,左營,簡易
2020-09-15,4350,650,616,1266,左營,簡易
2020-09-16,4350,684,631,1315,左營,簡易
2020-09-17,4350,674,637,1311,左營,簡易
2020-09-18,4350,754,790,1544,左營,簡易
2020-09-19,4350,570,612,1182,左營,簡易
2020-09-20,4350,615,589,1204,左營,簡易
2020-09-21,4350,702,694,1396,左營,簡易
2020-09-22,4350,685,623,1308,左營,簡易
2020-09-23,4350,669,639,1308,左營,簡易
2020-09-24,4350,673,669,1342,左營,簡易
2020-09-25,4350,735,721,1456,左營,簡易
2020-09-26,4350,597,597,1194,左營,簡易
2020-09-27,4350,579,568,1147,左營,簡易
2020-09-28,4350,690,665,1355,左營,簡易
2020-09-29,4350,650,648,1298,左營,簡易
2020-09-30,4350,795,910,1705,左營,簡易
2020-10-01,4350,1213,1244,2457,左營,簡易
2020-10-02,4350,1585,1644,3229,左營,簡易
2020-10-03,4350,1667,1715,3382,左營,簡易
2020-10-04,4350,1481,1438,2919,左營,簡易
2020-10-05,4350,714,722,1436,左營,簡易
2020-10-06,4350,741,662,1403,左營,簡易
2020-10-07,4350,694,663,1357,左營,簡易
2020-10-08,4350,768,843,1611,左營,簡易
2020-10-09,4350,609,684,1293,左營,簡易
2020-10-10,4350,637,671,1308,左營,簡易
2020-10-11,4350,613,638,1251,左營,簡易
2020-10-12,4350,715,709,1424,左營,簡易
2020-10-13,4350,712,669,1381,左營,簡易
2020-10-14,4350,707,662,1369,左營,簡易
2020-10-15,4350,763,706,1469,左營,簡易
2020-10-16,4350,790,851,1641,左營,簡易
2020-10-17,4350,573,604,1177,左營,簡易
2020-10-18,4350,635,704,1339,左營,簡易
2020-10-19,4350,734,667,1401,左營,簡易
2020-10-20,4350,658,656,1314,左營,簡易
2020-10-21,4350,706,672,1378,左營,簡易
2020-10-22,4350,689,643,1332,左營,簡易
2020-10-23,4350,1052,1111,2163,左營,簡易
2020-10-24,4350,580,631,1211,左營,簡易
2020-10-25,4350,605,634,1239,左營,簡易
2020-10-26,4350,630,614,1244,左營,簡易
2020-10-27,4350,635,635,1270,左營,簡易
2020-10-28,4350,673,692,1365,左營,簡易
2020-10-29,4350,660,677,1337,左營,簡易
2020-10-30,4350,795,838,1633,左營,簡易
2020-10-31,4350,582,634,1216,左營,簡易
2020-11-01,4350,603,590,1193,左營,簡易
2020-11-02,4350,706,682,1388,左營,簡易
2020-11-03,4350,677,673,1350,左營,簡易
2020-11-04,4350,677,644,1321,左營,簡易
2020-11-05,4350,675,666,1341,左營,簡易
2020-11-06,4350,744,776,1520,左營,簡易
2020-11-07,4350,480,551,1031,左營,簡易
2020-11-08,4350,619,680,1299,左營,簡易
2020-11-09,4350,618,611,1229,左營,簡易
2020-11-10,4350,660,677,1337,左營,簡易
2020-11-11,4350,654,615,1269,左營,簡易
2020-11-12,4350,738,706,1444,左營,簡易
2020-11-13,4350,775,849,1624,左營,簡易
2020-11-14,4350,624,675,1299,左營,簡易
2020-11-15,4350,852,815,1667,左營,簡易
2020-11-16,4350,715,666,1381,左營,簡易
2020-11-17,4350,656,624,1280,左營,簡易
2020-11-18,4350,711,688,1399,左營,簡易
2020-11-19,4350,737,673,1410,左營,簡易
2020-11-20,4350,840,909,1749,左營,簡易
2020-11-21,4350,549,576,1125,左營,簡易
2020-11-22,4350,631,690,1321,左營,簡易
2020-11-23,4350,748,666,1414,左營,簡易
2020-11-24,4350,711,675,1386,左營,簡易
2020-11-25,4350,683,670,1353,左營,簡易
2020-11-26,4350,648,639,1287,左營,簡易
2020-11-27,4350,716,837,1553,左營,簡易
2020-11-28,4350,664,644,1308,左營,簡易
2020-11-29,4350,604,630,1234,左營,簡易
2020-11-30,4350,736,674,1410,左營,簡易
2020-12-01,4350,682,627,1309,左營,簡易
2020-12-02,4350,695,642,1337,左營,簡易
2020-12-03,4350,697,673,1370,左營,簡易
2020-12-04,4350,808,855,1663,左營,簡易
2020-12-05,4350,640,686,1326,左營,簡易
2020-12-06,4350,680,693,1373,左營,簡易
2020-12-07,4350,740,683,1423,左營,簡易
2020-12-08,4350,709,679,1388,左營,簡易
2020-12-09,4350,698,616,1314,左營,簡易
2020-12-10,4350,674,647,1321,左營,簡易
2020-12-11,4350,774,863,1637,左營,簡易
2020-12-12,4350,799,836,1635,左營,簡易
2020-12-13,4350,694,718,1412,左營,簡易
2020-12-14,4350,769,697,1466,左營,簡易
2020-12-15,4350,627,637,1264,左營,簡易
2020-12-16,4350,684,627,1311,左營,簡易
2020-12-17,4350,732,700,1432,左營,簡易
2020-12-18,4350,757,851,1608,左營,簡易
2020-12-19,4350,686,762,1448,左營,簡易
2020-12-20,4350,675,693,1368,左營,簡易
2020-12-21,4350,635,591,1226,左營,簡易
2020-12-22,4350,633,597,1230,左營,簡易
2020-12-23,4350,584,602,1186,左營,簡易
2020-12-24,4350,594,625,1219,左營,簡易
2020-12-25,4350,709,747,1456,左營,簡易
2020-12-26,4350,732,657,1389,左營,簡易
2020-12-27,4350,607,557,1164,左營,簡易
2020-12-28,4350,657,615,1272,左營,簡易
2020-12-29,4350,622,609,1231,左營,簡易
2020-12-30,4350,614,634,1248,左營,簡易
2020-12-31,4350,662,743,1405,左營,簡易
2020-01-01,4360,705,728,1433,內惟,簡易
2020-01-02,4360,788,711,1499,內惟,簡易
2020-01-03,4360,797,867,1664,內惟,簡易
2020-01-04,4360,727,756,1483,內惟,簡易
2020-01-05,4360,765,697,1462,內惟,簡易
2020-01-06,4360,768,738,1506,內惟,簡易
2020-01-07,4360,734,709,1443,內惟,簡易
2020-01-08,4360,722,749,1471,內惟,簡易
2020-01-09,4360,755,805,1560,內惟,簡易
2020-01-10,4360,802,1011,1813,內惟,簡易
2020-01-11,4360,813,789,1602,內惟,簡易
2020-01-12,4360,726,666,1392,內惟,簡易
2020-01-13,4360,806,751,1557,內惟,簡易
2020-01-14,4360,717,716,1433,內惟,簡易
2020-01-15,4360,758,786,1544,內惟,簡易
2020-01-16,4360,765,787,1552,內惟,簡易
2020-01-17,4360,786,779,1565,內惟,簡易
2020-01-18,4360,764,748,1512,內惟,簡易
2020-01-19,4360,618,602,1220,內惟,簡易
2020-01-20,4360,783,770,1553,內惟,簡易
2020-01-21,4360,768,800,1568,內惟,簡易
2020-01-22,4360,688,783,1471,內惟,簡易
2020-01-23,4360,638,693,1331,內惟,簡易
2020-01-24,4360,587,483,1070,內惟,簡易
2020-01-25,4360,762,702,1464,內惟,簡易
2020-01-26,4360,731,762,1493,內惟,簡易
2020-01-27,4360,754,760,1514,內惟,簡易
2020-01-28,4360,597,598,1195,內惟,簡易
2020-01-29,4360,585,566,1151,內惟,簡易
2020-01-30,4360,631,590,1221,內惟,簡易
2020-01-31,4360,606,589,1195,內惟,簡易
2020-02-01,4360,497,488,985,內惟,簡易
2020-02-02,4360,526,524,1050,內惟,簡易
2020-02-03,4360,567,542,1109,內惟,簡易
2020-02-04,4360,571,582,1153,內惟,簡易
2020-02-05,4360,602,604,1206,內惟,簡易
2020-02-06,4360,600,574,1174,內惟,簡易
2020-02-07,4360,600,634,1234,內惟,簡易
2020-02-08,4360,566,521,1087,內惟,簡易
2020-02-09,4360,525,544,1069,內惟,簡易
2020-02-10,4360,551,514,1065,內惟,簡易
2020-02-11,4360,559,548,1107,內惟,簡易
2020-02-12,4360,573,544,1117,內惟,簡易
2020-02-13,4360,568,570,1138,內惟,簡易
2020-02-14,4360,598,618,1216,內惟,簡易
2020-02-15,4360,571,518,1089,內惟,簡易
2020-02-16,4360,520,563,1083,內惟,簡易
2020-02-17,4360,544,553,1097,內惟,簡易
2020-02-18,4360,538,519,1057,內惟,簡易
2020-02-19,4360,558,515,1073,內惟,簡易
2020-02-20,4360,553,597,1150,內惟,簡易
2020-02-21,4360,630,608,1238,內惟,簡易
2020-02-22,4360,482,491,973,內惟,簡易
2020-02-23,4360,444,457,901,內惟,簡易
2020-02-24,4360,592,551,1143,內惟,簡易
2020-02-25,4360,595,615,1210,內惟,簡易
2020-02-26,4360,630,632,1262,內惟,簡易
2020-02-27,4360,681,725,1406,內惟,簡易
2020-02-28,4360,570,529,1099,內惟,簡易
2020-02-29,4360,486,456,942,內惟,簡易
2020-03-01,4360,532,458,990,內惟,簡易
2020-03-02,4360,646,648,1294,內惟,簡易
2020-03-03,4360,613,619,1232,內惟,簡易
2020-03-04,4360,573,550,1123,內惟,簡易
2020-03-05,4360,572,615,1187,內惟,簡易
2020-03-06,4360,631,724,1355,內惟,簡易
2020-03-07,4360,475,492,967,內惟,簡易
2020-03-08,4360,507,457,964,內惟,簡易
2020-03-09,4360,629,598,1227,內惟,簡易
2020-03-10,4360,589,586,1175,內惟,簡易
2020-03-11,4360,594,607,1201,內惟,簡易
2020-03-12,4360,591,634,1225,內惟,簡易
2020-03-13,4360,644,730,1374,內惟,簡易
2020-03-14,4360,433,499,932,內惟,簡易
2020-03-15,4360,472,441,913,內惟,簡易
2020-03-16,4360,646,572,1218,內惟,簡易
2020-03-17,4360,609,601,1210,內惟,簡易
2020-03-18,4360,530,568,1098,內惟,簡易
2020-03-19,4360,550,582,1132,內惟,簡易
2020-03-20,4360,596,680,1276,內惟,簡易
2020-03-21,4360,451,466,917,內惟,簡易
2020-03-22,4360,441,404,845,內惟,簡易
2020-03-23,4360,610,553,1163,內惟,簡易
2020-03-24,4360,569,548,1117,內惟,簡易
2020-03-25,4360,543,528,1071,內惟,簡易
2020-03-26,4360,536,535,1071,內惟,簡易
2020-03-27,4360,558,639,1197,內惟,簡易
2020-03-28,4360,418,453,871,內惟,簡易
2020-03-29,4360,383,362,745,內惟,簡易
2020-03-30,4360,563,534,1097,內惟,簡易
2020-03-31,4360,530,543,1073,內惟,簡易
2020-04-01,4360,532,659,1191,內惟,簡易
2020-04-02,4360,349,375,724,內惟,簡易
2020-04-03,4360,378,376,754,內惟,簡易
2020-04-04,4360,335,317,652,內惟,簡易
2020-04-05,4360,389,357,746,內惟,簡易
2020-04-06,4360,601,558,1159,內惟,簡易
2020-04-07,4360,511,494,1005,內惟,簡易
2020-04-08,4360,512,507,1019,內惟,簡易
2020-04-09,4360,522,483,1005,內惟,簡易
2020-04-10,4360,447,390,837,內惟,簡易
2020-04-11,4360,373,353,726,內惟,簡易
2020-04-12,4360,367,326,693,內惟,簡易
2020-04-13,4360,515,532,1047,內惟,簡易
2020-04-14,4360,544,536,1080,內惟,簡易
2020-04-15,4360,523,539,1062,內惟,簡易
2020-04-16,4360,527,548,1075,內惟,簡易
2020-04-17,4360,548,619,1167,內惟,簡易
2020-04-18,4360,440,426,866,內惟,簡易
2020-04-19,4360,419,396,815,內惟,簡易
2020-04-20,4360,521,465,986,內惟,簡易
2020-04-21,4360,474,464,938,內惟,簡易
2020-04-22,4360,486,488,974,內惟,簡易
2020-04-23,4360,478,474,952,內惟,簡易
2020-04-24,4360,486,545,1031,內惟,簡易
2020-04-25,4360,305,290,595,內惟,簡易
2020-04-26,4360,339,293,632,內惟,簡易
2020-04-27,4360,544,511,1055,內惟,簡易
2020-04-28,4360,498,507,1005,內惟,簡易
2020-04-29,4360,486,498,984,內惟,簡易
2020-04-30,4360,508,522,1030,內惟,簡易
2020-05-01,4360,489,541,1030,內惟,簡易
2020-05-02,4360,373,371,744,內惟,簡易
2020-05-03,4360,362,350,712,內惟,簡易
2020-05-04,4360,586,557,1143,內惟,簡易
2020-05-05,4360,531,532,1063,內惟,簡易
2020-05-06,4360,539,469,1008,內惟,簡易
2020-05-07,4360,525,553,1078,內惟,簡易
2020-05-08,4360,559,710,1269,內惟,簡易
2020-05-09,4360,447,381,828,內惟,簡易
2020-05-10,4360,561,441,1002,內惟,簡易
2020-05-11,4360,662,595,1257,內惟,簡易
2020-05-12,4360,573,556,1129,內惟,簡易
2020-05-13,4360,548,562,1110,內惟,簡易
2020-05-14,4360,542,542,1084,內惟,簡易
2020-05-15,4360,621,680,1301,內惟,簡易
2020-05-16,4360,432,422,854,內惟,簡易
2020-05-17,4360,427,410,837,內惟,簡易
2020-05-18,4360,622,603,1225,內惟,簡易
2020-05-19,4360,558,558,1116,內惟,簡易
2020-05-20,4360,524,532,1056,內惟,簡易
2020-05-21,4360,525,554,1079,內惟,簡易
2020-05-22,4360,471,604,1075,內惟,簡易
2020-05-23,4360,441,445,886,內惟,簡易
2020-05-24,4360,485,447,932,內惟,簡易
2020-05-25,4360,610,573,1183,內惟,簡易
2020-05-26,4360,566,536,1102,內惟,簡易
2020-05-27,4360,507,530,1037,內惟,簡易
2020-05-28,4360,580,600,1180,內惟,簡易
2020-05-29,4360,619,724,1343,內惟,簡易
2020-05-30,4360,595,583,1178,內惟,簡易
2020-05-31,4360,587,526,1113,內惟,簡易
2020-06-01,4360,620,575,1195,內惟,簡易
2020-06-02,4360,571,579,1150,內惟,簡易
2020-06-03,4360,574,595,1169,內惟,簡易
2020-06-04,4360,569,592,1161,內惟,簡易
2020-06-05,4360,617,807,1424,內惟,簡易
2020-06-06,4360,549,559,1108,內惟,簡易
2020-06-07,4360,624,498,1122,內惟,簡易
2020-06-08,4360,670,606,1276,內惟,簡易
2020-06-09,4360,629,606,1235,內惟,簡易
2020-06-10,4360,614,611,1225,內惟,簡易
2020-06-11,4360,641,628,1269,內惟,簡易
2020-06-12,4360,687,741,1428,內惟,簡易
2020-06-13,4360,632,588,1220,內惟,簡易
2020-06-14,4360,532,542,1074,內惟,簡易
2020-06-15,4360,642,648,1290,內惟,簡易
2020-06-16,4360,611,582,1193,內惟,簡易
2020-06-17,4360,641,655,1296,內惟,簡易
2020-06-18,4360,588,637,1225,內惟,簡易
2020-06-19,4360,629,665,1294,內惟,簡易
2020-06-20,4360,589,623,1212,內惟,簡易
2020-06-21,4360,565,525,1090,內惟,簡易
2020-06-22,4360,671,647,1318,內惟,簡易
2020-06-23,4360,639,633,1272,內惟,簡易
2020-06-24,4360,678,754,1432,內惟,簡易
2020-06-25,4360,579,604,1183,內惟,簡易
2020-06-26,4360,632,629,1261,內惟,簡易
2020-06-27,4360,622,583,1205,內惟,簡易
2020-06-28,4360,534,541,1075,內惟,簡易
2020-06-29,4360,669,630,1299,內惟,簡易
2020-06-30,4360,566,605,1171,內惟,簡易
2020-07-01,4360,606,649,1255,內惟,簡易
2020-07-02,4360,615,604,1219,內惟,簡易
2020-07-03,4360,624,693,1317,內惟,簡易
2020-07-04,4360,518,501,1019,內惟,簡易
2020-07-05,4360,463,497,960,內惟,簡易
2020-07-06,4360,639,607,1246,內惟,簡易
2020-07-07,4360,618,607,1225,內惟,簡易
2020-07-08,4360,595,608,1203,內惟,簡易
2020-07-09,4360,599,599,1198,內惟,簡易
2020-07-10,4360,657,711,1368,內惟,簡易
2020-07-11,4360,552,539,1091,內惟,簡易
2020-07-12,4360,584,560,1144,內惟,簡易
2020-07-13,4360,646,696,1342,內惟,簡易
2020-07-14,4360,581,611,1192,內惟,簡易
2020-07-15,4360,598,588,1186,內惟,簡易
2020-07-16,4360,638,609,1247,內惟,簡易
2020-07-17,4360,756,776,1532,內惟,簡易
2020-07-18,4360,704,685,1389,內惟,簡易
2020-07-19,4360,678,689,1367,內惟,簡易
2020-07-20,4360,744,699,1443,內惟,簡易
2020-07-21,4360,675,640,1315,內惟,簡易
2020-07-22,4360,603,637,1240,內惟,簡易
2020-07-23,4360,676,658,1334,內惟,簡易
2020-07-24,4360,681,702,1383,內惟,簡易
2020-07-25,4360,623,591,1214,內惟,簡易
2020-07-26,4360,574,579,1153,內惟,簡易
2020-07-27,4360,679,623,1302,內惟,簡易
2020-07-28,4360,598,601,1199,內惟,簡易
2020-07-29,4360,614,612,1226,內惟,簡易
2020-07-30,4360,623,616,1239,內惟,簡易
2020-07-31,4360,700,746,1446,內惟,簡易
2020-08-01,4360,680,671,1351,內惟,簡易
2020-08-02,4360,577,558,1135,內惟,簡易
2020-08-03,4360,580,599,1179,內惟,簡易
2020-08-04,4360,548,559,1107,內惟,簡易
2020-08-05,4360,629,645,1274,內惟,簡易
2020-08-06,4360,657,680,1337,內惟,簡易
2020-08-07,4360,677,743,1420,內惟,簡易
2020-08-08,4360,605,561,1166,內惟,簡易
2020-08-09,4360,610,585,1195,內惟,簡易
2020-08-10,4360,653,674,1327,內惟,簡易
2020-08-11,4360,578,602,1180,內惟,簡易
2020-08-12,4360,614,642,1256,內惟,簡易
2020-08-13,4360,651,698,1349,內惟,簡易
2020-08-14,4360,708,839,1547,內惟,簡易
2020-08-15,4360,720,630,1350,內惟,簡易
2020-08-16,4360,659,606,1265,內惟,簡易
2020-08-17,4360,681,640,1321,內惟,簡易
2020-08-18,4360,660,672,1332,內惟,簡易
2020-08-19,4360,599,670,1269,內惟,簡易
2020-08-20,4360,663,659,1322,內惟,簡易
2020-08-21,4360,677,682,1359,內惟,簡易
2020-08-22,4360,627,599,1226,內惟,簡易
2020-08-23,4360,545,557,1102,內惟,簡易
2020-08-24,4360,605,648,1253,內惟,簡易
2020-08-25,4360,628,657,1285,內惟,簡易
2020-08-26,4360,540,598,1138,內惟,簡易
2020-08-27,4360,558,578,1136,內惟,簡易
2020-08-28,4360,632,657,1289,內惟,簡易
2020-08-29,4360,606,596,1202,內惟,簡易
2020-08-30,4360,484,436,920,內惟,簡易
2020-08-31,4360,639,649,1288,內惟,簡易
2020-09-01,4360,565,629,1194,內惟,簡易
2020-09-02,4360,620,644,1264,內惟,簡易
2020-09-03,4360,594,607,1201,內惟,簡易
2020-09-04,4360,687,709,1396,內惟,簡易
2020-09-05,4360,679,669,1348,內惟,簡易
2020-09-06,4360,615,590,1205,內惟,簡易
2020-09-07,4360,660,652,1312,內惟,簡易
2020-09-08,4360,652,682,1334,內惟,簡易
2020-09-09,4360,655,658,1313,內惟,簡易
2020-09-10,4360,607,644,1251,內惟,簡易
2020-09-11,4360,674,749,1423,內惟,簡易
2020-09-12,4360,557,532,1089,內惟,簡易
2020-09-13,4360,589,582,1171,內惟,簡易
2020-09-14,4360,675,648,1323,內惟,簡易
2020-09-15,4360,613,623,1236,內惟,簡易
2020-09-16,4360,621,629,1250,內惟,簡易
2020-09-17,4360,611,659,1270,內惟,簡易
2020-09-18,4360,706,793,1499,內惟,簡易
2020-09-19,4360,657,624,1281,內惟,簡易
2020-09-20,4360,572,542,1114,內惟,簡易
2020-09-21,4360,670,684,1354,內惟,簡易
2020-09-22,4360,615,669,1284,內惟,簡易
2020-09-23,4360,615,669,1284,內惟,簡易
2020-09-24,4360,648,634,1282,內惟,簡易
2020-09-25,4360,660,733,1393,內惟,簡易
2020-09-26,4360,680,724,1404,內惟,簡易
2020-09-27,4360,608,576,1184,內惟,簡易
2020-09-28,4360,658,675,1333,內惟,簡易
2020-09-29,4360,620,670,1290,內惟,簡易
2020-09-30,4360,692,849,1541,內惟,簡易
2020-10-01,4360,706,660,1366,內惟,簡易
2020-10-02,4360,655,671,1326,內惟,簡易
2020-10-03,4360,653,631,1284,內惟,簡易
2020-10-04,4360,630,599,1229,內惟,簡易
2020-10-05,4360,706,713,1419,內惟,簡易
2020-10-06,4360,676,703,1379,內惟,簡易
2020-10-07,4360,643,658,1301,內惟,簡易
2020-10-08,4360,724,830,1554,內惟,簡易
2020-10-09,4360,675,659,1334,內惟,簡易
2020-10-10,4360,627,578,1205,內惟,簡易
2020-10-11,4360,605,598,1203,內惟,簡易
2020-10-12,4360,674,661,1335,內惟,簡易
2020-10-13,4360,672,697,1369,內惟,簡易
2020-10-14,4360,616,688,1304,內惟,簡易
2020-10-15,4360,644,683,1327,內惟,簡易
2020-10-16,4360,710,823,1533,內惟,簡易
2020-10-17,4360,658,596,1254,內惟,簡易
2020-10-18,4360,607,589,1196,內惟,簡易
2020-10-19,4360,703,654,1357,內惟,簡易
2020-10-20,4360,668,707,1375,內惟,簡易
2020-10-21,4360,636,699,1335,內惟,簡易
2020-10-22,4360,608,656,1264,內惟,簡易
2020-10-23,4360,687,820,1507,內惟,簡易
2020-10-24,4360,657,625,1282,內惟,簡易
2020-10-25,4360,584,613,1197,內惟,簡易
2020-10-26,4360,676,656,1332,內惟,簡易
2020-10-27,4360,661,644,1305,內惟,簡易
2020-10-28,4360,635,664,1299,內惟,簡易
2020-10-29,4360,649,672,1321,內惟,簡易
2020-10-30,4360,687,826,1513,內惟,簡易
2020-10-31,4360,602,637,1239,內惟,簡易
2020-11-01,4360,611,626,1237,內惟,簡易
2020-11-02,4360,663,639,1302,內惟,簡易
2020-11-03,4360,618,651,1269,內惟,簡易
2020-11-04,4360,609,655,1264,內惟,簡易
2020-11-05,4360,592,656,1248,內惟,簡易
2020-11-06,4360,683,823,1506,內惟,簡易
2020-11-07,4360,547,553,1100,內惟,簡易
2020-11-08,4360,563,600,1163,內惟,簡易
2020-11-09,4360,641,621,1262,內惟,簡易
2020-11-10,4360,619,677,1296,內惟,簡易
2020-11-11,4360,607,645,1252,內惟,簡易
2020-11-12,4360,616,680,1296,內惟,簡易
2020-11-13,4360,725,824,1549,內惟,簡易
2020-11-14,4360,683,643,1326,內惟,簡易
2020-11-15,4360,611,624,1235,內惟,簡易
2020-11-16,4360,682,677,1359,內惟,簡易
2020-11-17,4360,646,691,1337,內惟,簡易
2020-11-18,4360,655,661,1316,內惟,簡易
2020-11-19,4360,644,685,1329,內惟,簡易
2020-11-20,4360,738,815,1553,內惟,簡易
2020-11-21,4360,644,666,1310,內惟,簡易
2020-11-22,4360,611,591,1202,內惟,簡易
2020-11-23,4360,695,687,1382,內惟,簡易
2020-11-24,4360,626,689,1315,內惟,簡易
2020-11-25,4360,667,702,1369,內惟,簡易
2020-11-26,4360,634,713,1347,內惟,簡易
2020-11-27,4360,680,776,1456,內惟,簡易
2020-11-28,4360,672,686,1358,內惟,簡易
2020-11-29,4360,640,616,1256,內惟,簡易
2020-11-30,4360,680,646,1326,內惟,簡易
2020-12-01,4360,605,641,1246,內惟,簡易
2020-12-02,4360,621,649,1270,內惟,簡易
2020-12-03,4360,630,707,1337,內惟,簡易
2020-12-04,4360,699,831,1530,內惟,簡易
2020-12-05,4360,664,656,1320,內惟,簡易
2020-12-06,4360,657,613,1270,內惟,簡易
2020-12-07,4360,732,725,1457,內惟,簡易
2020-12-08,4360,637,663,1300,內惟,簡易
2020-12-09,4360,625,668,1293,內惟,簡易
2020-12-10,4360,646,696,1342,內惟,簡易
2020-12-11,4360,715,774,1489,內惟,簡易
2020-12-12,4360,715,633,1348,內惟,簡易
2020-12-13,4360,674,719,1393,內惟,簡易
2020-12-14,4360,690,691,1381,內惟,簡易
2020-12-15,4360,670,699,1369,內惟,簡易
2020-12-16,4360,638,652,1290,內惟,簡易
2020-12-17,4360,648,704,1352,內惟,簡易
2020-12-18,4360,746,838,1584,內惟,簡易
2020-12-19,4360,642,640,1282,內惟,簡易
2020-12-20,4360,610,575,1185,內惟,簡易
2020-12-21,4360,705,694,1399,內惟,簡易
2020-12-22,4360,629,666,1295,內惟,簡易
2020-12-23,4360,645,653,1298,內惟,簡易
2020-12-24,4360,639,677,1316,內惟,簡易
2020-12-25,4360,692,778,1470,內惟,簡易
2020-12-26,4360,704,681,1385,內惟,簡易
2020-12-27,4360,561,571,1132,內惟,簡易
2020-12-28,4360,639,630,1269,內惟,簡易
2020-12-29,4360,598,682,1280,內惟,簡易
2020-12-30,4360,585,648,1233,內惟,簡易
2020-12-31,4360,672,782,1454,內惟,簡易
2020-01-01,4370,928,961,1889,美術館,乙簡
2020-01-02,4370,995,1008,2003,美術館,乙簡
2020-01-03,4370,1025,1058,2083,美術館,乙簡
2020-01-04,4370,1176,1049,2225,美術館,乙簡
2020-01-05,4370,817,785,1602,美術館,乙簡
2020-01-06,4370,1000,948,1948,美術館,乙簡
2020-01-07,4370,1024,906,1930,美術館,乙簡
2020-01-08,4370,1063,971,2034,美術館,乙簡
2020-01-09,4370,1020,992,2012,美術館,乙簡
2020-01-10,4370,1268,1308,2576,美術館,乙簡
2020-01-11,4370,947,881,1828,美術館,乙簡
2020-01-12,4370,899,822,1721,美術館,乙簡
2020-01-13,4370,1048,915,1963,美術館,乙簡
2020-01-14,4370,1057,967,2024,美術館,乙簡
2020-01-15,4370,981,973,1954,美術館,乙簡
2020-01-16,4370,1072,1001,2073,美術館,乙簡
2020-01-17,4370,921,933,1854,美術館,乙簡
2020-01-18,4370,915,939,1854,美術館,乙簡
2020-01-19,4370,911,905,1816,美術館,乙簡
2020-01-20,4370,787,780,1567,美術館,乙簡
2020-01-21,4370,846,814,1660,美術館,乙簡
2020-01-22,4370,877,993,1870,美術館,乙簡
2020-01-23,4370,749,846,1595,美術館,乙簡
2020-01-24,4370,613,538,1151,美術館,乙簡
2020-01-25,4370,867,834,1701,美術館,乙簡
2020-01-26,4370,792,747,1539,美術館,乙簡
2020-01-27,4370,933,1001,1934,美術館,乙簡
2020-01-28,4370,776,773,1549,美術館,乙簡
2020-01-29,4370,689,646,1335,美術館,乙簡
2020-01-30,4370,716,694,1410,美術館,乙簡
2020-01-31,4370,620,686,1306,美術館,乙簡
2020-02-01,4370,604,623,1227,美術館,乙簡
2020-02-02,4370,617,559,1176,美術館,乙簡
2020-02-03,4370,636,577,1213,美術館,乙簡
2020-02-04,4370,628,621,1249,美術館,乙簡
2020-02-05,4370,600,629,1229,美術館,乙簡
2020-02-06,4370,613,663,1276,美術館,乙簡
2020-02-07,4370,718,736,1454,美術館,乙簡
2020-02-08,4370,671,631,1302,美術館,乙簡
2020-02-09,4370,709,666,1375,美術館,乙簡
2020-02-10,4370,647,620,1267,美術館,乙簡
2020-02-11,4370,604,592,1196,美術館,乙簡
2020-02-12,4370,642,626,1268,美術館,乙簡
2020-02-13,4370,660,630,1290,美術館,乙簡
2020-02-14,4370,709,750,1459,美術館,乙簡
2020-02-15,4370,686,662,1348,美術館,乙簡
2020-02-16,4370,632,604,1236,美術館,乙簡
2020-02-17,4370,599,576,1175,美術館,乙簡
2020-02-18,4370,643,603,1246,美術館,乙簡
2020-02-19,4370,625,595,1220,美術館,乙簡
2020-02-20,4370,615,590,1205,美術館,乙簡
2020-02-21,4370,695,763,1458,美術館,乙簡
2020-02-22,4370,621,572,1193,美術館,乙簡
2020-02-23,4370,619,576,1195,美術館,乙簡
2020-02-24,4370,635,641,1276,美術館,乙簡
2020-02-25,4370,901,851,1752,美術館,乙簡
2020-02-26,4370,879,823,1702,美術館,乙簡
2020-02-27,4370,1052,974,2026,美術館,乙簡
2020-02-28,4370,682,687,1369,美術館,乙簡
2020-02-29,4370,591,609,1200,美術館,乙簡
2020-03-01,4370,612,587,1199,美術館,乙簡
2020-03-02,4370,881,784,1665,美術館,乙簡
2020-03-03,4370,838,793,1631,美術館,乙簡
2020-03-04,4370,885,825,1710,美術館,乙簡
2020-03-05,4370,836,786,1622,美術館,乙簡
2020-03-06,4370,981,980,1961,美術館,乙簡
2020-03-07,4370,601,623,1224,美術館,乙簡
2020-03-08,4370,644,598,1242,美術館,乙簡
2020-03-09,4370,918,846,1764,美術館,乙簡
2020-03-10,4370,864,800,1664,美術館,乙簡
2020-03-11,4370,850,805,1655,美術館,乙簡
2020-03-12,4370,834,809,1643,美術館,乙簡
2020-03-13,4370,1003,980,1983,美術館,乙簡
2020-03-14,4370,641,630,1271,美術館,乙簡
2020-03-15,4370,682,629,1311,美術館,乙簡
2020-03-16,4370,856,843,1699,美術館,乙簡
2020-03-17,4370,821,802,1623,美術館,乙簡
2020-03-18,4370,811,810,1621,美術館,乙簡
2020-03-19,4370,821,804,1625,美術館,乙簡
2020-03-20,4370,931,953,1884,美術館,乙簡
2020-03-21,4370,530,573,1103,美術館,乙簡
2020-03-22,4370,550,458,1008,美術館,乙簡
2020-03-23,4370,879,742,1621,美術館,乙簡
2020-03-24,4370,779,724,1503,美術館,乙簡
2020-03-25,4370,804,779,1583,美術館,乙簡
2020-03-26,4370,785,758,1543,美術館,乙簡
2020-03-27,4370,922,907,1829,美術館,乙簡
2020-03-28,4370,482,466,948,美術館,乙簡
2020-03-29,4370,551,491,1042,美術館,乙簡
2020-03-30,4370,828,772,1600,美術館,乙簡
2020-03-31,4370,739,771,1510,美術館,乙簡
2020-04-01,4370,886,902,1788,美術館,乙簡
2020-04-02,4370,508,569,1077,美術館,乙簡
2020-04-03,4370,490,469,959,美術館,乙簡
2020-04-04,4370,409,405,814,美術館,乙簡
2020-04-05,4370,519,451,970,美術館,乙簡
2020-04-06,4370,872,763,1635,美術館,乙簡
2020-04-07,4370,787,687,1474,美術館,乙簡
2020-04-08,4370,736,710,1446,美術館,乙簡
2020-04-09,4370,728,708,1436,美術館,乙簡
2020-04-10,4370,589,657,1246,美術館,乙簡
2020-04-11,4370,560,575,1135,美術館,乙簡
2020-04-12,4370,449,398,847,美術館,乙簡
2020-04-13,4370,779,719,1498,美術館,乙簡
2020-04-14,4370,758,711,1469,美術館,乙簡
2020-04-15,4370,789,754,1543,美術館,乙簡
2020-04-16,4370,731,711,1442,美術館,乙簡
2020-04-17,4370,893,889,1782,美術館,乙簡
2020-04-18,4370,465,501,966,美術館,乙簡
2020-04-19,4370,551,471,1022,美術館,乙簡
2020-04-20,4370,772,689,1461,美術館,乙簡
2020-04-21,4370,735,709,1444,美術館,乙簡
2020-04-22,4370,682,670,1352,美術館,乙簡
2020-04-23,4370,701,686,1387,美術館,乙簡
2020-04-24,4370,838,838,1676,美術館,乙簡
2020-04-25,4370,435,446,881,美術館,乙簡
2020-04-26,4370,416,431,847,美術館,乙簡
2020-04-27,4370,765,752,1517,美術館,乙簡
2020-04-28,4370,739,699,1438,美術館,乙簡
2020-04-29,4370,705,703,1408,美術館,乙簡
2020-04-30,4370,773,772,1545,美術館,乙簡
2020-05-01,4370,827,873,1700,美術館,乙簡
2020-05-02,4370,464,472,936,美術館,乙簡
2020-05-03,4370,514,460,974,美術館,乙簡
2020-05-04,4370,756,717,1473,美術館,乙簡
2020-05-05,4370,759,734,1493,美術館,乙簡
2020-05-06,4370,743,740,1483,美術館,乙簡
2020-05-07,4370,741,735,1476,美術館,乙簡
2020-05-08,4370,912,929,1841,美術館,乙簡
2020-05-09,4370,636,610,1246,美術館,乙簡
2020-05-10,4370,669,600,1269,美術館,乙簡
2020-05-11,4370,806,749,1555,美術館,乙簡
2020-05-12,4370,806,751,1557,美術館,乙簡
2020-05-13,4370,751,768,1519,美術館,乙簡
2020-05-14,4370,790,752,1542,美術館,乙簡
2020-05-15,4370,974,1021,1995,美術館,乙簡
2020-05-16,4370,577,552,1129,美術館,乙簡
2020-05-17,4370,590,566,1156,美術館,乙簡
2020-05-18,4370,840,762,1602,美術館,乙簡
2020-05-19,4370,811,749,1560,美術館,乙簡
2020-05-20,4370,763,755,1518,美術館,乙簡
2020-05-21,4370,809,768,1577,美術館,乙簡
2020-05-22,4370,848,894,1742,美術館,乙簡
2020-05-23,4370,535,517,1052,美術館,乙簡
2020-05-24,4370,673,600,1273,美術館,乙簡
2020-05-25,4370,837,800,1637,美術館,乙簡
2020-05-26,4370,782,789,1571,美術館,乙簡
2020-05-27,4370,746,717,1463,美術館,乙簡
2020-05-28,4370,856,820,1676,美術館,乙簡
2020-05-29,4370,949,970,1919,美術館,乙簡
2020-05-30,4370,761,759,1520,美術館,乙簡
2020-05-31,4370,789,698,1487,美術館,乙簡
2020-06-01,4370,825,796,1621,美術館,乙簡
2020-06-02,4370,842,807,1649,美術館,乙簡
2020-06-03,4370,800,754,1554,美術館,乙簡
2020-06-04,4370,780,805,1585,美術館,乙簡
2020-06-05,4370,958,1052,2010,美術館,乙簡
2020-06-06,4370,760,774,1534,美術館,乙簡
2020-06-07,4370,757,607,1364,美術館,乙簡
2020-06-08,4370,906,781,1687,美術館,乙簡
2020-06-09,4370,842,795,1637,美術館,乙簡
2020-06-10,4370,811,809,1620,美術館,乙簡
2020-06-11,4370,859,823,1682,美術館,乙簡
2020-06-12,4370,987,943,1930,美術館,乙簡
2020-06-13,4370,918,835,1753,美術館,乙簡
2020-06-14,4370,593,631,1224,美術館,乙簡
2020-06-15,4370,840,784,1624,美術館,乙簡
2020-06-16,4370,839,799,1638,美術館,乙簡
2020-06-17,4370,810,757,1567,美術館,乙簡
2020-06-18,4370,782,764,1546,美術館,乙簡
2020-06-19,4370,844,908,1752,美術館,乙簡
2020-06-20,4370,867,815,1682,美術館,乙簡
2020-06-21,4370,653,613,1266,美術館,乙簡
2020-06-22,4370,803,808,1611,美術館,乙簡
2020-06-23,4370,832,841,1673,美術館,乙簡
2020-06-24,4370,949,973,1922,美術館,乙簡
2020-06-25,4370,721,726,1447,美術館,乙簡
2020-06-26,4370,735,771,1506,美術館,乙簡
2020-06-27,4370,737,725,1462,美術館,乙簡
2020-06-28,4370,691,651,1342,美術館,乙簡
2020-06-29,4370,852,759,1611,美術館,乙簡
2020-06-30,4370,825,804,1629,美術館,乙簡
2020-07-01,4370,842,806,1648,美術館,乙簡
2020-07-02,4370,804,792,1596,美術館,乙簡
2020-07-03,4370,956,945,1901,美術館,乙簡
2020-07-04,4370,674,648,1322,美術館,乙簡
2020-07-05,4370,563,599,1162,美術館,乙簡
2020-07-06,4370,877,821,1698,美術館,乙簡
2020-07-07,4370,922,874,1796,美術館,乙簡
2020-07-08,4370,838,807,1645,美術館,乙簡
2020-07-09,4370,819,867,1686,美術館,乙簡
2020-07-10,4370,1038,1027,2065,美術館,乙簡
2020-07-11,4370,631,666,1297,美術館,乙簡
2020-07-12,4370,751,735,1486,美術館,乙簡
2020-07-13,4370,851,833,1684,美術館,乙簡
2020-07-14,4370,978,890,1868,美術館,乙簡
2020-07-15,4370,670,624,1294,美術館,乙簡
2020-07-16,4370,737,730,1467,美術館,乙簡
2020-07-17,4370,988,946,1934,美術館,乙簡
2020-07-18,4370,840,836,1676,美術館,乙簡
2020-07-19,4370,909,848,1757,美術館,乙簡
2020-07-20,4370,947,908,1855,美術館,乙簡
2020-07-21,4370,936,935,1871,美術館,乙簡
2020-07-22,4370,829,764,1593,美術館,乙簡
2020-07-23,4370,700,743,1443,美術館,乙簡
2020-07-24,4370,915,910,1825,美術館,乙簡
2020-07-25,4370,698,696,1394,美術館,乙簡
2020-07-26,4370,698,658,1356,美術館,乙簡
2020-07-27,4370,815,718,1533,美術館,乙簡
2020-07-28,4370,783,740,1523,美術館,乙簡
2020-07-29,4370,812,816,1628,美術館,乙簡
2020-07-30,4370,754,783,1537,美術館,乙簡
2020-07-31,4370,930,968,1898,美術館,乙簡
2020-08-01,4370,968,898,1866,美術館,乙簡
2020-08-02,4370,618,632,1250,美術館,乙簡
2020-08-03,4370,815,785,1600,美術館,乙簡
2020-08-04,4370,860,771,1631,美術館,乙簡
2020-08-05,4370,847,855,1702,美術館,乙簡
2020-08-06,4370,863,859,1722,美術館,乙簡
2020-08-07,4370,931,893,1824,美術館,乙簡
2020-08-08,4370,691,704,1395,美術館,乙簡
2020-08-09,4370,800,805,1605,美術館,乙簡
2020-08-10,4370,877,870,1747,美術館,乙簡
2020-08-11,4370,791,799,1590,美術館,乙簡
2020-08-12,4370,851,830,1681,美術館,乙簡
2020-08-13,4370,946,927,1873,美術館,乙簡
2020-08-14,4370,1097,1092,2189,美術館,乙簡
2020-08-15,4370,908,881,1789,美術館,乙簡
2020-08-16,4370,889,851,1740,美術館,乙簡
2020-08-17,4370,827,816,1643,美術館,乙簡
2020-08-18,4370,872,858,1730,美術館,乙簡
2020-08-19,4370,825,777,1602,美術館,乙簡
2020-08-20,4370,855,840,1695,美術館,乙簡
2020-08-21,4370,1052,1089,2141,美術館,乙簡
2020-08-22,4370,718,685,1403,美術館,乙簡
2020-08-23,4370,684,735,1419,美術館,乙簡
2020-08-24,4370,779,768,1547,美術館,乙簡
2020-08-25,4370,874,868,1742,美術館,乙簡
2020-08-26,4370,773,713,1486,美術館,乙簡
2020-08-27,4370,670,673,1343,美術館,乙簡
2020-08-28,4370,899,897,1796,美術館,乙簡
2020-08-29,4370,614,655,1269,美術館,乙簡
2020-08-30,4370,624,556,1180,美術館,乙簡
2020-08-31,4370,1034,952,1986,美術館,乙簡
2020-09-01,4370,1024,941,1965,美術館,乙簡
2020-09-02,4370,979,946,1925,美術館,乙簡
2020-09-03,4370,1040,970,2010,美術館,乙簡
2020-09-04,4370,1169,1095,2264,美術館,乙簡
2020-09-05,4370,725,734,1459,美術館,乙簡
2020-09-06,4370,720,778,1498,美術館,乙簡
2020-09-07,4370,1035,977,2012,美術館,乙簡
2020-09-08,4370,1065,1006,2071,美術館,乙簡
2020-09-09,4370,1074,984,2058,美術館,乙簡
2020-09-10,4370,1099,1022,2121,美術館,乙簡
2020-09-11,4370,1184,1152,2336,美術館,乙簡
2020-09-12,4370,792,755,1547,美術館,乙簡
2020-09-13,4370,809,791,1600,美術館,乙簡
2020-09-14,4370,1105,1036,2141,美術館,乙簡
2020-09-15,4370,1036,967,2003,美術館,乙簡
2020-09-16,4370,1047,983,2030,美術館,乙簡
2020-09-17,4370,1070,991,2061,美術館,乙簡
2020-09-18,4370,1157,1175,2332,美術館,乙簡
2020-09-19,4370,850,871,1721,美術館,乙簡
2020-09-20,4370,886,818,1704,美術館,乙簡
2020-09-21,4370,1113,1014,2127,美術館,乙簡
2020-09-22,4370,1095,987,2082,美術館,乙簡
2020-09-23,4370,1113,1006,2119,美術館,乙簡
2020-09-24,4370,1067,963,2030,美術館,乙簡
2020-09-25,4370,1179,1121,2300,美術館,乙簡
2020-09-26,4370,1107,1033,2140,美術館,乙簡
2020-09-27,4370,771,798,1569,美術館,乙簡
2020-09-28,4370,1094,1021,2115,美術館,乙簡
2020-09-29,4370,1095,1029,2124,美術館,乙簡
2020-09-30,4370,1207,1283,2490,美術館,乙簡
2020-10-01,4370,963,959,1922,美術館,乙簡
2020-10-02,4370,973,978,1951,美術館,乙簡
2020-10-03,4370,814,893,1707,美術館,乙簡
2020-10-04,4370,906,849,1755,美術館,乙簡
2020-10-05,4370,1151,1004,2155,美術館,乙簡
2020-10-06,4370,1112,1012,2124,美術館,乙簡
2020-10-07,4370,1074,993,2067,美術館,乙簡
2020-10-08,4370,1134,1181,2315,美術館,乙簡
2020-10-09,4370,857,853,1710,美術館,乙簡
2020-10-10,4370,772,738,1510,美術館,乙簡
2020-10-11,4370,752,784,1536,美術館,乙簡
2020-10-12,4370,1053,975,2028,美術館,乙簡
2020-10-13,4370,1062,984,2046,美術館,乙簡
2020-10-14,4370,1051,1008,2059,美術館,乙簡
2020-10-15,4370,1061,989,2050,美術館,乙簡
2020-10-16,4370,1167,1116,2283,美術館,乙簡
2020-10-17,4370,901,848,1749,美術館,乙簡
2020-10-18,4370,760,810,1570,美術館,乙簡
2020-10-19,4370,1068,989,2057,美術館,乙簡
2020-10-20,4370,1054,943,1997,美術館,乙簡
2020-10-21,4370,1030,974,2004,美術館,乙簡
2020-10-22,4370,1060,1021,2081,美術館,乙簡
2020-10-23,4370,1188,1189,2377,美術館,乙簡
2020-10-24,4370,853,813,1666,美術館,乙簡
2020-10-25,4370,812,744,1556,美術館,乙簡
2020-10-26,4370,1115,1021,2136,美術館,乙簡
2020-10-27,4370,1073,1016,2089,美術館,乙簡
2020-10-28,4370,1016,968,1984,美術館,乙簡
2020-10-29,4370,1035,974,2009,美術館,乙簡
2020-10-30,4370,1181,1163,2344,美術館,乙簡
2020-10-31,4370,932,881,1813,美術館,乙簡
2020-11-01,4370,868,849,1717,美術館,乙簡
2020-11-02,4370,1062,975,2037,美術館,乙簡
2020-11-03,4370,1081,1006,2087,美術館,乙簡
2020-11-04,4370,1046,983,2029,美術館,乙簡
2020-11-05,4370,1058,1013,2071,美術館,乙簡
2020-11-06,4370,1176,1149,2325,美術館,乙簡
2020-11-07,4370,784,746,1530,美術館,乙簡
2020-11-08,4370,795,800,1595,美術館,乙簡
2020-11-09,4370,1049,957,2006,美術館,乙簡
2020-11-10,4370,1034,950,1984,美術館,乙簡
2020-11-11,4370,1043,1001,2044,美術館,乙簡
2020-11-12,4370,1096,1055,2151,美術館,乙簡
2020-11-13,4370,1198,1185,2383,美術館,乙簡
2020-11-14,4370,893,880,1773,美術館,乙簡
2020-11-15,4370,946,872,1818,美術館,乙簡
2020-11-16,4370,1076,1003,2079,美術館,乙簡
2020-11-17,4370,1085,1021,2106,美術館,乙簡
2020-11-18,4370,1046,970,2016,美術館,乙簡
2020-11-19,4370,1071,1046,2117,美術館,乙簡
2020-11-20,4370,1216,1247,2463,美術館,乙簡
2020-11-21,4370,867,859,1726,美術館,乙簡
2020-11-22,4370,811,766,1577,美術館,乙簡
2020-11-23,4370,1084,1018,2102,美術館,乙簡
2020-11-24,4370,1084,1009,2093,美術館,乙簡
2020-11-25,4370,1075,1022,2097,美術館,乙簡
2020-11-26,4370,1068,1055,2123,美術館,乙簡
2020-11-27,4370,1259,1243,2502,美術館,乙簡
2020-11-28,4370,944,856,1800,美術館,乙簡
2020-11-29,4370,895,841,1736,美術館,乙簡
2020-11-30,4370,1212,1134,2346,美術館,乙簡
2020-12-01,4370,1034,981,2015,美術館,乙簡
2020-12-02,4370,974,985,1959,美術館,乙簡
2020-12-03,4370,1000,980,1980,美術館,乙簡
2020-12-04,4370,1160,1155,2315,美術館,乙簡
2020-12-05,4370,1108,1098,2206,美術館,乙簡
2020-12-06,4370,881,897,1778,美術館,乙簡
2020-12-07,4370,1091,1013,2104,美術館,乙簡
2020-12-08,4370,1088,960,2048,美術館,乙簡
2020-12-09,4370,1040,950,1990,美術館,乙簡
2020-12-10,4370,1070,999,2069,美術館,乙簡
2020-12-11,4370,1211,1208,2419,美術館,乙簡
2020-12-12,4370,955,865,1820,美術館,乙簡
2020-12-13,4370,844,840,1684,美術館,乙簡
2020-12-14,4370,1096,1068,2164,美術館,乙簡
2020-12-15,4370,1063,1013,2076,美術館,乙簡
2020-12-16,4370,1045,992,2037,美術館,乙簡
2020-12-17,4370,1066,1013,2079,美術館,乙簡
2020-12-18,4370,1233,1206,2439,美術館,乙簡
2020-12-19,4370,1171,1130,2301,美術館,乙簡
2020-12-20,4370,984,904,1888,美術館,乙簡
2020-12-21,4370,951,896,1847,美術館,乙簡
2020-12-22,4370,987,963,1950,美術館,乙簡
2020-12-23,4370,996,945,1941,美術館,乙簡
2020-12-24,4370,996,978,1974,美術館,乙簡
2020-12-25,4370,1215,1117,2332,美術館,乙簡
2020-12-26,4370,787,793,1580,美術館,乙簡
2020-12-27,4370,902,815,1717,美術館,乙簡
2020-12-28,4370,1043,974,2017,美術館,乙簡
2020-12-29,4370,1010,981,1991,美術館,乙簡
2020-12-30,4370,1066,1032,2098,美術館,乙簡
2020-12-31,4370,1164,1216,2380,美術館,乙簡
2020-01-01,4380,217,281,498,鼓山,簡易
2020-01-02,4380,203,206,409,鼓山,簡易
2020-01-03,4380,240,242,482,鼓山,簡易
2020-01-04,4380,193,155,348,鼓山,簡易
2020-01-05,4380,239,270,509,鼓山,簡易
2020-01-06,4380,194,208,402,鼓山,簡易
2020-01-07,4380,212,199,411,鼓山,簡易
2020-01-08,4380,225,240,465,鼓山,簡易
2020-01-09,4380,219,222,441,鼓山,簡易
2020-01-10,4380,332,283,615,鼓山,簡易
2020-01-11,4380,264,242,506,鼓山,簡易
2020-01-12,4380,230,240,470,鼓山,簡易
2020-01-13,4380,225,235,460,鼓山,簡易
2020-01-14,4380,215,224,439,鼓山,簡易
2020-01-15,4380,178,205,383,鼓山,簡易
2020-01-16,4380,214,220,434,鼓山,簡易
2020-01-17,4380,211,220,431,鼓山,簡易
2020-01-18,4380,245,238,483,鼓山,簡易
2020-01-19,4380,172,214,386,鼓山,簡易
2020-01-20,4380,234,212,446,鼓山,簡易
2020-01-21,4380,200,213,413,鼓山,簡易
2020-01-22,4380,220,222,442,鼓山,簡易
2020-01-23,4380,209,193,402,鼓山,簡易
2020-01-24,4380,145,171,316,鼓山,簡易
2020-01-25,4380,277,297,574,鼓山,簡易
2020-01-26,4380,247,252,499,鼓山,簡易
2020-01-27,4380,229,245,474,鼓山,簡易
2020-01-28,4380,187,215,402,鼓山,簡易
2020-01-29,4380,175,193,368,鼓山,簡易
2020-01-30,4380,181,189,370,鼓山,簡易
2020-01-31,4380,195,185,380,鼓山,簡易
2020-02-01,4380,152,148,300,鼓山,簡易
2020-02-02,4380,174,176,350,鼓山,簡易
2020-02-03,4380,184,174,358,鼓山,簡易
2020-02-04,4380,178,171,349,鼓山,簡易
2020-02-05,4380,169,164,333,鼓山,簡易
2020-02-06,4380,174,179,353,鼓山,簡易
2020-02-07,4380,225,203,428,鼓山,簡易
2020-02-08,4380,198,202,400,鼓山,簡易
2020-02-09,4380,183,219,402,鼓山,簡易
2020-02-10,4380,173,190,363,鼓山,簡易
2020-02-11,4380,152,148,300,鼓山,簡易
2020-02-12,4380,170,151,321,鼓山,簡易
2020-02-13,4380,186,192,378,鼓山,簡易
2020-02-14,4380,204,194,398,鼓山,簡易
2020-02-15,4380,175,181,356,鼓山,簡易
2020-02-16,4380,133,176,309,鼓山,簡易
2020-02-17,4380,150,165,315,鼓山,簡易
2020-02-18,4380,178,172,350,鼓山,簡易
2020-02-19,4380,169,188,357,鼓山,簡易
2020-02-20,4380,180,182,362,鼓山,簡易
2020-02-21,4380,215,189,404,鼓山,簡易
2020-02-22,4380,156,162,318,鼓山,簡易
2020-02-23,4380,156,197,353,鼓山,簡易
2020-02-24,4380,178,208,386,鼓山,簡易
2020-02-25,4380,179,182,361,鼓山,簡易
2020-02-26,4380,186,200,386,鼓山,簡易
2020-02-27,4380,241,221,462,鼓山,簡易
2020-02-28,4380,197,175,372,鼓山,簡易
2020-02-29,4380,134,162,296,鼓山,簡易
2020-03-01,4380,168,228,396,鼓山,簡易
2020-03-02,4380,176,197,373,鼓山,簡易
2020-03-03,4380,168,177,345,鼓山,簡易
2020-03-04,4380,180,187,367,鼓山,簡易
2020-03-05,4380,183,185,368,鼓山,簡易
2020-03-06,4380,252,238,490,鼓山,簡易
2020-03-07,4380,194,186,380,鼓山,簡易
2020-03-08,4380,179,230,409,鼓山,簡易
2020-03-09,4380,201,214,415,鼓山,簡易
2020-03-10,4380,175,180,355,鼓山,簡易
2020-03-11,4380,186,201,387,鼓山,簡易
2020-03-12,4380,193,190,383,鼓山,簡易
2020-03-13,4380,252,237,489,鼓山,簡易
2020-03-14,4380,180,145,325,鼓山,簡易
2020-03-15,4380,179,256,435,鼓山,簡易
2020-03-16,4380,181,223,404,鼓山,簡易
2020-03-17,4380,181,171,352,鼓山,簡易
2020-03-18,4380,144,159,303,鼓山,簡易
2020-03-19,4380,178,199,377,鼓山,簡易
2020-03-20,4380,235,206,441,鼓山,簡易
2020-03-21,4380,144,171,315,鼓山,簡易
2020-03-22,4380,174,178,352,鼓山,簡易
2020-03-23,4380,161,189,350,鼓山,簡易
2020-03-24,4380,163,172,335,鼓山,簡易
2020-03-25,4380,160,163,323,鼓山,簡易
2020-03-26,4380,156,184,340,鼓山,簡易
2020-03-27,4380,221,209,430,鼓山,簡易
2020-03-28,4380,134,130,264,鼓山,簡易
2020-03-29,4380,155,176,331,鼓山,簡易
2020-03-30,4380,161,186,347,鼓山,簡易
2020-03-31,4380,163,163,326,鼓山,簡易
2020-04-01,4380,232,210,442,鼓山,簡易
2020-04-02,4380,169,140,309,鼓山,簡易
2020-04-03,4380,122,108,230,鼓山,簡易
2020-04-04,4380,116,149,265,鼓山,簡易
2020-04-05,4380,163,219,382,鼓山,簡易
2020-04-06,4380,163,182,345,鼓山,簡易
2020-04-07,4380,139,139,278,鼓山,簡易
2020-04-08,4380,145,145,290,鼓山,簡易
2020-04-09,4380,153,173,326,鼓山,簡易
2020-04-10,4380,144,124,268,鼓山,簡易
2020-04-11,4380,111,102,213,鼓山,簡易
2020-04-12,4380,160,164,324,鼓山,簡易
2020-04-13,4380,151,157,308,鼓山,簡易
2020-04-14,4380,145,144,289,鼓山,簡易
2020-04-15,4380,156,165,321,鼓山,簡易
2020-04-16,4380,169,180,349,鼓山,簡易
2020-04-17,4380,230,199,429,鼓山,簡易
2020-04-18,4380,126,110,236,鼓山,簡易
2020-04-19,4380,145,184,329,鼓山,簡易
2020-04-20,4380,153,175,328,鼓山,簡易
2020-04-21,4380,130,142,272,鼓山,簡易
2020-04-22,4380,128,141,269,鼓山,簡易
2020-04-23,4380,126,145,271,鼓山,簡易
2020-04-24,4380,200,191,391,鼓山,簡易
2020-04-25,4380,117,97,214,鼓山,簡易
2020-04-26,4380,118,159,277,鼓山,簡易
2020-04-27,4380,153,193,346,鼓山,簡易
2020-04-28,4380,148,159,307,鼓山,簡易
2020-04-29,4380,139,138,277,鼓山,簡易
2020-04-30,4380,176,173,349,鼓山,簡易
2020-05-01,4380,192,173,365,鼓山,簡易
2020-05-02,4380,133,131,264,鼓山,簡易
2020-05-03,4380,159,191,350,鼓山,簡易
2020-05-04,4380,181,188,369,鼓山,簡易
2020-05-05,4380,156,159,315,鼓山,簡易
2020-05-06,4380,135,151,286,鼓山,簡易
2020-05-07,4380,173,187,360,鼓山,簡易
2020-05-08,4380,253,218,471,鼓山,簡易
2020-05-09,4380,194,171,365,鼓山,簡易
2020-05-10,4380,165,211,376,鼓山,簡易
2020-05-11,4380,168,209,377,鼓山,簡易
2020-05-12,4380,157,176,333,鼓山,簡易
2020-05-13,4380,157,162,319,鼓山,簡易
2020-05-14,4380,170,190,360,鼓山,簡易
2020-05-15,4380,221,227,448,鼓山,簡易
2020-05-16,4380,110,109,219,鼓山,簡易
2020-05-17,4380,134,206,340,鼓山,簡易
2020-05-18,4380,163,182,345,鼓山,簡易
2020-05-19,4380,149,185,334,鼓山,簡易
2020-05-20,4380,160,167,327,鼓山,簡易
2020-05-21,4380,141,176,317,鼓山,簡易
2020-05-22,4380,181,162,343,鼓山,簡易
2020-05-23,4380,137,121,258,鼓山,簡易
2020-05-24,4380,137,174,311,鼓山,簡易
2020-05-25,4380,163,186,349,鼓山,簡易
2020-05-26,4380,161,173,334,鼓山,簡易
2020-05-27,4380,138,130,268,鼓山,簡易
2020-05-28,4380,164,202,366,鼓山,簡易
2020-05-29,4380,233,220,453,鼓山,簡易
2020-05-30,4380,189,171,360,鼓山,簡易
2020-05-31,4380,182,218,400,鼓山,簡易
2020-06-01,4380,176,196,372,鼓山,簡易
2020-06-02,4380,186,185,371,鼓山,簡易
2020-06-03,4380,195,206,401,鼓山,簡易
2020-06-04,4380,171,202,373,鼓山,簡易
2020-06-05,4380,230,257,487,鼓山,簡易
2020-06-06,4380,206,209,415,鼓山,簡易
2020-06-07,4380,237,250,487,鼓山,簡易
2020-06-08,4380,187,196,383,鼓山,簡易
2020-06-09,4380,165,186,351,鼓山,簡易
2020-06-10,4380,182,193,375,鼓山,簡易
2020-06-11,4380,201,213,414,鼓山,簡易
2020-06-12,4380,217,221,438,鼓山,簡易
2020-06-13,4380,200,176,376,鼓山,簡易
2020-06-14,4380,191,238,429,鼓山,簡易
2020-06-15,4380,188,216,404,鼓山,簡易
2020-06-16,4380,174,184,358,鼓山,簡易
2020-06-17,4380,171,196,367,鼓山,簡易
2020-06-18,4380,176,183,359,鼓山,簡易
2020-06-19,4380,218,214,432,鼓山,簡易
2020-06-20,4380,174,152,326,鼓山,簡易
2020-06-21,4380,179,204,383,鼓山,簡易
2020-06-22,4380,186,202,388,鼓山,簡易
2020-06-23,4380,186,194,380,鼓山,簡易
2020-06-24,4380,250,255,505,鼓山,簡易
2020-06-25,4380,217,188,405,鼓山,簡易
2020-06-26,4380,186,192,378,鼓山,簡易
2020-06-27,4380,214,190,404,鼓山,簡易
2020-06-28,4380,190,218,408,鼓山,簡易
2020-06-29,4380,188,207,395,鼓山,簡易
2020-06-30,4380,188,207,395,鼓山,簡易
2020-07-01,4380,185,201,386,鼓山,簡易
2020-07-02,4380,170,181,351,鼓山,簡易
2020-07-03,4380,240,226,466,鼓山,簡易
2020-07-04,4380,169,160,329,鼓山,簡易
2020-07-05,4380,139,201,340,鼓山,簡易
2020-07-06,4380,191,210,401,鼓山,簡易
2020-07-07,4380,186,185,371,鼓山,簡易
2020-07-08,4380,176,190,366,鼓山,簡易
2020-07-09,4380,188,189,377,鼓山,簡易
2020-07-10,4380,230,221,451,鼓山,簡易
2020-07-11,4380,177,197,374,鼓山,簡易
2020-07-12,4380,166,214,380,鼓山,簡易
2020-07-13,4380,188,204,392,鼓山,簡易
2020-07-14,4380,205,196,401,鼓山,簡易
2020-07-15,4380,162,190,352,鼓山,簡易
2020-07-16,4380,191,183,374,鼓山,簡易
2020-07-17,4380,211,200,411,鼓山,簡易
2020-07-18,4380,244,224,468,鼓山,簡易
2020-07-19,4380,180,214,394,鼓山,簡易
2020-07-20,4380,198,215,413,鼓山,簡易
2020-07-21,4380,178,180,358,鼓山,簡易
2020-07-22,4380,200,196,396,鼓山,簡易
2020-07-23,4380,181,201,382,鼓山,簡易
2020-07-24,4380,245,220,465,鼓山,簡易
2020-07-25,4380,196,177,373,鼓山,簡易
2020-07-26,4380,169,209,378,鼓山,簡易
2020-07-27,4380,171,210,381,鼓山,簡易
2020-07-28,4380,194,197,391,鼓山,簡易
2020-07-29,4380,183,191,374,鼓山,簡易
2020-07-30,4380,196,198,394,鼓山,簡易
2020-07-31,4380,237,213,450,鼓山,簡易
2020-08-01,4380,173,173,346,鼓山,簡易
2020-08-02,4380,169,204,373,鼓山,簡易
2020-08-03,4380,168,196,364,鼓山,簡易
2020-08-04,4380,173,172,345,鼓山,簡易
2020-08-05,4380,194,196,390,鼓山,簡易
2020-08-06,4380,198,210,408,鼓山,簡易
2020-08-07,4380,251,213,464,鼓山,簡易
2020-08-08,4380,187,191,378,鼓山,簡易
2020-08-09,4380,192,228,420,鼓山,簡易
2020-08-10,4380,197,212,409,鼓山,簡易
2020-08-11,4380,184,201,385,鼓山,簡易
2020-08-12,4380,194,199,393,鼓山,簡易
2020-08-13,4380,187,218,405,鼓山,簡易
2020-08-14,4380,264,246,510,鼓山,簡易
2020-08-15,4380,258,226,484,鼓山,簡易
2020-08-16,4380,195,245,440,鼓山,簡易
2020-08-17,4380,212,228,440,鼓山,簡易
2020-08-18,4380,200,222,422,鼓山,簡易
2020-08-19,4380,211,212,423,鼓山,簡易
2020-08-20,4380,231,214,445,鼓山,簡易
2020-08-21,4380,245,228,473,鼓山,簡易
2020-08-22,4380,176,180,356,鼓山,簡易
2020-08-23,4380,178,212,390,鼓山,簡易
2020-08-24,4380,199,191,390,鼓山,簡易
2020-08-25,4380,198,205,403,鼓山,簡易
2020-08-26,4380,168,189,357,鼓山,簡易
2020-08-27,4380,154,178,332,鼓山,簡易
2020-08-28,4380,259,193,452,鼓山,簡易
2020-08-29,4380,192,200,392,鼓山,簡易
2020-08-30,4380,151,179,330,鼓山,簡易
2020-08-31,4380,186,212,398,鼓山,簡易
2020-09-01,4380,185,198,383,鼓山,簡易
2020-09-02,4380,202,215,417,鼓山,簡易
2020-09-03,4380,181,187,368,鼓山,簡易
2020-09-04,4380,240,228,468,鼓山,簡易
2020-09-05,4380,235,221,456,鼓山,簡易
2020-09-06,4380,189,211,400,鼓山,簡易
2020-09-07,4380,212,226,438,鼓山,簡易
2020-09-08,4380,180,178,358,鼓山,簡易
2020-09-09,4380,197,214,411,鼓山,簡易
2020-09-10,4380,204,190,394,鼓山,簡易
2020-09-11,4380,285,252,537,鼓山,簡易
2020-09-12,4380,206,184,390,鼓山,簡易
2020-09-13,4380,217,271,488,鼓山,簡易
2020-09-14,4380,212,226,438,鼓山,簡易
2020-09-15,4380,207,214,421,鼓山,簡易
2020-09-16,4380,203,200,403,鼓山,簡易
2020-09-17,4380,204,212,416,鼓山,簡易
2020-09-18,4380,277,257,534,鼓山,簡易
2020-09-19,4380,185,183,368,鼓山,簡易
2020-09-20,4380,231,260,491,鼓山,簡易
2020-09-21,4380,220,241,461,鼓山,簡易
2020-09-22,4380,201,213,414,鼓山,簡易
2020-09-23,4380,193,211,404,鼓山,簡易
2020-09-24,4380,211,246,457,鼓山,簡易
2020-09-25,4380,247,243,490,鼓山,簡易
2020-09-26,4380,225,230,455,鼓山,簡易
2020-09-27,4380,193,200,393,鼓山,簡易
2020-09-28,4380,211,201,412,鼓山,簡易
2020-09-29,4380,199,211,410,鼓山,簡易
2020-09-30,4380,314,302,616,鼓山,簡易
2020-10-01,4380,284,229,513,鼓山,簡易
2020-10-02,4380,246,249,495,鼓山,簡易
2020-10-03,4380,205,213,418,鼓山,簡易
2020-10-04,4380,206,307,513,鼓山,簡易
2020-10-05,4380,225,242,467,鼓山,簡易
2020-10-06,4380,210,220,430,鼓山,簡易
2020-10-07,4380,214,220,434,鼓山,簡易
2020-10-08,4380,302,279,581,鼓山,簡易
2020-10-09,4380,236,262,498,鼓山,簡易
2020-10-10,4380,202,192,394,鼓山,簡易
2020-10-11,4380,182,243,425,鼓山,簡易
2020-10-12,4380,199,217,416,鼓山,簡易
2020-10-13,4380,226,240,466,鼓山,簡易
2020-10-14,4380,213,216,429,鼓山,簡易
2020-10-15,4380,204,197,401,鼓山,簡易
2020-10-16,4380,264,270,534,鼓山,簡易
2020-10-17,4380,209,203,412,鼓山,簡易
2020-10-18,4380,213,220,433,鼓山,簡易
2020-10-19,4380,238,241,479,鼓山,簡易
2020-10-20,4380,224,226,450,鼓山,簡易
2020-10-21,4380,200,203,403,鼓山,簡易
2020-10-22,4380,232,236,468,鼓山,簡易
2020-10-23,4380,299,280,579,鼓山,簡易
2020-10-24,4380,210,217,427,鼓山,簡易
2020-10-25,4380,250,297,547,鼓山,簡易
2020-10-26,4380,227,237,464,鼓山,簡易
2020-10-27,4380,209,222,431,鼓山,簡易
2020-10-28,4380,199,212,411,鼓山,簡易
2020-10-29,4380,242,254,496,鼓山,簡易
2020-10-30,4380,277,270,547,鼓山,簡易
2020-10-31,4380,226,234,460,鼓山,簡易
2020-11-01,4380,212,247,459,鼓山,簡易
2020-11-02,4380,229,251,480,鼓山,簡易
2020-11-03,4380,208,212,420,鼓山,簡易
2020-11-04,4380,226,233,459,鼓山,簡易
2020-11-05,4380,250,232,482,鼓山,簡易
2020-11-06,4380,273,269,542,鼓山,簡易
2020-11-07,4380,194,211,405,鼓山,簡易
2020-11-08,4380,224,235,459,鼓山,簡易
2020-11-09,4380,223,226,449,鼓山,簡易
2020-11-10,4380,211,206,417,鼓山,簡易
2020-11-11,4380,220,236,456,鼓山,簡易
2020-11-12,4380,237,232,469,鼓山,簡易
2020-11-13,4380,291,268,559,鼓山,簡易
2020-11-14,4380,221,227,448,鼓山,簡易
2020-11-15,4380,250,279,529,鼓山,簡易
2020-11-16,4380,226,234,460,鼓山,簡易
2020-11-17,4380,225,230,455,鼓山,簡易
2020-11-18,4380,212,211,423,鼓山,簡易
2020-11-19,4380,202,219,421,鼓山,簡易
2020-11-20,4380,292,246,538,鼓山,簡易
2020-11-21,4380,242,209,451,鼓山,簡易
2020-11-22,4380,207,291,498,鼓山,簡易
2020-11-23,4380,232,253,485,鼓山,簡易
2020-11-24,4380,208,201,409,鼓山,簡易
2020-11-25,4380,211,219,430,鼓山,簡易
2020-11-26,4380,243,236,479,鼓山,簡易
2020-11-27,4380,325,316,641,鼓山,簡易
2020-11-28,4380,218,233,451,鼓山,簡易
2020-11-29,4380,209,265,474,鼓山,簡易
2020-11-30,4380,226,230,456,鼓山,簡易
2020-12-01,4380,193,182,375,鼓山,簡易
2020-12-02,4380,195,197,392,鼓山,簡易
2020-12-03,4380,231,242,473,鼓山,簡易
2020-12-04,4380,292,269,561,鼓山,簡易
2020-12-05,4380,241,242,483,鼓山,簡易
2020-12-06,4380,220,268,488,鼓山,簡易
2020-12-07,4380,242,244,486,鼓山,簡易
2020-12-08,4380,203,210,413,鼓山,簡易
2020-12-09,4380,213,224,437,鼓山,簡易
2020-12-10,4380,247,244,491,鼓山,簡易
2020-12-11,4380,289,271,560,鼓山,簡易
2020-12-12,4380,267,252,519,鼓山,簡易
2020-12-13,4380,244,304,548,鼓山,簡易
2020-12-14,4380,240,258,498,鼓山,簡易
2020-12-15,4380,201,203,404,鼓山,簡易
2020-12-16,4380,221,198,419,鼓山,簡易
2020-12-17,4380,232,234,466,鼓山,簡易
2020-12-18,4380,297,306,603,鼓山,簡易
2020-12-19,4380,246,205,451,鼓山,簡易
2020-12-20,4380,236,307,543,鼓山,簡易
2020-12-21,4380,227,241,468,鼓山,簡易
2020-12-22,4380,215,222,437,鼓山,簡易
2020-12-23,4380,211,207,418,鼓山,簡易
2020-12-24,4380,196,228,424,鼓山,簡易
2020-12-25,4380,290,258,548,鼓山,簡易
2020-12-26,4380,264,256,520,鼓山,簡易
2020-12-27,4380,215,259,474,鼓山,簡易
2020-12-28,4380,227,224,451,鼓山,簡易
2020-12-29,4380,181,205,386,鼓山,簡易
2020-12-30,4380,203,200,403,鼓山,簡易
2020-12-31,4380,274,285,559,鼓山,簡易
2020-01-01,4390,473,471,944,三塊厝,簡易
2020-01-02,4390,514,588,1102,三塊厝,簡易
2020-01-03,4390,541,602,1143,三塊厝,簡易
2020-01-04,4390,511,491,1002,三塊厝,簡易
2020-01-05,4390,439,397,836,三塊厝,簡易
2020-01-06,4390,499,544,1043,三塊厝,簡易
2020-01-07,4390,559,612,1171,三塊厝,簡易
2020-01-08,4390,514,582,1096,三塊厝,簡易
2020-01-09,4390,520,609,1129,三塊厝,簡易
2020-01-10,4390,571,691,1262,三塊厝,簡易
2020-01-11,4390,633,616,1249,三塊厝,簡易
2020-01-12,4390,601,541,1142,三塊厝,簡易
2020-01-13,4390,603,614,1217,三塊厝,簡易
2020-01-14,4390,644,687,1331,三塊厝,簡易
2020-01-15,4390,551,638,1189,三塊厝,簡易
2020-01-16,4390,598,632,1230,三塊厝,簡易
2020-01-17,4390,612,578,1190,三塊厝,簡易
2020-01-18,4390,698,726,1424,三塊厝,簡易
2020-01-19,4390,794,807,1601,三塊厝,簡易
2020-01-20,4390,587,580,1167,三塊厝,簡易
2020-01-21,4390,590,715,1305,三塊厝,簡易
2020-01-22,4390,641,657,1298,三塊厝,簡易
2020-01-23,4390,573,623,1196,三塊厝,簡易
2020-01-24,4390,364,344,708,三塊厝,簡易
2020-01-25,4390,429,454,883,三塊厝,簡易
2020-01-26,4390,420,363,783,三塊厝,簡易
2020-01-27,4390,475,454,929,三塊厝,簡易
2020-01-28,4390,288,315,603,三塊厝,簡易
2020-01-29,4390,392,352,744,三塊厝,簡易
2020-01-30,4390,411,410,821,三塊厝,簡易
2020-01-31,4390,373,406,779,三塊厝,簡易
2020-02-01,4390,361,331,692,三塊厝,簡易
2020-02-02,4390,306,307,613,三塊厝,簡易
2020-02-03,4390,380,403,783,三塊厝,簡易
2020-02-04,4390,403,428,831,三塊厝,簡易
2020-02-05,4390,366,405,771,三塊厝,簡易
2020-02-06,4390,399,393,792,三塊厝,簡易
2020-02-07,4390,412,407,819,三塊厝,簡易
2020-02-08,4390,305,313,618,三塊厝,簡易
2020-02-09,4390,282,286,568,三塊厝,簡易
2020-02-10,4390,403,405,808,三塊厝,簡易
2020-02-11,4390,370,366,736,三塊厝,簡易
2020-02-12,4390,356,380,736,三塊厝,簡易
2020-02-13,4390,400,384,784,三塊厝,簡易
2020-02-14,4390,376,390,766,三塊厝,簡易
2020-02-15,4390,339,336,675,三塊厝,簡易
2020-02-16,4390,275,316,591,三塊厝,簡易
2020-02-17,4390,355,374,729,三塊厝,簡易
2020-02-18,4390,369,388,757,三塊厝,簡易
2020-02-19,4390,396,387,783,三塊厝,簡易
2020-02-20,4390,373,409,782,三塊厝,簡易
2020-02-21,4390,405,416,821,三塊厝,簡易
2020-02-22,4390,299,323,622,三塊厝,簡易
2020-02-23,4390,271,273,544,三塊厝,簡易
2020-02-24,4390,364,408,772,三塊厝,簡易
2020-02-25,4390,419,510,929,三塊厝,簡易
2020-02-26,4390,412,495,907,三塊厝,簡易
2020-02-27,4390,457,522,979,三塊厝,簡易
2020-02-28,4390,317,315,632,三塊厝,簡易
2020-02-29,4390,268,272,540,三塊厝,簡易
2020-03-01,4390,259,281,540,三塊厝,簡易
2020-03-02,4390,455,517,972,三塊厝,簡易
2020-03-03,4390,422,493,915,三塊厝,簡易
2020-03-04,4390,424,508,932,三塊厝,簡易
2020-03-05,4390,412,478,890,三塊厝,簡易
2020-03-06,4390,469,564,1033,三塊厝,簡易
2020-03-07,4390,297,273,570,三塊厝,簡易
2020-03-08,4390,300,305,605,三塊厝,簡易
2020-03-09,4390,474,506,980,三塊厝,簡易
2020-03-10,4390,439,490,929,三塊厝,簡易
2020-03-11,4390,467,535,1002,三塊厝,簡易
2020-03-12,4390,428,485,913,三塊厝,簡易
2020-03-13,4390,483,573,1056,三塊厝,簡易
2020-03-14,4390,281,275,556,三塊厝,簡易
2020-03-15,4390,297,295,592,三塊厝,簡易
2020-03-16,4390,449,503,952,三塊厝,簡易
2020-03-17,4390,439,475,914,三塊厝,簡易
2020-03-18,4390,441,503,944,三塊厝,簡易
2020-03-19,4390,418,480,898,三塊厝,簡易
2020-03-20,4390,494,512,1006,三塊厝,簡易
2020-03-21,4390,273,261,534,三塊厝,簡易
2020-03-22,4390,261,241,502,三塊厝,簡易
2020-03-23,4390,414,486,900,三塊厝,簡易
2020-03-24,4390,420,471,891,三塊厝,簡易
2020-03-25,4390,412,475,887,三塊厝,簡易
2020-03-26,4390,443,469,912,三塊厝,簡易
2020-03-27,4390,456,537,993,三塊厝,簡易
2020-03-28,4390,271,247,518,三塊厝,簡易
2020-03-29,4390,242,232,474,三塊厝,簡易
2020-03-30,4390,421,459,880,三塊厝,簡易
2020-03-31,4390,394,476,870,三塊厝,簡易
2020-04-01,4390,422,536,958,三塊厝,簡易
2020-04-02,4390,285,282,567,三塊厝,簡易
2020-04-03,4390,251,246,497,三塊厝,簡易
2020-04-04,4390,186,185,371,三塊厝,簡易
2020-04-05,4390,218,200,418,三塊厝,簡易
2020-04-06,4390,444,463,907,三塊厝,簡易
2020-04-07,4390,392,437,829,三塊厝,簡易
2020-04-08,4390,372,431,803,三塊厝,簡易
2020-04-09,4390,422,458,880,三塊厝,簡易
2020-04-10,4390,355,373,728,三塊厝,簡易
2020-04-11,4390,197,234,431,三塊厝,簡易
2020-04-12,4390,225,184,409,三塊厝,簡易
2020-04-13,4390,380,422,802,三塊厝,簡易
2020-04-14,4390,396,426,822,三塊厝,簡易
2020-04-15,4390,403,453,856,三塊厝,簡易
2020-04-16,4390,433,450,883,三塊厝,簡易
2020-04-17,4390,448,481,929,三塊厝,簡易
2020-04-18,4390,277,268,545,三塊厝,簡易
2020-04-19,4390,261,244,505,三塊厝,簡易
2020-04-20,4390,380,449,829,三塊厝,簡易
2020-04-21,4390,359,392,751,三塊厝,簡易
2020-04-22,4390,354,421,775,三塊厝,簡易
2020-04-23,4390,385,409,794,三塊厝,簡易
2020-04-24,4390,376,438,814,三塊厝,簡易
2020-04-25,4390,218,211,429,三塊厝,簡易
2020-04-26,4390,216,193,409,三塊厝,簡易
2020-04-27,4390,375,425,800,三塊厝,簡易
2020-04-28,4390,354,401,755,三塊厝,簡易
2020-04-29,4390,356,420,776,三塊厝,簡易
2020-04-30,4390,380,433,813,三塊厝,簡易
2020-05-01,4390,364,388,752,三塊厝,簡易
2020-05-02,4390,237,217,454,三塊厝,簡易
2020-05-03,4390,216,223,439,三塊厝,簡易
2020-05-04,4390,375,448,823,三塊厝,簡易
2020-05-05,4390,402,437,839,三塊厝,簡易
2020-05-06,4390,426,454,880,三塊厝,簡易
2020-05-07,4390,416,452,868,三塊厝,簡易
2020-05-08,4390,434,522,956,三塊厝,簡易
2020-05-09,4390,260,232,492,三塊厝,簡易
2020-05-10,4390,242,234,476,三塊厝,簡易
2020-05-11,4390,396,450,846,三塊厝,簡易
2020-05-12,4390,413,461,874,三塊厝,簡易
2020-05-13,4390,367,470,837,三塊厝,簡易
2020-05-14,4390,437,480,917,三塊厝,簡易
2020-05-15,4390,414,502,916,三塊厝,簡易
2020-05-16,4390,255,245,500,三塊厝,簡易
2020-05-17,4390,304,267,571,三塊厝,簡易
2020-05-18,4390,413,458,871,三塊厝,簡易
2020-05-19,4390,410,473,883,三塊厝,簡易
2020-05-20,4390,376,440,816,三塊厝,簡易
2020-05-21,4390,395,447,842,三塊厝,簡易
2020-05-22,4390,376,411,787,三塊厝,簡易
2020-05-23,4390,222,217,439,三塊厝,簡易
2020-05-24,4390,234,231,465,三塊厝,簡易
2020-05-25,4390,405,440,845,三塊厝,簡易
2020-05-26,4390,392,451,843,三塊厝,簡易
2020-05-27,4390,390,445,835,三塊厝,簡易
2020-05-28,4390,385,443,828,三塊厝,簡易
2020-05-29,4390,449,506,955,三塊厝,簡易
2020-05-30,4390,318,297,615,三塊厝,簡易
2020-05-31,4390,278,265,543,三塊厝,簡易
2020-06-01,4390,424,470,894,三塊厝,簡易
2020-06-02,4390,415,473,888,三塊厝,簡易
2020-06-03,4390,398,471,869,三塊厝,簡易
2020-06-04,4390,405,465,870,三塊厝,簡易
2020-06-05,4390,442,571,1013,三塊厝,簡易
2020-06-06,4390,323,355,678,三塊厝,簡易
2020-06-07,4390,319,291,610,三塊厝,簡易
2020-06-08,4390,441,452,893,三塊厝,簡易
2020-06-09,4390,412,455,867,三塊厝,簡易
2020-06-10,4390,412,466,878,三塊厝,簡易
2020-06-11,4390,436,496,932,三塊厝,簡易
2020-06-12,4390,451,521,972,三塊厝,簡易
2020-06-13,4390,318,309,627,三塊厝,簡易
2020-06-14,4390,300,316,616,三塊厝,簡易
2020-06-15,4390,424,470,894,三塊厝,簡易
2020-06-16,4390,424,487,911,三塊厝,簡易
2020-06-17,4390,400,472,872,三塊厝,簡易
2020-06-18,4390,418,452,870,三塊厝,簡易
2020-06-19,4390,418,492,910,三塊厝,簡易
2020-06-20,4390,356,406,762,三塊厝,簡易
2020-06-21,4390,263,270,533,三塊厝,簡易
2020-06-22,4390,438,475,913,三塊厝,簡易
2020-06-23,4390,406,480,886,三塊厝,簡易
2020-06-24,4390,460,531,991,三塊厝,簡易
2020-06-25,4390,349,382,731,三塊厝,簡易
2020-06-26,4390,361,374,735,三塊厝,簡易
2020-06-27,4390,300,299,599,三塊厝,簡易
2020-06-28,4390,304,309,613,三塊厝,簡易
2020-06-29,4390,393,440,833,三塊厝,簡易
2020-06-30,4390,388,436,824,三塊厝,簡易
2020-07-01,4390,418,462,880,三塊厝,簡易
2020-07-02,4390,396,431,827,三塊厝,簡易
2020-07-03,4390,444,481,925,三塊厝,簡易
2020-07-04,4390,333,324,657,三塊厝,簡易
2020-07-05,4390,233,302,535,三塊厝,簡易
2020-07-06,4390,407,466,873,三塊厝,簡易
2020-07-07,4390,434,428,862,三塊厝,簡易
2020-07-08,4390,421,450,871,三塊厝,簡易
2020-07-09,4390,404,426,830,三塊厝,簡易
2020-07-10,4390,452,503,955,三塊厝,簡易
2020-07-11,4390,295,315,610,三塊厝,簡易
2020-07-12,4390,285,277,562,三塊厝,簡易
2020-07-13,4390,374,453,827,三塊厝,簡易
2020-07-14,4390,432,503,935,三塊厝,簡易
2020-07-15,4390,364,395,759,三塊厝,簡易
2020-07-16,4390,416,416,832,三塊厝,簡易
2020-07-17,4390,438,480,918,三塊厝,簡易
2020-07-18,4390,335,333,668,三塊厝,簡易
2020-07-19,4390,306,332,638,三塊厝,簡易
2020-07-20,4390,393,424,817,三塊厝,簡易
2020-07-21,4390,432,448,880,三塊厝,簡易
2020-07-22,4390,439,486,925,三塊厝,簡易
2020-07-23,4390,405,457,862,三塊厝,簡易
2020-07-24,4390,460,473,933,三塊厝,簡易
2020-07-25,4390,366,333,699,三塊厝,簡易
2020-07-26,4390,288,295,583,三塊厝,簡易
2020-07-27,4390,415,453,868,三塊厝,簡易
2020-07-28,4390,387,406,793,三塊厝,簡易
2020-07-29,4390,413,469,882,三塊厝,簡易
2020-07-30,4390,376,424,800,三塊厝,簡易
2020-07-31,4390,399,468,867,三塊厝,簡易
2020-08-01,4390,327,322,649,三塊厝,簡易
2020-08-02,4390,258,258,516,三塊厝,簡易
2020-08-03,4390,332,366,698,三塊厝,簡易
2020-08-04,4390,395,420,815,三塊厝,簡易
2020-08-05,4390,377,427,804,三塊厝,簡易
2020-08-06,4390,368,418,786,三塊厝,簡易
2020-08-07,4390,394,460,854,三塊厝,簡易
2020-08-08,4390,365,364,729,三塊厝,簡易
2020-08-09,4390,266,314,580,三塊厝,簡易
2020-08-10,4390,388,445,833,三塊厝,簡易
2020-08-11,4390,361,374,735,三塊厝,簡易
2020-08-12,4390,405,444,849,三塊厝,簡易
2020-08-13,4390,399,418,817,三塊厝,簡易
2020-08-14,4390,377,480,857,三塊厝,簡易
2020-08-15,4390,377,364,741,三塊厝,簡易
2020-08-16,4390,373,336,709,三塊厝,簡易
2020-08-17,4390,394,419,813,三塊厝,簡易
2020-08-18,4390,407,416,823,三塊厝,簡易
2020-08-19,4390,372,412,784,三塊厝,簡易
2020-08-20,4390,388,395,783,三塊厝,簡易
2020-08-21,4390,407,437,844,三塊厝,簡易
2020-08-22,4390,371,309,680,三塊厝,簡易
2020-08-23,4390,279,327,606,三塊厝,簡易
2020-08-24,4390,384,440,824,三塊厝,簡易
2020-08-25,4390,409,408,817,三塊厝,簡易
2020-08-26,4390,316,365,681,三塊厝,簡易
2020-08-27,4390,357,359,716,三塊厝,簡易
2020-08-28,4390,417,416,833,三塊厝,簡易
2020-08-29,4390,324,299,623,三塊厝,簡易
2020-08-30,4390,268,271,539,三塊厝,簡易
2020-08-31,4390,378,490,868,三塊厝,簡易
2020-09-01,4390,410,465,875,三塊厝,簡易
2020-09-02,4390,392,489,881,三塊厝,簡易
2020-09-03,4390,423,460,883,三塊厝,簡易
2020-09-04,4390,472,468,940,三塊厝,簡易
2020-09-05,4390,343,313,656,三塊厝,簡易
2020-09-06,4390,285,319,604,三塊厝,簡易
2020-09-07,4390,432,513,945,三塊厝,簡易
2020-09-08,4390,414,490,904,三塊厝,簡易
2020-09-09,4390,437,514,951,三塊厝,簡易
2020-09-10,4390,430,495,925,三塊厝,簡易
2020-09-11,4390,444,525,969,三塊厝,簡易
2020-09-12,4390,359,352,711,三塊厝,簡易
2020-09-13,4390,348,325,673,三塊厝,簡易
2020-09-14,4390,410,530,940,三塊厝,簡易
2020-09-15,4390,421,492,913,三塊厝,簡易
2020-09-16,4390,445,500,945,三塊厝,簡易
2020-09-17,4390,423,476,899,三塊厝,簡易
2020-09-18,4390,470,554,1024,三塊厝,簡易
2020-09-19,4390,353,353,706,三塊厝,簡易
2020-09-20,4390,326,328,654,三塊厝,簡易
2020-09-21,4390,432,473,905,三塊厝,簡易
2020-09-22,4390,441,486,927,三塊厝,簡易
2020-09-23,4390,455,518,973,三塊厝,簡易
2020-09-24,4390,437,494,931,三塊厝,簡易
2020-09-25,4390,463,520,983,三塊厝,簡易
2020-09-26,4390,424,483,907,三塊厝,簡易
2020-09-27,4390,346,334,680,三塊厝,簡易
2020-09-28,4390,445,522,967,三塊厝,簡易
2020-09-29,4390,458,507,965,三塊厝,簡易
2020-09-30,4390,492,626,1118,三塊厝,簡易
2020-10-01,4390,431,420,851,三塊厝,簡易
2020-10-02,4390,401,436,837,三塊厝,簡易
2020-10-03,4390,400,377,777,三塊厝,簡易
2020-10-04,4390,341,342,683,三塊厝,簡易
2020-10-05,4390,453,507,960,三塊厝,簡易
2020-10-06,4390,409,521,930,三塊厝,簡易
2020-10-07,4390,431,510,941,三塊厝,簡易
2020-10-08,4390,477,580,1057,三塊厝,簡易
2020-10-09,4390,381,377,758,三塊厝,簡易
2020-10-10,4390,347,325,672,三塊厝,簡易
2020-10-11,4390,329,350,679,三塊厝,簡易
2020-10-12,4390,491,508,999,三塊厝,簡易
2020-10-13,4390,423,477,900,三塊厝,簡易
2020-10-14,4390,427,518,945,三塊厝,簡易
2020-10-15,4390,468,528,996,三塊厝,簡易
2020-10-16,4390,473,551,1024,三塊厝,簡易
2020-10-17,4390,380,333,713,三塊厝,簡易
2020-10-18,4390,328,313,641,三塊厝,簡易
2020-10-19,4390,440,510,950,三塊厝,簡易
2020-10-20,4390,454,497,951,三塊厝,簡易
2020-10-21,4390,460,521,981,三塊厝,簡易
2020-10-22,4390,450,519,969,三塊厝,簡易
2020-10-23,4390,699,774,1473,三塊厝,簡易
2020-10-24,4390,379,362,741,三塊厝,簡易
2020-10-25,4390,350,351,701,三塊厝,簡易
2020-10-26,4390,448,521,969,三塊厝,簡易
2020-10-27,4390,472,502,974,三塊厝,簡易
2020-10-28,4390,445,497,942,三塊厝,簡易
2020-10-29,4390,444,537,981,三塊厝,簡易
2020-10-30,4390,458,586,1044,三塊厝,簡易
2020-10-31,4390,402,446,848,三塊厝,簡易
2020-11-01,4390,340,322,662,三塊厝,簡易
2020-11-02,4390,394,414,808,三塊厝,簡易
2020-11-03,4390,459,543,1002,三塊厝,簡易
2020-11-04,4390,492,533,1025,三塊厝,簡易
2020-11-05,4390,443,496,939,三塊厝,簡易
2020-11-06,4390,476,572,1048,三塊厝,簡易
2020-11-07,4390,357,310,667,三塊厝,簡易
2020-11-08,4390,341,311,652,三塊厝,簡易
2020-11-09,4390,452,522,974,三塊厝,簡易
2020-11-10,4390,408,486,894,三塊厝,簡易
2020-11-11,4390,454,516,970,三塊厝,簡易
2020-11-12,4390,450,518,968,三塊厝,簡易
2020-11-13,4390,516,598,1114,三塊厝,簡易
2020-11-14,4390,360,387,747,三塊厝,簡易
2020-11-15,4390,317,351,668,三塊厝,簡易
2020-11-16,4390,470,530,1000,三塊厝,簡易
2020-11-17,4390,427,466,893,三塊厝,簡易
2020-11-18,4390,471,545,1016,三塊厝,簡易
2020-11-19,4390,471,533,1004,三塊厝,簡易
2020-11-20,4390,512,624,1136,三塊厝,簡易
2020-11-21,4390,327,319,646,三塊厝,簡易
2020-11-22,4390,316,321,637,三塊厝,簡易
2020-11-23,4390,472,497,969,三塊厝,簡易
2020-11-24,4390,470,522,992,三塊厝,簡易
2020-11-25,4390,482,539,1021,三塊厝,簡易
2020-11-26,4390,473,520,993,三塊厝,簡易
2020-11-27,4390,484,576,1060,三塊厝,簡易
2020-11-28,4390,419,381,800,三塊厝,簡易
2020-11-29,4390,356,357,713,三塊厝,簡易
2020-11-30,4390,429,510,939,三塊厝,簡易
2020-12-01,4390,430,504,934,三塊厝,簡易
2020-12-02,4390,443,491,934,三塊厝,簡易
2020-12-03,4390,479,520,999,三塊厝,簡易
2020-12-04,4390,507,588,1095,三塊厝,簡易
2020-12-05,4390,375,380,755,三塊厝,簡易
2020-12-06,4390,356,386,742,三塊厝,簡易
2020-12-07,4390,461,527,988,三塊厝,簡易
2020-12-08,4390,471,507,978,三塊厝,簡易
2020-12-09,4390,459,545,1004,三塊厝,簡易
2020-12-10,4390,452,536,988,三塊厝,簡易
2020-12-11,4390,525,576,1101,三塊厝,簡易
2020-12-12,4390,396,418,814,三塊厝,簡易
2020-12-13,4390,339,345,684,三塊厝,簡易
2020-12-14,4390,481,538,1019,三塊厝,簡易
2020-12-15,4390,475,535,1010,三塊厝,簡易
2020-12-16,4390,455,547,1002,三塊厝,簡易
2020-12-17,4390,470,560,1030,三塊厝,簡易
2020-12-18,4390,543,618,1161,三塊厝,簡易
2020-12-19,4390,375,359,734,三塊厝,簡易
2020-12-20,4390,412,424,836,三塊厝,簡易
2020-12-21,4390,446,491,937,三塊厝,簡易
2020-12-22,4390,430,518,948,三塊厝,簡易
2020-12-23,4390,482,565,1047,三塊厝,簡易
2020-12-24,4390,474,521,995,三塊厝,簡易
2020-12-25,4390,530,612,1142,三塊厝,簡易
2020-12-26,4390,357,347,704,三塊厝,簡易
2020-12-27,4390,341,316,657,三塊厝,簡易
2020-12-28,4390,486,514,1000,三塊厝,簡易
2020-12-29,4390,491,529,1020,三塊厝,簡易
2020-12-30,4390,458,563,1021,三塊厝,簡易
2020-12-31,4390,482,589,1071,三塊厝,簡易
2020-01-01,4400,21694,16515,38209,高雄,特等
2020-01-02,4400,14049,13577,27626,高雄,特等
2020-01-03,4400,15661,16617,32278,高雄,特等
2020-01-04,4400,16563,16435,32998,高雄,特等
2020-01-05,4400,17473,17084,34557,高雄,特等
2020-01-06,4400,13740,13756,27496,高雄,特等
2020-01-07,4400,12793,12853,25646,高雄,特等
2020-01-08,4400,13132,13341,26473,高雄,特等
2020-01-09,4400,13780,14564,28344,高雄,特等
2020-01-10,4400,22345,23439,45784,高雄,特等
2020-01-11,4400,20206,19642,39848,高雄,特等
2020-01-12,4400,20475,20617,41092,高雄,特等
2020-01-13,4400,15895,15739,31634,高雄,特等
2020-01-14,4400,14365,14377,28742,高雄,特等
2020-01-15,4400,14301,14418,28719,高雄,特等
2020-01-16,4400,15484,15733,31217,高雄,特等
2020-01-17,4400,17390,18235,35625,高雄,特等
2020-01-18,4400,18708,18943,37651,高雄,特等
2020-01-19,4400,19580,19120,38700,高雄,特等
2020-01-20,4400,16678,16397,33075,高雄,特等
2020-01-21,4400,17661,17425,35086,高雄,特等
2020-01-22,4400,19155,19058,38213,高雄,特等
2020-01-23,4400,18921,17179,36100,高雄,特等
2020-01-24,4400,14644,12226,26870,高雄,特等
2020-01-25,4400,20010,20951,40961,高雄,特等
2020-01-26,4400,20929,21352,42281,高雄,特等
2020-01-27,4400,21820,23538,45358,高雄,特等
2020-01-28,4400,17891,19748,37639,高雄,特等
2020-01-29,4400,16799,18289,35088,高雄,特等
2020-01-30,4400,15506,15549,31055,高雄,特等
2020-01-31,4400,15073,15481,30554,高雄,特等
2020-02-01,4400,14179,13835,28014,高雄,特等
2020-02-02,4400,14466,14337,28803,高雄,特等
2020-02-03,4400,13931,13629,27560,高雄,特等
2020-02-04,4400,12924,13008,25932,高雄,特等
2020-02-05,4400,13453,13479,26932,高雄,特等
2020-02-06,4400,13588,13271,26859,高雄,特等
2020-02-07,4400,15718,16036,31754,高雄,特等
2020-02-08,4400,15534,14660,30194,高雄,特等
2020-02-09,4400,16124,16055,32179,高雄,特等
2020-02-10,4400,13346,13519,26865,高雄,特等
2020-02-11,4400,12381,12316,24697,高雄,特等
2020-02-12,4400,12480,12326,24806,高雄,特等
2020-02-13,4400,12185,12255,24440,高雄,特等
2020-02-14,4400,14067,14701,28768,高雄,特等
2020-02-15,4400,13668,14009,27677,高雄,特等
2020-02-16,4400,15823,14662,30485,高雄,特等
2020-02-17,4400,12027,11974,24001,高雄,特等
2020-02-18,4400,11613,11561,23174,高雄,特等
2020-02-19,4400,11806,11619,23425,高雄,特等
2020-02-20,4400,11823,11843,23666,高雄,特等
2020-02-21,4400,14083,14289,28372,高雄,特等
2020-02-22,4400,13730,13036,26766,高雄,特等
2020-02-23,4400,13944,13722,27666,高雄,特等
2020-02-24,4400,11992,12110,24102,高雄,特等
2020-02-25,4400,11332,11710,23042,高雄,特等
2020-02-26,4400,11409,11782,23191,高雄,特等
2020-02-27,4400,15252,15091,30343,高雄,特等
2020-02-28,4400,15181,14499,29680,高雄,特等
2020-02-29,4400,13000,12751,25751,高雄,特等
2020-03-01,4400,15082,15255,30337,高雄,特等
2020-03-02,4400,11284,10867,22151,高雄,特等
2020-03-03,4400,10102,9942,20044,高雄,特等
2020-03-04,4400,10139,9879,20018,高雄,特等
2020-03-05,4400,10169,10326,20495,高雄,特等
2020-03-06,4400,13873,14720,28593,高雄,特等
2020-03-07,4400,12773,12790,25563,高雄,特等
2020-03-08,4400,14455,13670,28125,高雄,特等
2020-03-09,4400,11465,11058,22523,高雄,特等
2020-03-10,4400,10009,10128,20137,高雄,特等
2020-03-11,4400,10381,10498,20879,高雄,特等
2020-03-12,4400,10970,10658,21628,高雄,特等
2020-03-13,4400,14121,15533,29654,高雄,特等
2020-03-14,4400,12611,12145,24756,高雄,特等
2020-03-15,4400,15021,14370,29391,高雄,特等
2020-03-16,4400,11449,10924,22373,高雄,特等
2020-03-17,4400,10105,10212,20317,高雄,特等
2020-03-18,4400,10013,10086,20099,高雄,特等
2020-03-19,4400,9938,9841,19779,高雄,特等
2020-03-20,4400,12840,14109,26949,高雄,特等
2020-03-21,4400,11332,10670,22002,高雄,特等
2020-03-22,4400,11818,11775,23593,高雄,特等
2020-03-23,4400,10098,9972,20070,高雄,特等
2020-03-24,4400,9142,9140,18282,高雄,特等
2020-03-25,4400,8996,9113,18109,高雄,特等
2020-03-26,4400,9262,9415,18677,高雄,特等
2020-03-27,4400,12226,13230,25456,高雄,特等
2020-03-28,4400,10032,9882,19914,高雄,特等
2020-03-29,4400,10365,10463,20828,高雄,特等
2020-03-30,4400,9907,9961,19868,高雄,特等
2020-03-31,4400,9510,9780,19290,高雄,特等
2020-04-01,4400,13457,14179,27636,高雄,特等
2020-04-02,4400,12113,11111,23224,高雄,特等
2020-04-03,4400,10227,9817,20044,高雄,特等
2020-04-04,4400,8441,8884,17325,高雄,特等
2020-04-05,4400,11663,12574,24237,高雄,特等
2020-04-06,4400,10693,10113,20806,高雄,特等
2020-04-07,4400,8911,8293,17204,高雄,特等
2020-04-08,4400,8466,8356,16822,高雄,特等
2020-04-09,4400,8399,8536,16935,高雄,特等
2020-04-10,4400,9498,9334,18832,高雄,特等
2020-04-11,4400,9024,8653,17677,高雄,特等
2020-04-12,4400,9788,9500,19288,高雄,特等
2020-04-13,4400,9238,9014,18252,高雄,特等
2020-04-14,4400,8535,8392,16927,高雄,特等
2020-04-15,4400,8662,8705,17367,高雄,特等
2020-04-16,4400,8902,8993,17895,高雄,特等
2020-04-17,4400,11796,12738,24534,高雄,特等
2020-04-18,4400,10023,9707,19730,高雄,特等
2020-04-19,4400,10987,10570,21557,高雄,特等
2020-04-20,4400,9418,9037,18455,高雄,特等
2020-04-21,4400,7824,7819,15643,高雄,特等
2020-04-22,4400,7993,7822,15815,高雄,特等
2020-04-23,4400,7978,8268,16246,高雄,特等
2020-04-24,4400,10378,11091,21469,高雄,特等
2020-04-25,4400,7667,7151,14818,高雄,特等
2020-04-26,4400,8144,8086,16230,高雄,特等
2020-04-27,4400,8654,8515,17169,高雄,特等
2020-04-28,4400,8125,8056,16181,高雄,特等
2020-04-29,4400,8384,8408,16792,高雄,特等
2020-04-30,4400,9591,10037,19628,高雄,特等
2020-05-01,4400,11161,11421,22582,高雄,特等
2020-05-02,4400,8606,8512,17118,高雄,特等
2020-05-03,4400,10207,10219,20426,高雄,特等
2020-05-04,4400,9728,9386,19114,高雄,特等
2020-05-05,4400,8738,8748,17486,高雄,特等
2020-05-06,4400,8959,8975,17934,高雄,特等
2020-05-07,4400,9324,9534,18858,高雄,特等
2020-05-08,4400,13359,14433,27792,高雄,特等
2020-05-09,4400,11371,10497,21868,高雄,特等
2020-05-10,4400,12518,12151,24669,高雄,特等
2020-05-11,4400,10649,10348,20997,高雄,特等
2020-05-12,4400,9367,9369,18736,高雄,特等
2020-05-13,4400,9432,9439,18871,高雄,特等
2020-05-14,4400,9582,9768,19350,高雄,特等
2020-05-15,4400,12871,13810,26681,高雄,特等
2020-05-16,4400,10949,10964,21913,高雄,特等
2020-05-17,4400,12328,11568,23896,高雄,特等
2020-05-18,4400,10322,9811,20133,高雄,特等
2020-05-19,4400,9036,9030,18066,高雄,特等
2020-05-20,4400,9020,9047,18067,高雄,特等
2020-05-21,4400,8857,9181,18038,高雄,特等
2020-05-22,4400,11111,11859,22970,高雄,特等
2020-05-23,4400,10262,10240,20502,高雄,特等
2020-05-24,4400,14828,13831,28659,高雄,特等
2020-05-25,4400,10726,10492,21218,高雄,特等
2020-05-26,4400,9433,9309,18742,高雄,特等
2020-05-27,4400,8887,8878,17765,高雄,特等
2020-05-28,4400,9544,9835,19379,高雄,特等
2020-05-29,4400,13324,14252,27576,高雄,特等
2020-05-30,4400,13439,13198,26637,高雄,特等
2020-05-31,4400,14487,14072,28559,高雄,特等
2020-06-01,4400,10889,10718,21607,高雄,特等
2020-06-02,4400,9936,9936,19872,高雄,特等
2020-06-03,4400,9882,10050,19932,高雄,特等
2020-06-04,4400,10179,10905,21084,高雄,特等
2020-06-05,4400,13360,17789,31149,高雄,特等
2020-06-06,4400,15905,15720,31625,高雄,特等
2020-06-07,4400,18037,14345,32382,高雄,特等
2020-06-08,4400,12224,11191,23415,高雄,特等
2020-06-09,4400,10583,10486,21069,高雄,特等
2020-06-10,4400,10612,10924,21536,高雄,特等
2020-06-11,4400,11317,11407,22724,高雄,特等
2020-06-12,4400,14457,15622,30079,高雄,特等
2020-06-13,4400,15999,16205,32204,高雄,特等
2020-06-14,4400,17190,16031,33221,高雄,特等
2020-06-15,4400,12413,12107,24520,高雄,特等
2020-06-16,4400,11326,11187,22513,高雄,特等
2020-06-17,4400,10991,10987,21978,高雄,特等
2020-06-18,4400,11411,11355,22766,高雄,特等
2020-06-19,4400,12981,13603,26584,高雄,特等
2020-06-20,4400,13376,13700,27076,高雄,特等
2020-06-21,4400,15284,14854,30138,高雄,特等
2020-06-22,4400,12166,12182,24348,高雄,特等
2020-06-23,4400,11722,11710,23432,高雄,特等
2020-06-24,4400,16204,16936,33140,高雄,特等
2020-06-25,4400,17725,16806,34531,高雄,特等
2020-06-26,4400,17247,17510,34757,高雄,特等
2020-06-27,4400,16932,17152,34084,高雄,特等
2020-06-28,4400,17298,17747,35045,高雄,特等
2020-06-29,4400,13680,13171,26851,高雄,特等
2020-06-30,4400,11867,11981,23848,高雄,特等
2020-07-01,4400,11350,11517,22867,高雄,特等
2020-07-02,4400,11353,11555,22908,高雄,特等
2020-07-03,4400,14452,14927,29379,高雄,特等
2020-07-04,4400,13816,13664,27480,高雄,特等
2020-07-05,4400,14102,14072,28174,高雄,特等
2020-07-06,4400,12973,12889,25862,高雄,特等
2020-07-07,4400,12829,12755,25584,高雄,特等
2020-07-08,4400,12777,12766,25543,高雄,特等
2020-07-09,4400,13146,12920,26066,高雄,特等
2020-07-10,4400,15675,16069,31744,高雄,特等
2020-07-11,4400,15751,15917,31668,高雄,特等
2020-07-12,4400,17197,16767,33964,高雄,特等
2020-07-13,4400,13588,13315,26903,高雄,特等
2020-07-14,4400,13538,13394,26932,高雄,特等
2020-07-15,4400,13425,13400,26825,高雄,特等
2020-07-16,4400,13949,14000,27949,高雄,特等
2020-07-17,4400,16727,17496,34223,高雄,特等
2020-07-18,4400,17335,17190,34525,高雄,特等
2020-07-19,4400,18819,18218,37037,高雄,特等
2020-07-20,4400,15320,14933,30253,高雄,特等
2020-07-21,4400,14148,14209,28357,高雄,特等
2020-07-22,4400,14491,14574,29065,高雄,特等
2020-07-23,4400,15188,14374,29562,高雄,特等
2020-07-24,4400,16815,17513,34328,高雄,特等
2020-07-25,4400,17478,17261,34739,高雄,特等
2020-07-26,4400,17737,17528,35265,高雄,特等
2020-07-27,4400,14521,14365,28886,高雄,特等
2020-07-28,4400,13537,13567,27104,高雄,特等
2020-07-29,4400,13747,13624,27371,高雄,特等
2020-07-30,4400,13799,13828,27627,高雄,特等
2020-07-31,4400,15956,16352,32308,高雄,特等
2020-08-01,4400,16431,15953,32384,高雄,特等
2020-08-02,4400,15708,15697,31405,高雄,特等
2020-08-03,4400,12725,12836,25561,高雄,特等
2020-08-04,4400,11648,11972,23620,高雄,特等
2020-08-05,4400,13477,13247,26724,高雄,特等
2020-08-06,4400,13920,13953,27873,高雄,特等
2020-08-07,4400,17394,17956,35350,高雄,特等
2020-08-08,4400,16355,15803,32158,高雄,特等
2020-08-09,4400,17805,17995,35800,高雄,特等
2020-08-10,4400,14682,14253,28935,高雄,特等
2020-08-11,4400,12827,12620,25447,高雄,特等
2020-08-12,4400,14127,14406,28533,高雄,特等
2020-08-13,4400,14458,14703,29161,高雄,特等
2020-08-14,4400,17622,19387,37009,高雄,特等
2020-08-15,4400,19250,19033,38283,高雄,特等
2020-08-16,4400,21146,19869,41015,高雄,特等
2020-08-17,4400,16300,15555,31855,高雄,特等
2020-08-18,4400,14965,14574,29539,高雄,特等
2020-08-19,4400,14053,13841,27894,高雄,特等
2020-08-20,4400,14701,14656,29357,高雄,特等
2020-08-21,4400,17662,18006,35668,高雄,特等
2020-08-22,4400,17856,18010,35866,高雄,特等
2020-08-23,4400,18802,17986,36788,高雄,特等
2020-08-24,4400,15115,14837,29952,高雄,特等
2020-08-25,4400,14390,14445,28835,高雄,特等
2020-08-26,4400,12332,12392,24724,高雄,特等
2020-08-27,4400,12469,12365,24834,高雄,特等
2020-08-28,4400,15696,16132,31828,高雄,特等
2020-08-29,4400,15402,15880,31282,高雄,特等
2020-08-30,4400,15893,14565,30458,高雄,特等
2020-08-31,4400,12689,12465,25154,高雄,特等
2020-09-01,4400,12082,11904,23986,高雄,特等
2020-09-02,4400,11689,11585,23274,高雄,特等
2020-09-03,4400,13114,12990,26104,高雄,特等
2020-09-04,4400,15719,16199,31918,高雄,特等
2020-09-05,4400,15533,16117,31650,高雄,特等
2020-09-06,4400,17322,16995,34317,高雄,特等
2020-09-07,4400,13295,12750,26045,高雄,特等
2020-09-08,4400,12078,12033,24111,高雄,特等
2020-09-09,4400,12362,12250,24612,高雄,特等
2020-09-10,4400,12743,12761,25504,高雄,特等
2020-09-11,4400,15956,16554,32510,高雄,特等
2020-09-12,4400,16712,16330,33042,高雄,特等
2020-09-13,4400,18422,17278,35700,高雄,特等
2020-09-14,4400,12248,12090,24338,高雄,特等
2020-09-15,4400,11448,11304,22752,高雄,特等
2020-09-16,4400,11188,11324,22512,高雄,特等
2020-09-17,4400,11932,12020,23952,高雄,特等
2020-09-18,4400,16082,17322,33404,高雄,特等
2020-09-19,4400,17768,17792,35560,高雄,特等
2020-09-20,4400,18659,18168,36827,高雄,特等
2020-09-21,4400,12508,12157,24665,高雄,特等
2020-09-22,4400,11566,11588,23154,高雄,特等
2020-09-23,4400,11795,11722,23517,高雄,特等
2020-09-24,4400,11977,12256,24233,高雄,特等
2020-09-25,4400,13485,14095,27580,高雄,特等
2020-09-26,4400,13996,14656,28652,高雄,特等
2020-09-27,4400,16131,15560,31691,高雄,特等
2020-09-28,4400,12241,11949,24190,高雄,特等
2020-09-29,4400,12016,12026,24042,高雄,特等
2020-09-30,4400,18285,19342,37627,高雄,特等
2020-10-01,4400,18981,17381,36362,高雄,特等
2020-10-02,4400,17147,17548,34695,高雄,特等
2020-10-03,4400,17571,18318,35889,高雄,特等
2020-10-04,4400,19428,19955,39383,高雄,特等
2020-10-05,4400,13233,13172,26405,高雄,特等
2020-10-06,4400,11571,11422,22993,高雄,特等
2020-10-07,4400,11414,11670,23084,高雄,特等
2020-10-08,4400,15946,17549,33495,高雄,特等
2020-10-09,4400,19057,18639,37696,高雄,特等
2020-10-10,4400,17505,17088,34593,高雄,特等
2020-10-11,4400,19754,19048,38802,高雄,特等
2020-10-12,4400,12609,12568,25177,高雄,特等
2020-10-13,4400,11504,11972,23476,高雄,特等
2020-10-14,4400,11781,11669,23450,高雄,特等
2020-10-15,4400,12178,12397,24575,高雄,特等
2020-10-16,4400,15740,17382,33122,高雄,特等
2020-10-17,4400,17779,17546,35325,高雄,特等
2020-10-18,4400,20032,18779,38811,高雄,特等
2020-10-19,4400,12811,12564,25375,高雄,特等
2020-10-20,4400,11643,11878,23521,高雄,特等
2020-10-21,4400,12061,12165,24226,高雄,特等
2020-10-22,4400,12077,12476,24553,高雄,特等
2020-10-23,4400,16604,17479,34083,高雄,特等
2020-10-24,4400,17237,17082,34319,高雄,特等
2020-10-25,4400,18840,18160,37000,高雄,特等
2020-10-26,4400,12475,12617,25092,高雄,特等
2020-10-27,4400,11840,11890,23730,高雄,特等
2020-10-28,4400,11648,11641,23289,高雄,特等
2020-10-29,4400,12015,12131,24146,高雄,特等
2020-10-30,4400,15470,17808,33278,高雄,特等
2020-10-31,4400,17356,16936,34292,高雄,特等
2020-11-01,4400,17203,16443,33646,高雄,特等
2020-11-02,4400,12015,11673,23688,高雄,特等
2020-11-03,4400,11093,10667,21760,高雄,特等
2020-11-04,4400,11267,11119,22386,高雄,特等
2020-11-05,4400,11696,12081,23777,高雄,特等
2020-11-06,4400,15831,16445,32276,高雄,特等
2020-11-07,4400,16054,16064,32118,高雄,特等
2020-11-08,4400,17834,17589,35423,高雄,特等
2020-11-09,4400,12271,12185,24456,高雄,特等
2020-11-10,4400,11130,11397,22527,高雄,特等
2020-11-11,4400,11820,11770,23590,高雄,特等
2020-11-12,4400,12252,12491,24743,高雄,特等
2020-11-13,4400,16634,17833,34467,高雄,特等
2020-11-14,4400,17811,18301,36112,高雄,特等
2020-11-15,4400,20553,18825,39378,高雄,特等
2020-11-16,4400,12777,12579,25356,高雄,特等
2020-11-17,4400,11727,11679,23406,高雄,特等
2020-11-18,4400,11648,11980,23628,高雄,特等
2020-11-19,4400,12056,12374,24430,高雄,特等
2020-11-20,4400,16631,18202,34833,高雄,特等
2020-11-21,4400,17620,17521,35141,高雄,特等
2020-11-22,4400,19185,18199,37384,高雄,特等
2020-11-23,4400,12954,12575,25529,高雄,特等
2020-11-24,4400,11495,11578,23073,高雄,特等
2020-11-25,4400,11663,11807,23470,高雄,特等
2020-11-26,4400,12456,12506,24962,高雄,特等
2020-11-27,4400,16557,18475,35032,高雄,特等
2020-11-28,4400,18582,18432,37014,高雄,特等
2020-11-29,4400,19203,18276,37479,高雄,特等
2020-11-30,4400,13063,12606,25669,高雄,特等
2020-12-01,4400,11364,11185,22549,高雄,特等
2020-12-02,4400,11286,11445,22731,高雄,特等
2020-12-03,4400,11583,11881,23464,高雄,特等
2020-12-04,4400,15772,16906,32678,高雄,特等
2020-12-05,4400,18954,18815,37769,高雄,特等
2020-12-06,4400,21306,19673,40979,高雄,特等
2020-12-07,4400,13012,12713,25725,高雄,特等
2020-12-08,4400,11345,11258,22603,高雄,特等
2020-12-09,4400,11647,11639,23286,高雄,特等
2020-12-10,4400,11910,12186,24096,高雄,特等
2020-12-11,4400,16639,18560,35199,高雄,特等
2020-12-12,4400,19071,18774,37845,高雄,特等
2020-12-13,4400,21012,19471,40483,高雄,特等
2020-12-14,4400,13528,13261,26789,高雄,特等
2020-12-15,4400,11519,11556,23075,高雄,特等
2020-12-16,4400,12070,11965,24035,高雄,特等
2020-12-17,4400,12491,12587,25078,高雄,特等
2020-12-18,4400,16810,18093,34903,高雄,特等
2020-12-19,4400,19448,19364,38812,高雄,特等
2020-12-20,4400,20278,19501,39779,高雄,特等
2020-12-21,4400,13165,12901,26066,高雄,特等
2020-12-22,4400,11660,11756,23416,高雄,特等
2020-12-23,4400,12357,12374,24731,高雄,特等
2020-12-24,4400,12172,12764,24936,高雄,特等
2020-12-25,4400,16420,17821,34241,高雄,特等
2020-12-26,4400,17934,17941,35875,高雄,特等
2020-12-27,4400,18646,17320,35966,高雄,特等
2020-12-28,4400,12842,12596,25438,高雄,特等
2020-12-29,4400,11632,11861,23493,高雄,特等
2020-12-30,4400,12868,12838,25706,高雄,特等
2020-12-31,4400,17568,20872,38440,高雄,特等
2020-01-01,4410,641,537,1178,民族,簡易
2020-01-02,4410,632,623,1255,民族,簡易
2020-01-03,4410,653,668,1321,民族,簡易
2020-01-04,4410,565,495,1060,民族,簡易
2020-01-05,4410,572,526,1098,民族,簡易
2020-01-06,4410,598,626,1224,民族,簡易
2020-01-07,4410,596,584,1180,民族,簡易
2020-01-08,4410,649,626,1275,民族,簡易
2020-01-09,4410,597,636,1233,民族,簡易
2020-01-10,4410,783,829,1612,民族,簡易
2020-01-11,4410,789,771,1560,民族,簡易
2020-01-12,4410,640,588,1228,民族,簡易
2020-01-13,4410,658,644,1302,民族,簡易
2020-01-14,4410,653,580,1233,民族,簡易
2020-01-15,4410,616,606,1222,民族,簡易
2020-01-16,4410,603,631,1234,民族,簡易
2020-01-17,4410,651,641,1292,民族,簡易
2020-01-18,4410,628,561,1189,民族,簡易
2020-01-19,4410,616,593,1209,民族,簡易
2020-01-20,4410,612,632,1244,民族,簡易
2020-01-21,4410,606,582,1188,民族,簡易
2020-01-22,4410,664,694,1358,民族,簡易
2020-01-23,4410,536,469,1005,民族,簡易
2020-01-24,4410,460,421,881,民族,簡易
2020-01-25,4410,613,571,1184,民族,簡易
2020-01-26,4410,571,514,1085,民族,簡易
2020-01-27,4410,691,654,1345,民族,簡易
2020-01-28,4410,504,538,1042,民族,簡易
2020-01-29,4410,527,482,1009,民族,簡易
2020-01-30,4410,561,540,1101,民族,簡易
2020-01-31,4410,566,563,1129,民族,簡易
2020-02-01,4410,443,398,841,民族,簡易
2020-02-02,4410,499,427,926,民族,簡易
2020-02-03,4410,552,565,1117,民族,簡易
2020-02-04,4410,539,520,1059,民族,簡易
2020-02-05,4410,529,513,1042,民族,簡易
2020-02-06,4410,513,494,1007,民族,簡易
2020-02-07,4410,616,590,1206,民族,簡易
2020-02-08,4410,508,467,975,民族,簡易
2020-02-09,4410,446,441,887,民族,簡易
2020-02-10,4410,502,493,995,民族,簡易
2020-02-11,4410,544,517,1061,民族,簡易
2020-02-12,4410,491,480,971,民族,簡易
2020-02-13,4410,505,498,1003,民族,簡易
2020-02-14,4410,540,533,1073,民族,簡易
2020-02-15,4410,523,468,991,民族,簡易
2020-02-16,4410,472,436,908,民族,簡易
2020-02-17,4410,480,477,957,民族,簡易
2020-02-18,4410,497,479,976,民族,簡易
2020-02-19,4410,521,498,1019,民族,簡易
2020-02-20,4410,551,500,1051,民族,簡易
2020-02-21,4410,541,573,1114,民族,簡易
2020-02-22,4410,409,411,820,民族,簡易
2020-02-23,4410,410,387,797,民族,簡易
2020-02-24,4410,525,509,1034,民族,簡易
2020-02-25,4410,478,460,938,民族,簡易
2020-02-26,4410,526,534,1060,民族,簡易
2020-02-27,4410,594,563,1157,民族,簡易
2020-02-28,4410,466,422,888,民族,簡易
2020-02-29,4410,423,403,826,民族,簡易
2020-03-01,4410,419,459,878,民族,簡易
2020-03-02,4410,559,559,1118,民族,簡易
2020-03-03,4410,520,520,1040,民族,簡易
2020-03-04,4410,515,540,1055,民族,簡易
2020-03-05,4410,538,507,1045,民族,簡易
2020-03-06,4410,602,636,1238,民族,簡易
2020-03-07,4410,472,424,896,民族,簡易
2020-03-08,4410,464,427,891,民族,簡易
2020-03-09,4410,531,542,1073,民族,簡易
2020-03-10,4410,513,488,1001,民族,簡易
2020-03-11,4410,428,568,996,民族,簡易
2020-03-12,4410,531,511,1042,民族,簡易
2020-03-13,4410,640,660,1300,民族,簡易
2020-03-14,4410,433,351,784,民族,簡易
2020-03-15,4410,460,491,951,民族,簡易
2020-03-16,4410,550,556,1106,民族,簡易
2020-03-17,4410,539,517,1056,民族,簡易
2020-03-18,4410,544,528,1072,民族,簡易
2020-03-19,4410,527,498,1025,民族,簡易
2020-03-20,4410,587,604,1191,民族,簡易
2020-03-21,4410,424,369,793,民族,簡易
2020-03-22,4410,407,398,805,民族,簡易
2020-03-23,4410,488,504,992,民族,簡易
2020-03-24,4410,481,517,998,民族,簡易
2020-03-25,4410,525,496,1021,民族,簡易
2020-03-26,4410,493,496,989,民族,簡易
2020-03-27,4410,566,603,1169,民族,簡易
2020-03-28,4410,403,386,789,民族,簡易
2020-03-29,4410,377,332,709,民族,簡易
2020-03-30,4410,521,518,1039,民族,簡易
2020-03-31,4410,481,475,956,民族,簡易
2020-04-01,4410,552,572,1124,民族,簡易
2020-04-02,4410,378,340,718,民族,簡易
2020-04-03,4410,355,317,672,民族,簡易
2020-04-04,4410,291,290,581,民族,簡易
2020-04-05,4410,362,364,726,民族,簡易
2020-04-06,4410,483,456,939,民族,簡易
2020-04-07,4410,447,426,873,民族,簡易
2020-04-08,4410,486,442,928,民族,簡易
2020-04-09,4410,445,458,903,民族,簡易
2020-04-10,4410,473,417,890,民族,簡易
2020-04-11,4410,363,284,647,民族,簡易
2020-04-12,4410,314,312,626,民族,簡易
2020-04-13,4410,474,466,940,民族,簡易
2020-04-14,4410,468,466,934,民族,簡易
2020-04-15,4410,500,470,970,民族,簡易
2020-04-16,4410,487,499,986,民族,簡易
2020-04-17,4410,492,517,1009,民族,簡易
2020-04-18,4410,373,334,707,民族,簡易
2020-04-19,4410,365,356,721,民族,簡易
2020-04-20,4410,460,472,932,民族,簡易
2020-04-21,4410,405,390,795,民族,簡易
2020-04-22,4410,411,399,810,民族,簡易
2020-04-23,4410,457,456,913,民族,簡易
2020-04-24,4410,483,505,988,民族,簡易
2020-04-25,4410,323,323,646,民族,簡易
2020-04-26,4410,303,284,587,民族,簡易
2020-04-27,4410,478,463,941,民族,簡易
2020-04-28,4410,467,456,923,民族,簡易
2020-04-29,4410,442,424,866,民族,簡易
2020-04-30,4410,458,470,928,民族,簡易
2020-05-01,4410,440,457,897,民族,簡易
2020-05-02,4410,325,339,664,民族,簡易
2020-05-03,4410,339,305,644,民族,簡易
2020-05-04,4410,509,474,983,民族,簡易
2020-05-05,4410,462,433,895,民族,簡易
2020-05-06,4410,454,460,914,民族,簡易
2020-05-07,4410,503,496,999,民族,簡易
2020-05-08,4410,556,589,1145,民族,簡易
2020-05-09,4410,417,373,790,民族,簡易
2020-05-10,4410,419,427,846,民族,簡易
2020-05-11,4410,523,491,1014,民族,簡易
2020-05-12,4410,464,466,930,民族,簡易
2020-05-13,4410,499,481,980,民族,簡易
2020-05-14,4410,509,486,995,民族,簡易
2020-05-15,4410,553,551,1104,民族,簡易
2020-05-16,4410,364,368,732,民族,簡易
2020-05-17,4410,398,336,734,民族,簡易
2020-05-18,4410,463,487,950,民族,簡易
2020-05-19,4410,470,480,950,民族,簡易
2020-05-20,4410,495,479,974,民族,簡易
2020-05-21,4410,477,470,947,民族,簡易
2020-05-22,4410,448,450,898,民族,簡易
2020-05-23,4410,414,397,811,民族,簡易
2020-05-24,4410,399,385,784,民族,簡易
2020-05-25,4410,553,540,1093,民族,簡易
2020-05-26,4410,494,468,962,民族,簡易
2020-05-27,4410,466,446,912,民族,簡易
2020-05-28,4410,523,494,1017,民族,簡易
2020-05-29,4410,574,584,1158,民族,簡易
2020-05-30,4410,467,404,871,民族,簡易
2020-05-31,4410,458,430,888,民族,簡易
2020-06-01,4410,533,529,1062,民族,簡易
2020-06-02,4410,486,502,988,民族,簡易
2020-06-03,4410,532,516,1048,民族,簡易
2020-06-04,4410,519,544,1063,民族,簡易
2020-06-05,4410,595,701,1296,民族,簡易
2020-06-06,4410,519,499,1018,民族,簡易
2020-06-07,4410,531,436,967,民族,簡易
2020-06-08,4410,552,516,1068,民族,簡易
2020-06-09,4410,524,519,1043,民族,簡易
2020-06-10,4410,542,539,1081,民族,簡易
2020-06-11,4410,552,549,1101,民族,簡易
2020-06-12,4410,613,629,1242,民族,簡易
2020-06-13,4410,511,440,951,民族,簡易
2020-06-14,4410,473,417,890,民族,簡易
2020-06-15,4410,517,554,1071,民族,簡易
2020-06-16,4410,518,529,1047,民族,簡易
2020-06-17,4410,523,517,1040,民族,簡易
2020-06-18,4410,566,590,1156,民族,簡易
2020-06-19,4410,573,595,1168,民族,簡易
2020-06-20,4410,499,490,989,民族,簡易
2020-06-21,4410,465,435,900,民族,簡易
2020-06-22,4410,510,539,1049,民族,簡易
2020-06-23,4410,528,539,1067,民族,簡易
2020-06-24,4410,627,643,1270,民族,簡易
2020-06-25,4410,504,487,991,民族,簡易
2020-06-26,4410,546,491,1037,民族,簡易
2020-06-27,4410,499,469,968,民族,簡易
2020-06-28,4410,513,494,1007,民族,簡易
2020-06-29,4410,553,572,1125,民族,簡易
2020-06-30,4410,502,530,1032,民族,簡易
2020-07-01,4410,540,529,1069,民族,簡易
2020-07-02,4410,520,514,1034,民族,簡易
2020-07-03,4410,585,609,1194,民族,簡易
2020-07-04,4410,447,422,869,民族,簡易
2020-07-05,4410,434,445,879,民族,簡易
2020-07-06,4410,572,548,1120,民族,簡易
2020-07-07,4410,572,551,1123,民族,簡易
2020-07-08,4410,591,569,1160,民族,簡易
2020-07-09,4410,559,523,1082,民族,簡易
2020-07-10,4410,615,595,1210,民族,簡易
2020-07-11,4410,495,441,936,民族,簡易
2020-07-12,4410,506,494,1000,民族,簡易
2020-07-13,4410,542,569,1111,民族,簡易
2020-07-14,4410,565,564,1129,民族,簡易
2020-07-15,4410,581,530,1111,民族,簡易
2020-07-16,4410,553,589,1142,民族,簡易
2020-07-17,4410,625,646,1271,民族,簡易
2020-07-18,4410,548,491,1039,民族,簡易
2020-07-19,4410,516,507,1023,民族,簡易
2020-07-20,4410,591,572,1163,民族,簡易
2020-07-21,4410,597,577,1174,民族,簡易
2020-07-22,4410,622,614,1236,民族,簡易
2020-07-23,4410,605,611,1216,民族,簡易
2020-07-24,4410,603,609,1212,民族,簡易
2020-07-25,4410,575,498,1073,民族,簡易
2020-07-26,4410,497,475,972,民族,簡易
2020-07-27,4410,547,571,1118,民族,簡易
2020-07-28,4410,548,512,1060,民族,簡易
2020-07-29,4410,550,562,1112,民族,簡易
2020-07-30,4410,563,584,1147,民族,簡易
2020-07-31,4410,622,617,1239,民族,簡易
2020-08-01,4410,550,516,1066,民族,簡易
2020-08-02,4410,489,470,959,民族,簡易
2020-08-03,4410,489,504,993,民族,簡易
2020-08-04,4410,493,502,995,民族,簡易
2020-08-05,4410,597,592,1189,民族,簡易
2020-08-06,4410,576,575,1151,民族,簡易
2020-08-07,4410,649,636,1285,民族,簡易
2020-08-08,4410,526,453,979,民族,簡易
2020-08-09,4410,507,512,1019,民族,簡易
2020-08-10,4410,556,563,1119,民族,簡易
2020-08-11,4410,519,499,1018,民族,簡易
2020-08-12,4410,556,577,1133,民族,簡易
2020-08-13,4410,559,623,1182,民族,簡易
2020-08-14,4410,591,672,1263,民族,簡易
2020-08-15,4410,567,524,1091,民族,簡易
2020-08-16,4410,619,543,1162,民族,簡易
2020-08-17,4410,585,592,1177,民族,簡易
2020-08-18,4410,592,596,1188,民族,簡易
2020-08-19,4410,575,588,1163,民族,簡易
2020-08-20,4410,595,609,1204,民族,簡易
2020-08-21,4410,625,622,1247,民族,簡易
2020-08-22,4410,564,466,1030,民族,簡易
2020-08-23,4410,507,538,1045,民族,簡易
2020-08-24,4410,600,568,1168,民族,簡易
2020-08-25,4410,563,570,1133,民族,簡易
2020-08-26,4410,480,500,980,民族,簡易
2020-08-27,4410,533,512,1045,民族,簡易
2020-08-28,4410,643,627,1270,民族,簡易
2020-08-29,4410,484,482,966,民族,簡易
2020-08-30,4410,478,422,900,民族,簡易
2020-08-31,4410,553,573,1126,民族,簡易
2020-09-01,4410,584,584,1168,民族,簡易
2020-09-02,4410,534,567,1101,民族,簡易
2020-09-03,4410,566,591,1157,民族,簡易
2020-09-04,4410,685,645,1330,民族,簡易
2020-09-05,4410,542,506,1048,民族,簡易
2020-09-06,4410,549,528,1077,民族,簡易
2020-09-07,4410,546,589,1135,民族,簡易
2020-09-08,4410,562,559,1121,民族,簡易
2020-09-09,4410,564,587,1151,民族,簡易
2020-09-10,4410,553,566,1119,民族,簡易
2020-09-11,4410,611,626,1237,民族,簡易
2020-09-12,4410,571,513,1084,民族,簡易
2020-09-13,4410,503,522,1025,民族,簡易
2020-09-14,4410,536,559,1095,民族,簡易
2020-09-15,4410,562,538,1100,民族,簡易
2020-09-16,4410,573,562,1135,民族,簡易
2020-09-17,4410,525,567,1092,民族,簡易
2020-09-18,4410,640,683,1323,民族,簡易
2020-09-19,4410,540,530,1070,民族,簡易
2020-09-20,4410,546,509,1055,民族,簡易
2020-09-21,4410,545,564,1109,民族,簡易
2020-09-22,4410,528,525,1053,民族,簡易
2020-09-23,4410,574,535,1109,民族,簡易
2020-09-24,4410,562,553,1115,民族,簡易
2020-09-25,4410,575,584,1159,民族,簡易
2020-09-26,4410,567,532,1099,民族,簡易
2020-09-27,4410,474,434,908,民族,簡易
2020-09-28,4410,534,570,1104,民族,簡易
2020-09-29,4410,529,575,1104,民族,簡易
2020-09-30,4410,676,720,1396,民族,簡易
2020-10-01,4410,576,498,1074,民族,簡易
2020-10-02,4410,558,545,1103,民族,簡易
2020-10-03,4410,521,532,1053,民族,簡易
2020-10-04,4410,550,522,1072,民族,簡易
2020-10-05,4410,609,574,1183,民族,簡易
2020-10-06,4410,585,575,1160,民族,簡易
2020-10-07,4410,555,520,1075,民族,簡易
2020-10-08,4410,674,715,1389,民族,簡易
2020-10-09,4410,600,502,1102,民族,簡易
2020-10-10,4410,465,500,965,民族,簡易
2020-10-11,4410,472,498,970,民族,簡易
2020-10-12,4410,623,602,1225,民族,簡易
2020-10-13,4410,605,568,1173,民族,簡易
2020-10-14,4410,568,571,1139,民族,簡易
2020-10-15,4410,600,608,1208,民族,簡易
2020-10-16,4410,643,653,1296,民族,簡易
2020-10-17,4410,634,571,1205,民族,簡易
2020-10-18,4410,549,530,1079,民族,簡易
2020-10-19,4410,547,576,1123,民族,簡易
2020-10-20,4410,510,533,1043,民族,簡易
2020-10-21,4410,538,568,1106,民族,簡易
2020-10-22,4410,529,530,1059,民族,簡易
2020-10-23,4410,578,630,1208,民族,簡易
2020-10-24,4410,469,478,947,民族,簡易
2020-10-25,4410,439,463,902,民族,簡易
2020-10-26,4410,514,537,1051,民族,簡易
2020-10-27,4410,514,496,1010,民族,簡易
2020-10-28,4410,518,505,1023,民族,簡易
2020-10-29,4410,527,525,1052,民族,簡易
2020-10-30,4410,575,632,1207,民族,簡易
2020-10-31,4410,562,510,1072,民族,簡易
2020-11-01,4410,540,553,1093,民族,簡易
2020-11-02,4410,558,550,1108,民族,簡易
2020-11-03,4410,524,466,990,民族,簡易
2020-11-04,4410,513,527,1040,民族,簡易
2020-11-05,4410,555,555,1110,民族,簡易
2020-11-06,4410,572,616,1188,民族,簡易
2020-11-07,4410,454,401,855,民族,簡易
2020-11-08,4410,513,526,1039,民族,簡易
2020-11-09,4410,582,549,1131,民族,簡易
2020-11-10,4410,551,533,1084,民族,簡易
2020-11-11,4410,552,521,1073,民族,簡易
2020-11-12,4410,527,559,1086,民族,簡易
2020-11-13,4410,626,682,1308,民族,簡易
2020-11-14,4410,542,512,1054,民族,簡易
2020-11-15,4410,558,508,1066,民族,簡易
2020-11-16,4410,559,578,1137,民族,簡易
2020-11-17,4410,531,560,1091,民族,簡易
2020-11-18,4410,555,552,1107,民族,簡易
2020-11-19,4410,544,541,1085,民族,簡易
2020-11-20,4410,634,646,1280,民族,簡易
2020-11-21,4410,509,493,1002,民族,簡易
2020-11-22,4410,504,486,990,民族,簡易
2020-11-23,4410,534,571,1105,民族,簡易
2020-11-24,4410,566,565,1131,民族,簡易
2020-11-25,4410,539,546,1085,民族,簡易
2020-11-26,4410,573,573,1146,民族,簡易
2020-11-27,4410,621,676,1297,民族,簡易
2020-11-28,4410,578,521,1099,民族,簡易
2020-11-29,4410,498,510,1008,民族,簡易
2020-11-30,4410,520,534,1054,民族,簡易
2020-12-01,4410,516,522,1038,民族,簡易
2020-12-02,4410,487,535,1022,民族,簡易
2020-12-03,4410,544,593,1137,民族,簡易
2020-12-04,4410,591,629,1220,民族,簡易
2020-12-05,4410,533,546,1079,民族,簡易
2020-12-06,4410,528,500,1028,民族,簡易
2020-12-07,4410,549,562,1111,民族,簡易
2020-12-08,4410,507,538,1045,民族,簡易
2020-12-09,4410,527,532,1059,民族,簡易
2020-12-10,4410,550,574,1124,民族,簡易
2020-12-11,4410,599,648,1247,民族,簡易
2020-12-12,4410,569,506,1075,民族,簡易
2020-12-13,4410,508,530,1038,民族,簡易
2020-12-14,4410,568,565,1133,民族,簡易
2020-12-15,4410,529,538,1067,民族,簡易
2020-12-16,4410,549,567,1116,民族,簡易
2020-12-17,4410,571,581,1152,民族,簡易
2020-12-18,4410,663,725,1388,民族,簡易
2020-12-19,4410,553,542,1095,民族,簡易
2020-12-20,4410,547,512,1059,民族,簡易
2020-12-21,4410,563,553,1116,民族,簡易
2020-12-22,4410,542,507,1049,民族,簡易
2020-12-23,4410,547,565,1112,民族,簡易
2020-12-24,4410,556,580,1136,民族,簡易
2020-12-25,4410,567,611,1178,民族,簡易
2020-12-26,4410,520,467,987,民族,簡易
2020-12-27,4410,466,464,930,民族,簡易
2020-12-28,4410,541,569,1110,民族,簡易
2020-12-29,4410,528,555,1083,民族,簡易
2020-12-30,4410,538,541,1079,民族,簡易
2020-12-31,4410,604,633,1237,民族,簡易
2020-01-01,4420,1015,1052,2067,科工館,簡易
2020-01-02,4420,1120,1035,2155,科工館,簡易
2020-01-03,4420,1184,1204,2388,科工館,簡易
2020-01-04,4420,1175,1122,2297,科工館,簡易
2020-01-05,4420,903,913,1816,科工館,簡易
2020-01-06,4420,1098,1019,2117,科工館,簡易
2020-01-07,4420,1029,973,2002,科工館,簡易
2020-01-08,4420,1023,992,2015,科工館,簡易
2020-01-09,4420,1126,1086,2212,科工館,簡易
2020-01-10,4420,1405,1517,2922,科工館,簡易
2020-01-11,4420,1193,1078,2271,科工館,簡易
2020-01-12,4420,1143,1029,2172,科工館,簡易
2020-01-13,4420,1167,1051,2218,科工館,簡易
2020-01-14,4420,1106,1048,2154,科工館,簡易
2020-01-15,4420,1061,999,2060,科工館,簡易
2020-01-16,4420,1214,1141,2355,科工館,簡易
2020-01-17,4420,1351,1264,2615,科工館,簡易
2020-01-18,4420,1214,1120,2334,科工館,簡易
2020-01-19,4420,1009,1034,2043,科工館,簡易
2020-01-20,4420,999,1018,2017,科工館,簡易
2020-01-21,4420,1258,1280,2538,科工館,簡易
2020-01-22,4420,1208,1325,2533,科工館,簡易
2020-01-23,4420,951,981,1932,科工館,簡易
2020-01-24,4420,713,599,1312,科工館,簡易
2020-01-25,4420,1063,1020,2083,科工館,簡易
2020-01-26,4420,1032,926,1958,科工館,簡易
2020-01-27,4420,1123,1147,2270,科工館,簡易
2020-01-28,4420,959,938,1897,科工館,簡易
2020-01-29,4420,885,847,1732,科工館,簡易
2020-01-30,4420,886,828,1714,科工館,簡易
2020-01-31,4420,942,937,1879,科工館,簡易
2020-02-01,4420,714,731,1445,科工館,簡易
2020-02-02,4420,876,800,1676,科工館,簡易
2020-02-03,4420,801,800,1601,科工館,簡易
2020-02-04,4420,763,788,1551,科工館,簡易
2020-02-05,4420,852,804,1656,科工館,簡易
2020-02-06,4420,780,840,1620,科工館,簡易
2020-02-07,4420,879,905,1784,科工館,簡易
2020-02-08,4420,783,728,1511,科工館,簡易
2020-02-09,4420,702,728,1430,科工館,簡易
2020-02-10,4420,816,814,1630,科工館,簡易
2020-02-11,4420,733,744,1477,科工館,簡易
2020-02-12,4420,760,778,1538,科工館,簡易
2020-02-13,4420,865,856,1721,科工館,簡易
2020-02-14,4420,895,913,1808,科工館,簡易
2020-02-15,4420,806,741,1547,科工館,簡易
2020-02-16,4420,715,731,1446,科工館,簡易
2020-02-17,4420,750,734,1484,科工館,簡易
2020-02-18,4420,690,706,1396,科工館,簡易
2020-02-19,4420,790,761,1551,科工館,簡易
2020-02-20,4420,781,853,1634,科工館,簡易
2020-02-21,4420,877,908,1785,科工館,簡易
2020-02-22,4420,775,669,1444,科工館,簡易
2020-02-23,4420,684,712,1396,科工館,簡易
2020-02-24,4420,846,852,1698,科工館,簡易
2020-02-25,4420,967,898,1865,科工館,簡易
2020-02-26,4420,973,928,1901,科工館,簡易
2020-02-27,4420,1093,1079,2172,科工館,簡易
2020-02-28,4420,854,807,1661,科工館,簡易
2020-02-29,4420,723,658,1381,科工館,簡易
2020-03-01,4420,781,833,1614,科工館,簡易
2020-03-02,4420,968,952,1920,科工館,簡易
2020-03-03,4420,917,894,1811,科工館,簡易
2020-03-04,4420,944,884,1828,科工館,簡易
2020-03-05,4420,992,917,1909,科工館,簡易
2020-03-06,4420,1176,1152,2328,科工館,簡易
2020-03-07,4420,753,760,1513,科工館,簡易
2020-03-08,4420,763,741,1504,科工館,簡易
2020-03-09,4420,922,899,1821,科工館,簡易
2020-03-10,4420,924,875,1799,科工館,簡易
2020-03-11,4420,942,874,1816,科工館,簡易
2020-03-12,4420,1000,937,1937,科工館,簡易
2020-03-13,4420,1127,1126,2253,科工館,簡易
2020-03-14,4420,747,758,1505,科工館,簡易
2020-03-15,4420,802,755,1557,科工館,簡易
2020-03-16,4420,1010,982,1992,科工館,簡易
2020-03-17,4420,889,848,1737,科工館,簡易
2020-03-18,4420,939,870,1809,科工館,簡易
2020-03-19,4420,938,877,1815,科工館,簡易
2020-03-20,4420,1101,1057,2158,科工館,簡易
2020-03-21,4420,666,641,1307,科工館,簡易
2020-03-22,4420,669,624,1293,科工館,簡易
2020-03-23,4420,988,913,1901,科工館,簡易
2020-03-24,4420,890,829,1719,科工館,簡易
2020-03-25,4420,898,833,1731,科工館,簡易
2020-03-26,4420,895,853,1748,科工館,簡易
2020-03-27,4420,1082,1024,2106,科工館,簡易
2020-03-28,4420,667,626,1293,科工館,簡易
2020-03-29,4420,545,590,1135,科工館,簡易
2020-03-30,4420,978,888,1866,科工館,簡易
2020-03-31,4420,884,849,1733,科工館,簡易
2020-04-01,4420,1072,1078,2150,科工館,簡易
2020-04-02,4420,628,570,1198,科工館,簡易
2020-04-03,4420,581,534,1115,科工館,簡易
2020-04-04,4420,418,436,854,科工館,簡易
2020-04-05,4420,553,579,1132,科工館,簡易
2020-04-06,4420,903,816,1719,科工館,簡易
2020-04-07,4420,833,780,1613,科工館,簡易
2020-04-08,4420,801,755,1556,科工館,簡易
2020-04-09,4420,904,825,1729,科工館,簡易
2020-04-10,4420,843,715,1558,科工館,簡易
2020-04-11,4420,550,591,1141,科工館,簡易
2020-04-12,4420,599,538,1137,科工館,簡易
2020-04-13,4420,896,816,1712,科工館,簡易
2020-04-14,4420,860,787,1647,科工館,簡易
2020-04-15,4420,862,787,1649,科工館,簡易
2020-04-16,4420,898,845,1743,科工館,簡易
2020-04-17,4420,1015,1020,2035,科工館,簡易
2020-04-18,4420,742,736,1478,科工館,簡易
2020-04-19,4420,663,681,1344,科工館,簡易
2020-04-20,4420,917,818,1735,科工館,簡易
2020-04-21,4420,849,737,1586,科工館,簡易
2020-04-22,4420,793,710,1503,科工館,簡易
2020-04-23,4420,753,703,1456,科工館,簡易
2020-04-24,4420,970,924,1894,科工館,簡易
2020-04-25,4420,560,518,1078,科工館,簡易
2020-04-26,4420,463,487,950,科工館,簡易
2020-04-27,4420,885,793,1678,科工館,簡易
2020-04-28,4420,780,739,1519,科工館,簡易
2020-04-29,4420,822,736,1558,科工館,簡易
2020-04-30,4420,874,834,1708,科工館,簡易
2020-05-01,4420,978,859,1837,科工館,簡易
2020-05-02,4420,650,627,1277,科工館,簡易
2020-05-03,4420,652,663,1315,科工館,簡易
2020-05-04,4420,914,809,1723,科工館,簡易
2020-05-05,4420,835,775,1610,科工館,簡易
2020-05-06,4420,823,780,1603,科工館,簡易
2020-05-07,4420,892,846,1738,科工館,簡易
2020-05-08,4420,1031,1099,2130,科工館,簡易
2020-05-09,4420,741,659,1400,科工館,簡易
2020-05-10,4420,736,669,1405,科工館,簡易
2020-05-11,4420,952,893,1845,科工館,簡易
2020-05-12,4420,834,789,1623,科工館,簡易
2020-05-13,4420,875,808,1683,科工館,簡易
2020-05-14,4420,921,830,1751,科工館,簡易
2020-05-15,4420,1051,1074,2125,科工館,簡易
2020-05-16,4420,597,572,1169,科工館,簡易
2020-05-17,4420,642,660,1302,科工館,簡易
2020-05-18,4420,974,861,1835,科工館,簡易
2020-05-19,4420,873,813,1686,科工館,簡易
2020-05-20,4420,905,814,1719,科工館,簡易
2020-05-21,4420,839,800,1639,科工館,簡易
2020-05-22,4420,901,864,1765,科工館,簡易
2020-05-23,4420,613,619,1232,科工館,簡易
2020-05-24,4420,792,731,1523,科工館,簡易
2020-05-25,4420,1001,932,1933,科工館,簡易
2020-05-26,4420,919,816,1735,科工館,簡易
2020-05-27,4420,862,785,1647,科工館,簡易
2020-05-28,4420,955,866,1821,科工館,簡易
2020-05-29,4420,1078,1096,2174,科工館,簡易
2020-05-30,4420,896,776,1672,科工館,簡易
2020-05-31,4420,872,823,1695,科工館,簡易
2020-06-01,4420,979,869,1848,科工館,簡易
2020-06-02,4420,915,824,1739,科工館,簡易
2020-06-03,4420,926,898,1824,科工館,簡易
2020-06-04,4420,890,891,1781,科工館,簡易
2020-06-05,4420,1068,1262,2330,科工館,簡易
2020-06-06,4420,879,867,1746,科工館,簡易
2020-06-07,4420,897,765,1662,科工館,簡易
2020-06-08,4420,1014,915,1929,科工館,簡易
2020-06-09,4420,939,860,1799,科工館,簡易
2020-06-10,4420,933,859,1792,科工館,簡易
2020-06-11,4420,990,930,1920,科工館,簡易
2020-06-12,4420,1141,1119,2260,科工館,簡易
2020-06-13,4420,1094,1020,2114,科工館,簡易
2020-06-14,4420,839,896,1735,科工館,簡易
2020-06-15,4420,984,912,1896,科工館,簡易
2020-06-16,4420,1036,992,2028,科工館,簡易
2020-06-17,4420,923,940,1863,科工館,簡易
2020-06-18,4420,948,961,1909,科工館,簡易
2020-06-19,4420,1139,1111,2250,科工館,簡易
2020-06-20,4420,1112,1033,2145,科工館,簡易
2020-06-21,4420,1048,1053,2101,科工館,簡易
2020-06-22,4420,962,908,1870,科工館,簡易
2020-06-23,4420,988,1027,2015,科工館,簡易
2020-06-24,4420,1241,1266,2507,科工館,簡易
2020-06-25,4420,978,946,1924,科工館,簡易
2020-06-26,4420,1184,1256,2440,科工館,簡易
2020-06-27,4420,1121,1099,2220,科工館,簡易
2020-06-28,4420,931,963,1894,科工館,簡易
2020-06-29,4420,1033,963,1996,科工館,簡易
2020-06-30,4420,984,961,1945,科工館,簡易
2020-07-01,4420,997,968,1965,科工館,簡易
2020-07-02,4420,1004,939,1943,科工館,簡易
2020-07-03,4420,1195,1169,2364,科工館,簡易
2020-07-04,4420,935,940,1875,科工館,簡易
2020-07-05,4420,777,909,1686,科工館,簡易
2020-07-06,4420,1024,955,1979,科工館,簡易
2020-07-07,4420,1039,1025,2064,科工館,簡易
2020-07-08,4420,1012,964,1976,科工館,簡易
2020-07-09,4420,1018,984,2002,科工館,簡易
2020-07-10,4420,1215,1149,2364,科工館,簡易
2020-07-11,4420,930,972,1902,科工館,簡易
2020-07-12,4420,998,1022,2020,科工館,簡易
2020-07-13,4420,949,952,1901,科工館,簡易
2020-07-14,4420,1092,1114,2206,科工館,簡易
2020-07-15,4420,1105,1147,2252,科工館,簡易
2020-07-16,4420,1064,1083,2147,科工館,簡易
2020-07-17,4420,1245,1296,2541,科工館,簡易
2020-07-18,4420,1196,1175,2371,科工館,簡易
2020-07-19,4420,1208,1210,2418,科工館,簡易
2020-07-20,4420,1065,1053,2118,科工館,簡易
2020-07-21,4420,1183,1193,2376,科工館,簡易
2020-07-22,4420,1150,1201,2351,科工館,簡易
2020-07-23,4420,1140,1175,2315,科工館,簡易
2020-07-24,4420,1371,1405,2776,科工館,簡易
2020-07-25,4420,1239,1243,2482,科工館,簡易
2020-07-26,4420,1090,1113,2203,科工館,簡易
2020-07-27,4420,1034,1018,2052,科工館,簡易
2020-07-28,4420,1216,1247,2463,科工館,簡易
2020-07-29,4420,1213,1173,2386,科工館,簡易
2020-07-30,4420,1292,1260,2552,科工館,簡易
2020-07-31,4420,1424,1460,2884,科工館,簡易
2020-08-01,4420,1111,1120,2231,科工館,簡易
2020-08-02,4420,1050,1114,2164,科工館,簡易
2020-08-03,4420,962,935,1897,科工館,簡易
2020-08-04,4420,1067,1055,2122,科工館,簡易
2020-08-05,4420,1266,1191,2457,科工館,簡易
2020-08-06,4420,1320,1299,2619,科工館,簡易
2020-08-07,4420,1385,1375,2760,科工館,簡易
2020-08-08,4420,1182,1102,2284,科工館,簡易
2020-08-09,4420,1144,1164,2308,科工館,簡易
2020-08-10,4420,1128,1010,2138,科工館,簡易
2020-08-11,4420,1157,1143,2300,科工館,簡易
2020-08-12,4420,1328,1276,2604,科工館,簡易
2020-08-13,4420,1225,1244,2469,科工館,簡易
2020-08-14,4420,1423,1598,3021,科工館,簡易
2020-08-15,4420,1285,1243,2528,科工館,簡易
2020-08-16,4420,1256,1203,2459,科工館,簡易
2020-08-17,4420,1166,1041,2207,科工館,簡易
2020-08-18,4420,1371,1381,2752,科工館,簡易
2020-08-19,4420,1232,1184,2416,科工館,簡易
2020-08-20,4420,1283,1266,2549,科工館,簡易
2020-08-21,4420,1444,1451,2895,科工館,簡易
2020-08-22,4420,1164,1116,2280,科工館,簡易
2020-08-23,4420,1098,1156,2254,科工館,簡易
2020-08-24,4420,1036,971,2007,科工館,簡易
2020-08-25,4420,1284,1254,2538,科工館,簡易
2020-08-26,4420,1132,1091,2223,科工館,簡易
2020-08-27,4420,956,952,1908,科工館,簡易
2020-08-28,4420,1102,1191,2293,科工館,簡易
2020-08-29,4420,1077,1033,2110,科工館,簡易
2020-08-30,4420,950,947,1897,科工館,簡易
2020-08-31,4420,1036,1005,2041,科工館,簡易
2020-09-01,4420,1056,970,2026,科工館,簡易
2020-09-02,4420,1023,978,2001,科工館,簡易
2020-09-03,4420,1076,1030,2106,科工館,簡易
2020-09-04,4420,1298,1255,2553,科工館,簡易
2020-09-05,4420,1010,1038,2048,科工館,簡易
2020-09-06,4420,1103,1208,2311,科工館,簡易
2020-09-07,4420,1134,1070,2204,科工館,簡易
2020-09-08,4420,1013,925,1938,科工館,簡易
2020-09-09,4420,1138,1063,2201,科工館,簡易
2020-09-10,4420,1164,1095,2259,科工館,簡易
2020-09-11,4420,1309,1280,2589,科工館,簡易
2020-09-12,4420,1176,1153,2329,科工館,簡易
2020-09-13,4420,1104,1157,2261,科工館,簡易
2020-09-14,4420,1132,1078,2210,科工館,簡易
2020-09-15,4420,1079,1003,2082,科工館,簡易
2020-09-16,4420,1053,1014,2067,科工館,簡易
2020-09-17,4420,1015,966,1981,科工館,簡易
2020-09-18,4420,1322,1265,2587,科工館,簡易
2020-09-19,4420,1078,1006,2084,科工館,簡易
2020-09-20,4420,1042,1035,2077,科工館,簡易
2020-09-21,4420,1115,1012,2127,科工館,簡易
2020-09-22,4420,1074,992,2066,科工館,簡易
2020-09-23,4420,1120,1058,2178,科工館,簡易
2020-09-24,4420,1115,1032,2147,科工館,簡易
2020-09-25,4420,1206,1135,2341,科工館,簡易
2020-09-26,4420,1205,1127,2332,科工館,簡易
2020-09-27,4420,919,976,1895,科工館,簡易
2020-09-28,4420,1103,985,2088,科工館,簡易
2020-09-29,4420,1077,1071,2148,科工館,簡易
2020-09-30,4420,1431,1370,2801,科工館,簡易
2020-10-01,4420,1157,1060,2217,科工館,簡易
2020-10-02,4420,1108,1091,2199,科工館,簡易
2020-10-03,4420,1036,1065,2101,科工館,簡易
2020-10-04,4420,1004,1089,2093,科工館,簡易
2020-10-05,4420,1181,1017,2198,科工館,簡易
2020-10-06,4420,1066,952,2018,科工館,簡易
2020-10-07,4420,1097,1017,2114,科工館,簡易
2020-10-08,4420,1378,1230,2608,科工館,簡易
2020-10-09,4420,1127,1013,2140,科工館,簡易
2020-10-10,4420,1038,926,1964,科工館,簡易
2020-10-11,4420,960,1053,2013,科工館,簡易
2020-10-12,4420,1164,1028,2192,科工館,簡易
2020-10-13,4420,1086,992,2078,科工館,簡易
2020-10-14,4420,1120,1070,2190,科工館,簡易
2020-10-15,4420,1127,1047,2174,科工館,簡易
2020-10-16,4420,1430,1334,2764,科工館,簡易
2020-10-17,4420,1060,1031,2091,科工館,簡易
2020-10-18,4420,1159,1110,2269,科工館,簡易
2020-10-19,4420,1169,1018,2187,科工館,簡易
2020-10-20,4420,1115,1005,2120,科工館,簡易
2020-10-21,4420,1148,1064,2212,科工館,簡易
2020-10-22,4420,1214,1082,2296,科工館,簡易
2020-10-23,4420,2450,2331,4781,科工館,簡易
2020-10-24,4420,1403,1391,2794,科工館,簡易
2020-10-25,4420,1025,978,2003,科工館,簡易
2020-10-26,4420,1124,1031,2155,科工館,簡易
2020-10-27,4420,1175,1032,2207,科工館,簡易
2020-10-28,4420,1152,1055,2207,科工館,簡易
2020-10-29,4420,1120,1005,2125,科工館,簡易
2020-10-30,4420,1446,1364,2810,科工館,簡易
2020-10-31,4420,1115,1128,2243,科工館,簡易
2020-11-01,4420,1050,1100,2150,科工館,簡易
2020-11-02,4420,1147,1006,2153,科工館,簡易
2020-11-03,4420,1071,957,2028,科工館,簡易
2020-11-04,4420,1124,987,2111,科工館,簡易
2020-11-05,4420,1170,1032,2202,科工館,簡易
2020-11-06,4420,1409,1347,2756,科工館,簡易
2020-11-07,4420,1095,1035,2130,科工館,簡易
2020-11-08,4420,1004,1019,2023,科工館,簡易
2020-11-09,4420,1044,976,2020,科工館,簡易
2020-11-10,4420,1074,1012,2086,科工館,簡易
2020-11-11,4420,1079,989,2068,科工館,簡易
2020-11-12,4420,1158,1071,2229,科工館,簡易
2020-11-13,4420,1395,1426,2821,科工館,簡易
2020-11-14,4420,1118,1082,2200,科工館,簡易
2020-11-15,4420,1109,1004,2113,科工館,簡易
2020-11-16,4420,1186,1040,2226,科工館,簡易
2020-11-17,4420,1134,1053,2187,科工館,簡易
2020-11-18,4420,1025,1013,2038,科工館,簡易
2020-11-19,4420,1059,998,2057,科工館,簡易
2020-11-20,4420,1521,1419,2940,科工館,簡易
2020-11-21,4420,1020,958,1978,科工館,簡易
2020-11-22,4420,1000,1060,2060,科工館,簡易
2020-11-23,4420,1142,988,2130,科工館,簡易
2020-11-24,4420,1098,976,2074,科工館,簡易
2020-11-25,4420,1050,990,2040,科工館,簡易
2020-11-26,4420,1097,986,2083,科工館,簡易
2020-11-27,4420,1327,1300,2627,科工館,簡易
2020-11-28,4420,965,956,1921,科工館,簡易
2020-11-29,4420,1071,1010,2081,科工館,簡易
2020-11-30,4420,1149,1020,2169,科工館,簡易
2020-12-01,4420,1016,943,1959,科工館,簡易
2020-12-02,4420,1047,988,2035,科工館,簡易
2020-12-03,4420,1073,1017,2090,科工館,簡易
2020-12-04,4420,1254,1270,2524,科工館,簡易
2020-12-05,4420,1086,1024,2110,科工館,簡易
2020-12-06,4420,1158,1138,2296,科工館,簡易
2020-12-07,4420,1172,1067,2239,科工館,簡易
2020-12-08,4420,1062,954,2016,科工館,簡易
2020-12-09,4420,1034,990,2024,科工館,簡易
2020-12-10,4420,1115,974,2089,科工館,簡易
2020-12-11,4420,1326,1240,2566,科工館,簡易
2020-12-12,4420,1149,1088,2237,科工館,簡易
2020-12-13,4420,1124,1169,2293,科工館,簡易
2020-12-14,4420,1159,1021,2180,科工館,簡易
2020-12-15,4420,1030,930,1960,科工館,簡易
2020-12-16,4420,1108,1018,2126,科工館,簡易
2020-12-17,4420,1106,1003,2109,科工館,簡易
2020-12-18,4420,1493,1356,2849,科工館,簡易
2020-12-19,4420,1185,1178,2363,科工館,簡易
2020-12-20,4420,1045,1082,2127,科工館,簡易
2020-12-21,4420,1129,1000,2129,科工館,簡易
2020-12-22,4420,1057,940,1997,科工館,簡易
2020-12-23,4420,1105,1016,2121,科工館,簡易
2020-12-24,4420,1007,980,1987,科工館,簡易
2020-12-25,4420,1324,1300,2624,科工館,簡易
2020-12-26,4420,1035,1084,2119,科工館,簡易
2020-12-27,4420,953,982,1935,科工館,簡易
2020-12-28,4420,1056,993,2049,科工館,簡易
2020-12-29,4420,1119,1022,2141,科工館,簡易
2020-12-30,4420,1065,995,2060,科工館,簡易
2020-12-31,4420,1349,1230,2579,科工館,簡易
2020-01-01,4430,1059,1031,2090,正義,簡易
2020-01-02,4430,1031,969,2000,正義,簡易
2020-01-03,4430,1268,1195,2463,正義,簡易
2020-01-04,4430,1136,1070,2206,正義,簡易
2020-01-05,4430,1050,992,2042,正義,簡易
2020-01-06,4430,1073,1036,2109,正義,簡易
2020-01-07,4430,1035,1005,2040,正義,簡易
2020-01-08,4430,1040,971,2011,正義,簡易
2020-01-09,4430,1045,1094,2139,正義,簡易
2020-01-10,4430,1306,1538,2844,正義,簡易
2020-01-11,4430,1249,1225,2474,正義,簡易
2020-01-12,4430,1204,1001,2205,正義,簡易
2020-01-13,4430,1190,1043,2233,正義,簡易
2020-01-14,4430,1004,934,1938,正義,簡易
2020-01-15,4430,1022,1016,2038,正義,簡易
2020-01-16,4430,1142,1082,2224,正義,簡易
2020-01-17,4430,1022,1089,2111,正義,簡易
2020-01-18,4430,1061,1028,2089,正義,簡易
2020-01-19,4430,962,941,1903,正義,簡易
2020-01-20,4430,924,952,1876,正義,簡易
2020-01-21,4430,971,1073,2044,正義,簡易
2020-01-22,4430,1017,1111,2128,正義,簡易
2020-01-23,4430,894,981,1875,正義,簡易
2020-01-24,4430,831,746,1577,正義,簡易
2020-01-25,4430,1106,1007,2113,正義,簡易
2020-01-26,4430,1146,1096,2242,正義,簡易
2020-01-27,4430,1232,1140,2372,正義,簡易
2020-01-28,4430,852,873,1725,正義,簡易
2020-01-29,4430,945,864,1809,正義,簡易
2020-01-30,4430,866,790,1656,正義,簡易
2020-01-31,4430,839,875,1714,正義,簡易
2020-02-01,4430,726,755,1481,正義,簡易
2020-02-02,4430,755,694,1449,正義,簡易
2020-02-03,4430,789,768,1557,正義,簡易
2020-02-04,4430,811,804,1615,正義,簡易
2020-02-05,4430,746,763,1509,正義,簡易
2020-02-06,4430,833,853,1686,正義,簡易
2020-02-07,4430,883,940,1823,正義,簡易
2020-02-08,4430,813,739,1552,正義,簡易
2020-02-09,4430,782,805,1587,正義,簡易
2020-02-10,4430,810,783,1593,正義,簡易
2020-02-11,4430,740,773,1513,正義,簡易
2020-02-12,4430,754,775,1529,正義,簡易
2020-02-13,4430,797,846,1643,正義,簡易
2020-02-14,4430,866,919,1785,正義,簡易
2020-02-15,4430,848,890,1738,正義,簡易
2020-02-16,4430,759,736,1495,正義,簡易
2020-02-17,4430,754,709,1463,正義,簡易
2020-02-18,4430,757,773,1530,正義,簡易
2020-02-19,4430,754,785,1539,正義,簡易
2020-02-20,4430,744,815,1559,正義,簡易
2020-02-21,4430,927,971,1898,正義,簡易
2020-02-22,4430,839,804,1643,正義,簡易
2020-02-23,4430,809,753,1562,正義,簡易
2020-02-24,4430,833,792,1625,正義,簡易
2020-02-25,4430,927,841,1768,正義,簡易
2020-02-26,4430,943,888,1831,正義,簡易
2020-02-27,4430,1064,1074,2138,正義,簡易
2020-02-28,4430,885,839,1724,正義,簡易
2020-02-29,4430,752,707,1459,正義,簡易
2020-03-01,4430,778,726,1504,正義,簡易
2020-03-02,4430,934,893,1827,正義,簡易
2020-03-03,4430,886,874,1760,正義,簡易
2020-03-04,4430,868,835,1703,正義,簡易
2020-03-05,4430,945,909,1854,正義,簡易
2020-03-06,4430,1058,1113,2171,正義,簡易
2020-03-07,4430,723,711,1434,正義,簡易
2020-03-08,4430,744,748,1492,正義,簡易
2020-03-09,4430,980,854,1834,正義,簡易
2020-03-10,4430,894,807,1701,正義,簡易
2020-03-11,4430,954,884,1838,正義,簡易
2020-03-12,4430,910,890,1800,正義,簡易
2020-03-13,4430,1045,1117,2162,正義,簡易
2020-03-14,4430,697,695,1392,正義,簡易
2020-03-15,4430,848,810,1658,正義,簡易
2020-03-16,4430,971,861,1832,正義,簡易
2020-03-17,4430,918,821,1739,正義,簡易
2020-03-18,4430,855,785,1640,正義,簡易
2020-03-19,4430,828,821,1649,正義,簡易
2020-03-20,4430,1007,1057,2064,正義,簡易
2020-03-21,4430,657,636,1293,正義,簡易
2020-03-22,4430,664,632,1296,正義,簡易
2020-03-23,4430,917,800,1717,正義,簡易
2020-03-24,4430,840,738,1578,正義,簡易
2020-03-25,4430,854,778,1632,正義,簡易
2020-03-26,4430,827,817,1644,正義,簡易
2020-03-27,4430,954,992,1946,正義,簡易
2020-03-28,4430,622,629,1251,正義,簡易
2020-03-29,4430,666,577,1243,正義,簡易
2020-03-30,4430,915,795,1710,正義,簡易
2020-03-31,4430,820,806,1626,正義,簡易
2020-04-01,4430,883,1045,1928,正義,簡易
2020-04-02,4430,643,650,1293,正義,簡易
2020-04-03,4430,636,563,1199,正義,簡易
2020-04-04,4430,491,469,960,正義,簡易
2020-04-05,4430,675,623,1298,正義,簡易
2020-04-06,4430,990,787,1777,正義,簡易
2020-04-07,4430,793,741,1534,正義,簡易
2020-04-08,4430,759,705,1464,正義,簡易
2020-04-09,4430,799,751,1550,正義,簡易
2020-04-10,4430,764,714,1478,正義,簡易
2020-04-11,4430,581,543,1124,正義,簡易
2020-04-12,4430,558,511,1069,正義,簡易
2020-04-13,4430,868,770,1638,正義,簡易
2020-04-14,4430,807,710,1517,正義,簡易
2020-04-15,4430,794,760,1554,正義,簡易
2020-04-16,4430,798,797,1595,正義,簡易
2020-04-17,4430,931,968,1899,正義,簡易
2020-04-18,4430,592,615,1207,正義,簡易
2020-04-19,4430,603,578,1181,正義,簡易
2020-04-20,4430,854,756,1610,正義,簡易
2020-04-21,4430,781,717,1498,正義,簡易
2020-04-22,4430,696,653,1349,正義,簡易
2020-04-23,4430,714,673,1387,正義,簡易
2020-04-24,4430,846,873,1719,正義,簡易
2020-04-25,4430,532,525,1057,正義,簡易
2020-04-26,4430,514,485,999,正義,簡易
2020-04-27,4430,832,740,1572,正義,簡易
2020-04-28,4430,774,706,1480,正義,簡易
2020-04-29,4430,716,671,1387,正義,簡易
2020-04-30,4430,835,833,1668,正義,簡易
2020-05-01,4430,856,859,1715,正義,簡易
2020-05-02,4430,558,574,1132,正義,簡易
2020-05-03,4430,678,634,1312,正義,簡易
2020-05-04,4430,902,782,1684,正義,簡易
2020-05-05,4430,799,750,1549,正義,簡易
2020-05-06,4430,788,729,1517,正義,簡易
2020-05-07,4430,776,795,1571,正義,簡易
2020-05-08,4430,951,1053,2004,正義,簡易
2020-05-09,4430,675,686,1361,正義,簡易
2020-05-10,4430,748,660,1408,正義,簡易
2020-05-11,4430,941,871,1812,正義,簡易
2020-05-12,4430,846,744,1590,正義,簡易
2020-05-13,4430,855,785,1640,正義,簡易
2020-05-14,4430,853,819,1672,正義,簡易
2020-05-15,4430,950,1006,1956,正義,簡易
2020-05-16,4430,631,630,1261,正義,簡易
2020-05-17,4430,721,649,1370,正義,簡易
2020-05-18,4430,896,817,1713,正義,簡易
2020-05-19,4430,804,782,1586,正義,簡易
2020-05-20,4430,826,763,1589,正義,簡易
2020-05-21,4430,806,792,1598,正義,簡易
2020-05-22,4430,824,857,1681,正義,簡易
2020-05-23,4430,618,627,1245,正義,簡易
2020-05-24,4430,733,676,1409,正義,簡易
2020-05-25,4430,935,829,1764,正義,簡易
2020-05-26,4430,827,760,1587,正義,簡易
2020-05-27,4430,781,780,1561,正義,簡易
2020-05-28,4430,858,830,1688,正義,簡易
2020-05-29,4430,1030,1040,2070,正義,簡易
2020-05-30,4430,787,748,1535,正義,簡易
2020-05-31,4430,746,753,1499,正義,簡易
2020-06-01,4430,916,790,1706,正義,簡易
2020-06-02,4430,881,808,1689,正義,簡易
2020-06-03,4430,855,800,1655,正義,簡易
2020-06-04,4430,874,895,1769,正義,簡易
2020-06-05,4430,1013,1267,2280,正義,簡易
2020-06-06,4430,919,888,1807,正義,簡易
2020-06-07,4430,972,765,1737,正義,簡易
2020-06-08,4430,989,845,1834,正義,簡易
2020-06-09,4430,888,804,1692,正義,簡易
2020-06-10,4430,880,865,1745,正義,簡易
2020-06-11,4430,1147,1061,2208,正義,簡易
2020-06-12,4430,1046,1009,2055,正義,簡易
2020-06-13,4430,875,805,1680,正義,簡易
2020-06-14,4430,787,815,1602,正義,簡易
2020-06-15,4430,960,891,1851,正義,簡易
2020-06-16,4430,951,867,1818,正義,簡易
2020-06-17,4430,901,905,1806,正義,簡易
2020-06-18,4430,908,870,1778,正義,簡易
2020-06-19,4430,1031,993,2024,正義,簡易
2020-06-20,4430,904,860,1764,正義,簡易
2020-06-21,4430,762,766,1528,正義,簡易
2020-06-22,4430,921,886,1807,正義,簡易
2020-06-23,4430,956,861,1817,正義,簡易
2020-06-24,4430,1108,1182,2290,正義,簡易
2020-06-25,4430,915,862,1777,正義,簡易
2020-06-26,4430,940,962,1902,正義,簡易
2020-06-27,4430,920,843,1763,正義,簡易
2020-06-28,4430,905,862,1767,正義,簡易
2020-06-29,4430,1026,930,1956,正義,簡易
2020-06-30,4430,910,891,1801,正義,簡易
2020-07-01,4430,881,856,1737,正義,簡易
2020-07-02,4430,925,913,1838,正義,簡易
2020-07-03,4430,1049,1084,2133,正義,簡易
2020-07-04,4430,836,809,1645,正義,簡易
2020-07-05,4430,813,849,1662,正義,簡易
2020-07-06,4430,932,908,1840,正義,簡易
2020-07-07,4430,911,871,1782,正義,簡易
2020-07-08,4430,874,922,1796,正義,簡易
2020-07-09,4430,898,856,1754,正義,簡易
2020-07-10,4430,1110,1053,2163,正義,簡易
2020-07-11,4430,846,857,1703,正義,簡易
2020-07-12,4430,824,833,1657,正義,簡易
2020-07-13,4430,983,942,1925,正義,簡易
2020-07-14,4430,902,903,1805,正義,簡易
2020-07-15,4430,838,865,1703,正義,簡易
2020-07-16,4430,863,913,1776,正義,簡易
2020-07-17,4430,1066,1029,2095,正義,簡易
2020-07-18,4430,900,872,1772,正義,簡易
2020-07-19,4430,905,846,1751,正義,簡易
2020-07-20,4430,1008,989,1997,正義,簡易
2020-07-21,4430,979,916,1895,正義,簡易
2020-07-22,4430,999,930,1929,正義,簡易
2020-07-23,4430,1014,944,1958,正義,簡易
2020-07-24,4430,1118,1092,2210,正義,簡易
2020-07-25,4430,976,952,1928,正義,簡易
2020-07-26,4430,814,816,1630,正義,簡易
2020-07-27,4430,1034,880,1914,正義,簡易
2020-07-28,4430,1020,995,2015,正義,簡易
2020-07-29,4430,944,914,1858,正義,簡易
2020-07-30,4430,1006,980,1986,正義,簡易
2020-07-31,4430,1078,1022,2100,正義,簡易
2020-08-01,4430,949,892,1841,正義,簡易
2020-08-02,4430,836,832,1668,正義,簡易
2020-08-03,4430,873,822,1695,正義,簡易
2020-08-04,4430,877,907,1784,正義,簡易
2020-08-05,4430,932,924,1856,正義,簡易
2020-08-06,4430,1016,1018,2034,正義,簡易
2020-08-07,4430,1158,1151,2309,正義,簡易
2020-08-08,4430,894,873,1767,正義,簡易
2020-08-09,4430,902,893,1795,正義,簡易
2020-08-10,4430,1038,957,1995,正義,簡易
2020-08-11,4430,876,895,1771,正義,簡易
2020-08-12,4430,974,963,1937,正義,簡易
2020-08-13,4430,1014,1046,2060,正義,簡易
2020-08-14,4430,1164,1335,2499,正義,簡易
2020-08-15,4430,964,937,1901,正義,簡易
2020-08-16,4430,1008,918,1926,正義,簡易
2020-08-17,4430,968,922,1890,正義,簡易
2020-08-18,4430,886,934,1820,正義,簡易
2020-08-19,4430,914,894,1808,正義,簡易
2020-08-20,4430,940,926,1866,正義,簡易
2020-08-21,4430,1001,1111,2112,正義,簡易
2020-08-22,4430,821,784,1605,正義,簡易
2020-08-23,4430,739,788,1527,正義,簡易
2020-08-24,4430,866,854,1720,正義,簡易
2020-08-25,4430,840,872,1712,正義,簡易
2020-08-26,4430,751,750,1501,正義,簡易
2020-08-27,4430,768,756,1524,正義,簡易
2020-08-28,4430,972,956,1928,正義,簡易
2020-08-29,4430,883,799,1682,正義,簡易
2020-08-30,4430,724,634,1358,正義,簡易
2020-08-31,4430,1009,905,1914,正義,簡易
2020-09-01,4430,950,884,1834,正義,簡易
2020-09-02,4430,932,861,1793,正義,簡易
2020-09-03,4430,1010,925,1935,正義,簡易
2020-09-04,4430,1142,1079,2221,正義,簡易
2020-09-05,4430,891,868,1759,正義,簡易
2020-09-06,4430,841,846,1687,正義,簡易
2020-09-07,4430,1028,935,1963,正義,簡易
2020-09-08,4430,981,905,1886,正義,簡易
2020-09-09,4430,1030,936,1966,正義,簡易
2020-09-10,4430,1011,942,1953,正義,簡易
2020-09-11,4430,1224,1146,2370,正義,簡易
2020-09-12,4430,944,886,1830,正義,簡易
2020-09-13,4430,973,951,1924,正義,簡易
2020-09-14,4430,1025,943,1968,正義,簡易
2020-09-15,4430,988,900,1888,正義,簡易
2020-09-16,4430,1006,888,1894,正義,簡易
2020-09-17,4430,1005,966,1971,正義,簡易
2020-09-18,4430,1229,1236,2465,正義,簡易
2020-09-19,4430,1110,1061,2171,正義,簡易
2020-09-20,4430,995,957,1952,正義,簡易
2020-09-21,4430,1044,925,1969,正義,簡易
2020-09-22,4430,1017,941,1958,正義,簡易
2020-09-23,4430,985,964,1949,正義,簡易
2020-09-24,4430,998,950,1948,正義,簡易
2020-09-25,4430,1111,1060,2171,正義,簡易
2020-09-26,4430,1045,994,2039,正義,簡易
2020-09-27,4430,912,855,1767,正義,簡易
2020-09-28,4430,1042,953,1995,正義,簡易
2020-09-29,4430,1035,954,1989,正義,簡易
2020-09-30,4430,1264,1414,2678,正義,簡易
2020-10-01,4430,1050,1032,2082,正義,簡易
2020-10-02,4430,1208,1164,2372,正義,簡易
2020-10-03,4430,1042,1020,2062,正義,簡易
2020-10-04,4430,1077,1003,2080,正義,簡易
2020-10-05,4430,1173,1006,2179,正義,簡易
2020-10-06,4430,1018,899,1917,正義,簡易
2020-10-07,4430,1071,930,2001,正義,簡易
2020-10-08,4430,1241,1262,2503,正義,簡易
2020-10-09,4430,1014,925,1939,正義,簡易
2020-10-10,4430,940,902,1842,正義,簡易
2020-10-11,4430,980,1024,2004,正義,簡易
2020-10-12,4430,1118,955,2073,正義,簡易
2020-10-13,4430,995,966,1961,正義,簡易
2020-10-14,4430,1041,972,2013,正義,簡易
2020-10-15,4430,986,971,1957,正義,簡易
2020-10-16,4430,1281,1234,2515,正義,簡易
2020-10-17,4430,982,981,1963,正義,簡易
2020-10-18,4430,979,977,1956,正義,簡易
2020-10-19,4430,1137,968,2105,正義,簡易
2020-10-20,4430,978,929,1907,正義,簡易
2020-10-21,4430,1012,965,1977,正義,簡易
2020-10-22,4430,1099,1012,2111,正義,簡易
2020-10-23,4430,1269,1209,2478,正義,簡易
2020-10-24,4430,1062,997,2059,正義,簡易
2020-10-25,4430,932,912,1844,正義,簡易
2020-10-26,4430,1101,1004,2105,正義,簡易
2020-10-27,4430,1045,957,2002,正義,簡易
2020-10-28,4430,1008,977,1985,正義,簡易
2020-10-29,4430,1086,1028,2114,正義,簡易
2020-10-30,4430,1248,1256,2504,正義,簡易
2020-10-31,4430,1061,974,2035,正義,簡易
2020-11-01,4430,1009,981,1990,正義,簡易
2020-11-02,4430,1028,929,1957,正義,簡易
2020-11-03,4430,1035,929,1964,正義,簡易
2020-11-04,4430,1054,1000,2054,正義,簡易
2020-11-05,4430,1076,1016,2092,正義,簡易
2020-11-06,4430,1275,1194,2469,正義,簡易
2020-11-07,4430,926,906,1832,正義,簡易
2020-11-08,4430,1000,922,1922,正義,簡易
2020-11-09,4430,1085,947,2032,正義,簡易
2020-11-10,4430,1006,945,1951,正義,簡易
2020-11-11,4430,1023,936,1959,正義,簡易
2020-11-12,4430,1041,1012,2053,正義,簡易
2020-11-13,4430,1258,1316,2574,正義,簡易
2020-11-14,4430,1007,976,1983,正義,簡易
2020-11-15,4430,1142,1118,2260,正義,簡易
2020-11-16,4430,1136,1004,2140,正義,簡易
2020-11-17,4430,1040,961,2001,正義,簡易
2020-11-18,4430,1018,975,1993,正義,簡易
2020-11-19,4430,1065,1008,2073,正義,簡易
2020-11-20,4430,1206,1277,2483,正義,簡易
2020-11-21,4430,1003,958,1961,正義,簡易
2020-11-22,4430,928,924,1852,正義,簡易
2020-11-23,4430,1101,972,2073,正義,簡易
2020-11-24,4430,1070,1004,2074,正義,簡易
2020-11-25,4430,1038,969,2007,正義,簡易
2020-11-26,4430,1033,986,2019,正義,簡易
2020-11-27,4430,1285,1324,2609,正義,簡易
2020-11-28,4430,1062,965,2027,正義,簡易
2020-11-29,4430,1053,1053,2106,正義,簡易
2020-11-30,4430,1145,1030,2175,正義,簡易
2020-12-01,4430,1021,916,1937,正義,簡易
2020-12-02,4430,1011,952,1963,正義,簡易
2020-12-03,4430,1024,1006,2030,正義,簡易
2020-12-04,4430,1290,1301,2591,正義,簡易
2020-12-05,4430,1168,1135,2303,正義,簡易
2020-12-06,4430,1095,1054,2149,正義,簡易
2020-12-07,4430,1088,993,2081,正義,簡易
2020-12-08,4430,1054,963,2017,正義,簡易
2020-12-09,4430,1011,945,1956,正義,簡易
2020-12-10,4430,1042,954,1996,正義,簡易
2020-12-11,4430,1236,1299,2535,正義,簡易
2020-12-12,4430,1082,1039,2121,正義,簡易
2020-12-13,4430,1056,1016,2072,正義,簡易
2020-12-14,4430,1135,1055,2190,正義,簡易
2020-12-15,4430,1090,984,2074,正義,簡易
2020-12-16,4430,1066,959,2025,正義,簡易
2020-12-17,4430,1083,1028,2111,正義,簡易
2020-12-18,4430,1330,1362,2692,正義,簡易
2020-12-19,4430,1142,1086,2228,正義,簡易
2020-12-20,4430,1008,1001,2009,正義,簡易
2020-12-21,4430,1092,982,2074,正義,簡易
2020-12-22,4430,1090,1007,2097,正義,簡易
2020-12-23,4430,1013,983,1996,正義,簡易
2020-12-24,4430,1034,968,2002,正義,簡易
2020-12-25,4430,1265,1251,2516,正義,簡易
2020-12-26,4430,1020,953,1973,正義,簡易
2020-12-27,4430,1017,1006,2023,正義,簡易
2020-12-28,4430,1088,977,2065,正義,簡易
2020-12-29,4430,1050,989,2039,正義,簡易
2020-12-30,4430,1055,983,2038,正義,簡易
2020-12-31,4430,1273,1212,2485,正義,簡易
2020-01-01,4440,5054,4985,10039,鳳山,二等
2020-01-02,4440,4513,4455,8968,鳳山,二等
2020-01-03,4440,5827,5547,11374,鳳山,二等
2020-01-04,4440,5128,4914,10042,鳳山,二等
2020-01-05,4440,5326,5508,10834,鳳山,二等
2020-01-06,4440,4954,4651,9605,鳳山,二等
2020-01-07,4440,4500,4318,8818,鳳山,二等
2020-01-08,4440,4412,4349,8761,鳳山,二等
2020-01-09,4440,4726,5192,9918,鳳山,二等
2020-01-10,4440,7196,8277,15473,鳳山,二等
2020-01-11,4440,5990,5864,11854,鳳山,二等
2020-01-12,4440,7043,6407,13450,鳳山,二等
2020-01-13,4440,5534,4849,10383,鳳山,二等
2020-01-14,4440,4872,4581,9453,鳳山,二等
2020-01-15,4440,4695,4538,9233,鳳山,二等
2020-01-16,4440,5290,4802,10092,鳳山,二等
2020-01-17,4440,5582,5379,10961,鳳山,二等
2020-01-18,4440,4913,4628,9541,鳳山,二等
2020-01-19,4440,5007,5565,10572,鳳山,二等
2020-01-20,4440,4853,4693,9546,鳳山,二等
2020-01-21,4440,4988,5055,10043,鳳山,二等
2020-01-22,4440,5770,6245,12015,鳳山,二等
2020-01-23,4440,4840,5293,10133,鳳山,二等
2020-01-24,4440,4278,3827,8105,鳳山,二等
2020-01-25,4440,6039,5595,11634,鳳山,二等
2020-01-26,4440,6231,5838,12069,鳳山,二等
2020-01-27,4440,6784,6568,13352,鳳山,二等
2020-01-28,4440,5173,5311,10484,鳳山,二等
2020-01-29,4440,5673,5529,11202,鳳山,二等
2020-01-30,4440,4747,4049,8796,鳳山,二等
2020-01-31,4440,4981,4729,9710,鳳山,二等
2020-02-01,4440,4224,3905,8129,鳳山,二等
2020-02-02,4440,4475,4845,9320,鳳山,二等
2020-02-03,4440,4344,4066,8410,鳳山,二等
2020-02-04,4440,3849,3747,7596,鳳山,二等
2020-02-05,4440,3921,3910,7831,鳳山,二等
2020-02-06,4440,3836,3826,7662,鳳山,二等
2020-02-07,4440,5117,4930,10047,鳳山,二等
2020-02-08,4440,4633,3839,8472,鳳山,二等
2020-02-09,4440,4892,5444,10336,鳳山,二等
2020-02-10,4440,4145,4119,8264,鳳山,二等
2020-02-11,4440,3685,3573,7258,鳳山,二等
2020-02-12,4440,3686,3682,7368,鳳山,二等
2020-02-13,4440,3467,3672,7139,鳳山,二等
2020-02-14,4440,4131,4362,8493,鳳山,二等
2020-02-15,4440,4080,4005,8085,鳳山,二等
2020-02-16,4440,4460,4502,8962,鳳山,二等
2020-02-17,4440,3603,3524,7127,鳳山,二等
2020-02-18,4440,3482,3472,6954,鳳山,二等
2020-02-19,4440,3591,3510,7101,鳳山,二等
2020-02-20,4440,3515,3626,7141,鳳山,二等
2020-02-21,4440,5033,4652,9685,鳳山,二等
2020-02-22,4440,4028,3820,7848,鳳山,二等
2020-02-23,4440,4174,5226,9400,鳳山,二等
2020-02-24,4440,3868,3778,7646,鳳山,二等
2020-02-25,4440,3936,3674,7610,鳳山,二等
2020-02-26,4440,4007,3902,7909,鳳山,二等
2020-02-27,4440,6584,5569,12153,鳳山,二等
2020-02-28,4440,4734,4358,9092,鳳山,二等
2020-02-29,4440,3705,3581,7286,鳳山,二等
2020-03-01,4440,5135,6110,11245,鳳山,二等
2020-03-02,4440,4450,3862,8312,鳳山,二等
2020-03-03,4440,3772,3637,7409,鳳山,二等
2020-03-04,4440,3690,3628,7318,鳳山,二等
2020-03-05,4440,3886,3868,7754,鳳山,二等
2020-03-06,4440,5397,5383,10780,鳳山,二等
2020-03-07,4440,3961,3509,7470,鳳山,二等
2020-03-08,4440,4611,4896,9507,鳳山,二等
2020-03-09,4440,4365,3869,8234,鳳山,二等
2020-03-10,4440,3823,3739,7562,鳳山,二等
2020-03-11,4440,3979,3719,7698,鳳山,二等
2020-03-12,4440,4013,4015,8028,鳳山,二等
2020-03-13,4440,6077,5597,11674,鳳山,二等
2020-03-14,4440,3989,3412,7401,鳳山,二等
2020-03-15,4440,4947,5647,10594,鳳山,二等
2020-03-16,4440,4399,3985,8384,鳳山,二等
2020-03-17,4440,3868,3579,7447,鳳山,二等
2020-03-18,4440,3775,3734,7509,鳳山,二等
2020-03-19,4440,3698,3641,7339,鳳山,二等
2020-03-20,4440,5334,5201,10535,鳳山,二等
2020-03-21,4440,3761,3234,6995,鳳山,二等
2020-03-22,4440,4064,4500,8564,鳳山,二等
2020-03-23,4440,3992,3610,7602,鳳山,二等
2020-03-24,4440,3469,3317,6786,鳳山,二等
2020-03-25,4440,3436,3427,6863,鳳山,二等
2020-03-26,4440,3618,3561,7179,鳳山,二等
2020-03-27,4440,5242,4982,10224,鳳山,二等
2020-03-28,4440,3434,2948,6382,鳳山,二等
2020-03-29,4440,3556,3895,7451,鳳山,二等
2020-03-30,4440,3858,3569,7427,鳳山,二等
2020-03-31,4440,3734,3749,7483,鳳山,二等
2020-04-01,4440,5818,5648,11466,鳳山,二等
2020-04-02,4440,3646,3669,7315,鳳山,二等
2020-04-03,4440,3208,3182,6390,鳳山,二等
2020-04-04,4440,2609,2739,5348,鳳山,二等
2020-04-05,4440,4695,5131,9826,鳳山,二等
2020-04-06,4440,4296,3470,7766,鳳山,二等
2020-04-07,4440,3413,3044,6457,鳳山,二等
2020-04-08,4440,3319,3129,6448,鳳山,二等
2020-04-09,4440,3305,3277,6582,鳳山,二等
2020-04-10,4440,4007,3567,7574,鳳山,二等
2020-04-11,4440,3140,2551,5691,鳳山,二等
2020-04-12,4440,3239,3607,6846,鳳山,二等
2020-04-13,4440,3708,3313,7021,鳳山,二等
2020-04-14,4440,3281,3228,6509,鳳山,二等
2020-04-15,4440,3410,3249,6659,鳳山,二等
2020-04-16,4440,3441,3508,6949,鳳山,二等
2020-04-17,4440,5349,4833,10182,鳳山,二等
2020-04-18,4440,3439,3146,6585,鳳山,二等
2020-04-19,4440,3691,4096,7787,鳳山,二等
2020-04-20,4440,3834,3432,7266,鳳山,二等
2020-04-21,4440,3086,3035,6121,鳳山,二等
2020-04-22,4440,3192,3022,6214,鳳山,二等
2020-04-23,4440,3213,3184,6397,鳳山,二等
2020-04-24,4440,4630,4460,9090,鳳山,二等
2020-04-25,4440,2691,2408,5099,鳳山,二等
2020-04-26,4440,3133,3317,6450,鳳山,二等
2020-04-27,4440,3554,3280,6834,鳳山,二等
2020-04-28,4440,3248,3060,6308,鳳山,二等
2020-04-29,4440,3236,3050,6286,鳳山,二等
2020-04-30,4440,3818,4021,7839,鳳山,二等
2020-05-01,4440,4770,4483,9253,鳳山,二等
2020-05-02,4440,3029,2914,5943,鳳山,二等
2020-05-03,4440,4207,4234,8441,鳳山,二等
2020-05-04,4440,3936,3509,7445,鳳山,二等
2020-05-05,4440,3419,3191,6610,鳳山,二等
2020-05-06,4440,3416,3264,6680,鳳山,二等
2020-05-07,4440,3608,3711,7319,鳳山,二等
2020-05-08,4440,5850,5735,11585,鳳山,二等
2020-05-09,4440,3795,3571,7366,鳳山,二等
2020-05-10,4440,4849,4959,9808,鳳山,二等
2020-05-11,4440,4285,3676,7961,鳳山,二等
2020-05-12,4440,3571,3298,6869,鳳山,二等
2020-05-13,4440,3594,3416,7010,鳳山,二等
2020-05-14,4440,3708,3705,7413,鳳山,二等
2020-05-15,4440,5613,5334,10947,鳳山,二等
2020-05-16,4440,3879,3369,7248,鳳山,二等
2020-05-17,4440,4355,4661,9016,鳳山,二等
2020-05-18,4440,4021,3624,7645,鳳山,二等
2020-05-19,4440,3533,3365,6898,鳳山,二等
2020-05-20,4440,3605,3353,6958,鳳山,二等
2020-05-21,4440,3218,3279,6497,鳳山,二等
2020-05-22,4440,4472,4351,8823,鳳山,二等
2020-05-23,4440,3518,2982,6500,鳳山,二等
2020-05-24,4440,4423,4420,8843,鳳山,二等
2020-05-25,4440,4177,3788,7965,鳳山,二等
2020-05-26,4440,3624,3344,6968,鳳山,二等
2020-05-27,4440,3364,3156,6520,鳳山,二等
2020-05-28,4440,3583,3577,7160,鳳山,二等
2020-05-29,4440,5862,5354,11216,鳳山,二等
2020-05-30,4440,4352,3842,8194,鳳山,二等
2020-05-31,4440,4567,5236,9803,鳳山,二等
2020-06-01,4440,4206,3886,8092,鳳山,二等
2020-06-02,4440,3769,3591,7360,鳳山,二等
2020-06-03,4440,3761,3691,7452,鳳山,二等
2020-06-04,4440,3820,3913,7733,鳳山,二等
2020-06-05,4440,5234,6842,12076,鳳山,二等
2020-06-06,4440,4657,4435,9092,鳳山,二等
2020-06-07,4440,5996,4833,10829,鳳山,二等
2020-06-08,4440,4750,3944,8694,鳳山,二等
2020-06-09,4440,3995,3719,7714,鳳山,二等
2020-06-10,4440,3934,3801,7735,鳳山,二等
2020-06-11,4440,4320,4220,8540,鳳山,二等
2020-06-12,4440,6015,5275,11290,鳳山,二等
2020-06-13,4440,4767,4351,9118,鳳山,二等
2020-06-14,4440,4829,5553,10382,鳳山,二等
2020-06-15,4440,4538,4128,8666,鳳山,二等
2020-06-16,4440,4035,3794,7829,鳳山,二等
2020-06-17,4440,3991,3828,7819,鳳山,二等
2020-06-18,4440,3867,3759,7626,鳳山,二等
2020-06-19,4440,4641,4560,9201,鳳山,二等
2020-06-20,4440,4273,4056,8329,鳳山,二等
2020-06-21,4440,4680,4573,9253,鳳山,二等
2020-06-22,4440,4327,4110,8437,鳳山,二等
2020-06-23,4440,4148,4249,8397,鳳山,二等
2020-06-24,4440,6409,6333,12742,鳳山,二等
2020-06-25,4440,5188,4883,10071,鳳山,二等
2020-06-26,4440,4716,4749,9465,鳳山,二等
2020-06-27,4440,4578,4778,9356,鳳山,二等
2020-06-28,4440,5920,6291,12211,鳳山,二等
2020-06-29,4440,4870,4336,9206,鳳山,二等
2020-06-30,4440,3976,3942,7918,鳳山,二等
2020-07-01,4440,3949,3758,7707,鳳山,二等
2020-07-02,4440,3818,3908,7726,鳳山,二等
2020-07-03,4440,5397,5257,10654,鳳山,二等
2020-07-04,4440,4227,3900,8127,鳳山,二等
2020-07-05,4440,4309,4881,9190,鳳山,二等
2020-07-06,4440,4615,4251,8866,鳳山,二等
2020-07-07,4440,4146,4006,8152,鳳山,二等
2020-07-08,4440,4106,4057,8163,鳳山,二等
2020-07-09,4440,4192,4188,8380,鳳山,二等
2020-07-10,4440,5904,5631,11535,鳳山,二等
2020-07-11,4440,4540,4263,8803,鳳山,二等
2020-07-12,4440,5117,5524,10641,鳳山,二等
2020-07-13,4440,4438,4190,8628,鳳山,二等
2020-07-14,4440,4653,4070,8723,鳳山,二等
2020-07-15,4440,3919,3895,7814,鳳山,二等
2020-07-16,4440,4267,4103,8370,鳳山,二等
2020-07-17,4440,5696,5732,11428,鳳山,二等
2020-07-18,4440,4977,4747,9724,鳳山,二等
2020-07-19,4440,5352,5687,11039,鳳山,二等
2020-07-20,4440,4778,4486,9264,鳳山,二等
2020-07-21,4440,4392,4286,8678,鳳山,二等
2020-07-22,4440,4687,4524,9211,鳳山,二等
2020-07-23,4440,4413,4387,8800,鳳山,二等
2020-07-24,4440,5736,5531,11267,鳳山,二等
2020-07-25,4440,4872,4614,9486,鳳山,二等
2020-07-26,4440,4978,5358,10336,鳳山,二等
2020-07-27,4440,4836,4487,9323,鳳山,二等
2020-07-28,4440,4349,4077,8426,鳳山,二等
2020-07-29,4440,4489,4545,9034,鳳山,二等
2020-07-30,4440,4314,4347,8661,鳳山,二等
2020-07-31,4440,5526,5348,10874,鳳山,二等
2020-08-01,4440,5053,4790,9843,鳳山,二等
2020-08-02,4440,5161,5641,10802,鳳山,二等
2020-08-03,4440,4179,3952,8131,鳳山,二等
2020-08-04,4440,3652,3568,7220,鳳山,二等
2020-08-05,4440,4277,4185,8462,鳳山,二等
2020-08-06,4440,4478,4330,8808,鳳山,二等
2020-08-07,4440,6006,5970,11976,鳳山,二等
2020-08-08,4440,4643,4335,8978,鳳山,二等
2020-08-09,4440,5514,5750,11264,鳳山,二等
2020-08-10,4440,4701,4403,9104,鳳山,二等
2020-08-11,4440,3813,3716,7529,鳳山,二等
2020-08-12,4440,4314,4279,8593,鳳山,二等
2020-08-13,4440,4425,4433,8858,鳳山,二等
2020-08-14,4440,5717,5996,11713,鳳山,二等
2020-08-15,4440,5085,4587,9672,鳳山,二等
2020-08-16,4440,5817,5499,11316,鳳山,二等
2020-08-17,4440,4975,4608,9583,鳳山,二等
2020-08-18,4440,4691,4520,9211,鳳山,二等
2020-08-19,4440,4288,4247,8535,鳳山,二等
2020-08-20,4440,4566,4376,8942,鳳山,二等
2020-08-21,4440,5265,5466,10731,鳳山,二等
2020-08-22,4440,4505,4177,8682,鳳山,二等
2020-08-23,4440,4658,4784,9442,鳳山,二等
2020-08-24,4440,4434,4153,8587,鳳山,二等
2020-08-25,4440,4098,4027,8125,鳳山,二等
2020-08-26,4440,3524,3542,7066,鳳山,二等
2020-08-27,4440,3611,3655,7266,鳳山,二等
2020-08-28,4440,5058,4946,10004,鳳山,二等
2020-08-29,4440,4322,4639,8961,鳳山,二等
2020-08-30,4440,4488,4525,9013,鳳山,二等
2020-08-31,4440,4403,4194,8597,鳳山,二等
2020-09-01,4440,4059,3856,7915,鳳山,二等
2020-09-02,4440,4038,3972,8010,鳳山,二等
2020-09-03,4440,4502,4175,8677,鳳山,二等
2020-09-04,4440,5359,5557,10916,鳳山,二等
2020-09-05,4440,4545,4511,9056,鳳山,二等
2020-09-06,4440,5201,5054,10255,鳳山,二等
2020-09-07,4440,4630,4334,8964,鳳山,二等
2020-09-08,4440,4325,4098,8423,鳳山,二等
2020-09-09,4440,4217,4314,8531,鳳山,二等
2020-09-10,4440,4321,4338,8659,鳳山,二等
2020-09-11,4440,6350,5786,12136,鳳山,二等
2020-09-12,4440,5092,4355,9447,鳳山,二等
2020-09-13,4440,5679,6215,11894,鳳山,二等
2020-09-14,4440,4590,4274,8864,鳳山,二等
2020-09-15,4440,4183,4017,8200,鳳山,二等
2020-09-16,4440,4056,3993,8049,鳳山,二等
2020-09-17,4440,4278,4146,8424,鳳山,二等
2020-09-18,4440,6263,6336,12599,鳳山,二等
2020-09-19,4440,4952,4724,9676,鳳山,二等
2020-09-20,4440,5568,6025,11593,鳳山,二等
2020-09-21,4440,4781,4496,9277,鳳山,二等
2020-09-22,4440,4405,4156,8561,鳳山,二等
2020-09-23,4440,4399,4171,8570,鳳山,二等
2020-09-24,4440,4348,4347,8695,鳳山,二等
2020-09-25,4440,5193,4993,10186,鳳山,二等
2020-09-26,4440,4909,4740,9649,鳳山,二等
2020-09-27,4440,5217,5353,10570,鳳山,二等
2020-09-28,4440,4423,4192,8615,鳳山,二等
2020-09-29,4440,4212,4446,8658,鳳山,二等
2020-09-30,4440,7616,7707,15323,鳳山,二等
2020-10-01,4440,5842,5867,11709,鳳山,二等
2020-10-02,4440,5699,5451,11150,鳳山,二等
2020-10-03,4440,5573,5566,11139,鳳山,二等
2020-10-04,4440,7578,7418,14996,鳳山,二等
2020-10-05,4440,5360,4482,9842,鳳山,二等
2020-10-06,4440,4317,4048,8365,鳳山,二等
2020-10-07,4440,4442,4348,8790,鳳山,二等
2020-10-08,4440,7238,6768,14006,鳳山,二等
2020-10-09,4440,5677,4970,10647,鳳山,二等
2020-10-10,4440,5080,4975,10055,鳳山,二等
2020-10-11,4440,5955,7198,13153,鳳山,二等
2020-10-12,4440,4974,4307,9281,鳳山,二等
2020-10-13,4440,4336,4077,8413,鳳山,二等
2020-10-14,4440,4557,4274,8831,鳳山,二等
2020-10-15,4440,4373,4311,8684,鳳山,二等
2020-10-16,4440,7023,6421,13444,鳳山,二等
2020-10-17,4440,5373,4924,10297,鳳山,二等
2020-10-18,4440,5931,6749,12680,鳳山,二等
2020-10-19,4440,5054,4759,9813,鳳山,二等
2020-10-20,4440,4468,4362,8830,鳳山,二等
2020-10-21,4440,4467,4355,8822,鳳山,二等
2020-10-22,4440,4410,4584,8994,鳳山,二等
2020-10-23,4440,6880,6505,13385,鳳山,二等
2020-10-24,4440,5266,4846,10112,鳳山,二等
2020-10-25,4440,6019,6330,12349,鳳山,二等
2020-10-26,4440,5115,4853,9968,鳳山,二等
2020-10-27,4440,4405,4189,8594,鳳山,二等
2020-10-28,4440,4519,4447,8966,鳳山,二等
2020-10-29,4440,4422,4416,8838,鳳山,二等
2020-10-30,4440,6953,6419,13372,鳳山,二等
2020-10-31,4440,5256,4800,10056,鳳山,二等
2020-11-01,4440,5737,6486,12223,鳳山,二等
2020-11-02,4440,4692,4301,8993,鳳山,二等
2020-11-03,4440,4406,4040,8446,鳳山,二等
2020-11-04,4440,4386,4285,8671,鳳山,二等
2020-11-05,4440,4475,4514,8989,鳳山,二等
2020-11-06,4440,6370,6131,12501,鳳山,二等
2020-11-07,4440,5646,4864,10510,鳳山,二等
2020-11-08,4440,5871,6490,12361,鳳山,二等
2020-11-09,4440,4412,4319,8731,鳳山,二等
2020-11-10,4440,4389,4268,8657,鳳山,二等
2020-11-11,4440,4586,4515,9101,鳳山,二等
2020-11-12,4440,4781,4643,9424,鳳山,二等
2020-11-13,4440,6904,6812,13716,鳳山,二等
2020-11-14,4440,5787,5188,10975,鳳山,二等
2020-11-15,4440,6118,6870,12988,鳳山,二等
2020-11-16,4440,5339,4652,9991,鳳山,二等
2020-11-17,4440,4549,4420,8969,鳳山,二等
2020-11-18,4440,4583,4364,8947,鳳山,二等
2020-11-19,4440,4746,4754,9500,鳳山,二等
2020-11-20,4440,6969,6562,13531,鳳山,二等
2020-11-21,4440,5540,4816,10356,鳳山,二等
2020-11-22,4440,6026,6641,12667,鳳山,二等
2020-11-23,4440,5162,4825,9987,鳳山,二等
2020-11-24,4440,4405,4264,8669,鳳山,二等
2020-11-25,4440,4402,4345,8747,鳳山,二等
2020-11-26,4440,4579,4644,9223,鳳山,二等
2020-11-27,4440,6407,6712,13119,鳳山,二等
2020-11-28,4440,6029,5219,11248,鳳山,二等
2020-11-29,4440,6391,6502,12893,鳳山,二等
2020-11-30,4440,5197,5102,10299,鳳山,二等
2020-12-01,4440,4371,4275,8646,鳳山,二等
2020-12-02,4440,4430,4282,8712,鳳山,二等
2020-12-03,4440,5091,4470,9561,鳳山,二等
2020-12-04,4440,6618,6512,13130,鳳山,二等
2020-12-05,4440,5898,5323,11221,鳳山,二等
2020-12-06,4440,6363,7141,13504,鳳山,二等
2020-12-07,4440,5337,4834,10171,鳳山,二等
2020-12-08,4440,4644,4487,9131,鳳山,二等
2020-12-09,4440,4526,4448,8974,鳳山,二等
2020-12-10,4440,4636,4714,9350,鳳山,二等
2020-12-11,4440,6761,6656,13417,鳳山,二等
2020-12-12,4440,5779,5127,10906,鳳山,二等
2020-12-13,4440,6363,6579,12942,鳳山,二等
2020-12-14,4440,5391,4811,10202,鳳山,二等
2020-12-15,4440,4555,4382,8937,鳳山,二等
2020-12-16,4440,4767,4582,9349,鳳山,二等
2020-12-17,4440,4667,4789,9456,鳳山,二等
2020-12-18,4440,7543,6614,14157,鳳山,二等
2020-12-19,4440,5983,5605,11588,鳳山,二等
2020-12-20,4440,6093,6871,12964,鳳山,二等
2020-12-21,4440,5127,4751,9878,鳳山,二等
2020-12-22,4440,4560,4368,8928,鳳山,二等
2020-12-23,4440,4604,4496,9100,鳳山,二等
2020-12-24,4440,4953,4804,9757,鳳山,二等
2020-12-25,4440,6902,6506,13408,鳳山,二等
2020-12-26,4440,5585,5186,10771,鳳山,二等
2020-12-27,4440,5962,6353,12315,鳳山,二等
2020-12-28,4440,5059,4719,9778,鳳山,二等
2020-12-29,4440,4445,4327,8772,鳳山,二等
2020-12-30,4440,4824,4771,9595,鳳山,二等
2020-12-31,4440,7419,6888,14307,鳳山,二等
2020-01-01,4450,681,716,1397,後庄,簡易
2020-01-02,4450,619,680,1299,後庄,簡易
2020-01-03,4450,743,832,1575,後庄,簡易
2020-01-04,4450,734,723,1457,後庄,簡易
2020-01-05,4450,703,715,1418,後庄,簡易
2020-01-06,4450,690,715,1405,後庄,簡易
2020-01-07,4450,678,671,1349,後庄,簡易
2020-01-08,4450,654,674,1328,後庄,簡易
2020-01-09,4450,660,712,1372,後庄,簡易
2020-01-10,4450,819,1022,1841,後庄,簡易
2020-01-11,4450,836,855,1691,後庄,簡易
2020-01-12,4450,925,777,1702,後庄,簡易
2020-01-13,4450,740,692,1432,後庄,簡易
2020-01-14,4450,640,634,1274,後庄,簡易
2020-01-15,4450,668,685,1353,後庄,簡易
2020-01-16,4450,700,706,1406,後庄,簡易
2020-01-17,4450,707,710,1417,後庄,簡易
2020-01-18,4450,718,704,1422,後庄,簡易
2020-01-19,4450,745,749,1494,後庄,簡易
2020-01-20,4450,608,649,1257,後庄,簡易
2020-01-21,4450,742,719,1461,後庄,簡易
2020-01-22,4450,668,774,1442,後庄,簡易
2020-01-23,4450,684,780,1464,後庄,簡易
2020-01-24,4450,635,705,1340,後庄,簡易
2020-01-25,4450,1015,965,1980,後庄,簡易
2020-01-26,4450,943,809,1752,後庄,簡易
2020-01-27,4450,986,1018,2004,後庄,簡易
2020-01-28,4450,712,738,1450,後庄,簡易
2020-01-29,4450,695,649,1344,後庄,簡易
2020-01-30,4450,596,556,1152,後庄,簡易
2020-01-31,4450,585,593,1178,後庄,簡易
2020-02-01,4450,589,584,1173,後庄,簡易
2020-02-02,4450,643,562,1205,後庄,簡易
2020-02-03,4450,581,516,1097,後庄,簡易
2020-02-04,4450,535,527,1062,後庄,簡易
2020-02-05,4450,617,585,1202,後庄,簡易
2020-02-06,4450,567,556,1123,後庄,簡易
2020-02-07,4450,630,672,1302,後庄,簡易
2020-02-08,4450,610,575,1185,後庄,簡易
2020-02-09,4450,605,576,1181,後庄,簡易
2020-02-10,4450,535,525,1060,後庄,簡易
2020-02-11,4450,543,590,1133,後庄,簡易
2020-02-12,4450,554,504,1058,後庄,簡易
2020-02-13,4450,544,539,1083,後庄,簡易
2020-02-14,4450,643,574,1217,後庄,簡易
2020-02-15,4450,574,556,1130,後庄,簡易
2020-02-16,4450,578,537,1115,後庄,簡易
2020-02-17,4450,536,510,1046,後庄,簡易
2020-02-18,4450,551,567,1118,後庄,簡易
2020-02-19,4450,529,534,1063,後庄,簡易
2020-02-20,4450,569,564,1133,後庄,簡易
2020-02-21,4450,585,591,1176,後庄,簡易
2020-02-22,4450,490,511,1001,後庄,簡易
2020-02-23,4450,598,544,1142,後庄,簡易
2020-02-24,4450,545,577,1122,後庄,簡易
2020-02-25,4450,603,594,1197,後庄,簡易
2020-02-26,4450,600,615,1215,後庄,簡易
2020-02-27,4450,698,771,1469,後庄,簡易
2020-02-28,4450,573,537,1110,後庄,簡易
2020-02-29,4450,560,490,1050,後庄,簡易
2020-03-01,4450,622,568,1190,後庄,簡易
2020-03-02,4450,605,603,1208,後庄,簡易
2020-03-03,4450,561,584,1145,後庄,簡易
2020-03-04,4450,579,590,1169,後庄,簡易
2020-03-05,4450,586,644,1230,後庄,簡易
2020-03-06,4450,679,780,1459,後庄,簡易
2020-03-07,4450,529,554,1083,後庄,簡易
2020-03-08,4450,623,555,1178,後庄,簡易
2020-03-09,4450,620,584,1204,後庄,簡易
2020-03-10,4450,599,604,1203,後庄,簡易
2020-03-11,4450,572,586,1158,後庄,簡易
2020-03-12,4450,554,611,1165,後庄,簡易
2020-03-13,4450,670,740,1410,後庄,簡易
2020-03-14,4450,533,520,1053,後庄,簡易
2020-03-15,4450,634,595,1229,後庄,簡易
2020-03-16,4450,629,621,1250,後庄,簡易
2020-03-17,4450,548,567,1115,後庄,簡易
2020-03-18,4450,579,595,1174,後庄,簡易
2020-03-19,4450,566,610,1176,後庄,簡易
2020-03-20,4450,664,727,1391,後庄,簡易
2020-03-21,4450,504,477,981,後庄,簡易
2020-03-22,4450,494,440,934,後庄,簡易
2020-03-23,4450,573,554,1127,後庄,簡易
2020-03-24,4450,540,570,1110,後庄,簡易
2020-03-25,4450,539,554,1093,後庄,簡易
2020-03-26,4450,526,535,1061,後庄,簡易
2020-03-27,4450,642,683,1325,後庄,簡易
2020-03-28,4450,405,439,844,後庄,簡易
2020-03-29,4450,415,401,816,後庄,簡易
2020-03-30,4450,573,580,1153,後庄,簡易
2020-03-31,4450,534,580,1114,後庄,簡易
2020-04-01,4450,585,679,1264,後庄,簡易
2020-04-02,4450,437,482,919,後庄,簡易
2020-04-03,4450,428,410,838,後庄,簡易
2020-04-04,4450,395,367,762,後庄,簡易
2020-04-05,4450,483,443,926,後庄,簡易
2020-04-06,4450,627,581,1208,後庄,簡易
2020-04-07,4450,530,561,1091,後庄,簡易
2020-04-08,4450,518,526,1044,後庄,簡易
2020-04-09,4450,496,551,1047,後庄,簡易
2020-04-10,4450,551,491,1042,後庄,簡易
2020-04-11,4450,447,433,880,後庄,簡易
2020-04-12,4450,479,456,935,後庄,簡易
2020-04-13,4450,540,547,1087,後庄,簡易
2020-04-14,4450,527,540,1067,後庄,簡易
2020-04-15,4450,528,539,1067,後庄,簡易
2020-04-16,4450,525,541,1066,後庄,簡易
2020-04-17,4450,636,700,1336,後庄,簡易
2020-04-18,4450,468,473,941,後庄,簡易
2020-04-19,4450,505,477,982,後庄,簡易
2020-04-20,4450,551,552,1103,後庄,簡易
2020-04-21,4450,482,530,1012,後庄,簡易
2020-04-22,4450,476,488,964,後庄,簡易
2020-04-23,4450,468,528,996,後庄,簡易
2020-04-24,4450,578,613,1191,後庄,簡易
2020-04-25,4450,361,342,703,後庄,簡易
2020-04-26,4450,395,384,779,後庄,簡易
2020-04-27,4450,541,525,1066,後庄,簡易
2020-04-28,4450,533,534,1067,後庄,簡易
2020-04-29,4450,473,469,942,後庄,簡易
2020-04-30,4450,528,559,1087,後庄,簡易
2020-05-01,4450,607,633,1240,後庄,簡易
2020-05-02,4450,429,425,854,後庄,簡易
2020-05-03,4450,447,421,868,後庄,簡易
2020-05-04,4450,531,531,1062,後庄,簡易
2020-05-05,4450,552,553,1105,後庄,簡易
2020-05-06,4450,519,511,1030,後庄,簡易
2020-05-07,4450,536,563,1099,後庄,簡易
2020-05-08,4450,618,723,1341,後庄,簡易
2020-05-09,4450,490,520,1010,後庄,簡易
2020-05-10,4450,563,461,1024,後庄,簡易
2020-05-11,4450,601,565,1166,後庄,簡易
2020-05-12,4450,541,543,1084,後庄,簡易
2020-05-13,4450,534,538,1072,後庄,簡易
2020-05-14,4450,546,574,1120,後庄,簡易
2020-05-15,4450,721,752,1473,後庄,簡易
2020-05-16,4450,486,464,950,後庄,簡易
2020-05-17,4450,514,503,1017,後庄,簡易
2020-05-18,4450,588,568,1156,後庄,簡易
2020-05-19,4450,522,541,1063,後庄,簡易
2020-05-20,4450,536,530,1066,後庄,簡易
2020-05-21,4450,515,549,1064,後庄,簡易
2020-05-22,4450,511,563,1074,後庄,簡易
2020-05-23,4450,448,446,894,後庄,簡易
2020-05-24,4450,532,531,1063,後庄,簡易
2020-05-25,4450,572,572,1144,後庄,簡易
2020-05-26,4450,517,518,1035,後庄,簡易
2020-05-27,4450,494,518,1012,後庄,簡易
2020-05-28,4450,508,573,1081,後庄,簡易
2020-05-29,4450,643,671,1314,後庄,簡易
2020-05-30,4450,551,529,1080,後庄,簡易
2020-05-31,4450,556,503,1059,後庄,簡易
2020-06-01,4450,626,604,1230,後庄,簡易
2020-06-02,4450,559,569,1128,後庄,簡易
2020-06-03,4450,536,540,1076,後庄,簡易
2020-06-04,4450,529,612,1141,後庄,簡易
2020-06-05,4450,702,833,1535,後庄,簡易
2020-06-06,4450,667,668,1335,後庄,簡易
2020-06-07,4450,717,606,1323,後庄,簡易
2020-06-08,4450,629,590,1219,後庄,簡易
2020-06-09,4450,569,554,1123,後庄,簡易
2020-06-10,4450,605,623,1228,後庄,簡易
2020-06-11,4450,542,567,1109,後庄,簡易
2020-06-12,4450,660,687,1347,後庄,簡易
2020-06-13,4450,637,624,1261,後庄,簡易
2020-06-14,4450,594,645,1239,後庄,簡易
2020-06-15,4450,620,656,1276,後庄,簡易
2020-06-16,4450,526,537,1063,後庄,簡易
2020-06-17,4450,531,561,1092,後庄,簡易
2020-06-18,4450,559,576,1135,後庄,簡易
2020-06-19,4450,583,631,1214,後庄,簡易
2020-06-20,4450,586,603,1189,後庄,簡易
2020-06-21,4450,554,539,1093,後庄,簡易
2020-06-22,4450,621,597,1218,後庄,簡易
2020-06-23,4450,541,563,1104,後庄,簡易
2020-06-24,4450,681,776,1457,後庄,簡易
2020-06-25,4450,555,597,1152,後庄,簡易
2020-06-26,4450,655,654,1309,後庄,簡易
2020-06-27,4450,657,576,1233,後庄,簡易
2020-06-28,4450,675,629,1304,後庄,簡易
2020-06-29,4450,577,580,1157,後庄,簡易
2020-06-30,4450,566,596,1162,後庄,簡易
2020-07-01,4450,571,570,1141,後庄,簡易
2020-07-02,4450,562,579,1141,後庄,簡易
2020-07-03,4450,646,666,1312,後庄,簡易
2020-07-04,4450,519,507,1026,後庄,簡易
2020-07-05,4450,520,546,1066,後庄,簡易
2020-07-06,4450,611,589,1200,後庄,簡易
2020-07-07,4450,572,614,1186,後庄,簡易
2020-07-08,4450,577,575,1152,後庄,簡易
2020-07-09,4450,580,576,1156,後庄,簡易
2020-07-10,4450,730,755,1485,後庄,簡易
2020-07-11,4450,611,608,1219,後庄,簡易
2020-07-12,4450,703,660,1363,後庄,簡易
2020-07-13,4450,591,597,1188,後庄,簡易
2020-07-14,4450,571,592,1163,後庄,簡易
2020-07-15,4450,540,532,1072,後庄,簡易
2020-07-16,4450,605,569,1174,後庄,簡易
2020-07-17,4450,660,680,1340,後庄,簡易
2020-07-18,4450,615,575,1190,後庄,簡易
2020-07-19,4450,623,604,1227,後庄,簡易
2020-07-20,4450,633,618,1251,後庄,簡易
2020-07-21,4450,558,575,1133,後庄,簡易
2020-07-22,4450,572,582,1154,後庄,簡易
2020-07-23,4450,555,562,1117,後庄,簡易
2020-07-24,4450,707,691,1398,後庄,簡易
2020-07-25,4450,617,619,1236,後庄,簡易
2020-07-26,4450,652,594,1246,後庄,簡易
2020-07-27,4450,569,537,1106,後庄,簡易
2020-07-28,4450,551,546,1097,後庄,簡易
2020-07-29,4450,587,575,1162,後庄,簡易
2020-07-30,4450,592,588,1180,後庄,簡易
2020-07-31,4450,667,643,1310,後庄,簡易
2020-08-01,4450,594,566,1160,後庄,簡易
2020-08-02,4450,560,538,1098,後庄,簡易
2020-08-03,4450,560,557,1117,後庄,簡易
2020-08-04,4450,535,552,1087,後庄,簡易
2020-08-05,4450,636,636,1272,後庄,簡易
2020-08-06,4450,617,642,1259,後庄,簡易
2020-08-07,4450,659,692,1351,後庄,簡易
2020-08-08,4450,622,609,1231,後庄,簡易
2020-08-09,4450,682,633,1315,後庄,簡易
2020-08-10,4450,659,601,1260,後庄,簡易
2020-08-11,4450,538,546,1084,後庄,簡易
2020-08-12,4450,597,577,1174,後庄,簡易
2020-08-13,4450,576,601,1177,後庄,簡易
2020-08-14,4450,689,729,1418,後庄,簡易
2020-08-15,4450,658,619,1277,後庄,簡易
2020-08-16,4450,681,676,1357,後庄,簡易
2020-08-17,4450,626,607,1233,後庄,簡易
2020-08-18,4450,663,633,1296,後庄,簡易
2020-08-19,4450,592,596,1188,後庄,簡易
2020-08-20,4450,662,682,1344,後庄,簡易
2020-08-21,4450,656,661,1317,後庄,簡易
2020-08-22,4450,555,488,1043,後庄,簡易
2020-08-23,4450,578,587,1165,後庄,簡易
2020-08-24,4450,576,594,1170,後庄,簡易
2020-08-25,4450,553,552,1105,後庄,簡易
2020-08-26,4450,443,454,897,後庄,簡易
2020-08-27,4450,495,510,1005,後庄,簡易
2020-08-28,4450,662,671,1333,後庄,簡易
2020-08-29,4450,540,541,1081,後庄,簡易
2020-08-30,4450,549,476,1025,後庄,簡易
2020-08-31,4450,658,644,1302,後庄,簡易
2020-09-01,4450,614,629,1243,後庄,簡易
2020-09-02,4450,617,617,1234,後庄,簡易
2020-09-03,4450,619,631,1250,後庄,簡易
2020-09-04,4450,736,714,1450,後庄,簡易
2020-09-05,4450,572,549,1121,後庄,簡易
2020-09-06,4450,632,622,1254,後庄,簡易
2020-09-07,4450,651,638,1289,後庄,簡易
2020-09-08,4450,630,636,1266,後庄,簡易
2020-09-09,4450,628,618,1246,後庄,簡易
2020-09-10,4450,631,686,1317,後庄,簡易
2020-09-11,4450,698,699,1397,後庄,簡易
2020-09-12,4450,623,611,1234,後庄,簡易
2020-09-13,4450,728,632,1360,後庄,簡易
2020-09-14,4450,613,630,1243,後庄,簡易
2020-09-15,4450,608,650,1258,後庄,簡易
2020-09-16,4450,590,620,1210,後庄,簡易
2020-09-17,4450,611,640,1251,後庄,簡易
2020-09-18,4450,728,780,1508,後庄,簡易
2020-09-19,4450,625,636,1261,後庄,簡易
2020-09-20,4450,677,647,1324,後庄,簡易
2020-09-21,4450,646,626,1272,後庄,簡易
2020-09-22,4450,589,641,1230,後庄,簡易
2020-09-23,4450,599,659,1258,後庄,簡易
2020-09-24,4450,601,629,1230,後庄,簡易
2020-09-25,4450,626,661,1287,後庄,簡易
2020-09-26,4450,622,668,1290,後庄,簡易
2020-09-27,4450,634,570,1204,後庄,簡易
2020-09-28,4450,624,655,1279,後庄,簡易
2020-09-29,4450,597,613,1210,後庄,簡易
2020-09-30,4450,683,890,1573,後庄,簡易
2020-10-01,4450,665,806,1471,後庄,簡易
2020-10-02,4450,740,754,1494,後庄,簡易
2020-10-03,4450,738,697,1435,後庄,簡易
2020-10-04,4450,820,640,1460,後庄,簡易
2020-10-05,4450,667,631,1298,後庄,簡易
2020-10-06,4450,623,641,1264,後庄,簡易
2020-10-07,4450,558,620,1178,後庄,簡易
2020-10-08,4450,684,781,1465,後庄,簡易
2020-10-09,4450,674,606,1280,後庄,簡易
2020-10-10,4450,642,593,1235,後庄,簡易
2020-10-11,4450,653,649,1302,後庄,簡易
2020-10-12,4450,657,629,1286,後庄,簡易
2020-10-13,4450,583,600,1183,後庄,簡易
2020-10-14,4450,632,637,1269,後庄,簡易
2020-10-15,4450,582,612,1194,後庄,簡易
2020-10-16,4450,680,761,1441,後庄,簡易
2020-10-17,4450,636,634,1270,後庄,簡易
2020-10-18,4450,677,648,1325,後庄,簡易
2020-10-19,4450,648,618,1266,後庄,簡易
2020-10-20,4450,598,653,1251,後庄,簡易
2020-10-21,4450,602,637,1239,後庄,簡易
2020-10-22,4450,604,604,1208,後庄,簡易
2020-10-23,4450,689,778,1467,後庄,簡易
2020-10-24,4450,648,610,1258,後庄,簡易
2020-10-25,4450,756,713,1469,後庄,簡易
2020-10-26,4450,630,617,1247,後庄,簡易
2020-10-27,4450,608,636,1244,後庄,簡易
2020-10-28,4450,578,599,1177,後庄,簡易
2020-10-29,4450,589,616,1205,後庄,簡易
2020-10-30,4450,654,743,1397,後庄,簡易
2020-10-31,4450,597,614,1211,後庄,簡易
2020-11-01,4450,684,676,1360,後庄,簡易
2020-11-02,4450,636,608,1244,後庄,簡易
2020-11-03,4450,555,564,1119,後庄,簡易
2020-11-04,4450,600,633,1233,後庄,簡易
2020-11-05,4450,561,611,1172,後庄,簡易
2020-11-06,4450,685,732,1417,後庄,簡易
2020-11-07,4450,636,612,1248,後庄,簡易
2020-11-08,4450,709,689,1398,後庄,簡易
2020-11-09,4450,604,586,1190,後庄,簡易
2020-11-10,4450,622,619,1241,後庄,簡易
2020-11-11,4450,600,619,1219,後庄,簡易
2020-11-12,4450,607,611,1218,後庄,簡易
2020-11-13,4450,668,744,1412,後庄,簡易
2020-11-14,4450,707,640,1347,後庄,簡易
2020-11-15,4450,704,664,1368,後庄,簡易
2020-11-16,4450,615,594,1209,後庄,簡易
2020-11-17,4450,609,625,1234,後庄,簡易
2020-11-18,4450,597,588,1185,後庄,簡易
2020-11-19,4450,574,598,1172,後庄,簡易
2020-11-20,4450,661,772,1433,後庄,簡易
2020-11-21,4450,619,593,1212,後庄,簡易
2020-11-22,4450,695,671,1366,後庄,簡易
2020-11-23,4450,616,581,1197,後庄,簡易
2020-11-24,4450,595,606,1201,後庄,簡易
2020-11-25,4450,582,580,1162,後庄,簡易
2020-11-26,4450,595,613,1208,後庄,簡易
2020-11-27,4450,735,753,1488,後庄,簡易
2020-11-28,4450,673,651,1324,後庄,簡易
2020-11-29,4450,664,627,1291,後庄,簡易
2020-11-30,4450,668,673,1341,後庄,簡易
2020-12-01,4450,606,593,1199,後庄,簡易
2020-12-02,4450,572,612,1184,後庄,簡易
2020-12-03,4450,547,602,1149,後庄,簡易
2020-12-04,4450,665,755,1420,後庄,簡易
2020-12-05,4450,675,662,1337,後庄,簡易
2020-12-06,4450,734,673,1407,後庄,簡易
2020-12-07,4450,667,667,1334,後庄,簡易
2020-12-08,4450,589,610,1199,後庄,簡易
2020-12-09,4450,564,617,1181,後庄,簡易
2020-12-10,4450,575,629,1204,後庄,簡易
2020-12-11,4450,686,785,1471,後庄,簡易
2020-12-12,4450,680,661,1341,後庄,簡易
2020-12-13,4450,695,665,1360,後庄,簡易
2020-12-14,4450,629,619,1248,後庄,簡易
2020-12-15,4450,602,615,1217,後庄,簡易
2020-12-16,4450,584,632,1216,後庄,簡易
2020-12-17,4450,585,617,1202,後庄,簡易
2020-12-18,4450,696,801,1497,後庄,簡易
2020-12-19,4450,657,623,1280,後庄,簡易
2020-12-20,4450,694,661,1355,後庄,簡易
2020-12-21,4450,637,643,1280,後庄,簡易
2020-12-22,4450,591,582,1173,後庄,簡易
2020-12-23,4450,583,604,1187,後庄,簡易
2020-12-24,4450,599,635,1234,後庄,簡易
2020-12-25,4450,710,764,1474,後庄,簡易
2020-12-26,4450,641,623,1264,後庄,簡易
2020-12-27,4450,627,566,1193,後庄,簡易
2020-12-28,4450,618,597,1215,後庄,簡易
2020-12-29,4450,558,607,1165,後庄,簡易
2020-12-30,4450,604,667,1271,後庄,簡易
2020-12-31,4450,784,825,1609,後庄,簡易
2020-01-01,4460,1344,1470,2814,九曲堂,三等
2020-01-02,4460,1150,1185,2335,九曲堂,三等
2020-01-03,4460,1323,1373,2696,九曲堂,三等
2020-01-04,4460,1218,1276,2494,九曲堂,三等
2020-01-05,4460,1233,1188,2421,九曲堂,三等
2020-01-06,4460,1268,1312,2580,九曲堂,三等
2020-01-07,4460,1127,1160,2287,九曲堂,三等
2020-01-08,4460,1139,1210,2349,九曲堂,三等
2020-01-09,4460,1194,1254,2448,九曲堂,三等
2020-01-10,4460,1433,1752,3185,九曲堂,三等
2020-01-11,4460,1363,1412,2775,九曲堂,三等
2020-01-12,4460,1445,1264,2709,九曲堂,三等
2020-01-13,4460,1257,1250,2507,九曲堂,三等
2020-01-14,4460,1213,1228,2441,九曲堂,三等
2020-01-15,4460,1208,1252,2460,九曲堂,三等
2020-01-16,4460,1289,1404,2693,九曲堂,三等
2020-01-17,4460,1240,1264,2504,九曲堂,三等
2020-01-18,4460,1224,1236,2460,九曲堂,三等
2020-01-19,4460,1212,1230,2442,九曲堂,三等
2020-01-20,4460,1119,1155,2274,九曲堂,三等
2020-01-21,4460,1174,1271,2445,九曲堂,三等
2020-01-22,4460,1305,1473,2778,九曲堂,三等
2020-01-23,4460,1024,1362,2386,九曲堂,三等
2020-01-24,4460,784,985,1769,九曲堂,三等
2020-01-25,4460,2057,1968,4025,九曲堂,三等
2020-01-26,4460,1422,1512,2934,九曲堂,三等
2020-01-27,4460,1687,1629,3316,九曲堂,三等
2020-01-28,4460,1187,1126,2313,九曲堂,三等
2020-01-29,4460,1401,1218,2619,九曲堂,三等
2020-01-30,4460,1096,1064,2160,九曲堂,三等
2020-01-31,4460,1228,1166,2394,九曲堂,三等
2020-02-01,4460,974,1017,1991,九曲堂,三等
2020-02-02,4460,1080,1034,2114,九曲堂,三等
2020-02-03,4460,991,915,1906,九曲堂,三等
2020-02-04,4460,925,946,1871,九曲堂,三等
2020-02-05,4460,1030,1063,2093,九曲堂,三等
2020-02-06,4460,953,962,1915,九曲堂,三等
2020-02-07,4460,1100,1100,2200,九曲堂,三等
2020-02-08,4460,1055,1065,2120,九曲堂,三等
2020-02-09,4460,954,1028,1982,九曲堂,三等
2020-02-10,4460,927,917,1844,九曲堂,三等
2020-02-11,4460,952,936,1888,九曲堂,三等
2020-02-12,4460,901,906,1807,九曲堂,三等
2020-02-13,4460,933,884,1817,九曲堂,三等
2020-02-14,4460,1112,1072,2184,九曲堂,三等
2020-02-15,4460,1117,1119,2236,九曲堂,三等
2020-02-16,4460,952,997,1949,九曲堂,三等
2020-02-17,4460,841,847,1688,九曲堂,三等
2020-02-18,4460,901,897,1798,九曲堂,三等
2020-02-19,4460,965,966,1931,九曲堂,三等
2020-02-20,4460,928,916,1844,九曲堂,三等
2020-02-21,4460,1090,1036,2126,九曲堂,三等
2020-02-22,4460,1114,1132,2246,九曲堂,三等
2020-02-23,4460,950,922,1872,九曲堂,三等
2020-02-24,4460,965,926,1891,九曲堂,三等
2020-02-25,4460,1002,1087,2089,九曲堂,三等
2020-02-26,4460,1037,1100,2137,九曲堂,三等
2020-02-27,4460,1215,1342,2557,九曲堂,三等
2020-02-28,4460,1074,1139,2213,九曲堂,三等
2020-02-29,4460,946,961,1907,九曲堂,三等
2020-03-01,4460,1043,894,1937,九曲堂,三等
2020-03-02,4460,1052,1082,2134,九曲堂,三等
2020-03-03,4460,989,1028,2017,九曲堂,三等
2020-03-04,4460,973,1005,1978,九曲堂,三等
2020-03-05,4460,1026,1076,2102,九曲堂,三等
2020-03-06,4460,1145,1258,2403,九曲堂,三等
2020-03-07,4460,882,896,1778,九曲堂,三等
2020-03-08,4460,885,891,1776,九曲堂,三等
2020-03-09,4460,1022,1051,2073,九曲堂,三等
2020-03-10,4460,993,1002,1995,九曲堂,三等
2020-03-11,4460,1049,1081,2130,九曲堂,三等
2020-03-12,4460,1000,1052,2052,九曲堂,三等
2020-03-13,4460,1176,1273,2449,九曲堂,三等
2020-03-14,4460,873,937,1810,九曲堂,三等
2020-03-15,4460,982,989,1971,九曲堂,三等
2020-03-16,4460,1022,1004,2026,九曲堂,三等
2020-03-17,4460,982,1009,1991,九曲堂,三等
2020-03-18,4460,982,1018,2000,九曲堂,三等
2020-03-19,4460,942,1011,1953,九曲堂,三等
2020-03-20,4460,1110,1180,2290,九曲堂,三等
2020-03-21,4460,835,874,1709,九曲堂,三等
2020-03-22,4460,797,801,1598,九曲堂,三等
2020-03-23,4460,934,960,1894,九曲堂,三等
2020-03-24,4460,909,946,1855,九曲堂,三等
2020-03-25,4460,893,976,1869,九曲堂,三等
2020-03-26,4460,871,936,1807,九曲堂,三等
2020-03-27,4460,1086,1134,2220,九曲堂,三等
2020-03-28,4460,768,872,1640,九曲堂,三等
2020-03-29,4460,762,722,1484,九曲堂,三等
2020-03-30,4460,990,979,1969,九曲堂,三等
2020-03-31,4460,891,1011,1902,九曲堂,三等
2020-04-01,4460,1086,1299,2385,九曲堂,三等
2020-04-02,4460,741,927,1668,九曲堂,三等
2020-04-03,4460,828,873,1701,九曲堂,三等
2020-04-04,4460,619,597,1216,九曲堂,三等
2020-04-05,4460,930,717,1647,九曲堂,三等
2020-04-06,4460,988,963,1951,九曲堂,三等
2020-04-07,4460,905,921,1826,九曲堂,三等
2020-04-08,4460,883,900,1783,九曲堂,三等
2020-04-09,4460,863,912,1775,九曲堂,三等
2020-04-10,4460,973,895,1868,九曲堂,三等
2020-04-11,4460,661,704,1365,九曲堂,三等
2020-04-12,4460,723,765,1488,九曲堂,三等
2020-04-13,4460,898,949,1847,九曲堂,三等
2020-04-14,4460,871,927,1798,九曲堂,三等
2020-04-15,4460,896,947,1843,九曲堂,三等
2020-04-16,4460,897,970,1867,九曲堂,三等
2020-04-17,4460,1090,1175,2265,九曲堂,三等
2020-04-18,4460,765,791,1556,九曲堂,三等
2020-04-19,4460,767,758,1525,九曲堂,三等
2020-04-20,4460,899,908,1807,九曲堂,三等
2020-04-21,4460,808,874,1682,九曲堂,三等
2020-04-22,4460,798,841,1639,九曲堂,三等
2020-04-23,4460,791,830,1621,九曲堂,三等
2020-04-24,4460,989,1025,2014,九曲堂,三等
2020-04-25,4460,569,599,1168,九曲堂,三等
2020-04-26,4460,575,551,1126,九曲堂,三等
2020-04-27,4460,866,911,1777,九曲堂,三等
2020-04-28,4460,826,896,1722,九曲堂,三等
2020-04-29,4460,792,831,1623,九曲堂,三等
2020-04-30,4460,900,955,1855,九曲堂,三等
2020-05-01,4460,1004,1089,2093,九曲堂,三等
2020-05-02,4460,764,778,1542,九曲堂,三等
2020-05-03,4460,800,775,1575,九曲堂,三等
2020-05-04,4460,928,914,1842,九曲堂,三等
2020-05-05,4460,910,966,1876,九曲堂,三等
2020-05-06,4460,877,937,1814,九曲堂,三等
2020-05-07,4460,880,964,1844,九曲堂,三等
2020-05-08,4460,1109,1238,2347,九曲堂,三等
2020-05-09,4460,769,881,1650,九曲堂,三等
2020-05-10,4460,934,787,1721,九曲堂,三等
2020-05-11,4460,1042,983,2025,九曲堂,三等
2020-05-12,4460,910,923,1833,九曲堂,三等
2020-05-13,4460,903,969,1872,九曲堂,三等
2020-05-14,4460,928,983,1911,九曲堂,三等
2020-05-15,4460,1178,1268,2446,九曲堂,三等
2020-05-16,4460,867,947,1814,九曲堂,三等
2020-05-17,4460,925,941,1866,九曲堂,三等
2020-05-18,4460,964,958,1922,九曲堂,三等
2020-05-19,4460,892,951,1843,九曲堂,三等
2020-05-20,4460,893,970,1863,九曲堂,三等
2020-05-21,4460,870,887,1757,九曲堂,三等
2020-05-22,4460,959,1048,2007,九曲堂,三等
2020-05-23,4460,755,761,1516,九曲堂,三等
2020-05-24,4460,932,990,1922,九曲堂,三等
2020-05-25,4460,984,1001,1985,九曲堂,三等
2020-05-26,4460,908,931,1839,九曲堂,三等
2020-05-27,4460,877,948,1825,九曲堂,三等
2020-05-28,4460,911,964,1875,九曲堂,三等
2020-05-29,4460,1142,1192,2334,九曲堂,三等
2020-05-30,4460,974,1013,1987,九曲堂,三等
2020-05-31,4460,1008,934,1942,九曲堂,三等
2020-06-01,4460,921,972,1893,九曲堂,三等
2020-06-02,4460,893,954,1847,九曲堂,三等
2020-06-03,4460,931,991,1922,九曲堂,三等
2020-06-04,4460,939,998,1937,九曲堂,三等
2020-06-05,4460,1189,1409,2598,九曲堂,三等
2020-06-06,4460,1078,1189,2267,九曲堂,三等
2020-06-07,4460,1263,1024,2287,九曲堂,三等
2020-06-08,4460,1054,1016,2070,九曲堂,三等
2020-06-09,4460,950,966,1916,九曲堂,三等
2020-06-10,4460,953,1004,1957,九曲堂,三等
2020-06-11,4460,969,986,1955,九曲堂,三等
2020-06-12,4460,1216,1193,2409,九曲堂,三等
2020-06-13,4460,1042,1070,2112,九曲堂,三等
2020-06-14,4460,1039,1169,2208,九曲堂,三等
2020-06-15,4460,1052,1069,2121,九曲堂,三等
2020-06-16,4460,899,981,1880,九曲堂,三等
2020-06-17,4460,936,944,1880,九曲堂,三等
2020-06-18,4460,892,950,1842,九曲堂,三等
2020-06-19,4460,1106,1106,2212,九曲堂,三等
2020-06-20,4460,1116,1112,2228,九曲堂,三等
2020-06-21,4460,885,980,1865,九曲堂,三等
2020-06-22,4460,938,953,1891,九曲堂,三等
2020-06-23,4460,993,1051,2044,九曲堂,三等
2020-06-24,4460,1190,1346,2536,九曲堂,三等
2020-06-25,4460,1029,1120,2149,九曲堂,三等
2020-06-26,4460,1156,1105,2261,九曲堂,三等
2020-06-27,4460,1101,1096,2197,九曲堂,三等
2020-06-28,4460,1221,1142,2363,九曲堂,三等
2020-06-29,4460,1001,991,1992,九曲堂,三等
2020-06-30,4460,938,939,1877,九曲堂,三等
2020-07-01,4460,923,973,1896,九曲堂,三等
2020-07-02,4460,928,1010,1938,九曲堂,三等
2020-07-03,4460,1226,1127,2353,九曲堂,三等
2020-07-04,4460,964,956,1920,九曲堂,三等
2020-07-05,4460,940,1042,1982,九曲堂,三等
2020-07-06,4460,1028,1094,2122,九曲堂,三等
2020-07-07,4460,993,1005,1998,九曲堂,三等
2020-07-08,4460,1009,1065,2074,九曲堂,三等
2020-07-09,4460,1039,1055,2094,九曲堂,三等
2020-07-10,4460,1408,1289,2697,九曲堂,三等
2020-07-11,4460,1071,1048,2119,九曲堂,三等
2020-07-12,4460,1118,1204,2322,九曲堂,三等
2020-07-13,4460,994,1010,2004,九曲堂,三等
2020-07-14,4460,1010,1055,2065,九曲堂,三等
2020-07-15,4460,953,944,1897,九曲堂,三等
2020-07-16,4460,890,949,1839,九曲堂,三等
2020-07-17,4460,1380,1266,2646,九曲堂,三等
2020-07-18,4460,1161,1147,2308,九曲堂,三等
2020-07-19,4460,1045,1225,2270,九曲堂,三等
2020-07-20,4460,1025,1078,2103,九曲堂,三等
2020-07-21,4460,1124,1120,2244,九曲堂,三等
2020-07-22,4460,1091,1148,2239,九曲堂,三等
2020-07-23,4460,1175,1122,2297,九曲堂,三等
2020-07-24,4460,1328,1297,2625,九曲堂,三等
2020-07-25,4460,1255,1182,2437,九曲堂,三等
2020-07-26,4460,1164,1139,2303,九曲堂,三等
2020-07-27,4460,1072,1108,2180,九曲堂,三等
2020-07-28,4460,1047,1055,2102,九曲堂,三等
2020-07-29,4460,1095,1129,2224,九曲堂,三等
2020-07-30,4460,1040,1129,2169,九曲堂,三等
2020-07-31,4460,1324,1253,2577,九曲堂,三等
2020-08-01,4460,1044,1007,2051,九曲堂,三等
2020-08-02,4460,927,989,1916,九曲堂,三等
2020-08-03,4460,927,980,1907,九曲堂,三等
2020-08-04,4460,902,935,1837,九曲堂,三等
2020-08-05,4460,1057,1096,2153,九曲堂,三等
2020-08-06,4460,1028,1066,2094,九曲堂,三等
2020-08-07,4460,1280,1310,2590,九曲堂,三等
2020-08-08,4460,1168,1118,2286,九曲堂,三等
2020-08-09,4460,1066,1098,2164,九曲堂,三等
2020-08-10,4460,1049,1052,2101,九曲堂,三等
2020-08-11,4460,868,896,1764,九曲堂,三等
2020-08-12,4460,1062,1089,2151,九曲堂,三等
2020-08-13,4460,1017,1060,2077,九曲堂,三等
2020-08-14,4460,1300,1280,2580,九曲堂,三等
2020-08-15,4460,1145,1137,2282,九曲堂,三等
2020-08-16,4460,1184,1199,2383,九曲堂,三等
2020-08-17,4460,1157,1101,2258,九曲堂,三等
2020-08-18,4460,1181,1177,2358,九曲堂,三等
2020-08-19,4460,1110,1090,2200,九曲堂,三等
2020-08-20,4460,1130,1138,2268,九曲堂,三等
2020-08-21,4460,1265,1270,2535,九曲堂,三等
2020-08-22,4460,960,981,1941,九曲堂,三等
2020-08-23,4460,1057,1058,2115,九曲堂,三等
2020-08-24,4460,997,975,1972,九曲堂,三等
2020-08-25,4460,1107,1094,2201,九曲堂,三等
2020-08-26,4460,841,860,1701,九曲堂,三等
2020-08-27,4460,878,886,1764,九曲堂,三等
2020-08-28,4460,1140,1119,2259,九曲堂,三等
2020-08-29,4460,992,1005,1997,九曲堂,三等
2020-08-30,4460,973,998,1971,九曲堂,三等
2020-08-31,4460,1082,1070,2152,九曲堂,三等
2020-09-01,4460,1015,1052,2067,九曲堂,三等
2020-09-02,4460,1064,1030,2094,九曲堂,三等
2020-09-03,4460,1086,1129,2215,九曲堂,三等
2020-09-04,4460,1243,1287,2530,九曲堂,三等
2020-09-05,4460,1008,1025,2033,九曲堂,三等
2020-09-06,4460,1145,1133,2278,九曲堂,三等
2020-09-07,4460,1064,1098,2162,九曲堂,三等
2020-09-08,4460,1076,1084,2160,九曲堂,三等
2020-09-09,4460,1075,1103,2178,九曲堂,三等
2020-09-10,4460,1060,1090,2150,九曲堂,三等
2020-09-11,4460,1231,1278,2509,九曲堂,三等
2020-09-12,4460,1109,1107,2216,九曲堂,三等
2020-09-13,4460,1179,1095,2274,九曲堂,三等
2020-09-14,4460,1018,1036,2054,九曲堂,三等
2020-09-15,4460,1051,1058,2109,九曲堂,三等
2020-09-16,4460,1041,1112,2153,九曲堂,三等
2020-09-17,4460,1078,1088,2166,九曲堂,三等
2020-09-18,4460,1311,1354,2665,九曲堂,三等
2020-09-19,4460,1162,1178,2340,九曲堂,三等
2020-09-20,4460,1162,1201,2363,九曲堂,三等
2020-09-21,4460,1085,1093,2178,九曲堂,三等
2020-09-22,4460,1028,1040,2068,九曲堂,三等
2020-09-23,4460,1040,1039,2079,九曲堂,三等
2020-09-24,4460,1049,1070,2119,九曲堂,三等
2020-09-25,4460,1119,1188,2307,九曲堂,三等
2020-09-26,4460,1134,1124,2258,九曲堂,三等
2020-09-27,4460,965,987,1952,九曲堂,三等
2020-09-28,4460,1089,1080,2169,九曲堂,三等
2020-09-29,4460,1074,1082,2156,九曲堂,三等
2020-09-30,4460,1262,1635,2897,九曲堂,三等
2020-10-01,4460,1128,1401,2529,九曲堂,三等
2020-10-02,4460,1425,1419,2844,九曲堂,三等
2020-10-03,4460,1361,1346,2707,九曲堂,三等
2020-10-04,4460,1512,1175,2687,九曲堂,三等
2020-10-05,4460,1136,1064,2200,九曲堂,三等
2020-10-06,4460,1102,1063,2165,九曲堂,三等
2020-10-07,4460,1106,1120,2226,九曲堂,三等
2020-10-08,4460,1253,1412,2665,九曲堂,三等
2020-10-09,4460,1239,1244,2483,九曲堂,三等
2020-10-10,4460,1194,1169,2363,九曲堂,三等
2020-10-11,4460,1143,1098,2241,九曲堂,三等
2020-10-12,4460,1112,1104,2216,九曲堂,三等
2020-10-13,4460,1024,1150,2174,九曲堂,三等
2020-10-14,4460,1076,1099,2175,九曲堂,三等
2020-10-15,4460,1033,1116,2149,九曲堂,三等
2020-10-16,4460,1223,1382,2605,九曲堂,三等
2020-10-17,4460,1172,1217,2389,九曲堂,三等
2020-10-18,4460,1182,1151,2333,九曲堂,三等
2020-10-19,4460,1108,1083,2191,九曲堂,三等
2020-10-20,4460,1043,1048,2091,九曲堂,三等
2020-10-21,4460,1062,1087,2149,九曲堂,三等
2020-10-22,4460,1088,1074,2162,九曲堂,三等
2020-10-23,4460,1250,1363,2613,九曲堂,三等
2020-10-24,4460,1268,1263,2531,九曲堂,三等
2020-10-25,4460,1241,1181,2422,九曲堂,三等
2020-10-26,4460,1076,1057,2133,九曲堂,三等
2020-10-27,4460,1138,1116,2254,九曲堂,三等
2020-10-28,4460,1019,1182,2201,九曲堂,三等
2020-10-29,4460,1036,1054,2090,九曲堂,三等
2020-10-30,4460,1220,1337,2557,九曲堂,三等
2020-10-31,4460,1151,1258,2409,九曲堂,三等
2020-11-01,4460,1173,1145,2318,九曲堂,三等
2020-11-02,4460,1057,1005,2062,九曲堂,三等
2020-11-03,4460,995,1041,2036,九曲堂,三等
2020-11-04,4460,980,1004,1984,九曲堂,三等
2020-11-05,4460,1005,1082,2087,九曲堂,三等
2020-11-06,4460,1217,1331,2548,九曲堂,三等
2020-11-07,4460,1152,1182,2334,九曲堂,三等
2020-11-08,4460,1260,1221,2481,九曲堂,三等
2020-11-09,4460,1015,1000,2015,九曲堂,三等
2020-11-10,4460,1100,1085,2185,九曲堂,三等
2020-11-11,4460,1061,1110,2171,九曲堂,三等
2020-11-12,4460,1073,1132,2205,九曲堂,三等
2020-11-13,4460,1303,1460,2763,九曲堂,三等
2020-11-14,4460,1255,1246,2501,九曲堂,三等
2020-11-15,4460,1197,1266,2463,九曲堂,三等
2020-11-16,4460,1122,1082,2204,九曲堂,三等
2020-11-17,4460,1083,1102,2185,九曲堂,三等
2020-11-18,4460,1536,1088,2624,九曲堂,三等
2020-11-19,4460,1040,1103,2143,九曲堂,三等
2020-11-20,4460,1297,1411,2708,九曲堂,三等
2020-11-21,4460,1103,1140,2243,九曲堂,三等
2020-11-22,4460,1184,1169,2353,九曲堂,三等
2020-11-23,4460,1089,1111,2200,九曲堂,三等
2020-11-24,4460,1035,1066,2101,九曲堂,三等
2020-11-25,4460,1061,1098,2159,九曲堂,三等
2020-11-26,4460,1070,1082,2152,九曲堂,三等
2020-11-27,4460,1254,1462,2716,九曲堂,三等
2020-11-28,4460,1282,1374,2656,九曲堂,三等
2020-11-29,4460,1249,1221,2470,九曲堂,三等
2020-11-30,4460,1104,1106,2210,九曲堂,三等
2020-12-01,4460,1056,1075,2131,九曲堂,三等
2020-12-02,4460,1031,1086,2117,九曲堂,三等
2020-12-03,4460,1042,1148,2190,九曲堂,三等
2020-12-04,4460,1273,1419,2692,九曲堂,三等
2020-12-05,4460,1364,1450,2814,九曲堂,三等
2020-12-06,4460,1299,1229,2528,九曲堂,三等
2020-12-07,4460,1145,1148,2293,九曲堂,三等
2020-12-08,4460,1088,1103,2191,九曲堂,三等
2020-12-09,4460,1017,1044,2061,九曲堂,三等
2020-12-10,4460,1064,1143,2207,九曲堂,三等
2020-12-11,4460,1296,1390,2686,九曲堂,三等
2020-12-12,4460,1436,1414,2850,九曲堂,三等
2020-12-13,4460,1271,1269,2540,九曲堂,三等
2020-12-14,4460,1066,1085,2151,九曲堂,三等
2020-12-15,4460,1042,1065,2107,九曲堂,三等
2020-12-16,4460,1052,1102,2154,九曲堂,三等
2020-12-17,4460,1087,1143,2230,九曲堂,三等
2020-12-18,4460,1319,1463,2782,九曲堂,三等
2020-12-19,4460,1447,1435,2882,九曲堂,三等
2020-12-20,4460,1294,1288,2582,九曲堂,三等
2020-12-21,4460,1082,1115,2197,九曲堂,三等
2020-12-22,4460,1122,1114,2236,九曲堂,三等
2020-12-23,4460,1059,1078,2137,九曲堂,三等
2020-12-24,4460,1072,1156,2228,九曲堂,三等
2020-12-25,4460,1362,1441,2803,九曲堂,三等
2020-12-26,4460,1252,1228,2480,九曲堂,三等
2020-12-27,4460,1056,1085,2141,九曲堂,三等
2020-12-28,4460,1093,1054,2147,九曲堂,三等
2020-12-29,4460,1034,1082,2116,九曲堂,三等
2020-12-30,4460,1092,1164,2256,九曲堂,三等
2020-12-31,4460,1410,1498,2908,九曲堂,三等
2020-01-01,4470,83,128,211,六塊厝,招呼
2020-01-02,4470,139,142,281,六塊厝,招呼
2020-01-03,4470,145,162,307,六塊厝,招呼
2020-01-04,4470,116,134,250,六塊厝,招呼
2020-01-05,4470,135,153,288,六塊厝,招呼
2020-01-06,4470,136,155,291,六塊厝,招呼
2020-01-07,4470,160,162,322,六塊厝,招呼
2020-01-08,4470,156,157,313,六塊厝,招呼
2020-01-09,4470,151,164,315,六塊厝,招呼
2020-01-10,4470,164,210,374,六塊厝,招呼
2020-01-11,4470,107,141,248,六塊厝,招呼
2020-01-12,4470,105,142,247,六塊厝,招呼
2020-01-13,4470,162,177,339,六塊厝,招呼
2020-01-14,4470,156,161,317,六塊厝,招呼
2020-01-15,4470,170,182,352,六塊厝,招呼
2020-01-16,4470,154,180,334,六塊厝,招呼
2020-01-17,4470,170,182,352,六塊厝,招呼
2020-01-18,4470,101,128,229,六塊厝,招呼
2020-01-19,4470,111,148,259,六塊厝,招呼
2020-01-20,4470,140,152,292,六塊厝,招呼
2020-01-21,4470,144,164,308,六塊厝,招呼
2020-01-22,4470,136,170,306,六塊厝,招呼
2020-01-23,4470,101,115,216,六塊厝,招呼
2020-01-24,4470,73,92,165,六塊厝,招呼
2020-01-25,4470,104,125,229,六塊厝,招呼
2020-01-26,4470,79,109,188,六塊厝,招呼
2020-01-27,4470,114,138,252,六塊厝,招呼
2020-01-28,4470,75,89,164,六塊厝,招呼
2020-01-29,4470,100,114,214,六塊厝,招呼
2020-01-30,4470,134,144,278,六塊厝,招呼
2020-01-31,4470,128,146,274,六塊厝,招呼
2020-02-01,4470,101,116,217,六塊厝,招呼
2020-02-02,4470,79,84,163,六塊厝,招呼
2020-02-03,4470,127,154,281,六塊厝,招呼
2020-02-04,4470,143,167,310,六塊厝,招呼
2020-02-05,4470,124,133,257,六塊厝,招呼
2020-02-06,4470,138,185,323,六塊厝,招呼
2020-02-07,4470,159,173,332,六塊厝,招呼
2020-02-08,4470,104,133,237,六塊厝,招呼
2020-02-09,4470,102,106,208,六塊厝,招呼
2020-02-10,4470,137,161,298,六塊厝,招呼
2020-02-11,4470,149,147,296,六塊厝,招呼
2020-02-12,4470,128,138,266,六塊厝,招呼
2020-02-13,4470,131,141,272,六塊厝,招呼
2020-02-14,4470,158,231,389,六塊厝,招呼
2020-02-15,4470,120,132,252,六塊厝,招呼
2020-02-16,4470,82,118,200,六塊厝,招呼
2020-02-17,4470,129,134,263,六塊厝,招呼
2020-02-18,4470,138,153,291,六塊厝,招呼
2020-02-19,4470,144,176,320,六塊厝,招呼
2020-02-20,4470,140,138,278,六塊厝,招呼
2020-02-21,4470,137,159,296,六塊厝,招呼
2020-02-22,4470,92,113,205,六塊厝,招呼
2020-02-23,4470,91,98,189,六塊厝,招呼
2020-02-24,4470,141,154,295,六塊厝,招呼
2020-02-25,4470,139,165,304,六塊厝,招呼
2020-02-26,4470,125,123,248,六塊厝,招呼
2020-02-27,4470,136,153,289,六塊厝,招呼
2020-02-28,4470,121,137,258,六塊厝,招呼
2020-02-29,4470,79,137,216,六塊厝,招呼
2020-03-01,4470,92,112,204,六塊厝,招呼
2020-03-02,4470,151,143,294,六塊厝,招呼
2020-03-03,4470,146,144,290,六塊厝,招呼
2020-03-04,4470,136,140,276,六塊厝,招呼
2020-03-05,4470,141,133,274,六塊厝,招呼
2020-03-06,4470,143,170,313,六塊厝,招呼
2020-03-07,4470,108,123,231,六塊厝,招呼
2020-03-08,4470,118,118,236,六塊厝,招呼
2020-03-09,4470,129,149,278,六塊厝,招呼
2020-03-10,4470,130,136,266,六塊厝,招呼
2020-03-11,4470,154,154,308,六塊厝,招呼
2020-03-12,4470,134,159,293,六塊厝,招呼
2020-03-13,4470,134,180,314,六塊厝,招呼
2020-03-14,4470,80,121,201,六塊厝,招呼
2020-03-15,4470,95,109,204,六塊厝,招呼
2020-03-16,4470,135,143,278,六塊厝,招呼
2020-03-17,4470,145,151,296,六塊厝,招呼
2020-03-18,4470,136,153,289,六塊厝,招呼
2020-03-19,4470,139,150,289,六塊厝,招呼
2020-03-20,4470,147,172,319,六塊厝,招呼
2020-03-21,4470,85,114,199,六塊厝,招呼
2020-03-22,4470,78,97,175,六塊厝,招呼
2020-03-23,4470,124,124,248,六塊厝,招呼
2020-03-24,4470,125,139,264,六塊厝,招呼
2020-03-25,4470,127,123,250,六塊厝,招呼
2020-03-26,4470,136,141,277,六塊厝,招呼
2020-03-27,4470,132,151,283,六塊厝,招呼
2020-03-28,4470,77,103,180,六塊厝,招呼
2020-03-29,4470,65,76,141,六塊厝,招呼
2020-03-30,4470,118,131,249,六塊厝,招呼
2020-03-31,4470,134,147,281,六塊厝,招呼
2020-04-01,4470,133,170,303,六塊厝,招呼
2020-04-02,4470,66,98,164,六塊厝,招呼
2020-04-03,4470,75,85,160,六塊厝,招呼
2020-04-04,4470,56,64,120,六塊厝,招呼
2020-04-05,4470,77,62,139,六塊厝,招呼
2020-04-06,4470,120,128,248,六塊厝,招呼
2020-04-07,4470,130,131,261,六塊厝,招呼
2020-04-08,4470,134,127,261,六塊厝,招呼
2020-04-09,4470,118,117,235,六塊厝,招呼
2020-04-10,4470,109,121,230,六塊厝,招呼
2020-04-11,4470,69,90,159,六塊厝,招呼
2020-04-12,4470,75,89,164,六塊厝,招呼
2020-04-13,4470,120,133,253,六塊厝,招呼
2020-04-14,4470,128,141,269,六塊厝,招呼
2020-04-15,4470,139,147,286,六塊厝,招呼
2020-04-16,4470,139,142,281,六塊厝,招呼
2020-04-17,4470,139,152,291,六塊厝,招呼
2020-04-18,4470,87,95,182,六塊厝,招呼
2020-04-19,4470,78,97,175,六塊厝,招呼
2020-04-20,4470,126,151,277,六塊厝,招呼
2020-04-21,4470,118,114,232,六塊厝,招呼
2020-04-22,4470,125,126,251,六塊厝,招呼
2020-04-23,4470,124,130,254,六塊厝,招呼
2020-04-24,4470,148,155,303,六塊厝,招呼
2020-04-25,4470,70,86,156,六塊厝,招呼
2020-04-26,4470,78,74,152,六塊厝,招呼
2020-04-27,4470,114,126,240,六塊厝,招呼
2020-04-28,4470,128,123,251,六塊厝,招呼
2020-04-29,4470,105,131,236,六塊厝,招呼
2020-04-30,4470,137,135,272,六塊厝,招呼
2020-05-01,4470,118,143,261,六塊厝,招呼
2020-05-02,4470,71,92,163,六塊厝,招呼
2020-05-03,4470,81,78,159,六塊厝,招呼
2020-05-04,4470,118,129,247,六塊厝,招呼
2020-05-05,4470,134,130,264,六塊厝,招呼
2020-05-06,4470,130,130,260,六塊厝,招呼
2020-05-07,4470,129,144,273,六塊厝,招呼
2020-05-08,4470,139,136,275,六塊厝,招呼
2020-05-09,4470,86,101,187,六塊厝,招呼
2020-05-10,4470,69,84,153,六塊厝,招呼
2020-05-11,4470,128,135,263,六塊厝,招呼
2020-05-12,4470,129,133,262,六塊厝,招呼
2020-05-13,4470,146,146,292,六塊厝,招呼
2020-05-14,4470,134,146,280,六塊厝,招呼
2020-05-15,4470,145,181,326,六塊厝,招呼
2020-05-16,4470,72,79,151,六塊厝,招呼
2020-05-17,4470,95,88,183,六塊厝,招呼
2020-05-18,4470,133,153,286,六塊厝,招呼
2020-05-19,4470,118,128,246,六塊厝,招呼
2020-05-20,4470,124,130,254,六塊厝,招呼
2020-05-21,4470,122,119,241,六塊厝,招呼
2020-05-22,4470,92,118,210,六塊厝,招呼
2020-05-23,4470,56,75,131,六塊厝,招呼
2020-05-24,4470,93,105,198,六塊厝,招呼
2020-05-25,4470,131,141,272,六塊厝,招呼
2020-05-26,4470,131,119,250,六塊厝,招呼
2020-05-27,4470,106,128,234,六塊厝,招呼
2020-05-28,4470,110,113,223,六塊厝,招呼
2020-05-29,4470,143,163,306,六塊厝,招呼
2020-05-30,4470,73,101,174,六塊厝,招呼
2020-05-31,4470,83,70,153,六塊厝,招呼
2020-06-01,4470,132,133,265,六塊厝,招呼
2020-06-02,4470,140,129,269,六塊厝,招呼
2020-06-03,4470,137,142,279,六塊厝,招呼
2020-06-04,4470,130,139,269,六塊厝,招呼
2020-06-05,4470,156,178,334,六塊厝,招呼
2020-06-06,4470,82,101,183,六塊厝,招呼
2020-06-07,4470,104,104,208,六塊厝,招呼
2020-06-08,4470,119,129,248,六塊厝,招呼
2020-06-09,4470,126,128,254,六塊厝,招呼
2020-06-10,4470,123,136,259,六塊厝,招呼
2020-06-11,4470,139,154,293,六塊厝,招呼
2020-06-12,4470,150,174,324,六塊厝,招呼
2020-06-13,4470,108,131,239,六塊厝,招呼
2020-06-14,4470,96,115,211,六塊厝,招呼
2020-06-15,4470,124,138,262,六塊厝,招呼
2020-06-16,4470,123,137,260,六塊厝,招呼
2020-06-17,4470,140,134,274,六塊厝,招呼
2020-06-18,4470,133,145,278,六塊厝,招呼
2020-06-19,4470,131,139,270,六塊厝,招呼
2020-06-20,4470,135,153,288,六塊厝,招呼
2020-06-21,4470,92,92,184,六塊厝,招呼
2020-06-22,4470,137,150,287,六塊厝,招呼
2020-06-23,4470,145,166,311,六塊厝,招呼
2020-06-24,4470,155,165,320,六塊厝,招呼
2020-06-25,4470,91,134,225,六塊厝,招呼
2020-06-26,4470,125,146,271,六塊厝,招呼
2020-06-27,4470,110,133,243,六塊厝,招呼
2020-06-28,4470,85,91,176,六塊厝,招呼
2020-06-29,4470,135,133,268,六塊厝,招呼
2020-06-30,4470,129,131,260,六塊厝,招呼
2020-07-01,4470,146,155,301,六塊厝,招呼
2020-07-02,4470,149,146,295,六塊厝,招呼
2020-07-03,4470,156,142,298,六塊厝,招呼
2020-07-04,4470,115,120,235,六塊厝,招呼
2020-07-05,4470,111,115,226,六塊厝,招呼
2020-07-06,4470,131,146,277,六塊厝,招呼
2020-07-07,4470,144,133,277,六塊厝,招呼
2020-07-08,4470,142,157,299,六塊厝,招呼
2020-07-09,4470,135,134,269,六塊厝,招呼
2020-07-10,4470,138,156,294,六塊厝,招呼
2020-07-11,4470,130,158,288,六塊厝,招呼
2020-07-12,4470,97,109,206,六塊厝,招呼
2020-07-13,4470,132,142,274,六塊厝,招呼
2020-07-14,4470,119,129,248,六塊厝,招呼
2020-07-15,4470,114,120,234,六塊厝,招呼
2020-07-16,4470,130,147,277,六塊厝,招呼
2020-07-17,4470,156,176,332,六塊厝,招呼
2020-07-18,4470,94,111,205,六塊厝,招呼
2020-07-19,4470,87,97,184,六塊厝,招呼
2020-07-20,4470,128,143,271,六塊厝,招呼
2020-07-21,4470,148,142,290,六塊厝,招呼
2020-07-22,4470,137,137,274,六塊厝,招呼
2020-07-23,4470,144,143,287,六塊厝,招呼
2020-07-24,4470,162,153,315,六塊厝,招呼
2020-07-25,4470,122,145,267,六塊厝,招呼
2020-07-26,4470,100,114,214,六塊厝,招呼
2020-07-27,4470,136,159,295,六塊厝,招呼
2020-07-28,4470,127,131,258,六塊厝,招呼
2020-07-29,4470,132,128,260,六塊厝,招呼
2020-07-30,4470,138,121,259,六塊厝,招呼
2020-07-31,4470,148,165,313,六塊厝,招呼
2020-08-01,4470,119,130,249,六塊厝,招呼
2020-08-02,4470,86,107,193,六塊厝,招呼
2020-08-03,4470,120,127,247,六塊厝,招呼
2020-08-04,4470,112,143,255,六塊厝,招呼
2020-08-05,4470,133,128,261,六塊厝,招呼
2020-08-06,4470,158,163,321,六塊厝,招呼
2020-08-07,4470,159,164,323,六塊厝,招呼
2020-08-08,4470,84,111,195,六塊厝,招呼
2020-08-09,4470,122,124,246,六塊厝,招呼
2020-08-10,4470,116,140,256,六塊厝,招呼
2020-08-11,4470,123,132,255,六塊厝,招呼
2020-08-12,4470,150,161,311,六塊厝,招呼
2020-08-13,4470,125,150,275,六塊厝,招呼
2020-08-14,4470,149,168,317,六塊厝,招呼
2020-08-15,4470,112,114,226,六塊厝,招呼
2020-08-16,4470,102,125,227,六塊厝,招呼
2020-08-17,4470,134,142,276,六塊厝,招呼
2020-08-18,4470,121,124,245,六塊厝,招呼
2020-08-19,4470,144,156,300,六塊厝,招呼
2020-08-20,4470,136,146,282,六塊厝,招呼
2020-08-21,4470,146,158,304,六塊厝,招呼
2020-08-22,4470,76,99,175,六塊厝,招呼
2020-08-23,4470,103,113,216,六塊厝,招呼
2020-08-24,4470,130,143,273,六塊厝,招呼
2020-08-25,4470,136,134,270,六塊厝,招呼
2020-08-26,4470,125,125,250,六塊厝,招呼
2020-08-27,4470,103,116,219,六塊厝,招呼
2020-08-28,4470,140,151,291,六塊厝,招呼
2020-08-29,4470,93,118,211,六塊厝,招呼
2020-08-30,4470,90,103,193,六塊厝,招呼
2020-08-31,4470,137,147,284,六塊厝,招呼
2020-09-01,4470,150,144,294,六塊厝,招呼
2020-09-02,4470,143,147,290,六塊厝,招呼
2020-09-03,4470,120,119,239,六塊厝,招呼
2020-09-04,4470,152,174,326,六塊厝,招呼
2020-09-05,4470,107,123,230,六塊厝,招呼
2020-09-06,4470,103,114,217,六塊厝,招呼
2020-09-07,4470,134,164,298,六塊厝,招呼
2020-09-08,4470,149,152,301,六塊厝,招呼
2020-09-09,4470,153,157,310,六塊厝,招呼
2020-09-10,4470,153,159,312,六塊厝,招呼
2020-09-11,4470,158,160,318,六塊厝,招呼
2020-09-12,4470,104,108,212,六塊厝,招呼
2020-09-13,4470,119,131,250,六塊厝,招呼
2020-09-14,4470,132,142,274,六塊厝,招呼
2020-09-15,4470,137,142,279,六塊厝,招呼
2020-09-16,4470,133,133,266,六塊厝,招呼
2020-09-17,4470,147,137,284,六塊厝,招呼
2020-09-18,4470,163,171,334,六塊厝,招呼
2020-09-19,4470,117,118,235,六塊厝,招呼
2020-09-20,4470,87,99,186,六塊厝,招呼
2020-09-21,4470,145,146,291,六塊厝,招呼
2020-09-22,4470,135,143,278,六塊厝,招呼
2020-09-23,4470,157,154,311,六塊厝,招呼
2020-09-24,4470,149,161,310,六塊厝,招呼
2020-09-25,4470,149,150,299,六塊厝,招呼
2020-09-26,4470,141,143,284,六塊厝,招呼
2020-09-27,4470,97,109,206,六塊厝,招呼
2020-09-28,4470,127,150,277,六塊厝,招呼
2020-09-29,4470,142,155,297,六塊厝,招呼
2020-09-30,4470,161,189,350,六塊厝,招呼
2020-10-01,4470,113,160,273,六塊厝,招呼
2020-10-02,4470,120,131,251,六塊厝,招呼
2020-10-03,4470,118,130,248,六塊厝,招呼
2020-10-04,4470,117,110,227,六塊厝,招呼
2020-10-05,4470,155,149,304,六塊厝,招呼
2020-10-06,4470,146,143,289,六塊厝,招呼
2020-10-07,4470,134,133,267,六塊厝,招呼
2020-10-08,4470,160,196,356,六塊厝,招呼
2020-10-09,4470,111,126,237,六塊厝,招呼
2020-10-10,4470,108,136,244,六塊厝,招呼
2020-10-11,4470,99,89,188,六塊厝,招呼
2020-10-12,4470,145,150,295,六塊厝,招呼
2020-10-13,4470,146,151,297,六塊厝,招呼
2020-10-14,4470,142,146,288,六塊厝,招呼
2020-10-15,4470,144,150,294,六塊厝,招呼
2020-10-16,4470,162,177,339,六塊厝,招呼
2020-10-17,4470,117,136,253,六塊厝,招呼
2020-10-18,4470,114,127,241,六塊厝,招呼
2020-10-19,4470,148,139,287,六塊厝,招呼
2020-10-20,4470,136,143,279,六塊厝,招呼
2020-10-21,4470,153,157,310,六塊厝,招呼
2020-10-22,4470,156,160,316,六塊厝,招呼
2020-10-23,4470,150,177,327,六塊厝,招呼
2020-10-24,4470,80,93,173,六塊厝,招呼
2020-10-25,4470,103,119,222,六塊厝,招呼
2020-10-26,4470,132,159,291,六塊厝,招呼
2020-10-27,4470,152,158,310,六塊厝,招呼
2020-10-28,4470,150,150,300,六塊厝,招呼
2020-10-29,4470,163,173,336,六塊厝,招呼
2020-10-30,4470,155,180,335,六塊厝,招呼
2020-10-31,4470,105,138,243,六塊厝,招呼
2020-11-01,4470,104,123,227,六塊厝,招呼
2020-11-02,4470,163,176,339,六塊厝,招呼
2020-11-03,4470,195,190,385,六塊厝,招呼
2020-11-04,4470,181,196,377,六塊厝,招呼
2020-11-05,4470,156,161,317,六塊厝,招呼
2020-11-06,4470,147,182,329,六塊厝,招呼
2020-11-07,4470,108,126,234,六塊厝,招呼
2020-11-08,4470,119,133,252,六塊厝,招呼
2020-11-09,4470,147,148,295,六塊厝,招呼
2020-11-10,4470,148,163,311,六塊厝,招呼
2020-11-11,4470,143,144,287,六塊厝,招呼
2020-11-12,4470,147,163,310,六塊厝,招呼
2020-11-13,4470,153,182,335,六塊厝,招呼
2020-11-14,4470,119,125,244,六塊厝,招呼
2020-11-15,4470,101,123,224,六塊厝,招呼
2020-11-16,4470,159,163,322,六塊厝,招呼
2020-11-17,4470,160,162,322,六塊厝,招呼
2020-11-18,4470,151,156,307,六塊厝,招呼
2020-11-19,4470,157,158,315,六塊厝,招呼
2020-11-20,4470,142,188,330,六塊厝,招呼
2020-11-21,4470,113,143,256,六塊厝,招呼
2020-11-22,4470,85,99,184,六塊厝,招呼
2020-11-23,4470,150,146,296,六塊厝,招呼
2020-11-24,4470,153,157,310,六塊厝,招呼
2020-11-25,4470,133,148,281,六塊厝,招呼
2020-11-26,4470,180,174,354,六塊厝,招呼
2020-11-27,4470,168,195,363,六塊厝,招呼
2020-11-28,4470,102,121,223,六塊厝,招呼
2020-11-29,4470,103,105,208,六塊厝,招呼
2020-11-30,4470,154,159,313,六塊厝,招呼
2020-12-01,4470,154,155,309,六塊厝,招呼
2020-12-02,4470,140,147,287,六塊厝,招呼
2020-12-03,4470,158,168,326,六塊厝,招呼
2020-12-04,4470,157,192,349,六塊厝,招呼
2020-12-05,4470,93,120,213,六塊厝,招呼
2020-12-06,4470,119,130,249,六塊厝,招呼
2020-12-07,4470,152,183,335,六塊厝,招呼
2020-12-08,4470,140,146,286,六塊厝,招呼
2020-12-09,4470,156,158,314,六塊厝,招呼
2020-12-10,4470,183,182,365,六塊厝,招呼
2020-12-11,4470,170,202,372,六塊厝,招呼
2020-12-12,4470,131,128,259,六塊厝,招呼
2020-12-13,4470,128,140,268,六塊厝,招呼
2020-12-14,4470,150,161,311,六塊厝,招呼
2020-12-15,4470,168,179,347,六塊厝,招呼
2020-12-16,4470,170,160,330,六塊厝,招呼
2020-12-17,4470,165,161,326,六塊厝,招呼
2020-12-18,4470,163,200,363,六塊厝,招呼
2020-12-19,4470,104,132,236,六塊厝,招呼
2020-12-20,4470,118,152,270,六塊厝,招呼
2020-12-21,4470,160,167,327,六塊厝,招呼
2020-12-22,4470,158,178,336,六塊厝,招呼
2020-12-23,4470,163,170,333,六塊厝,招呼
2020-12-24,4470,180,175,355,六塊厝,招呼
2020-12-25,4470,159,200,359,六塊厝,招呼
2020-12-26,4470,104,134,238,六塊厝,招呼
2020-12-27,4470,107,127,234,六塊厝,招呼
2020-12-28,4470,158,167,325,六塊厝,招呼
2020-12-29,4470,148,168,316,六塊厝,招呼
2020-12-30,4470,141,172,313,六塊厝,招呼
2020-12-31,4470,163,206,369,六塊厝,招呼
2020-01-01,5000,11064,12267,23331,屏東,一等
2020-01-02,5000,9220,9598,18818,屏東,一等
2020-01-03,5000,10952,11708,22660,屏東,一等
2020-01-04,5000,10360,10632,20992,屏東,一等
2020-01-05,5000,11513,11103,22616,屏東,一等
2020-01-06,5000,9455,9628,19083,屏東,一等
2020-01-07,5000,9037,9082,18119,屏東,一等
2020-01-08,5000,9425,9436,18861,屏東,一等
2020-01-09,5000,10112,10437,20549,屏東,一等
2020-01-10,5000,14825,18658,33483,屏東,一等
2020-01-11,5000,13217,13661,26878,屏東,一等
2020-01-12,5000,15457,12124,27581,屏東,一等
2020-01-13,5000,11285,10735,22020,屏東,一等
2020-01-14,5000,9674,9471,19145,屏東,一等
2020-01-15,5000,9461,9740,19201,屏東,一等
2020-01-16,5000,10347,10799,21146,屏東,一等
2020-01-17,5000,11314,12204,23518,屏東,一等
2020-01-18,5000,11719,11710,23429,屏東,一等
2020-01-19,5000,12253,11671,23924,屏東,一等
2020-01-20,5000,10327,11149,21476,屏東,一等
2020-01-21,5000,10968,12340,23308,屏東,一等
2020-01-22,5000,11495,15263,26758,屏東,一等
2020-01-23,5000,9680,14950,24630,屏東,一等
2020-01-24,5000,7526,10664,18190,屏東,一等
2020-01-25,5000,13358,15058,28416,屏東,一等
2020-01-26,5000,13611,13788,27399,屏東,一等
2020-01-27,5000,16853,15214,32067,屏東,一等
2020-01-28,5000,14262,10956,25218,屏東,一等
2020-01-29,5000,14560,10703,25263,屏東,一等
2020-01-30,5000,11421,9680,21101,屏東,一等
2020-01-31,5000,10566,10370,20936,屏東,一等
2020-02-01,5000,8880,9109,17989,屏東,一等
2020-02-02,5000,10031,9077,19108,屏東,一等
2020-02-03,5000,9224,8961,18185,屏東,一等
2020-02-04,5000,8894,9097,17991,屏東,一等
2020-02-05,5000,8956,9650,18606,屏東,一等
2020-02-06,5000,9151,9335,18486,屏東,一等
2020-02-07,5000,11048,11233,22281,屏東,一等
2020-02-08,5000,8900,9396,18296,屏東,一等
2020-02-09,5000,10509,9892,20401,屏東,一等
2020-02-10,5000,9088,8942,18030,屏東,一等
2020-02-11,5000,8318,8323,16641,屏東,一等
2020-02-12,5000,8353,8407,16760,屏東,一等
2020-02-13,5000,8129,8345,16474,屏東,一等
2020-02-14,5000,9445,9834,19279,屏東,一等
2020-02-15,5000,8493,9178,17671,屏東,一等
2020-02-16,5000,9370,8997,18367,屏東,一等
2020-02-17,5000,7925,7964,15889,屏東,一等
2020-02-18,5000,8033,8029,16062,屏東,一等
2020-02-19,5000,7810,7974,15784,屏東,一等
2020-02-20,5000,8231,8363,16594,屏東,一等
2020-02-21,5000,9478,10431,19909,屏東,一等
2020-02-22,5000,8062,9940,18002,屏東,一等
2020-02-23,5000,9212,8456,17668,屏東,一等
2020-02-24,5000,8634,8282,16916,屏東,一等
2020-02-25,5000,8068,8053,16121,屏東,一等
2020-02-26,5000,8077,8298,16375,屏東,一等
2020-02-27,5000,10065,12192,22257,屏東,一等
2020-02-28,5000,8908,10467,19375,屏東,一等
2020-02-29,5000,8443,8905,17348,屏東,一等
2020-03-01,5000,11811,10026,21837,屏東,一等
2020-03-02,5000,8544,8481,17025,屏東,一等
2020-03-03,5000,7640,7584,15224,屏東,一等
2020-03-04,5000,7481,7571,15052,屏東,一等
2020-03-05,5000,7728,7681,15409,屏東,一等
2020-03-06,5000,10909,11248,22157,屏東,一等
2020-03-07,5000,7987,8507,16494,屏東,一等
2020-03-08,5000,9699,9486,19185,屏東,一等
2020-03-09,5000,8352,8855,17207,屏東,一等
2020-03-10,5000,7566,7671,15237,屏東,一等
2020-03-11,5000,7920,7909,15829,屏東,一等
2020-03-12,5000,8235,8206,16441,屏東,一等
2020-03-13,5000,11582,11754,23336,屏東,一等
2020-03-14,5000,7735,8140,15875,屏東,一等
2020-03-15,5000,10586,9892,20478,屏東,一等
2020-03-16,5000,8422,8462,16884,屏東,一等
2020-03-17,5000,7598,7682,15280,屏東,一等
2020-03-18,5000,7558,7473,15031,屏東,一等
2020-03-19,5000,7694,7696,15390,屏東,一等
2020-03-20,5000,10383,10996,21379,屏東,一等
2020-03-21,5000,6965,7664,14629,屏東,一等
2020-03-22,5000,8502,8017,16519,屏東,一等
2020-03-23,5000,7644,7812,15456,屏東,一等
2020-03-24,5000,6988,7096,14084,屏東,一等
2020-03-25,5000,6870,6964,13834,屏東,一等
2020-03-26,5000,7330,7756,15086,屏東,一等
2020-03-27,5000,9501,10458,19959,屏東,一等
2020-03-28,5000,6347,6865,13212,屏東,一等
2020-03-29,5000,7475,7038,14513,屏東,一等
2020-03-30,5000,7632,7731,15363,屏東,一等
2020-03-31,5000,7456,7780,15236,屏東,一等
2020-04-01,5000,11043,12235,23278,屏東,一等
2020-04-02,5000,7523,9023,16546,屏東,一等
2020-04-03,5000,6506,7320,13826,屏東,一等
2020-04-04,5000,5909,5443,11352,屏東,一等
2020-04-05,5000,10639,8477,19116,屏東,一等
2020-04-06,5000,8492,8695,17187,屏東,一等
2020-04-07,5000,6827,6363,13190,屏東,一等
2020-04-08,5000,6498,6309,12807,屏東,一等
2020-04-09,5000,6487,6414,12901,屏東,一等
2020-04-10,5000,8261,8394,16655,屏東,一等
2020-04-11,5000,5730,6363,12093,屏東,一等
2020-04-12,5000,6954,6466,13420,屏東,一等
2020-04-13,5000,6927,7098,14025,屏東,一等
2020-04-14,5000,6476,6923,13399,屏東,一等
2020-04-15,5000,6592,6861,13453,屏東,一等
2020-04-16,5000,6888,6977,13865,屏東,一等
2020-04-17,5000,9629,10144,19773,屏東,一等
2020-04-18,5000,6543,7038,13581,屏東,一等
2020-04-19,5000,7701,7342,15043,屏東,一等
2020-04-20,5000,7043,7173,14216,屏東,一等
2020-04-21,5000,5968,6039,12007,屏東,一等
2020-04-22,5000,6060,6093,12153,屏東,一等
2020-04-23,5000,6430,6252,12682,屏東,一等
2020-04-24,5000,8133,8556,16689,屏東,一等
2020-04-25,5000,4762,5257,10019,屏東,一等
2020-04-26,5000,5971,5750,11721,屏東,一等
2020-04-27,5000,6866,6918,13784,屏東,一等
2020-04-28,5000,6255,6311,12566,屏東,一等
2020-04-29,5000,6269,6417,12686,屏東,一等
2020-04-30,5000,7211,8059,15270,屏東,一等
2020-05-01,5000,8758,9421,18179,屏東,一等
2020-05-02,5000,5788,6260,12048,屏東,一等
2020-05-03,5000,8402,7570,15972,屏東,一等
2020-05-04,5000,7458,7557,15015,屏東,一等
2020-05-05,5000,6805,6788,13593,屏東,一等
2020-05-06,5000,6889,6947,13836,屏東,一等
2020-05-07,5000,7341,7313,14654,屏東,一等
2020-05-08,5000,11240,11826,23066,屏東,一等
2020-05-09,5000,7213,8359,15572,屏東,一等
2020-05-10,5000,9550,9130,18680,屏東,一等
2020-05-11,5000,8410,8380,16790,屏東,一等
2020-05-12,5000,7256,7059,14315,屏東,一等
2020-05-13,5000,7114,7077,14191,屏東,一等
2020-05-14,5000,7424,7394,14818,屏東,一等
2020-05-15,5000,10391,10775,21166,屏東,一等
2020-05-16,5000,6962,7496,14458,屏東,一等
2020-05-17,5000,8252,8190,16442,屏東,一等
2020-05-18,5000,7980,7964,15944,屏東,一等
2020-05-19,5000,6797,6780,13577,屏東,一等
2020-05-20,5000,6872,6840,13712,屏東,一等
2020-05-21,5000,6821,6852,13673,屏東,一等
2020-05-22,5000,8587,8989,17576,屏東,一等
2020-05-23,5000,6435,6795,13230,屏東,一等
2020-05-24,5000,9212,8951,18163,屏東,一等
2020-05-25,5000,8055,8173,16228,屏東,一等
2020-05-26,5000,7115,7176,14291,屏東,一等
2020-05-27,5000,6687,6658,13345,屏東,一等
2020-05-28,5000,7433,7368,14801,屏東,一等
2020-05-29,5000,10658,11021,21679,屏東,一等
2020-05-30,5000,8434,9073,17507,屏東,一等
2020-05-31,5000,9978,9768,19746,屏東,一等
2020-06-01,5000,8179,8374,16553,屏東,一等
2020-06-02,5000,7451,7442,14893,屏東,一等
2020-06-03,5000,7401,7477,14878,屏東,一等
2020-06-04,5000,7604,7776,15380,屏東,一等
2020-06-05,5000,11099,11145,22244,屏東,一等
2020-06-06,5000,8656,9202,17858,屏東,一等
2020-06-07,5000,10427,10240,20667,屏東,一等
2020-06-08,5000,8224,8390,16614,屏東,一等
2020-06-09,5000,7594,7613,15207,屏東,一等
2020-06-10,5000,7826,7892,15718,屏東,一等
2020-06-11,5000,8355,8213,16568,屏東,一等
2020-06-12,5000,10889,11918,22807,屏東,一等
2020-06-13,5000,10862,10800,21662,屏東,一等
2020-06-14,5000,10889,10730,21619,屏東,一等
2020-06-15,5000,8850,9037,17887,屏東,一等
2020-06-16,5000,8244,8294,16538,屏東,一等
2020-06-17,5000,7790,7945,15735,屏東,一等
2020-06-18,5000,8364,8183,16547,屏東,一等
2020-06-19,5000,9460,9811,19271,屏東,一等
2020-06-20,5000,9153,9616,18769,屏東,一等
2020-06-21,5000,9927,9616,19543,屏東,一等
2020-06-22,5000,8654,8639,17293,屏東,一等
2020-06-23,5000,8469,8762,17231,屏東,一等
2020-06-24,5000,11493,14353,25846,屏東,一等
2020-06-25,5000,10190,12811,23001,屏東,一等
2020-06-26,5000,11105,11468,22573,屏東,一等
2020-06-27,5000,11345,10208,21553,屏東,一等
2020-06-28,5000,13489,10696,24185,屏東,一等
2020-06-29,5000,10187,9094,19281,屏東,一等
2020-06-30,5000,8343,8206,16549,屏東,一等
2020-07-01,5000,7869,8028,15897,屏東,一等
2020-07-02,5000,7896,8148,16044,屏東,一等
2020-07-03,5000,10146,10735,20881,屏東,一等
2020-07-04,5000,8860,8707,17567,屏東,一等
2020-07-05,5000,9033,9141,18174,屏東,一等
2020-07-06,5000,9258,9063,18321,屏東,一等
2020-07-07,5000,8662,8551,17213,屏東,一等
2020-07-08,5000,8533,8664,17197,屏東,一等
2020-07-09,5000,8682,8965,17647,屏東,一等
2020-07-10,5000,10612,11167,21779,屏東,一等
2020-07-11,5000,9391,9804,19195,屏東,一等
2020-07-12,5000,10795,10356,21151,屏東,一等
2020-07-13,5000,8601,8819,17420,屏東,一等
2020-07-14,5000,9057,9298,18355,屏東,一等
2020-07-15,5000,8568,8757,17325,屏東,一等
2020-07-16,5000,9225,9497,18722,屏東,一等
2020-07-17,5000,11217,12597,23814,屏東,一等
2020-07-18,5000,11331,12401,23732,屏東,一等
2020-07-19,5000,12763,12536,25299,屏東,一等
2020-07-20,5000,11166,11031,22197,屏東,一等
2020-07-21,5000,10362,10307,20669,屏東,一等
2020-07-22,5000,10678,10475,21153,屏東,一等
2020-07-23,5000,10450,10332,20782,屏東,一等
2020-07-24,5000,11086,11739,22825,屏東,一等
2020-07-25,5000,10122,10465,20587,屏東,一等
2020-07-26,5000,11090,10700,21790,屏東,一等
2020-07-27,5000,9786,9744,19530,屏東,一等
2020-07-28,5000,8952,8925,17877,屏東,一等
2020-07-29,5000,8836,8964,17800,屏東,一等
2020-07-30,5000,9222,9285,18507,屏東,一等
2020-07-31,5000,10746,11351,22097,屏東,一等
2020-08-01,5000,9645,10265,19910,屏東,一等
2020-08-02,5000,10244,9721,19965,屏東,一等
2020-08-03,5000,8448,8259,16707,屏東,一等
2020-08-04,5000,7592,7540,15132,屏東,一等
2020-08-05,5000,8862,8857,17719,屏東,一等
2020-08-06,5000,9356,9504,18860,屏東,一等
2020-08-07,5000,11288,12895,24183,屏東,一等
2020-08-08,5000,9511,10339,19850,屏東,一等
2020-08-09,5000,12313,10796,23109,屏東,一等
2020-08-10,5000,10131,9538,19669,屏東,一等
2020-08-11,5000,8183,8164,16347,屏東,一等
2020-08-12,5000,9053,9366,18419,屏東,一等
2020-08-13,5000,9199,9491,18690,屏東,一等
2020-08-14,5000,11396,12144,23540,屏東,一等
2020-08-15,5000,11067,11286,22353,屏東,一等
2020-08-16,5000,12796,12122,24918,屏東,一等
2020-08-17,5000,10338,10294,20632,屏東,一等
2020-08-18,5000,9656,9704,19360,屏東,一等
2020-08-19,5000,9271,9408,18679,屏東,一等
2020-08-20,5000,9394,9442,18836,屏東,一等
2020-08-21,5000,11250,11555,22805,屏東,一等
2020-08-22,5000,9473,9702,19175,屏東,一等
2020-08-23,5000,10703,10204,20907,屏東,一等
2020-08-24,5000,9637,9898,19535,屏東,一等
2020-08-25,5000,9388,9272,18660,屏東,一等
2020-08-26,5000,8146,8187,16333,屏東,一等
2020-08-27,5000,8258,8288,16546,屏東,一等
2020-08-28,5000,10260,11222,21482,屏東,一等
2020-08-29,5000,9294,9542,18836,屏東,一等
2020-08-30,5000,10217,9613,19830,屏東,一等
2020-08-31,5000,8634,8785,17419,屏東,一等
2020-09-01,5000,8287,8580,16867,屏東,一等
2020-09-02,5000,7978,8117,16095,屏東,一等
2020-09-03,5000,8930,8948,17878,屏東,一等
2020-09-04,5000,10728,11426,22154,屏東,一等
2020-09-05,5000,9863,10412,20275,屏東,一等
2020-09-06,5000,11486,10767,22253,屏東,一等
2020-09-07,5000,8878,8827,17705,屏東,一等
2020-09-08,5000,8598,8765,17363,屏東,一等
2020-09-09,5000,8577,9011,17588,屏東,一等
2020-09-10,5000,9031,8975,18006,屏東,一等
2020-09-11,5000,11287,11944,23231,屏東,一等
2020-09-12,5000,10171,10665,20836,屏東,一等
2020-09-13,5000,11835,11983,23818,屏東,一等
2020-09-14,5000,8530,8540,17070,屏東,一等
2020-09-15,5000,7866,8039,15905,屏東,一等
2020-09-16,5000,8026,8116,16142,屏東,一等
2020-09-17,5000,8618,8395,17013,屏東,一等
2020-09-18,5000,12479,12408,24887,屏東,一等
2020-09-19,5000,10524,10972,21496,屏東,一等
2020-09-20,5000,11927,12218,24145,屏東,一等
2020-09-21,5000,8746,9216,17962,屏東,一等
2020-09-22,5000,8303,8431,16734,屏東,一等
2020-09-23,5000,8372,8444,16816,屏東,一等
2020-09-24,5000,8520,8578,17098,屏東,一等
2020-09-25,5000,9721,9942,19663,屏東,一等
2020-09-26,5000,9855,9883,19738,屏東,一等
2020-09-27,5000,10444,10684,21128,屏東,一等
2020-09-28,5000,8552,8872,17424,屏東,一等
2020-09-29,5000,8530,9327,17857,屏東,一等
2020-09-30,5000,14913,16664,31577,屏東,一等
2020-10-01,5000,11847,14265,26112,屏東,一等
2020-10-02,5000,11729,12145,23874,屏東,一等
2020-10-03,5000,12463,11421,23884,屏東,一等
2020-10-04,5000,16551,14306,30857,屏東,一等
2020-10-05,5000,10467,9978,20445,屏東,一等
2020-10-06,5000,8575,8532,17107,屏東,一等
2020-10-07,5000,8466,8832,17298,屏東,一等
2020-10-08,5000,12866,13335,26201,屏東,一等
2020-10-09,5000,11780,12088,23868,屏東,一等
2020-10-10,5000,10619,10491,21110,屏東,一等
2020-10-11,5000,13289,13358,26647,屏東,一等
2020-10-12,5000,9298,9511,18809,屏東,一等
2020-10-13,5000,8377,8432,16809,屏東,一等
2020-10-14,5000,8454,8506,16960,屏東,一等
2020-10-15,5000,9018,8905,17923,屏東,一等
2020-10-16,5000,12135,12336,24471,屏東,一等
2020-10-17,5000,11380,11346,22726,屏東,一等
2020-10-18,5000,12328,12129,24457,屏東,一等
2020-10-19,5000,9142,9719,18861,屏東,一等
2020-10-20,5000,8452,8719,17171,屏東,一等
2020-10-21,5000,8540,8540,17080,屏東,一等
2020-10-22,5000,8782,8950,17732,屏東,一等
2020-10-23,5000,12206,12562,24768,屏東,一等
2020-10-24,5000,11012,11438,22450,屏東,一等
2020-10-25,5000,12041,12031,24072,屏東,一等
2020-10-26,5000,8990,9230,18220,屏東,一等
2020-10-27,5000,8586,8466,17052,屏東,一等
2020-10-28,5000,8757,8621,17378,屏東,一等
2020-10-29,5000,8680,8780,17460,屏東,一等
2020-10-30,5000,12231,12570,24801,屏東,一等
2020-10-31,5000,10322,10801,21123,屏東,一等
2020-11-01,5000,11607,11602,23209,屏東,一等
2020-11-02,5000,8773,9153,17926,屏東,一等
2020-11-03,5000,7969,8229,16198,屏東,一等
2020-11-04,5000,8222,8582,16804,屏東,一等
2020-11-05,5000,8730,8799,17529,屏東,一等
2020-11-06,5000,11468,11966,23434,屏東,一等
2020-11-07,5000,9893,9998,19891,屏東,一等
2020-11-08,5000,11565,11697,23262,屏東,一等
2020-11-09,5000,9034,9052,18086,屏東,一等
2020-11-10,5000,8471,8598,17069,屏東,一等
2020-11-11,5000,8700,8700,17400,屏東,一等
2020-11-12,5000,9650,9288,18938,屏東,一等
2020-11-13,5000,13346,13604,26950,屏東,一等
2020-11-14,5000,11912,11966,23878,屏東,一等
2020-11-15,5000,13062,13604,26666,屏東,一等
2020-11-16,5000,9357,9840,19197,屏東,一等
2020-11-17,5000,8520,8738,17258,屏東,一等
2020-11-18,5000,8695,8656,17351,屏東,一等
2020-11-19,5000,9186,9152,18338,屏東,一等
2020-11-20,5000,13205,13382,26587,屏東,一等
2020-11-21,5000,10933,11321,22254,屏東,一等
2020-11-22,5000,12590,12708,25298,屏東,一等
2020-11-23,5000,9341,9608,18949,屏東,一等
2020-11-24,5000,8438,8484,16922,屏東,一等
2020-11-25,5000,8728,8680,17408,屏東,一等
2020-11-26,5000,9356,9167,18523,屏東,一等
2020-11-27,5000,12639,13462,26101,屏東,一等
2020-11-28,5000,11342,11929,23271,屏東,一等
2020-11-29,5000,12673,12222,24895,屏東,一等
2020-11-30,5000,9472,9505,18977,屏東,一等
2020-12-01,5000,8202,8240,16442,屏東,一等
2020-12-02,5000,8366,8458,16824,屏東,一等
2020-12-03,5000,8866,8953,17819,屏東,一等
2020-12-04,5000,13076,13023,26099,屏東,一等
2020-12-05,5000,12417,12606,25023,屏東,一等
2020-12-06,5000,13380,13696,27076,屏東,一等
2020-12-07,5000,9634,9884,19518,屏東,一等
2020-12-08,5000,8607,8587,17194,屏東,一等
2020-12-09,5000,8284,8471,16755,屏東,一等
2020-12-10,5000,8914,8874,17788,屏東,一等
2020-12-11,5000,12929,13155,26084,屏東,一等
2020-12-12,5000,12950,13188,26138,屏東,一等
2020-12-13,5000,13434,13830,27264,屏東,一等
2020-12-14,5000,9898,10326,20224,屏東,一等
2020-12-15,5000,8561,8593,17154,屏東,一等
2020-12-16,5000,8865,8975,17840,屏東,一等
2020-12-17,5000,9299,9396,18695,屏東,一等
2020-12-18,5000,13322,13434,26756,屏東,一等
2020-12-19,5000,12307,12971,25278,屏東,一等
2020-12-20,5000,13833,13595,27428,屏東,一等
2020-12-21,5000,9466,9950,19416,屏東,一等
2020-12-22,5000,8715,8814,17529,屏東,一等
2020-12-23,5000,8702,8819,17521,屏東,一等
2020-12-24,5000,9598,9712,19310,屏東,一等
2020-12-25,5000,13286,13302,26588,屏東,一等
2020-12-26,5000,11817,12279,24096,屏東,一等
2020-12-27,5000,12186,12202,24388,屏東,一等
2020-12-28,5000,9347,9674,19021,屏東,一等
2020-12-29,5000,8656,8824,17480,屏東,一等
2020-12-30,5000,9567,9663,19230,屏東,一等
2020-12-31,5000,15030,14346,29376,屏東,一等
2020-01-01,5010,227,264,491,歸來,招呼
2020-01-02,5010,192,221,413,歸來,招呼
2020-01-03,5010,264,240,504,歸來,招呼
2020-01-04,5010,205,217,422,歸來,招呼
2020-01-05,5010,191,237,428,歸來,招呼
2020-01-06,5010,204,239,443,歸來,招呼
2020-01-07,5010,213,227,440,歸來,招呼
2020-01-08,5010,202,215,417,歸來,招呼
2020-01-09,5010,210,222,432,歸來,招呼
2020-01-10,5010,307,295,602,歸來,招呼
2020-01-11,5010,237,292,529,歸來,招呼
2020-01-12,5010,213,212,425,歸來,招呼
2020-01-13,5010,243,253,496,歸來,招呼
2020-01-14,5010,218,225,443,歸來,招呼
2020-01-15,5010,217,221,438,歸來,招呼
2020-01-16,5010,226,219,445,歸來,招呼
2020-01-17,5010,246,250,496,歸來,招呼
2020-01-18,5010,185,216,401,歸來,招呼
2020-01-19,5010,189,190,379,歸來,招呼
2020-01-20,5010,208,207,415,歸來,招呼
2020-01-21,5010,196,224,420,歸來,招呼
2020-01-22,5010,197,231,428,歸來,招呼
2020-01-23,5010,161,206,367,歸來,招呼
2020-01-24,5010,120,165,285,歸來,招呼
2020-01-25,5010,207,257,464,歸來,招呼
2020-01-26,5010,212,232,444,歸來,招呼
2020-01-27,5010,258,295,553,歸來,招呼
2020-01-28,5010,185,181,366,歸來,招呼
2020-01-29,5010,169,176,345,歸來,招呼
2020-01-30,5010,209,214,423,歸來,招呼
2020-01-31,5010,163,179,342,歸來,招呼
2020-02-01,5010,133,165,298,歸來,招呼
2020-02-02,5010,109,125,234,歸來,招呼
2020-02-03,5010,182,192,374,歸來,招呼
2020-02-04,5010,185,178,363,歸來,招呼
2020-02-05,5010,208,223,431,歸來,招呼
2020-02-06,5010,187,186,373,歸來,招呼
2020-02-07,5010,233,216,449,歸來,招呼
2020-02-08,5010,288,399,687,歸來,招呼
2020-02-09,5010,167,178,345,歸來,招呼
2020-02-10,5010,189,202,391,歸來,招呼
2020-02-11,5010,177,188,365,歸來,招呼
2020-02-12,5010,190,177,367,歸來,招呼
2020-02-13,5010,182,190,372,歸來,招呼
2020-02-14,5010,208,214,422,歸來,招呼
2020-02-15,5010,173,198,371,歸來,招呼
2020-02-16,5010,150,168,318,歸來,招呼
2020-02-17,5010,180,201,381,歸來,招呼
2020-02-18,5010,191,194,385,歸來,招呼
2020-02-19,5010,187,191,378,歸來,招呼
2020-02-20,5010,173,174,347,歸來,招呼
2020-02-21,5010,210,236,446,歸來,招呼
2020-02-22,5010,148,227,375,歸來,招呼
2020-02-23,5010,129,157,286,歸來,招呼
2020-02-24,5010,191,196,387,歸來,招呼
2020-02-25,5010,196,189,385,歸來,招呼
2020-02-26,5010,219,209,428,歸來,招呼
2020-02-27,5010,209,264,473,歸來,招呼
2020-02-28,5010,156,178,334,歸來,招呼
2020-02-29,5010,138,195,333,歸來,招呼
2020-03-01,5010,176,210,386,歸來,招呼
2020-03-02,5010,221,239,460,歸來,招呼
2020-03-03,5010,205,223,428,歸來,招呼
2020-03-04,5010,215,213,428,歸來,招呼
2020-03-05,5010,198,204,402,歸來,招呼
2020-03-06,5010,308,264,572,歸來,招呼
2020-03-07,5010,162,173,335,歸來,招呼
2020-03-08,5010,174,200,374,歸來,招呼
2020-03-09,5010,208,232,440,歸來,招呼
2020-03-10,5010,214,224,438,歸來,招呼
2020-03-11,5010,214,203,417,歸來,招呼
2020-03-12,5010,201,230,431,歸來,招呼
2020-03-13,5010,299,244,543,歸來,招呼
2020-03-14,5010,152,162,314,歸來,招呼
2020-03-15,5010,154,190,344,歸來,招呼
2020-03-16,5010,206,249,455,歸來,招呼
2020-03-17,5010,203,199,402,歸來,招呼
2020-03-18,5010,225,218,443,歸來,招呼
2020-03-19,5010,212,202,414,歸來,招呼
2020-03-20,5010,320,249,569,歸來,招呼
2020-03-21,5010,122,133,255,歸來,招呼
2020-03-22,5010,137,157,294,歸來,招呼
2020-03-23,5010,234,252,486,歸來,招呼
2020-03-24,5010,186,195,381,歸來,招呼
2020-03-25,5010,201,198,399,歸來,招呼
2020-03-26,5010,209,217,426,歸來,招呼
2020-03-27,5010,296,225,521,歸來,招呼
2020-03-28,5010,126,153,279,歸來,招呼
2020-03-29,5010,177,210,387,歸來,招呼
2020-03-30,5010,222,249,471,歸來,招呼
2020-03-31,5010,194,204,398,歸來,招呼
2020-04-01,5010,306,235,541,歸來,招呼
2020-04-02,5010,166,161,327,歸來,招呼
2020-04-03,5010,115,146,261,歸來,招呼
2020-04-04,5010,119,105,224,歸來,招呼
2020-04-05,5010,152,171,323,歸來,招呼
2020-04-06,5010,210,240,450,歸來,招呼
2020-04-07,5010,208,205,413,歸來,招呼
2020-04-08,5010,200,199,399,歸來,招呼
2020-04-09,5010,184,178,362,歸來,招呼
2020-04-10,5010,234,200,434,歸來,招呼
2020-04-11,5010,112,114,226,歸來,招呼
2020-04-12,5010,113,134,247,歸來,招呼
2020-04-13,5010,191,224,415,歸來,招呼
2020-04-14,5010,194,210,404,歸來,招呼
2020-04-15,5010,179,212,391,歸來,招呼
2020-04-16,5010,202,201,403,歸來,招呼
2020-04-17,5010,270,215,485,歸來,招呼
2020-04-18,5010,139,156,295,歸來,招呼
2020-04-19,5010,147,181,328,歸來,招呼
2020-04-20,5010,191,203,394,歸來,招呼
2020-04-21,5010,183,178,361,歸來,招呼
2020-04-22,5010,193,191,384,歸來,招呼
2020-04-23,5010,174,177,351,歸來,招呼
2020-04-24,5010,255,204,459,歸來,招呼
2020-04-25,5010,96,115,211,歸來,招呼
2020-04-26,5010,105,123,228,歸來,招呼
2020-04-27,5010,193,203,396,歸來,招呼
2020-04-28,5010,197,197,394,歸來,招呼
2020-04-29,5010,179,183,362,歸來,招呼
2020-04-30,5010,193,195,388,歸來,招呼
2020-05-01,5010,244,182,426,歸來,招呼
2020-05-02,5010,129,133,262,歸來,招呼
2020-05-03,5010,146,169,315,歸來,招呼
2020-05-04,5010,194,218,412,歸來,招呼
2020-05-05,5010,172,196,368,歸來,招呼
2020-05-06,5010,201,207,408,歸來,招呼
2020-05-07,5010,211,212,423,歸來,招呼
2020-05-08,5010,303,225,528,歸來,招呼
2020-05-09,5010,136,164,300,歸來,招呼
2020-05-10,5010,154,205,359,歸來,招呼
2020-05-11,5010,204,238,442,歸來,招呼
2020-05-12,5010,170,179,349,歸來,招呼
2020-05-13,5010,207,204,411,歸來,招呼
2020-05-14,5010,201,186,387,歸來,招呼
2020-05-15,5010,281,254,535,歸來,招呼
2020-05-16,5010,105,119,224,歸來,招呼
2020-05-17,5010,110,156,266,歸來,招呼
2020-05-18,5010,203,236,439,歸來,招呼
2020-05-19,5010,214,209,423,歸來,招呼
2020-05-20,5010,218,234,452,歸來,招呼
2020-05-21,5010,195,223,418,歸來,招呼
2020-05-22,5010,240,185,425,歸來,招呼
2020-05-23,5010,150,137,287,歸來,招呼
2020-05-24,5010,141,182,323,歸來,招呼
2020-05-25,5010,215,226,441,歸來,招呼
2020-05-26,5010,196,221,417,歸來,招呼
2020-05-27,5010,178,191,369,歸來,招呼
2020-05-28,5010,215,200,415,歸來,招呼
2020-05-29,5010,301,221,522,歸來,招呼
2020-05-30,5010,162,222,384,歸來,招呼
2020-05-31,5010,152,201,353,歸來,招呼
2020-06-01,5010,199,218,417,歸來,招呼
2020-06-02,5010,198,210,408,歸來,招呼
2020-06-03,5010,213,205,418,歸來,招呼
2020-06-04,5010,207,211,418,歸來,招呼
2020-06-05,5010,307,240,547,歸來,招呼
2020-06-06,5010,164,187,351,歸來,招呼
2020-06-07,5010,199,223,422,歸來,招呼
2020-06-08,5010,211,218,429,歸來,招呼
2020-06-09,5010,198,198,396,歸來,招呼
2020-06-10,5010,232,226,458,歸來,招呼
2020-06-11,5010,218,212,430,歸來,招呼
2020-06-12,5010,293,249,542,歸來,招呼
2020-06-13,5010,192,241,433,歸來,招呼
2020-06-14,5010,176,188,364,歸來,招呼
2020-06-15,5010,216,232,448,歸來,招呼
2020-06-16,5010,211,219,430,歸來,招呼
2020-06-17,5010,213,214,427,歸來,招呼
2020-06-18,5010,217,213,430,歸來,招呼
2020-06-19,5010,263,256,519,歸來,招呼
2020-06-20,5010,208,198,406,歸來,招呼
2020-06-21,5010,175,186,361,歸來,招呼
2020-06-22,5010,235,249,484,歸來,招呼
2020-06-23,5010,228,226,454,歸來,招呼
2020-06-24,5010,249,275,524,歸來,招呼
2020-06-25,5010,185,210,395,歸來,招呼
2020-06-26,5010,234,238,472,歸來,招呼
2020-06-27,5010,198,202,400,歸來,招呼
2020-06-28,5010,206,198,404,歸來,招呼
2020-06-29,5010,228,236,464,歸來,招呼
2020-06-30,5010,220,221,441,歸來,招呼
2020-07-01,5010,242,226,468,歸來,招呼
2020-07-02,5010,219,214,433,歸來,招呼
2020-07-03,5010,219,222,441,歸來,招呼
2020-07-04,5010,171,159,330,歸來,招呼
2020-07-05,5010,146,170,316,歸來,招呼
2020-07-06,5010,203,208,411,歸來,招呼
2020-07-07,5010,214,231,445,歸來,招呼
2020-07-08,5010,236,206,442,歸來,招呼
2020-07-09,5010,209,192,401,歸來,招呼
2020-07-10,5010,211,229,440,歸來,招呼
2020-07-11,5010,175,193,368,歸來,招呼
2020-07-12,5010,179,184,363,歸來,招呼
2020-07-13,5010,190,200,390,歸來,招呼
2020-07-14,5010,198,189,387,歸來,招呼
2020-07-15,5010,215,207,422,歸來,招呼
2020-07-16,5010,227,228,455,歸來,招呼
2020-07-17,5010,208,214,422,歸來,招呼
2020-07-18,5010,197,219,416,歸來,招呼
2020-07-19,5010,178,188,366,歸來,招呼
2020-07-20,5010,218,222,440,歸來,招呼
2020-07-21,5010,206,218,424,歸來,招呼
2020-07-22,5010,225,234,459,歸來,招呼
2020-07-23,5010,223,218,441,歸來,招呼
2020-07-24,5010,249,259,508,歸來,招呼
2020-07-25,5010,173,190,363,歸來,招呼
2020-07-26,5010,179,158,337,歸來,招呼
2020-07-27,5010,200,206,406,歸來,招呼
2020-07-28,5010,238,245,483,歸來,招呼
2020-07-29,5010,228,216,444,歸來,招呼
2020-07-30,5010,270,253,523,歸來,招呼
2020-07-31,5010,255,245,500,歸來,招呼
2020-08-01,5010,208,217,425,歸來,招呼
2020-08-02,5010,146,156,302,歸來,招呼
2020-08-03,5010,202,217,419,歸來,招呼
2020-08-04,5010,199,199,398,歸來,招呼
2020-08-05,5010,225,244,469,歸來,招呼
2020-08-06,5010,219,216,435,歸來,招呼
2020-08-07,5010,236,263,499,歸來,招呼
2020-08-08,5010,200,200,400,歸來,招呼
2020-08-09,5010,214,209,423,歸來,招呼
2020-08-10,5010,210,226,436,歸來,招呼
2020-08-11,5010,216,210,426,歸來,招呼
2020-08-12,5010,223,222,445,歸來,招呼
2020-08-13,5010,224,215,439,歸來,招呼
2020-08-14,5010,266,248,514,歸來,招呼
2020-08-15,5010,189,216,405,歸來,招呼
2020-08-16,5010,178,220,398,歸來,招呼
2020-08-17,5010,245,218,463,歸來,招呼
2020-08-18,5010,242,247,489,歸來,招呼
2020-08-19,5010,227,212,439,歸來,招呼
2020-08-20,5010,228,229,457,歸來,招呼
2020-08-21,5010,226,221,447,歸來,招呼
2020-08-22,5010,160,186,346,歸來,招呼
2020-08-23,5010,198,211,409,歸來,招呼
2020-08-24,5010,224,209,433,歸來,招呼
2020-08-25,5010,225,225,450,歸來,招呼
2020-08-26,5010,194,197,391,歸來,招呼
2020-08-27,5010,193,210,403,歸來,招呼
2020-08-28,5010,226,229,455,歸來,招呼
2020-08-29,5010,152,190,342,歸來,招呼
2020-08-30,5010,191,155,346,歸來,招呼
2020-08-31,5010,224,208,432,歸來,招呼
2020-09-01,5010,186,193,379,歸來,招呼
2020-09-02,5010,199,218,417,歸來,招呼
2020-09-03,5010,210,199,409,歸來,招呼
2020-09-04,5010,227,232,459,歸來,招呼
2020-09-05,5010,187,167,354,歸來,招呼
2020-09-06,5010,207,166,373,歸來,招呼
2020-09-07,5010,246,235,481,歸來,招呼
2020-09-08,5010,214,214,428,歸來,招呼
2020-09-09,5010,193,208,401,歸來,招呼
2020-09-10,5010,195,192,387,歸來,招呼
2020-09-11,5010,242,227,469,歸來,招呼
2020-09-12,5010,220,243,463,歸來,招呼
2020-09-13,5010,204,215,419,歸來,招呼
2020-09-14,5010,239,225,464,歸來,招呼
2020-09-15,5010,204,205,409,歸來,招呼
2020-09-16,5010,224,229,453,歸來,招呼
2020-09-17,5010,238,218,456,歸來,招呼
2020-09-18,5010,304,258,562,歸來,招呼
2020-09-19,5010,230,216,446,歸來,招呼
2020-09-20,5010,233,242,475,歸來,招呼
2020-09-21,5010,256,274,530,歸來,招呼
2020-09-22,5010,227,239,466,歸來,招呼
2020-09-23,5010,221,244,465,歸來,招呼
2020-09-24,5010,243,242,485,歸來,招呼
2020-09-25,5010,239,240,479,歸來,招呼
2020-09-26,5010,262,223,485,歸來,招呼
2020-09-27,5010,222,244,466,歸來,招呼
2020-09-28,5010,216,233,449,歸來,招呼
2020-09-29,5010,216,233,449,歸來,招呼
2020-09-30,5010,362,314,676,歸來,招呼
2020-10-01,5010,245,288,533,歸來,招呼
2020-10-02,5010,219,287,506,歸來,招呼
2020-10-03,5010,235,231,466,歸來,招呼
2020-10-04,5010,225,249,474,歸來,招呼
2020-10-05,5010,237,274,511,歸來,招呼
2020-10-06,5010,231,235,466,歸來,招呼
2020-10-07,5010,243,232,475,歸來,招呼
2020-10-08,5010,332,289,621,歸來,招呼
2020-10-09,5010,222,228,450,歸來,招呼
2020-10-10,5010,224,215,439,歸來,招呼
2020-10-11,5010,189,227,416,歸來,招呼
2020-10-12,5010,223,257,480,歸來,招呼
2020-10-13,5010,203,209,412,歸來,招呼
2020-10-14,5010,249,243,492,歸來,招呼
2020-10-15,5010,247,236,483,歸來,招呼
2020-10-16,5010,306,280,586,歸來,招呼
2020-10-17,5010,546,737,1283,歸來,招呼
2020-10-18,5010,215,238,453,歸來,招呼
2020-10-19,5010,240,278,518,歸來,招呼
2020-10-20,5010,212,224,436,歸來,招呼
2020-10-21,5010,229,223,452,歸來,招呼
2020-10-22,5010,224,222,446,歸來,招呼
2020-10-23,5010,310,255,565,歸來,招呼
2020-10-24,5010,215,215,430,歸來,招呼
2020-10-25,5010,212,244,456,歸來,招呼
2020-10-26,5010,227,274,501,歸來,招呼
2020-10-27,5010,219,227,446,歸來,招呼
2020-10-28,5010,232,216,448,歸來,招呼
2020-10-29,5010,215,223,438,歸來,招呼
2020-10-30,5010,293,236,529,歸來,招呼
2020-10-31,5010,234,261,495,歸來,招呼
2020-11-01,5010,202,223,425,歸來,招呼
2020-11-02,5010,228,259,487,歸來,招呼
2020-11-03,5010,222,241,463,歸來,招呼
2020-11-04,5010,223,229,452,歸來,招呼
2020-11-05,5010,238,242,480,歸來,招呼
2020-11-06,5010,323,253,576,歸來,招呼
2020-11-07,5010,202,216,418,歸來,招呼
2020-11-08,5010,206,237,443,歸來,招呼
2020-11-09,5010,220,237,457,歸來,招呼
2020-11-10,5010,215,217,432,歸來,招呼
2020-11-11,5010,227,257,484,歸來,招呼
2020-11-12,5010,248,230,478,歸來,招呼
2020-11-13,5010,315,304,619,歸來,招呼
2020-11-14,5010,253,257,510,歸來,招呼
2020-11-15,5010,218,288,506,歸來,招呼
2020-11-16,5010,221,252,473,歸來,招呼
2020-11-17,5010,218,216,434,歸來,招呼
2020-11-18,5010,242,248,490,歸來,招呼
2020-11-19,5010,236,217,453,歸來,招呼
2020-11-20,5010,359,298,657,歸來,招呼
2020-11-21,5010,221,201,422,歸來,招呼
2020-11-22,5010,208,276,484,歸來,招呼
2020-11-23,5010,211,268,479,歸來,招呼
2020-11-24,5010,230,223,453,歸來,招呼
2020-11-25,5010,229,235,464,歸來,招呼
2020-11-26,5010,257,247,504,歸來,招呼
2020-11-27,5010,279,264,543,歸來,招呼
2020-11-28,5010,199,217,416,歸來,招呼
2020-11-29,5010,195,251,446,歸來,招呼
2020-11-30,5010,192,235,427,歸來,招呼
2020-12-01,5010,220,229,449,歸來,招呼
2020-12-02,5010,222,224,446,歸來,招呼
2020-12-03,5010,247,230,477,歸來,招呼
2020-12-04,5010,286,248,534,歸來,招呼
2020-12-05,5010,243,261,504,歸來,招呼
2020-12-06,5010,215,249,464,歸來,招呼
2020-12-07,5010,227,278,505,歸來,招呼
2020-12-08,5010,221,230,451,歸來,招呼
2020-12-09,5010,215,253,468,歸來,招呼
2020-12-10,5010,238,210,448,歸來,招呼
2020-12-11,5010,315,268,583,歸來,招呼
2020-12-12,5010,240,276,516,歸來,招呼
2020-12-13,5010,213,285,498,歸來,招呼
2020-12-14,5010,236,260,496,歸來,招呼
2020-12-15,5010,241,238,479,歸來,招呼
2020-12-16,5010,244,238,482,歸來,招呼
2020-12-17,5010,258,243,501,歸來,招呼
2020-12-18,5010,326,309,635,歸來,招呼
2020-12-19,5010,206,281,487,歸來,招呼
2020-12-20,5010,222,318,540,歸來,招呼
2020-12-21,5010,245,300,545,歸來,招呼
2020-12-22,5010,225,251,476,歸來,招呼
2020-12-23,5010,232,240,472,歸來,招呼
2020-12-24,5010,246,240,486,歸來,招呼
2020-12-25,5010,321,276,597,歸來,招呼
2020-12-26,5010,214,197,411,歸來,招呼
2020-12-27,5010,190,231,421,歸來,招呼
2020-12-28,5010,212,268,480,歸來,招呼
2020-12-29,5010,221,252,473,歸來,招呼
2020-12-30,5010,242,238,480,歸來,招呼
2020-12-31,5010,385,302,687,歸來,招呼
2020-01-01,5020,126,200,326,麟洛,招呼
2020-01-02,5020,149,172,321,麟洛,招呼
2020-01-03,5020,174,194,368,麟洛,招呼
2020-01-04,5020,156,177,333,麟洛,招呼
2020-01-05,5020,194,165,359,麟洛,招呼
2020-01-06,5020,142,132,274,麟洛,招呼
2020-01-07,5020,154,131,285,麟洛,招呼
2020-01-08,5020,135,164,299,麟洛,招呼
2020-01-09,5020,144,159,303,麟洛,招呼
2020-01-10,5020,145,242,387,麟洛,招呼
2020-01-11,5020,178,232,410,麟洛,招呼
2020-01-12,5020,199,151,350,麟洛,招呼
2020-01-13,5020,171,161,332,麟洛,招呼
2020-01-14,5020,159,178,337,麟洛,招呼
2020-01-15,5020,136,166,302,麟洛,招呼
2020-01-16,5020,163,173,336,麟洛,招呼
2020-01-17,5020,169,191,360,麟洛,招呼
2020-01-18,5020,156,191,347,麟洛,招呼
2020-01-19,5020,145,159,304,麟洛,招呼
2020-01-20,5020,165,168,333,麟洛,招呼
2020-01-21,5020,137,198,335,麟洛,招呼
2020-01-22,5020,136,228,364,麟洛,招呼
2020-01-23,5020,112,213,325,麟洛,招呼
2020-01-24,5020,96,172,268,麟洛,招呼
2020-01-25,5020,212,282,494,麟洛,招呼
2020-01-26,5020,220,266,486,麟洛,招呼
2020-01-27,5020,273,253,526,麟洛,招呼
2020-01-28,5020,206,190,396,麟洛,招呼
2020-01-29,5020,226,136,362,麟洛,招呼
2020-01-30,5020,176,151,327,麟洛,招呼
2020-01-31,5020,133,173,306,麟洛,招呼
2020-02-01,5020,117,144,261,麟洛,招呼
2020-02-02,5020,149,136,285,麟洛,招呼
2020-02-03,5020,145,142,287,麟洛,招呼
2020-02-04,5020,140,144,284,麟洛,招呼
2020-02-05,5020,142,156,298,麟洛,招呼
2020-02-06,5020,122,139,261,麟洛,招呼
2020-02-07,5020,147,185,332,麟洛,招呼
2020-02-08,5020,106,160,266,麟洛,招呼
2020-02-09,5020,160,138,298,麟洛,招呼
2020-02-10,5020,146,133,279,麟洛,招呼
2020-02-11,5020,121,131,252,麟洛,招呼
2020-02-12,5020,117,128,245,麟洛,招呼
2020-02-13,5020,139,153,292,麟洛,招呼
2020-02-14,5020,144,162,306,麟洛,招呼
2020-02-15,5020,126,149,275,麟洛,招呼
2020-02-16,5020,144,131,275,麟洛,招呼
2020-02-17,5020,130,127,257,麟洛,招呼
2020-02-18,5020,128,126,254,麟洛,招呼
2020-02-19,5020,122,121,243,麟洛,招呼
2020-02-20,5020,126,129,255,麟洛,招呼
2020-02-21,5020,115,148,263,麟洛,招呼
2020-02-22,5020,95,140,235,麟洛,招呼
2020-02-23,5020,148,124,272,麟洛,招呼
2020-02-24,5020,140,142,282,麟洛,招呼
2020-02-25,5020,119,122,241,麟洛,招呼
2020-02-26,5020,134,157,291,麟洛,招呼
2020-02-27,5020,119,184,303,麟洛,招呼
2020-02-28,5020,131,167,298,麟洛,招呼
2020-02-29,5020,146,153,299,麟洛,招呼
2020-03-01,5020,182,115,297,麟洛,招呼
2020-03-02,5020,140,112,252,麟洛,招呼
2020-03-03,5020,111,116,227,麟洛,招呼
2020-03-04,5020,107,114,221,麟洛,招呼
2020-03-05,5020,114,130,244,麟洛,招呼
2020-03-06,5020,141,183,324,麟洛,招呼
2020-03-07,5020,109,139,248,麟洛,招呼
2020-03-08,5020,142,98,240,麟洛,招呼
2020-03-09,5020,131,134,265,麟洛,招呼
2020-03-10,5020,118,135,253,麟洛,招呼
2020-03-11,5020,121,125,246,麟洛,招呼
2020-03-12,5020,119,139,258,麟洛,招呼
2020-03-13,5020,139,181,320,麟洛,招呼
2020-03-14,5020,90,116,206,麟洛,招呼
2020-03-15,5020,133,114,247,麟洛,招呼
2020-03-16,5020,126,123,249,麟洛,招呼
2020-03-17,5020,117,132,249,麟洛,招呼
2020-03-18,5020,108,114,222,麟洛,招呼
2020-03-19,5020,117,117,234,麟洛,招呼
2020-03-20,5020,118,165,283,麟洛,招呼
2020-03-21,5020,94,103,197,麟洛,招呼
2020-03-22,5020,120,99,219,麟洛,招呼
2020-03-23,5020,113,113,226,麟洛,招呼
2020-03-24,5020,112,116,228,麟洛,招呼
2020-03-25,5020,100,127,227,麟洛,招呼
2020-03-26,5020,98,112,210,麟洛,招呼
2020-03-27,5020,99,139,238,麟洛,招呼
2020-03-28,5020,93,101,194,麟洛,招呼
2020-03-29,5020,120,93,213,麟洛,招呼
2020-03-30,5020,105,113,218,麟洛,招呼
2020-03-31,5020,101,126,227,麟洛,招呼
2020-04-01,5020,107,184,291,麟洛,招呼
2020-04-02,5020,73,124,197,麟洛,招呼
2020-04-03,5020,103,113,216,麟洛,招呼
2020-04-04,5020,99,88,187,麟洛,招呼
2020-04-05,5020,167,97,264,麟洛,招呼
2020-04-06,5020,134,111,245,麟洛,招呼
2020-04-07,5020,108,115,223,麟洛,招呼
2020-04-08,5020,118,104,222,麟洛,招呼
2020-04-09,5020,104,107,211,麟洛,招呼
2020-04-10,5020,112,128,240,麟洛,招呼
2020-04-11,5020,89,121,210,麟洛,招呼
2020-04-12,5020,90,90,180,麟洛,招呼
2020-04-13,5020,104,106,210,麟洛,招呼
2020-04-14,5020,98,114,212,麟洛,招呼
2020-04-15,5020,99,106,205,麟洛,招呼
2020-04-16,5020,110,130,240,麟洛,招呼
2020-04-17,5020,114,145,259,麟洛,招呼
2020-04-18,5020,104,121,225,麟洛,招呼
2020-04-19,5020,116,95,211,麟洛,招呼
2020-04-20,5020,117,111,228,麟洛,招呼
2020-04-21,5020,72,104,176,麟洛,招呼
2020-04-22,5020,100,101,201,麟洛,招呼
2020-04-23,5020,101,103,204,麟洛,招呼
2020-04-24,5020,102,140,242,麟洛,招呼
2020-04-25,5020,81,101,182,麟洛,招呼
2020-04-26,5020,94,70,164,麟洛,招呼
2020-04-27,5020,91,104,195,麟洛,招呼
2020-04-28,5020,113,123,236,麟洛,招呼
2020-04-29,5020,101,114,215,麟洛,招呼
2020-04-30,5020,124,138,262,麟洛,招呼
2020-05-01,5020,110,172,282,麟洛,招呼
2020-05-02,5020,103,109,212,麟洛,招呼
2020-05-03,5020,128,89,217,麟洛,招呼
2020-05-04,5020,128,106,234,麟洛,招呼
2020-05-05,5020,105,122,227,麟洛,招呼
2020-05-06,5020,97,115,212,麟洛,招呼
2020-05-07,5020,110,125,235,麟洛,招呼
2020-05-08,5020,125,177,302,麟洛,招呼
2020-05-09,5020,121,146,267,麟洛,招呼
2020-05-10,5020,147,101,248,麟洛,招呼
2020-05-11,5020,122,123,245,麟洛,招呼
2020-05-12,5020,106,112,218,麟洛,招呼
2020-05-13,5020,108,99,207,麟洛,招呼
2020-05-14,5020,100,114,214,麟洛,招呼
2020-05-15,5020,121,167,288,麟洛,招呼
2020-05-16,5020,71,102,173,麟洛,招呼
2020-05-17,5020,148,122,270,麟洛,招呼
2020-05-18,5020,121,120,241,麟洛,招呼
2020-05-19,5020,120,121,241,麟洛,招呼
2020-05-20,5020,90,90,180,麟洛,招呼
2020-05-21,5020,107,127,234,麟洛,招呼
2020-05-22,5020,115,125,240,麟洛,招呼
2020-05-23,5020,109,115,224,麟洛,招呼
2020-05-24,5020,129,112,241,麟洛,招呼
2020-05-25,5020,121,122,243,麟洛,招呼
2020-05-26,5020,115,129,244,麟洛,招呼
2020-05-27,5020,100,128,228,麟洛,招呼
2020-05-28,5020,100,124,224,麟洛,招呼
2020-05-29,5020,131,169,300,麟洛,招呼
2020-05-30,5020,125,139,264,麟洛,招呼
2020-05-31,5020,151,152,303,麟洛,招呼
2020-06-01,5020,108,107,215,麟洛,招呼
2020-06-02,5020,115,133,248,麟洛,招呼
2020-06-03,5020,112,114,226,麟洛,招呼
2020-06-04,5020,121,130,251,麟洛,招呼
2020-06-05,5020,126,150,276,麟洛,招呼
2020-06-06,5020,142,172,314,麟洛,招呼
2020-06-07,5020,122,119,241,麟洛,招呼
2020-06-08,5020,128,102,230,麟洛,招呼
2020-06-09,5020,102,113,215,麟洛,招呼
2020-06-10,5020,124,136,260,麟洛,招呼
2020-06-11,5020,129,149,278,麟洛,招呼
2020-06-12,5020,143,175,318,麟洛,招呼
2020-06-13,5020,162,178,340,麟洛,招呼
2020-06-14,5020,162,150,312,麟洛,招呼
2020-06-15,5020,145,135,280,麟洛,招呼
2020-06-16,5020,112,123,235,麟洛,招呼
2020-06-17,5020,117,122,239,麟洛,招呼
2020-06-18,5020,115,129,244,麟洛,招呼
2020-06-19,5020,129,150,279,麟洛,招呼
2020-06-20,5020,142,154,296,麟洛,招呼
2020-06-21,5020,112,111,223,麟洛,招呼
2020-06-22,5020,123,139,262,麟洛,招呼
2020-06-23,5020,136,141,277,麟洛,招呼
2020-06-24,5020,148,211,359,麟洛,招呼
2020-06-25,5020,136,191,327,麟洛,招呼
2020-06-26,5020,152,196,348,麟洛,招呼
2020-06-27,5020,167,162,329,麟洛,招呼
2020-06-28,5020,209,155,364,麟洛,招呼
2020-06-29,5020,167,152,319,麟洛,招呼
2020-06-30,5020,138,140,278,麟洛,招呼
2020-07-01,5020,116,129,245,麟洛,招呼
2020-07-02,5020,117,142,259,麟洛,招呼
2020-07-03,5020,145,164,309,麟洛,招呼
2020-07-04,5020,130,142,272,麟洛,招呼
2020-07-05,5020,87,104,191,麟洛,招呼
2020-07-06,5020,127,134,261,麟洛,招呼
2020-07-07,5020,113,131,244,麟洛,招呼
2020-07-08,5020,109,126,235,麟洛,招呼
2020-07-09,5020,125,138,263,麟洛,招呼
2020-07-10,5020,131,158,289,麟洛,招呼
2020-07-11,5020,172,176,348,麟洛,招呼
2020-07-12,5020,133,142,275,麟洛,招呼
2020-07-13,5020,130,133,263,麟洛,招呼
2020-07-14,5020,116,141,257,麟洛,招呼
2020-07-15,5020,136,145,281,麟洛,招呼
2020-07-16,5020,152,165,317,麟洛,招呼
2020-07-17,5020,146,183,329,麟洛,招呼
2020-07-18,5020,144,161,305,麟洛,招呼
2020-07-19,5020,159,141,300,麟洛,招呼
2020-07-20,5020,176,170,346,麟洛,招呼
2020-07-21,5020,130,151,281,麟洛,招呼
2020-07-22,5020,130,165,295,麟洛,招呼
2020-07-23,5020,160,177,337,麟洛,招呼
2020-07-24,5020,132,143,275,麟洛,招呼
2020-07-25,5020,165,188,353,麟洛,招呼
2020-07-26,5020,145,141,286,麟洛,招呼
2020-07-27,5020,135,155,290,麟洛,招呼
2020-07-28,5020,115,144,259,麟洛,招呼
2020-07-29,5020,146,143,289,麟洛,招呼
2020-07-30,5020,133,149,282,麟洛,招呼
2020-07-31,5020,151,181,332,麟洛,招呼
2020-08-01,5020,180,203,383,麟洛,招呼
2020-08-02,5020,148,153,301,麟洛,招呼
2020-08-03,5020,121,118,239,麟洛,招呼
2020-08-04,5020,120,133,253,麟洛,招呼
2020-08-05,5020,138,145,283,麟洛,招呼
2020-08-06,5020,134,156,290,麟洛,招呼
2020-08-07,5020,155,194,349,麟洛,招呼
2020-08-08,5020,164,207,371,麟洛,招呼
2020-08-09,5020,178,138,316,麟洛,招呼
2020-08-10,5020,150,133,283,麟洛,招呼
2020-08-11,5020,121,136,257,麟洛,招呼
2020-08-12,5020,138,150,288,麟洛,招呼
2020-08-13,5020,143,137,280,麟洛,招呼
2020-08-14,5020,164,174,338,麟洛,招呼
2020-08-15,5020,165,191,356,麟洛,招呼
2020-08-16,5020,170,159,329,麟洛,招呼
2020-08-17,5020,152,166,318,麟洛,招呼
2020-08-18,5020,132,143,275,麟洛,招呼
2020-08-19,5020,128,137,265,麟洛,招呼
2020-08-20,5020,138,152,290,麟洛,招呼
2020-08-21,5020,139,171,310,麟洛,招呼
2020-08-22,5020,151,165,316,麟洛,招呼
2020-08-23,5020,151,158,309,麟洛,招呼
2020-08-24,5020,147,147,294,麟洛,招呼
2020-08-25,5020,127,147,274,麟洛,招呼
2020-08-26,5020,128,131,259,麟洛,招呼
2020-08-27,5020,124,132,256,麟洛,招呼
2020-08-28,5020,140,156,296,麟洛,招呼
2020-08-29,5020,120,157,277,麟洛,招呼
2020-08-30,5020,156,123,279,麟洛,招呼
2020-08-31,5020,125,136,261,麟洛,招呼
2020-09-01,5020,133,161,294,麟洛,招呼
2020-09-02,5020,121,124,245,麟洛,招呼
2020-09-03,5020,127,167,294,麟洛,招呼
2020-09-04,5020,141,176,317,麟洛,招呼
2020-09-05,5020,156,153,309,麟洛,招呼
2020-09-06,5020,180,168,348,麟洛,招呼
2020-09-07,5020,160,156,316,麟洛,招呼
2020-09-08,5020,115,129,244,麟洛,招呼
2020-09-09,5020,124,143,267,麟洛,招呼
2020-09-10,5020,122,141,263,麟洛,招呼
2020-09-11,5020,156,194,350,麟洛,招呼
2020-09-12,5020,131,166,297,麟洛,招呼
2020-09-13,5020,158,126,284,麟洛,招呼
2020-09-14,5020,121,119,240,麟洛,招呼
2020-09-15,5020,121,143,264,麟洛,招呼
2020-09-16,5020,130,148,278,麟洛,招呼
2020-09-17,5020,134,136,270,麟洛,招呼
2020-09-18,5020,159,162,321,麟洛,招呼
2020-09-19,5020,130,157,287,麟洛,招呼
2020-09-20,5020,119,141,260,麟洛,招呼
2020-09-21,5020,122,131,253,麟洛,招呼
2020-09-22,5020,123,138,261,麟洛,招呼
2020-09-23,5020,136,130,266,麟洛,招呼
2020-09-24,5020,110,136,246,麟洛,招呼
2020-09-25,5020,134,136,270,麟洛,招呼
2020-09-26,5020,136,130,266,麟洛,招呼
2020-09-27,5020,127,149,276,麟洛,招呼
2020-09-28,5020,116,123,239,麟洛,招呼
2020-09-29,5020,125,143,268,麟洛,招呼
2020-09-30,5020,168,214,382,麟洛,招呼
2020-10-01,5020,147,260,407,麟洛,招呼
2020-10-02,5020,213,218,431,麟洛,招呼
2020-10-03,5020,193,206,399,麟洛,招呼
2020-10-04,5020,207,158,365,麟洛,招呼
2020-10-05,5020,164,149,313,麟洛,招呼
2020-10-06,5020,136,144,280,麟洛,招呼
2020-10-07,5020,135,133,268,麟洛,招呼
2020-10-08,5020,149,182,331,麟洛,招呼
2020-10-09,5020,183,194,377,麟洛,招呼
2020-10-10,5020,156,181,337,麟洛,招呼
2020-10-11,5020,172,164,336,麟洛,招呼
2020-10-12,5020,132,136,268,麟洛,招呼
2020-10-13,5020,125,138,263,麟洛,招呼
2020-10-14,5020,131,138,269,麟洛,招呼
2020-10-15,5020,136,149,285,麟洛,招呼
2020-10-16,5020,145,172,317,麟洛,招呼
2020-10-17,5020,192,226,418,麟洛,招呼
2020-10-18,5020,153,132,285,麟洛,招呼
2020-10-19,5020,140,147,287,麟洛,招呼
2020-10-20,5020,128,137,265,麟洛,招呼
2020-10-21,5020,138,143,281,麟洛,招呼
2020-10-22,5020,139,131,270,麟洛,招呼
2020-10-23,5020,159,177,336,麟洛,招呼
2020-10-24,5020,131,160,291,麟洛,招呼
2020-10-25,5020,153,137,290,麟洛,招呼
2020-10-26,5020,149,142,291,麟洛,招呼
2020-10-27,5020,128,132,260,麟洛,招呼
2020-10-28,5020,132,144,276,麟洛,招呼
2020-10-29,5020,133,150,283,麟洛,招呼
2020-10-30,5020,154,174,328,麟洛,招呼
2020-10-31,5020,125,164,289,麟洛,招呼
2020-11-01,5020,150,140,290,麟洛,招呼
2020-11-02,5020,142,140,282,麟洛,招呼
2020-11-03,5020,125,146,271,麟洛,招呼
2020-11-04,5020,129,142,271,麟洛,招呼
2020-11-05,5020,141,154,295,麟洛,招呼
2020-11-06,5020,134,154,288,麟洛,招呼
2020-11-07,5020,177,235,412,麟洛,招呼
2020-11-08,5020,187,149,336,麟洛,招呼
2020-11-09,5020,134,131,265,麟洛,招呼
2020-11-10,5020,129,130,259,麟洛,招呼
2020-11-11,5020,139,144,283,麟洛,招呼
2020-11-12,5020,150,151,301,麟洛,招呼
2020-11-13,5020,154,183,337,麟洛,招呼
2020-11-14,5020,159,199,358,麟洛,招呼
2020-11-15,5020,174,153,327,麟洛,招呼
2020-11-16,5020,134,149,283,麟洛,招呼
2020-11-17,5020,139,131,270,麟洛,招呼
2020-11-18,5020,128,137,265,麟洛,招呼
2020-11-19,5020,134,157,291,麟洛,招呼
2020-11-20,5020,161,192,353,麟洛,招呼
2020-11-21,5020,156,165,321,麟洛,招呼
2020-11-22,5020,166,169,335,麟洛,招呼
2020-11-23,5020,134,143,277,麟洛,招呼
2020-11-24,5020,147,139,286,麟洛,招呼
2020-11-25,5020,130,131,261,麟洛,招呼
2020-11-26,5020,138,154,292,麟洛,招呼
2020-11-27,5020,132,200,332,麟洛,招呼
2020-11-28,5020,133,176,309,麟洛,招呼
2020-11-29,5020,181,143,324,麟洛,招呼
2020-11-30,5020,143,144,287,麟洛,招呼
2020-12-01,5020,124,131,255,麟洛,招呼
2020-12-02,5020,132,119,251,麟洛,招呼
2020-12-03,5020,140,167,307,麟洛,招呼
2020-12-04,5020,173,188,361,麟洛,招呼
2020-12-05,5020,143,176,319,麟洛,招呼
2020-12-06,5020,206,167,373,麟洛,招呼
2020-12-07,5020,140,154,294,麟洛,招呼
2020-12-08,5020,120,132,252,麟洛,招呼
2020-12-09,5020,134,132,266,麟洛,招呼
2020-12-10,5020,140,167,307,麟洛,招呼
2020-12-11,5020,157,199,356,麟洛,招呼
2020-12-12,5020,137,172,309,麟洛,招呼
2020-12-13,5020,175,145,320,麟洛,招呼
2020-12-14,5020,139,156,295,麟洛,招呼
2020-12-15,5020,113,139,252,麟洛,招呼
2020-12-16,5020,148,144,292,麟洛,招呼
2020-12-17,5020,145,165,310,麟洛,招呼
2020-12-18,5020,141,178,319,麟洛,招呼
2020-12-19,5020,176,218,394,麟洛,招呼
2020-12-20,5020,220,162,382,麟洛,招呼
2020-12-21,5020,141,152,293,麟洛,招呼
2020-12-22,5020,137,137,274,麟洛,招呼
2020-12-23,5020,136,124,260,麟洛,招呼
2020-12-24,5020,141,163,304,麟洛,招呼
2020-12-25,5020,160,191,351,麟洛,招呼
2020-12-26,5020,158,184,342,麟洛,招呼
2020-12-27,5020,164,143,307,麟洛,招呼
2020-12-28,5020,134,141,275,麟洛,招呼
2020-12-29,5020,140,151,291,麟洛,招呼
2020-12-30,5020,128,138,266,麟洛,招呼
2020-12-31,5020,188,222,410,麟洛,招呼
2020-01-01,5030,653,684,1337,西勢,三等
2020-01-02,5030,560,586,1146,西勢,三等
2020-01-03,5030,681,713,1394,西勢,三等
2020-01-04,5030,611,667,1278,西勢,三等
2020-01-05,5030,688,566,1254,西勢,三等
2020-01-06,5030,636,609,1245,西勢,三等
2020-01-07,5030,547,553,1100,西勢,三等
2020-01-08,5030,584,604,1188,西勢,三等
2020-01-09,5030,663,619,1282,西勢,三等
2020-01-10,5030,744,989,1733,西勢,三等
2020-01-11,5030,770,825,1595,西勢,三等
2020-01-12,5030,948,632,1580,西勢,三等
2020-01-13,5030,709,636,1345,西勢,三等
2020-01-14,5030,612,611,1223,西勢,三等
2020-01-15,5030,603,605,1208,西勢,三等
2020-01-16,5030,693,682,1375,西勢,三等
2020-01-17,5030,613,684,1297,西勢,三等
2020-01-18,5030,627,647,1274,西勢,三等
2020-01-19,5030,731,635,1366,西勢,三等
2020-01-20,5030,557,592,1149,西勢,三等
2020-01-21,5030,572,635,1207,西勢,三等
2020-01-22,5030,623,834,1457,西勢,三等
2020-01-23,5030,570,864,1434,西勢,三等
2020-01-24,5030,424,638,1062,西勢,三等
2020-01-25,5030,778,814,1592,西勢,三等
2020-01-26,5030,859,787,1646,西勢,三等
2020-01-27,5030,1033,813,1846,西勢,三等
2020-01-28,5030,851,587,1438,西勢,三等
2020-01-29,5030,893,535,1428,西勢,三等
2020-01-30,5030,642,513,1155,西勢,三等
2020-01-31,5030,563,544,1107,西勢,三等
2020-02-01,5030,488,517,1005,西勢,三等
2020-02-02,5030,594,446,1040,西勢,三等
2020-02-03,5030,540,500,1040,西勢,三等
2020-02-04,5030,546,521,1067,西勢,三等
2020-02-05,5030,521,490,1011,西勢,三等
2020-02-06,5030,520,501,1021,西勢,三等
2020-02-07,5030,570,631,1201,西勢,三等
2020-02-08,5030,569,584,1153,西勢,三等
2020-02-09,5030,566,457,1023,西勢,三等
2020-02-10,5030,479,475,954,西勢,三等
2020-02-11,5030,495,469,964,西勢,三等
2020-02-12,5030,469,448,917,西勢,三等
2020-02-13,5030,481,468,949,西勢,三等
2020-02-14,5030,556,550,1106,西勢,三等
2020-02-15,5030,507,527,1034,西勢,三等
2020-02-16,5030,557,512,1069,西勢,三等
2020-02-17,5030,486,472,958,西勢,三等
2020-02-18,5030,497,474,971,西勢,三等
2020-02-19,5030,550,501,1051,西勢,三等
2020-02-20,5030,471,480,951,西勢,三等
2020-02-21,5030,617,638,1255,西勢,三等
2020-02-22,5030,454,536,990,西勢,三等
2020-02-23,5030,550,418,968,西勢,三等
2020-02-24,5030,546,481,1027,西勢,三等
2020-02-25,5030,541,555,1096,西勢,三等
2020-02-26,5030,508,534,1042,西勢,三等
2020-02-27,5030,601,738,1339,西勢,三等
2020-02-28,5030,597,667,1264,西勢,三等
2020-02-29,5030,471,450,921,西勢,三等
2020-03-01,5030,724,506,1230,西勢,三等
2020-03-02,5030,589,512,1101,西勢,三等
2020-03-03,5030,507,536,1043,西勢,三等
2020-03-04,5030,494,494,988,西勢,三等
2020-03-05,5030,526,534,1060,西勢,三等
2020-03-06,5030,619,666,1285,西勢,三等
2020-03-07,5030,495,575,1070,西勢,三等
2020-03-08,5030,627,474,1101,西勢,三等
2020-03-09,5030,600,521,1121,西勢,三等
2020-03-10,5030,504,515,1019,西勢,三等
2020-03-11,5030,500,518,1018,西勢,三等
2020-03-12,5030,537,535,1072,西勢,三等
2020-03-13,5030,648,677,1325,西勢,三等
2020-03-14,5030,433,480,913,西勢,三等
2020-03-15,5030,680,494,1174,西勢,三等
2020-03-16,5030,555,540,1095,西勢,三等
2020-03-17,5030,549,550,1099,西勢,三等
2020-03-18,5030,528,525,1053,西勢,三等
2020-03-19,5030,524,527,1051,西勢,三等
2020-03-20,5030,592,659,1251,西勢,三等
2020-03-21,5030,455,521,976,西勢,三等
2020-03-22,5030,564,456,1020,西勢,三等
2020-03-23,5030,533,474,1007,西勢,三等
2020-03-24,5030,472,513,985,西勢,三等
2020-03-25,5030,477,491,968,西勢,三等
2020-03-26,5030,484,518,1002,西勢,三等
2020-03-27,5030,547,714,1261,西勢,三等
2020-03-28,5030,403,449,852,西勢,三等
2020-03-29,5030,595,417,1012,西勢,三等
2020-03-30,5030,533,496,1029,西勢,三等
2020-03-31,5030,471,497,968,西勢,三等
2020-04-01,5030,590,702,1292,西勢,三等
2020-04-02,5030,420,514,934,西勢,三等
2020-04-03,5030,413,420,833,西勢,三等
2020-04-04,5030,382,315,697,西勢,三等
2020-04-05,5030,640,369,1009,西勢,三等
2020-04-06,5030,549,538,1087,西勢,三等
2020-04-07,5030,466,474,940,西勢,三等
2020-04-08,5030,430,432,862,西勢,三等
2020-04-09,5030,463,477,940,西勢,三等
2020-04-10,5030,532,551,1083,西勢,三等
2020-04-11,5030,343,379,722,西勢,三等
2020-04-12,5030,477,400,877,西勢,三等
2020-04-13,5030,491,466,957,西勢,三等
2020-04-14,5030,457,447,904,西勢,三等
2020-04-15,5030,465,461,926,西勢,三等
2020-04-16,5030,502,489,991,西勢,三等
2020-04-17,5030,567,594,1161,西勢,三等
2020-04-18,5030,397,438,835,西勢,三等
2020-04-19,5030,492,405,897,西勢,三等
2020-04-20,5030,481,460,941,西勢,三等
2020-04-21,5030,428,422,850,西勢,三等
2020-04-22,5030,435,410,845,西勢,三等
2020-04-23,5030,451,437,888,西勢,三等
2020-04-24,5030,500,545,1045,西勢,三等
2020-04-25,5030,312,361,673,西勢,三等
2020-04-26,5030,384,297,681,西勢,三等
2020-04-27,5030,469,447,916,西勢,三等
2020-04-28,5030,461,462,923,西勢,三等
2020-04-29,5030,442,426,868,西勢,三等
2020-04-30,5030,505,528,1033,西勢,三等
2020-05-01,5030,468,601,1069,西勢,三等
2020-05-02,5030,379,437,816,西勢,三等
2020-05-03,5030,552,378,930,西勢,三等
2020-05-04,5030,550,513,1063,西勢,三等
2020-05-05,5030,522,501,1023,西勢,三等
2020-05-06,5030,493,473,966,西勢,三等
2020-05-07,5030,495,505,1000,西勢,三等
2020-05-08,5030,625,700,1325,西勢,三等
2020-05-09,5030,410,545,955,西勢,三等
2020-05-10,5030,630,482,1112,西勢,三等
2020-05-11,5030,612,523,1135,西勢,三等
2020-05-12,5030,507,493,1000,西勢,三等
2020-05-13,5030,494,470,964,西勢,三等
2020-05-14,5030,533,518,1051,西勢,三等
2020-05-15,5030,601,660,1261,西勢,三等
2020-05-16,5030,439,453,892,西勢,三等
2020-05-17,5030,571,456,1027,西勢,三等
2020-05-18,5030,537,533,1070,西勢,三等
2020-05-19,5030,493,489,982,西勢,三等
2020-05-20,5030,502,490,992,西勢,三等
2020-05-21,5030,511,505,1016,西勢,三等
2020-05-22,5030,474,534,1008,西勢,三等
2020-05-23,5030,424,449,873,西勢,三等
2020-05-24,5030,572,492,1064,西勢,三等
2020-05-25,5030,594,519,1113,西勢,三等
2020-05-26,5030,541,518,1059,西勢,三等
2020-05-27,5030,437,465,902,西勢,三等
2020-05-28,5030,507,485,992,西勢,三等
2020-05-29,5030,662,689,1351,西勢,三等
2020-05-30,5030,517,560,1077,西勢,三等
2020-05-31,5030,664,566,1230,西勢,三等
2020-06-01,5030,537,508,1045,西勢,三等
2020-06-02,5030,524,536,1060,西勢,三等
2020-06-03,5030,498,485,983,西勢,三等
2020-06-04,5030,516,491,1007,西勢,三等
2020-06-05,5030,666,691,1357,西勢,三等
2020-06-06,5030,565,591,1156,西勢,三等
2020-06-07,5030,651,573,1224,西勢,三等
2020-06-08,5030,556,547,1103,西勢,三等
2020-06-09,5030,523,513,1036,西勢,三等
2020-06-10,5030,529,536,1065,西勢,三等
2020-06-11,5030,551,564,1115,西勢,三等
2020-06-12,5030,673,741,1414,西勢,三等
2020-06-13,5030,608,636,1244,西勢,三等
2020-06-14,5030,735,619,1354,西勢,三等
2020-06-15,5030,597,566,1163,西勢,三等
2020-06-16,5030,531,538,1069,西勢,三等
2020-06-17,5030,530,513,1043,西勢,三等
2020-06-18,5030,554,533,1087,西勢,三等
2020-06-19,5030,604,610,1214,西勢,三等
2020-06-20,5030,558,604,1162,西勢,三等
2020-06-21,5030,556,504,1060,西勢,三等
2020-06-22,5030,529,522,1051,西勢,三等
2020-06-23,5030,574,586,1160,西勢,三等
2020-06-24,5030,648,795,1443,西勢,三等
2020-06-25,5030,629,760,1389,西勢,三等
2020-06-26,5030,741,752,1493,西勢,三等
2020-06-27,5030,703,684,1387,西勢,三等
2020-06-28,5030,882,572,1454,西勢,三等
2020-06-29,5030,644,595,1239,西勢,三等
2020-06-30,5030,554,537,1091,西勢,三等
2020-07-01,5030,582,541,1123,西勢,三等
2020-07-02,5030,539,515,1054,西勢,三等
2020-07-03,5030,640,675,1315,西勢,三等
2020-07-04,5030,555,563,1118,西勢,三等
2020-07-05,5030,563,533,1096,西勢,三等
2020-07-06,5030,595,564,1159,西勢,三等
2020-07-07,5030,535,537,1072,西勢,三等
2020-07-08,5030,545,562,1107,西勢,三等
2020-07-09,5030,570,568,1138,西勢,三等
2020-07-10,5030,668,741,1409,西勢,三等
2020-07-11,5030,573,634,1207,西勢,三等
2020-07-12,5030,688,564,1252,西勢,三等
2020-07-13,5030,541,566,1107,西勢,三等
2020-07-14,5030,563,586,1149,西勢,三等
2020-07-15,5030,550,528,1078,西勢,三等
2020-07-16,5030,590,542,1132,西勢,三等
2020-07-17,5030,787,788,1575,西勢,三等
2020-07-18,5030,649,710,1359,西勢,三等
2020-07-19,5030,713,591,1304,西勢,三等
2020-07-20,5030,668,628,1296,西勢,三等
2020-07-21,5030,614,628,1242,西勢,三等
2020-07-22,5030,572,549,1121,西勢,三等
2020-07-23,5030,644,604,1248,西勢,三等
2020-07-24,5030,717,700,1417,西勢,三等
2020-07-25,5030,632,677,1309,西勢,三等
2020-07-26,5030,712,640,1352,西勢,三等
2020-07-27,5030,624,619,1243,西勢,三等
2020-07-28,5030,586,542,1128,西勢,三等
2020-07-29,5030,714,706,1420,西勢,三等
2020-07-30,5030,609,596,1205,西勢,三等
2020-07-31,5030,667,708,1375,西勢,三等
2020-08-01,5030,617,617,1234,西勢,三等
2020-08-02,5030,639,527,1166,西勢,三等
2020-08-03,5030,585,552,1137,西勢,三等
2020-08-04,5030,519,494,1013,西勢,三等
2020-08-05,5030,627,616,1243,西勢,三等
2020-08-06,5030,605,624,1229,西勢,三等
2020-08-07,5030,721,795,1516,西勢,三等
2020-08-08,5030,626,718,1344,西勢,三等
2020-08-09,5030,827,617,1444,西勢,三等
2020-08-10,5030,666,604,1270,西勢,三等
2020-08-11,5030,545,521,1066,西勢,三等
2020-08-12,5030,577,565,1142,西勢,三等
2020-08-13,5030,632,603,1235,西勢,三等
2020-08-14,5030,723,718,1441,西勢,三等
2020-08-15,5030,673,704,1377,西勢,三等
2020-08-16,5030,686,634,1320,西勢,三等
2020-08-17,5030,659,640,1299,西勢,三等
2020-08-18,5030,625,609,1234,西勢,三等
2020-08-19,5030,584,586,1170,西勢,三等
2020-08-20,5030,608,589,1197,西勢,三等
2020-08-21,5030,714,712,1426,西勢,三等
2020-08-22,5030,570,623,1193,西勢,三等
2020-08-23,5030,702,597,1299,西勢,三等
2020-08-24,5030,636,628,1264,西勢,三等
2020-08-25,5030,603,576,1179,西勢,三等
2020-08-26,5030,553,509,1062,西勢,三等
2020-08-27,5030,560,522,1082,西勢,三等
2020-08-28,5030,695,758,1453,西勢,三等
2020-08-29,5030,592,602,1194,西勢,三等
2020-08-30,5030,648,503,1151,西勢,三等
2020-08-31,5030,604,666,1270,西勢,三等
2020-09-01,5030,556,568,1124,西勢,三等
2020-09-02,5030,571,557,1128,西勢,三等
2020-09-03,5030,624,587,1211,西勢,三等
2020-09-04,5030,646,729,1375,西勢,三等
2020-09-05,5030,581,609,1190,西勢,三等
2020-09-06,5030,735,621,1356,西勢,三等
2020-09-07,5030,654,586,1240,西勢,三等
2020-09-08,5030,561,609,1170,西勢,三等
2020-09-09,5030,587,558,1145,西勢,三等
2020-09-10,5030,573,558,1131,西勢,三等
2020-09-11,5030,686,751,1437,西勢,三等
2020-09-12,5030,647,687,1334,西勢,三等
2020-09-13,5030,786,669,1455,西勢,三等
2020-09-14,5030,579,549,1128,西勢,三等
2020-09-15,5030,554,549,1103,西勢,三等
2020-09-16,5030,583,576,1159,西勢,三等
2020-09-17,5030,628,599,1227,西勢,三等
2020-09-18,5030,726,767,1493,西勢,三等
2020-09-19,5030,624,655,1279,西勢,三等
2020-09-20,5030,750,647,1397,西勢,三等
2020-09-21,5030,626,604,1230,西勢,三等
2020-09-22,5030,592,587,1179,西勢,三等
2020-09-23,5030,592,571,1163,西勢,三等
2020-09-24,5030,636,626,1262,西勢,三等
2020-09-25,5030,629,652,1281,西勢,三等
2020-09-26,5030,592,648,1240,西勢,三等
2020-09-27,5030,676,643,1319,西勢,三等
2020-09-28,5030,634,607,1241,西勢,三等
2020-09-29,5030,602,603,1205,西勢,三等
2020-09-30,5030,744,944,1688,西勢,三等
2020-10-01,5030,721,958,1679,西勢,三等
2020-10-02,5030,846,833,1679,西勢,三等
2020-10-03,5030,873,810,1683,西勢,三等
2020-10-04,5030,1051,713,1764,西勢,三等
2020-10-05,5030,745,617,1362,西勢,三等
2020-10-06,5030,570,575,1145,西勢,三等
2020-10-07,5030,558,529,1087,西勢,三等
2020-10-08,5030,719,822,1541,西勢,三等
2020-10-09,5030,686,738,1424,西勢,三等
2020-10-10,5030,682,649,1331,西勢,三等
2020-10-11,5030,788,672,1460,西勢,三等
2020-10-12,5030,684,644,1328,西勢,三等
2020-10-13,5030,568,586,1154,西勢,三等
2020-10-14,5030,584,599,1183,西勢,三等
2020-10-15,5030,637,627,1264,西勢,三等
2020-10-16,5030,688,786,1474,西勢,三等
2020-10-17,5030,765,720,1485,西勢,三等
2020-10-18,5030,779,697,1476,西勢,三等
2020-10-19,5030,611,618,1229,西勢,三等
2020-10-20,5030,570,553,1123,西勢,三等
2020-10-21,5030,590,564,1154,西勢,三等
2020-10-22,5030,710,650,1360,西勢,三等
2020-10-23,5030,756,823,1579,西勢,三等
2020-10-24,5030,703,708,1411,西勢,三等
2020-10-25,5030,762,671,1433,西勢,三等
2020-10-26,5030,639,578,1217,西勢,三等
2020-10-27,5030,587,613,1200,西勢,三等
2020-10-28,5030,587,588,1175,西勢,三等
2020-10-29,5030,580,580,1160,西勢,三等
2020-10-30,5030,669,751,1420,西勢,三等
2020-10-31,5030,738,673,1411,西勢,三等
2020-11-01,5030,766,641,1407,西勢,三等
2020-11-02,5030,640,617,1257,西勢,三等
2020-11-03,5030,607,598,1205,西勢,三等
2020-11-04,5030,596,601,1197,西勢,三等
2020-11-05,5030,611,581,1192,西勢,三等
2020-11-06,5030,663,777,1440,西勢,三等
2020-11-07,5030,619,629,1248,西勢,三等
2020-11-08,5030,769,607,1376,西勢,三等
2020-11-09,5030,641,608,1249,西勢,三等
2020-11-10,5030,602,573,1175,西勢,三等
2020-11-11,5030,589,561,1150,西勢,三等
2020-11-12,5030,643,607,1250,西勢,三等
2020-11-13,5030,805,883,1688,西勢,三等
2020-11-14,5030,723,723,1446,西勢,三等
2020-11-15,5030,790,705,1495,西勢,三等
2020-11-16,5030,677,658,1335,西勢,三等
2020-11-17,5030,618,610,1228,西勢,三等
2020-11-18,5030,645,629,1274,西勢,三等
2020-11-19,5030,682,631,1313,西勢,三等
2020-11-20,5030,781,858,1639,西勢,三等
2020-11-21,5030,731,739,1470,西勢,三等
2020-11-22,5030,731,716,1447,西勢,三等
2020-11-23,5030,667,643,1310,西勢,三等
2020-11-24,5030,577,587,1164,西勢,三等
2020-11-25,5030,597,548,1145,西勢,三等
2020-11-26,5030,685,621,1306,西勢,三等
2020-11-27,5030,730,843,1573,西勢,三等
2020-11-28,5030,698,740,1438,西勢,三等
2020-11-29,5030,743,630,1373,西勢,三等
2020-11-30,5030,662,616,1278,西勢,三等
2020-12-01,5030,575,593,1168,西勢,三等
2020-12-02,5030,577,555,1132,西勢,三等
2020-12-03,5030,605,628,1233,西勢,三等
2020-12-04,5030,747,784,1531,西勢,三等
2020-12-05,5030,751,803,1554,西勢,三等
2020-12-06,5030,885,760,1645,西勢,三等
2020-12-07,5030,635,597,1232,西勢,三等
2020-12-08,5030,566,576,1142,西勢,三等
2020-12-09,5030,540,547,1087,西勢,三等
2020-12-10,5030,681,638,1319,西勢,三等
2020-12-11,5030,755,790,1545,西勢,三等
2020-12-12,5030,788,788,1576,西勢,三等
2020-12-13,5030,757,690,1447,西勢,三等
2020-12-14,5030,665,614,1279,西勢,三等
2020-12-15,5030,579,559,1138,西勢,三等
2020-12-16,5030,598,595,1193,西勢,三等
2020-12-17,5030,637,597,1234,西勢,三等
2020-12-18,5030,760,809,1569,西勢,三等
2020-12-19,5030,774,765,1539,西勢,三等
2020-12-20,5030,824,738,1562,西勢,三等
2020-12-21,5030,688,669,1357,西勢,三等
2020-12-22,5030,613,598,1211,西勢,三等
2020-12-23,5030,650,636,1286,西勢,三等
2020-12-24,5030,664,648,1312,西勢,三等
2020-12-25,5030,786,772,1558,西勢,三等
2020-12-26,5030,696,737,1433,西勢,三等
2020-12-27,5030,796,754,1550,西勢,三等
2020-12-28,5030,654,608,1262,西勢,三等
2020-12-29,5030,577,565,1142,西勢,三等
2020-12-30,5030,642,650,1292,西勢,三等
2020-12-31,5030,866,822,1688,西勢,三等
2020-01-01,5040,449,474,923,竹田,簡易
2020-01-02,5040,283,312,595,竹田,簡易
2020-01-03,5040,317,351,668,竹田,簡易
2020-01-04,5040,313,394,707,竹田,簡易
2020-01-05,5040,409,381,790,竹田,簡易
2020-01-06,5040,293,301,594,竹田,簡易
2020-01-07,5040,312,326,638,竹田,簡易
2020-01-08,5040,301,283,584,竹田,簡易
2020-01-09,5040,326,352,678,竹田,簡易
2020-01-10,5040,398,462,860,竹田,簡易
2020-01-11,5040,355,408,763,竹田,簡易
2020-01-12,5040,460,382,842,竹田,簡易
2020-01-13,5040,324,294,618,竹田,簡易
2020-01-14,5040,262,268,530,竹田,簡易
2020-01-15,5040,269,269,538,竹田,簡易
2020-01-16,5040,354,358,712,竹田,簡易
2020-01-17,5040,301,302,603,竹田,簡易
2020-01-18,5040,287,328,615,竹田,簡易
2020-01-19,5040,329,325,654,竹田,簡易
2020-01-20,5040,285,289,574,竹田,簡易
2020-01-21,5040,286,327,613,竹田,簡易
2020-01-22,5040,271,357,628,竹田,簡易
2020-01-23,5040,270,366,636,竹田,簡易
2020-01-24,5040,275,356,631,竹田,簡易
2020-01-25,5040,506,492,998,竹田,簡易
2020-01-26,5040,423,401,824,竹田,簡易
2020-01-27,5040,628,553,1181,竹田,簡易
2020-01-28,5040,412,325,737,竹田,簡易
2020-01-29,5040,397,332,729,竹田,簡易
2020-01-30,5040,257,200,457,竹田,簡易
2020-01-31,5040,293,272,565,竹田,簡易
2020-02-01,5040,225,262,487,竹田,簡易
2020-02-02,5040,274,250,524,竹田,簡易
2020-02-03,5040,246,234,480,竹田,簡易
2020-02-04,5040,263,269,532,竹田,簡易
2020-02-05,5040,299,285,584,竹田,簡易
2020-02-06,5040,231,236,467,竹田,簡易
2020-02-07,5040,302,299,601,竹田,簡易
2020-02-08,5040,252,235,487,竹田,簡易
2020-02-09,5040,281,293,574,竹田,簡易
2020-02-10,5040,277,260,537,竹田,簡易
2020-02-11,5040,262,259,521,竹田,簡易
2020-02-12,5040,235,234,469,竹田,簡易
2020-02-13,5040,224,232,456,竹田,簡易
2020-02-14,5040,249,273,522,竹田,簡易
2020-02-15,5040,247,264,511,竹田,簡易
2020-02-16,5040,319,326,645,竹田,簡易
2020-02-17,5040,215,190,405,竹田,簡易
2020-02-18,5040,244,262,506,竹田,簡易
2020-02-19,5040,220,210,430,竹田,簡易
2020-02-20,5040,243,255,498,竹田,簡易
2020-02-21,5040,342,324,666,竹田,簡易
2020-02-22,5040,236,255,491,竹田,簡易
2020-02-23,5040,246,231,477,竹田,簡易
2020-02-24,5040,262,253,515,竹田,簡易
2020-02-25,5040,233,239,472,竹田,簡易
2020-02-26,5040,237,230,467,竹田,簡易
2020-02-27,5040,262,310,572,竹田,簡易
2020-02-28,5040,269,323,592,竹田,簡易
2020-02-29,5040,374,367,741,竹田,簡易
2020-03-01,5040,348,294,642,竹田,簡易
2020-03-02,5040,267,244,511,竹田,簡易
2020-03-03,5040,256,255,511,竹田,簡易
2020-03-04,5040,261,247,508,竹田,簡易
2020-03-05,5040,280,269,549,竹田,簡易
2020-03-06,5040,327,317,644,竹田,簡易
2020-03-07,5040,243,290,533,竹田,簡易
2020-03-08,5040,286,277,563,竹田,簡易
2020-03-09,5040,269,274,543,竹田,簡易
2020-03-10,5040,254,277,531,竹田,簡易
2020-03-11,5040,262,265,527,竹田,簡易
2020-03-12,5040,290,273,563,竹田,簡易
2020-03-13,5040,313,318,631,竹田,簡易
2020-03-14,5040,232,290,522,竹田,簡易
2020-03-15,5040,300,297,597,竹田,簡易
2020-03-16,5040,251,257,508,竹田,簡易
2020-03-17,5040,260,271,531,竹田,簡易
2020-03-18,5040,256,238,494,竹田,簡易
2020-03-19,5040,264,261,525,竹田,簡易
2020-03-20,5040,288,294,582,竹田,簡易
2020-03-21,5040,235,225,460,竹田,簡易
2020-03-22,5040,238,232,470,竹田,簡易
2020-03-23,5040,255,239,494,竹田,簡易
2020-03-24,5040,226,236,462,竹田,簡易
2020-03-25,5040,233,236,469,竹田,簡易
2020-03-26,5040,232,250,482,竹田,簡易
2020-03-27,5040,288,347,635,竹田,簡易
2020-03-28,5040,197,202,399,竹田,簡易
2020-03-29,5040,280,195,475,竹田,簡易
2020-03-30,5040,266,258,524,竹田,簡易
2020-03-31,5040,242,246,488,竹田,簡易
2020-04-01,5040,309,306,615,竹田,簡易
2020-04-02,5040,182,203,385,竹田,簡易
2020-04-03,5040,242,246,488,竹田,簡易
2020-04-04,5040,182,169,351,竹田,簡易
2020-04-05,5040,246,203,449,竹田,簡易
2020-04-06,5040,276,242,518,竹田,簡易
2020-04-07,5040,225,215,440,竹田,簡易
2020-04-08,5040,229,215,444,竹田,簡易
2020-04-09,5040,222,228,450,竹田,簡易
2020-04-10,5040,263,253,516,竹田,簡易
2020-04-11,5040,159,177,336,竹田,簡易
2020-04-12,5040,224,200,424,竹田,簡易
2020-04-13,5040,247,231,478,竹田,簡易
2020-04-14,5040,216,218,434,竹田,簡易
2020-04-15,5040,231,240,471,竹田,簡易
2020-04-16,5040,239,241,480,竹田,簡易
2020-04-17,5040,267,282,549,竹田,簡易
2020-04-18,5040,189,184,373,竹田,簡易
2020-04-19,5040,205,211,416,竹田,簡易
2020-04-20,5040,239,245,484,竹田,簡易
2020-04-21,5040,205,217,422,竹田,簡易
2020-04-22,5040,214,202,416,竹田,簡易
2020-04-23,5040,199,205,404,竹田,簡易
2020-04-24,5040,254,243,497,竹田,簡易
2020-04-25,5040,180,180,360,竹田,簡易
2020-04-26,5040,159,151,310,竹田,簡易
2020-04-27,5040,211,223,434,竹田,簡易
2020-04-28,5040,217,213,430,竹田,簡易
2020-04-29,5040,223,209,432,竹田,簡易
2020-04-30,5040,237,275,512,竹田,簡易
2020-05-01,5040,229,266,495,竹田,簡易
2020-05-02,5040,224,206,430,竹田,簡易
2020-05-03,5040,243,202,445,竹田,簡易
2020-05-04,5040,249,255,504,竹田,簡易
2020-05-05,5040,233,242,475,竹田,簡易
2020-05-06,5040,226,225,451,竹田,簡易
2020-05-07,5040,236,249,485,竹田,簡易
2020-05-08,5040,329,342,671,竹田,簡易
2020-05-09,5040,219,258,477,竹田,簡易
2020-05-10,5040,300,252,552,竹田,簡易
2020-05-11,5040,290,268,558,竹田,簡易
2020-05-12,5040,211,229,440,竹田,簡易
2020-05-13,5040,247,262,509,竹田,簡易
2020-05-14,5040,235,235,470,竹田,簡易
2020-05-15,5040,282,298,580,竹田,簡易
2020-05-16,5040,168,181,349,竹田,簡易
2020-05-17,5040,237,230,467,竹田,簡易
2020-05-18,5040,250,265,515,竹田,簡易
2020-05-19,5040,240,245,485,竹田,簡易
2020-05-20,5040,221,220,441,竹田,簡易
2020-05-21,5040,234,244,478,竹田,簡易
2020-05-22,5040,250,253,503,竹田,簡易
2020-05-23,5040,172,197,369,竹田,簡易
2020-05-24,5040,256,294,550,竹田,簡易
2020-05-25,5040,250,273,523,竹田,簡易
2020-05-26,5040,234,250,484,竹田,簡易
2020-05-27,5040,224,228,452,竹田,簡易
2020-05-28,5040,256,254,510,竹田,簡易
2020-05-29,5040,295,301,596,竹田,簡易
2020-05-30,5040,255,287,542,竹田,簡易
2020-05-31,5040,313,308,621,竹田,簡易
2020-06-01,5040,274,276,550,竹田,簡易
2020-06-02,5040,229,241,470,竹田,簡易
2020-06-03,5040,259,260,519,竹田,簡易
2020-06-04,5040,250,244,494,竹田,簡易
2020-06-05,5040,321,311,632,竹田,簡易
2020-06-06,5040,250,301,551,竹田,簡易
2020-06-07,5040,297,298,595,竹田,簡易
2020-06-08,5040,275,253,528,竹田,簡易
2020-06-09,5040,233,241,474,竹田,簡易
2020-06-10,5040,255,236,491,竹田,簡易
2020-06-11,5040,257,254,511,竹田,簡易
2020-06-12,5040,320,344,664,竹田,簡易
2020-06-13,5040,334,350,684,竹田,簡易
2020-06-14,5040,356,312,668,竹田,簡易
2020-06-15,5040,318,279,597,竹田,簡易
2020-06-16,5040,264,259,523,竹田,簡易
2020-06-17,5040,244,236,480,竹田,簡易
2020-06-18,5040,258,271,529,竹田,簡易
2020-06-19,5040,376,383,759,竹田,簡易
2020-06-20,5040,290,282,572,竹田,簡易
2020-06-21,5040,269,305,574,竹田,簡易
2020-06-22,5040,253,260,513,竹田,簡易
2020-06-23,5040,234,255,489,竹田,簡易
2020-06-24,5040,317,313,630,竹田,簡易
2020-06-25,5040,274,380,654,竹田,簡易
2020-06-26,5040,370,405,775,竹田,簡易
2020-06-27,5040,422,404,826,竹田,簡易
2020-06-28,5040,379,320,699,竹田,簡易
2020-06-29,5040,272,272,544,竹田,簡易
2020-06-30,5040,250,263,513,竹田,簡易
2020-07-01,5040,224,229,453,竹田,簡易
2020-07-02,5040,274,252,526,竹田,簡易
2020-07-03,5040,277,284,561,竹田,簡易
2020-07-04,5040,248,270,518,竹田,簡易
2020-07-05,5040,308,294,602,竹田,簡易
2020-07-06,5040,248,257,505,竹田,簡易
2020-07-07,5040,237,248,485,竹田,簡易
2020-07-08,5040,257,253,510,竹田,簡易
2020-07-09,5040,233,233,466,竹田,簡易
2020-07-10,5040,289,302,591,竹田,簡易
2020-07-11,5040,277,281,558,竹田,簡易
2020-07-12,5040,302,298,600,竹田,簡易
2020-07-13,5040,247,252,499,竹田,簡易
2020-07-14,5040,241,284,525,竹田,簡易
2020-07-15,5040,238,247,485,竹田,簡易
2020-07-16,5040,254,271,525,竹田,簡易
2020-07-17,5040,273,286,559,竹田,簡易
2020-07-18,5040,301,344,645,竹田,簡易
2020-07-19,5040,347,325,672,竹田,簡易
2020-07-20,5040,311,312,623,竹田,簡易
2020-07-21,5040,277,289,566,竹田,簡易
2020-07-22,5040,363,363,726,竹田,簡易
2020-07-23,5040,310,272,582,竹田,簡易
2020-07-24,5040,326,320,646,竹田,簡易
2020-07-25,5040,337,362,699,竹田,簡易
2020-07-26,5040,308,295,603,竹田,簡易
2020-07-27,5040,243,266,509,竹田,簡易
2020-07-28,5040,277,290,567,竹田,簡易
2020-07-29,5040,243,270,513,竹田,簡易
2020-07-30,5040,289,332,621,竹田,簡易
2020-07-31,5040,315,299,614,竹田,簡易
2020-08-01,5040,283,320,603,竹田,簡易
2020-08-02,5040,277,289,566,竹田,簡易
2020-08-03,5040,256,256,512,竹田,簡易
2020-08-04,5040,235,241,476,竹田,簡易
2020-08-05,5040,252,277,529,竹田,簡易
2020-08-06,5040,250,248,498,竹田,簡易
2020-08-07,5040,289,323,612,竹田,簡易
2020-08-08,5040,279,325,604,竹田,簡易
2020-08-09,5040,330,293,623,竹田,簡易
2020-08-10,5040,260,238,498,竹田,簡易
2020-08-11,5040,242,246,488,竹田,簡易
2020-08-12,5040,256,246,502,竹田,簡易
2020-08-13,5040,263,263,526,竹田,簡易
2020-08-14,5040,281,317,598,竹田,簡易
2020-08-15,5040,324,341,665,竹田,簡易
2020-08-16,5040,376,345,721,竹田,簡易
2020-08-17,5040,263,271,534,竹田,簡易
2020-08-18,5040,305,265,570,竹田,簡易
2020-08-19,5040,232,228,460,竹田,簡易
2020-08-20,5040,300,293,593,竹田,簡易
2020-08-21,5040,290,299,589,竹田,簡易
2020-08-22,5040,315,316,631,竹田,簡易
2020-08-23,5040,311,315,626,竹田,簡易
2020-08-24,5040,234,230,464,竹田,簡易
2020-08-25,5040,282,274,556,竹田,簡易
2020-08-26,5040,207,212,419,竹田,簡易
2020-08-27,5040,224,217,441,竹田,簡易
2020-08-28,5040,272,287,559,竹田,簡易
2020-08-29,5040,212,248,460,竹田,簡易
2020-08-30,5040,234,238,472,竹田,簡易
2020-08-31,5040,247,235,482,竹田,簡易
2020-09-01,5040,260,267,527,竹田,簡易
2020-09-02,5040,230,227,457,竹田,簡易
2020-09-03,5040,234,240,474,竹田,簡易
2020-09-04,5040,266,293,559,竹田,簡易
2020-09-05,5040,313,314,627,竹田,簡易
2020-09-06,5040,274,243,517,竹田,簡易
2020-09-07,5040,239,245,484,竹田,簡易
2020-09-08,5040,253,251,504,竹田,簡易
2020-09-09,5040,252,262,514,竹田,簡易
2020-09-10,5040,265,260,525,竹田,簡易
2020-09-11,5040,292,297,589,竹田,簡易
2020-09-12,5040,367,407,774,竹田,簡易
2020-09-13,5040,396,383,779,竹田,簡易
2020-09-14,5040,318,292,610,竹田,簡易
2020-09-15,5040,249,254,503,竹田,簡易
2020-09-16,5040,276,259,535,竹田,簡易
2020-09-17,5040,293,307,600,竹田,簡易
2020-09-18,5040,356,351,707,竹田,簡易
2020-09-19,5040,296,333,629,竹田,簡易
2020-09-20,5040,346,337,683,竹田,簡易
2020-09-21,5040,284,286,570,竹田,簡易
2020-09-22,5040,261,249,510,竹田,簡易
2020-09-23,5040,256,249,505,竹田,簡易
2020-09-24,5040,259,280,539,竹田,簡易
2020-09-25,5040,277,306,583,竹田,簡易
2020-09-26,5040,305,314,619,竹田,簡易
2020-09-27,5040,302,265,567,竹田,簡易
2020-09-28,5040,292,301,593,竹田,簡易
2020-09-29,5040,256,263,519,竹田,簡易
2020-09-30,5040,355,428,783,竹田,簡易
2020-10-01,5040,341,473,814,竹田,簡易
2020-10-02,5040,386,439,825,竹田,簡易
2020-10-03,5040,452,417,869,竹田,簡易
2020-10-04,5040,393,322,715,竹田,簡易
2020-10-05,5040,317,312,629,竹田,簡易
2020-10-06,5040,267,260,527,竹田,簡易
2020-10-07,5040,259,272,531,竹田,簡易
2020-10-08,5040,327,325,652,竹田,簡易
2020-10-09,5040,339,380,719,竹田,簡易
2020-10-10,5040,312,330,642,竹田,簡易
2020-10-11,5040,359,308,667,竹田,簡易
2020-10-12,5040,296,275,571,竹田,簡易
2020-10-13,5040,281,266,547,竹田,簡易
2020-10-14,5040,257,262,519,竹田,簡易
2020-10-15,5040,264,286,550,竹田,簡易
2020-10-16,5040,318,349,667,竹田,簡易
2020-10-17,5040,351,377,728,竹田,簡易
2020-10-18,5040,357,308,665,竹田,簡易
2020-10-19,5040,272,274,546,竹田,簡易
2020-10-20,5040,285,264,549,竹田,簡易
2020-10-21,5040,266,261,527,竹田,簡易
2020-10-22,5040,274,261,535,竹田,簡易
2020-10-23,5040,299,326,625,竹田,簡易
2020-10-24,5040,283,320,603,竹田,簡易
2020-10-25,5040,307,283,590,竹田,簡易
2020-10-26,5040,279,274,553,竹田,簡易
2020-10-27,5040,281,279,560,竹田,簡易
2020-10-28,5040,261,260,521,竹田,簡易
2020-10-29,5040,269,270,539,竹田,簡易
2020-10-30,5040,315,327,642,竹田,簡易
2020-10-31,5040,306,351,657,竹田,簡易
2020-11-01,5040,364,340,704,竹田,簡易
2020-11-02,5040,275,269,544,竹田,簡易
2020-11-03,5040,292,278,570,竹田,簡易
2020-11-04,5040,284,251,535,竹田,簡易
2020-11-05,5040,259,268,527,竹田,簡易
2020-11-06,5040,301,336,637,竹田,簡易
2020-11-07,5040,500,704,1204,竹田,簡易
2020-11-08,5040,380,370,750,竹田,簡易
2020-11-09,5040,286,287,573,竹田,簡易
2020-11-10,5040,280,299,579,竹田,簡易
2020-11-11,5040,267,270,537,竹田,簡易
2020-11-12,5040,252,291,543,竹田,簡易
2020-11-13,5040,308,324,632,竹田,簡易
2020-11-14,5040,338,370,708,竹田,簡易
2020-11-15,5040,401,355,756,竹田,簡易
2020-11-16,5040,282,307,589,竹田,簡易
2020-11-17,5040,287,304,591,竹田,簡易
2020-11-18,5040,300,285,585,竹田,簡易
2020-11-19,5040,256,274,530,竹田,簡易
2020-11-20,5040,386,364,750,竹田,簡易
2020-11-21,5040,310,325,635,竹田,簡易
2020-11-22,5040,339,331,670,竹田,簡易
2020-11-23,5040,319,294,613,竹田,簡易
2020-11-24,5040,242,244,486,竹田,簡易
2020-11-25,5040,272,280,552,竹田,簡易
2020-11-26,5040,261,271,532,竹田,簡易
2020-11-27,5040,296,343,639,竹田,簡易
2020-11-28,5040,329,388,717,竹田,簡易
2020-11-29,5040,347,289,636,竹田,簡易
2020-11-30,5040,280,290,570,竹田,簡易
2020-12-01,5040,275,267,542,竹田,簡易
2020-12-02,5040,254,266,520,竹田,簡易
2020-12-03,5040,299,289,588,竹田,簡易
2020-12-04,5040,316,327,643,竹田,簡易
2020-12-05,5040,332,354,686,竹田,簡易
2020-12-06,5040,322,316,638,竹田,簡易
2020-12-07,5040,292,296,588,竹田,簡易
2020-12-08,5040,260,263,523,竹田,簡易
2020-12-09,5040,265,270,535,竹田,簡易
2020-12-10,5040,279,285,564,竹田,簡易
2020-12-11,5040,303,347,650,竹田,簡易
2020-12-12,5040,409,427,836,竹田,簡易
2020-12-13,5040,372,327,699,竹田,簡易
2020-12-14,5040,291,449,740,竹田,簡易
2020-12-15,5040,258,262,520,竹田,簡易
2020-12-16,5040,277,258,535,竹田,簡易
2020-12-17,5040,275,311,586,竹田,簡易
2020-12-18,5040,300,352,652,竹田,簡易
2020-12-19,5040,384,418,802,竹田,簡易
2020-12-20,5040,409,324,733,竹田,簡易
2020-12-21,5040,302,286,588,竹田,簡易
2020-12-22,5040,287,302,589,竹田,簡易
2020-12-23,5040,285,280,565,竹田,簡易
2020-12-24,5040,335,359,694,竹田,簡易
2020-12-25,5040,329,369,698,竹田,簡易
2020-12-26,5040,300,346,646,竹田,簡易
2020-12-27,5040,335,321,656,竹田,簡易
2020-12-28,5040,292,307,599,竹田,簡易
2020-12-29,5040,277,295,572,竹田,簡易
2020-12-30,5040,290,258,548,竹田,簡易
2020-12-31,5040,349,335,684,竹田,簡易
2020-01-01,5050,4126,4048,8174,潮州,一等
2020-01-02,5050,3388,3135,6523,潮州,一等
2020-01-03,5050,3603,4163,7766,潮州,一等
2020-01-04,5050,3632,3870,7502,潮州,一等
2020-01-05,5050,4030,3338,7368,潮州,一等
2020-01-06,5050,3411,3058,6469,潮州,一等
2020-01-07,5050,3058,2870,5928,潮州,一等
2020-01-08,5050,3162,3172,6334,潮州,一等
2020-01-09,5050,3161,3636,6797,潮州,一等
2020-01-10,5050,4064,6768,10832,潮州,一等
2020-01-11,5050,4712,4989,9701,潮州,一等
2020-01-12,5050,5660,3567,9227,潮州,一等
2020-01-13,5050,4052,3451,7503,潮州,一等
2020-01-14,5050,3353,3679,7032,潮州,一等
2020-01-15,5050,3409,3758,7167,潮州,一等
2020-01-16,5050,3741,3987,7728,潮州,一等
2020-01-17,5050,3608,4178,7786,潮州,一等
2020-01-18,5050,3446,3837,7283,潮州,一等
2020-01-19,5050,3944,3360,7304,潮州,一等
2020-01-20,5050,3631,3757,7388,潮州,一等
2020-01-21,5050,3488,4058,7546,潮州,一等
2020-01-22,5050,3577,5677,9254,潮州,一等
2020-01-23,5050,3235,5770,9005,潮州,一等
2020-01-24,5050,2858,5030,7888,潮州,一等
2020-01-25,5050,7900,8853,16753,潮州,一等
2020-01-26,5050,6801,6849,13650,潮州,一等
2020-01-27,5050,9046,7718,16764,潮州,一等
2020-01-28,5050,6171,3816,9987,潮州,一等
2020-01-29,5050,5799,3497,9296,潮州,一等
2020-01-30,5050,4358,3394,7752,潮州,一等
2020-01-31,5050,3744,3613,7357,潮州,一等
2020-02-01,5050,3150,3095,6245,潮州,一等
2020-02-02,5050,3705,2885,6590,潮州,一等
2020-02-03,5050,3313,3139,6452,潮州,一等
2020-02-04,5050,3065,2958,6023,潮州,一等
2020-02-05,5050,2933,2909,5842,潮州,一等
2020-02-06,5050,2916,2951,5867,潮州,一等
2020-02-07,5050,3389,3863,7252,潮州,一等
2020-02-08,5050,3255,3317,6572,潮州,一等
2020-02-09,5050,3520,3145,6665,潮州,一等
2020-02-10,5050,3265,2971,6236,潮州,一等
2020-02-11,5050,2834,2783,5617,潮州,一等
2020-02-12,5050,2840,2751,5591,潮州,一等
2020-02-13,5050,2750,2662,5412,潮州,一等
2020-02-14,5050,3132,3436,6568,潮州,一等
2020-02-15,5050,2833,3136,5969,潮州,一等
2020-02-16,5050,3321,3037,6358,潮州,一等
2020-02-17,5050,2999,2825,5824,潮州,一等
2020-02-18,5050,2720,2575,5295,潮州,一等
2020-02-19,5050,2842,2775,5617,潮州,一等
2020-02-20,5050,2840,2829,5669,潮州,一等
2020-02-21,5050,3200,3684,6884,潮州,一等
2020-02-22,5050,4384,3155,7539,潮州,一等
2020-02-23,5050,3381,2711,6092,潮州,一等
2020-02-24,5050,3061,2725,5786,潮州,一等
2020-02-25,5050,2870,2791,5661,潮州,一等
2020-02-26,5050,2939,2952,5891,潮州,一等
2020-02-27,5050,3363,4567,7930,潮州,一等
2020-02-28,5050,3177,3959,7136,潮州,一等
2020-02-29,5050,3158,3187,6345,潮州,一等
2020-03-01,5050,4679,2865,7544,潮州,一等
2020-03-02,5050,3227,2704,5931,潮州,一等
2020-03-03,5050,2720,2586,5306,潮州,一等
2020-03-04,5050,2632,2571,5203,潮州,一等
2020-03-05,5050,2690,2746,5436,潮州,一等
2020-03-06,5050,3280,4142,7422,潮州,一等
2020-03-07,5050,2684,3176,5860,潮州,一等
2020-03-08,5050,3604,2648,6252,潮州,一等
2020-03-09,5050,3131,2776,5907,潮州,一等
2020-03-10,5050,2679,2600,5279,潮州,一等
2020-03-11,5050,2650,2713,5363,潮州,一等
2020-03-12,5050,2742,2836,5578,潮州,一等
2020-03-13,5050,3321,4362,7683,潮州,一等
2020-03-14,5050,2735,3103,5838,潮州,一等
2020-03-15,5050,3787,2798,6585,潮州,一等
2020-03-16,5050,3173,2746,5919,潮州,一等
2020-03-17,5050,2712,2600,5312,潮州,一等
2020-03-18,5050,2529,2585,5114,潮州,一等
2020-03-19,5050,2633,2657,5290,潮州,一等
2020-03-20,5050,3054,4306,7360,潮州,一等
2020-03-21,5050,2658,2991,5649,潮州,一等
2020-03-22,5050,3397,2274,5671,潮州,一等
2020-03-23,5050,2917,2495,5412,潮州,一等
2020-03-24,5050,2403,2353,4756,潮州,一等
2020-03-25,5050,2468,2452,4920,潮州,一等
2020-03-26,5050,3003,2650,5653,潮州,一等
2020-03-27,5050,2958,3981,6939,潮州,一等
2020-03-28,5050,2164,2562,4726,潮州,一等
2020-03-29,5050,2979,2144,5123,潮州,一等
2020-03-30,5050,2838,2544,5382,潮州,一等
2020-03-31,5050,2480,2698,5178,潮州,一等
2020-04-01,5050,3102,4607,7709,潮州,一等
2020-04-02,5050,2451,3717,6168,潮州,一等
2020-04-03,5050,2469,2987,5456,潮州,一等
2020-04-04,5050,2390,1975,4365,潮州,一等
2020-04-05,5050,4391,2290,6681,潮州,一等
2020-04-06,5050,3271,2452,5723,潮州,一等
2020-04-07,5050,2473,2252,4725,潮州,一等
2020-04-08,5050,2323,2212,4535,潮州,一等
2020-04-09,5050,2316,2372,4688,潮州,一等
2020-04-10,5050,2745,3342,6087,潮州,一等
2020-04-11,5050,2015,2241,4256,潮州,一等
2020-04-12,5050,2708,1988,4696,潮州,一等
2020-04-13,5050,2619,2268,4887,潮州,一等
2020-04-14,5050,2395,2336,4731,潮州,一等
2020-04-15,5050,2394,2429,4823,潮州,一等
2020-04-16,5050,2441,2500,4941,潮州,一等
2020-04-17,5050,2863,3691,6554,潮州,一等
2020-04-18,5050,2152,2426,4578,潮州,一等
2020-04-19,5050,2976,2191,5167,潮州,一等
2020-04-20,5050,2596,2338,4934,潮州,一等
2020-04-21,5050,2180,2083,4263,潮州,一等
2020-04-22,5050,2132,2114,4246,潮州,一等
2020-04-23,5050,2071,2144,4215,潮州,一等
2020-04-24,5050,2479,3154,5633,潮州,一等
2020-04-25,5050,1557,1885,3442,潮州,一等
2020-04-26,5050,2368,1643,4011,潮州,一等
2020-04-27,5050,2452,2251,4703,潮州,一等
2020-04-28,5050,2251,2195,4446,潮州,一等
2020-04-29,5050,2189,2187,4376,潮州,一等
2020-04-30,5050,2328,2789,5117,潮州,一等
2020-05-01,5050,2543,3558,6101,潮州,一等
2020-05-02,5050,2056,2302,4358,潮州,一等
2020-05-03,5050,3290,2122,5412,潮州,一等
2020-05-04,5050,2761,2319,5080,潮州,一等
2020-05-05,5050,2365,2324,4689,潮州,一等
2020-05-06,5050,2424,2413,4837,潮州,一等
2020-05-07,5050,2404,2651,5055,潮州,一等
2020-05-08,5050,3064,4378,7442,潮州,一等
2020-05-09,5050,2304,2967,5271,潮州,一等
2020-05-10,5050,3793,2444,6237,潮州,一等
2020-05-11,5050,3315,2665,5980,潮州,一等
2020-05-12,5050,2585,2452,5037,潮州,一等
2020-05-13,5050,2542,2459,5001,潮州,一等
2020-05-14,5050,2522,2561,5083,潮州,一等
2020-05-15,5050,3246,3970,7216,潮州,一等
2020-05-16,5050,2317,2615,4932,潮州,一等
2020-05-17,5050,3147,2445,5592,潮州,一等
2020-05-18,5050,2911,2572,5483,潮州,一等
2020-05-19,5050,2472,2343,4815,潮州,一等
2020-05-20,5050,2415,2388,4803,潮州,一等
2020-05-21,5050,2338,2399,4737,潮州,一等
2020-05-22,5050,2493,3250,5743,潮州,一等
2020-05-23,5050,2068,2503,4571,潮州,一等
2020-05-24,5050,3512,2653,6165,潮州,一等
2020-05-25,5050,2951,2585,5536,潮州,一等
2020-05-26,5050,2521,2497,5018,潮州,一等
2020-05-27,5050,2354,2284,4638,潮州,一等
2020-05-28,5050,2539,2613,5152,潮州,一等
2020-05-29,5050,3150,3937,7087,潮州,一等
2020-05-30,5050,2921,3073,5994,潮州,一等
2020-05-31,5050,3742,2895,6637,潮州,一等
2020-06-01,5050,2904,2590,5494,潮州,一等
2020-06-02,5050,2681,2616,5297,潮州,一等
2020-06-03,5050,2585,2586,5171,潮州,一等
2020-06-04,5050,2640,2757,5397,潮州,一等
2020-06-05,5050,3332,4085,7417,潮州,一等
2020-06-06,5050,3006,3352,6358,潮州,一等
2020-06-07,5050,3818,3160,6978,潮州,一等
2020-06-08,5050,3154,2783,5937,潮州,一等
2020-06-09,5050,2760,2677,5437,潮州,一等
2020-06-10,5050,2820,2695,5515,潮州,一等
2020-06-11,5050,2841,2838,5679,潮州,一等
2020-06-12,5050,3390,4202,7592,潮州,一等
2020-06-13,5050,3440,3729,7169,潮州,一等
2020-06-14,5050,4026,3330,7356,潮州,一等
2020-06-15,5050,3290,3120,6410,潮州,一等
2020-06-16,5050,2888,2790,5678,潮州,一等
2020-06-17,5050,2719,2674,5393,潮州,一等
2020-06-18,5050,2778,2861,5639,潮州,一等
2020-06-19,5050,2963,3305,6268,潮州,一等
2020-06-20,5050,3016,3330,6346,潮州,一等
2020-06-21,5050,3256,3126,6382,潮州,一等
2020-06-22,5050,3079,2977,6056,潮州,一等
2020-06-23,5050,2828,3083,5911,潮州,一等
2020-06-24,5050,3724,5364,9088,潮州,一等
2020-06-25,5050,3551,4970,8521,潮州,一等
2020-06-26,5050,4194,4333,8527,潮州,一等
2020-06-27,5050,4334,3926,8260,潮州,一等
2020-06-28,5050,5545,3387,8932,潮州,一等
2020-06-29,5050,3969,3172,7141,潮州,一等
2020-06-30,5050,2938,2852,5790,潮州,一等
2020-07-01,5050,2911,2854,5765,潮州,一等
2020-07-02,5050,2875,2956,5831,潮州,一等
2020-07-03,5050,3533,3901,7434,潮州,一等
2020-07-04,5050,3078,3182,6260,潮州,一等
2020-07-05,5050,3298,2911,6209,潮州,一等
2020-07-06,5050,3352,3053,6405,潮州,一等
2020-07-07,5050,3040,2993,6033,潮州,一等
2020-07-08,5050,2980,3080,6060,潮州,一等
2020-07-09,5050,3091,3069,6160,潮州,一等
2020-07-10,5050,3634,4243,7877,潮州,一等
2020-07-11,5050,3617,3653,7270,潮州,一等
2020-07-12,5050,4048,3409,7457,潮州,一等
2020-07-13,5050,3324,3222,6546,潮州,一等
2020-07-14,5050,3361,3280,6641,潮州,一等
2020-07-15,5050,3123,3377,6500,潮州,一等
2020-07-16,5050,3264,3169,6433,潮州,一等
2020-07-17,5050,3684,4513,8197,潮州,一等
2020-07-18,5050,3833,4137,7970,潮州,一等
2020-07-19,5050,4305,3755,8060,潮州,一等
2020-07-20,5050,3743,3496,7239,潮州,一等
2020-07-21,5050,3458,3328,6786,潮州,一等
2020-07-22,5050,3421,3385,6806,潮州,一等
2020-07-23,5050,3432,3371,6803,潮州,一等
2020-07-24,5050,3745,4347,8092,潮州,一等
2020-07-25,5050,3465,3865,7330,潮州,一等
2020-07-26,5050,4074,3479,7553,潮州,一等
2020-07-27,5050,3603,3385,6988,潮州,一等
2020-07-28,5050,3184,3096,6280,潮州,一等
2020-07-29,5050,3307,3302,6609,潮州,一等
2020-07-30,5050,3183,3335,6518,潮州,一等
2020-07-31,5050,3628,4246,7874,潮州,一等
2020-08-01,5050,3454,3751,7205,潮州,一等
2020-08-02,5050,3859,3213,7072,潮州,一等
2020-08-03,5050,3229,2999,6228,潮州,一等
2020-08-04,5050,2845,2809,5654,潮州,一等
2020-08-05,5050,3127,3101,6228,潮州,一等
2020-08-06,5050,3224,3381,6605,潮州,一等
2020-08-07,5050,3741,4886,8627,潮州,一等
2020-08-08,5050,3541,4111,7652,潮州,一等
2020-08-09,5050,4795,3595,8390,潮州,一等
2020-08-10,5050,3823,3341,7164,潮州,一等
2020-08-11,5050,2917,2935,5852,潮州,一等
2020-08-12,5050,3261,3297,6558,潮州,一等
2020-08-13,5050,3204,3400,6604,潮州,一等
2020-08-14,5050,3865,4450,8315,潮州,一等
2020-08-15,5050,3735,4002,7737,潮州,一等
2020-08-16,5050,4671,3836,8507,潮州,一等
2020-08-17,5050,3714,3431,7145,潮州,一等
2020-08-18,5050,3289,3211,6500,潮州,一等
2020-08-19,5050,3247,3183,6430,潮州,一等
2020-08-20,5050,3338,3340,6678,潮州,一等
2020-08-21,5050,4087,4491,8578,潮州,一等
2020-08-22,5050,3208,3515,6723,潮州,一等
2020-08-23,5050,3952,3440,7392,潮州,一等
2020-08-24,5050,3613,3144,6757,潮州,一等
2020-08-25,5050,3338,3328,6666,潮州,一等
2020-08-26,5050,2919,2894,5813,潮州,一等
2020-08-27,5050,2762,2995,5757,潮州,一等
2020-08-28,5050,3403,4024,7427,潮州,一等
2020-08-29,5050,3281,3531,6812,潮州,一等
2020-08-30,5050,3715,3064,6779,潮州,一等
2020-08-31,5050,3414,3194,6608,潮州,一等
2020-09-01,5050,2981,3113,6094,潮州,一等
2020-09-02,5050,2979,2914,5893,潮州,一等
2020-09-03,5050,3328,3312,6640,潮州,一等
2020-09-04,5050,3586,4141,7727,潮州,一等
2020-09-05,5050,3397,3567,6964,潮州,一等
2020-09-06,5050,3915,3319,7234,潮州,一等
2020-09-07,5050,3393,3161,6554,潮州,一等
2020-09-08,5050,3067,2934,6001,潮州,一等
2020-09-09,5050,3093,2995,6088,潮州,一等
2020-09-10,5050,3064,3142,6206,潮州,一等
2020-09-11,5050,3518,4299,7817,潮州,一等
2020-09-12,5050,3468,3660,7128,潮州,一等
2020-09-13,5050,4416,3463,7879,潮州,一等
2020-09-14,5050,3243,2978,6221,潮州,一等
2020-09-15,5050,2917,2864,5781,潮州,一等
2020-09-16,5050,2914,2794,5708,潮州,一等
2020-09-17,5050,2916,2919,5835,潮州,一等
2020-09-18,5050,3663,4735,8398,潮州,一等
2020-09-19,5050,3632,3902,7534,潮州,一等
2020-09-20,5050,4427,3356,7783,潮州,一等
2020-09-21,5050,3390,3091,6481,潮州,一等
2020-09-22,5050,3137,3020,6157,潮州,一等
2020-09-23,5050,3017,3008,6025,潮州,一等
2020-09-24,5050,3014,3033,6047,潮州,一等
2020-09-25,5050,3188,3574,6762,潮州,一等
2020-09-26,5050,3202,3443,6645,潮州,一等
2020-09-27,5050,3713,3404,7117,潮州,一等
2020-09-28,5050,3195,3011,6206,潮州,一等
2020-09-29,5050,3023,3258,6281,潮州,一等
2020-09-30,5050,3903,6357,10260,潮州,一等
2020-10-01,5050,3876,6031,9907,潮州,一等
2020-10-02,5050,4437,4638,9075,潮州,一等
2020-10-03,5050,4989,4137,9126,潮州,一等
2020-10-04,5050,6753,3681,10434,潮州,一等
2020-10-05,5050,3813,2981,6794,潮州,一等
2020-10-06,5050,3115,2931,6046,潮州,一等
2020-10-07,5050,3047,3062,6109,潮州,一等
2020-10-08,5050,3616,4869,8485,潮州,一等
2020-10-09,5050,3918,4630,8548,潮州,一等
2020-10-10,5050,3689,3662,7351,潮州,一等
2020-10-11,5050,5273,3567,8840,潮州,一等
2020-10-12,5050,3534,3082,6616,潮州,一等
2020-10-13,5050,3160,3027,6187,潮州,一等
2020-10-14,5050,3142,3089,6231,潮州,一等
2020-10-15,5050,3179,3161,6340,潮州,一等
2020-10-16,5050,3806,4644,8450,潮州,一等
2020-10-17,5050,3923,4009,7932,潮州,一等
2020-10-18,5050,4645,3718,8363,潮州,一等
2020-10-19,5050,3369,3110,6479,潮州,一等
2020-10-20,5050,3139,2989,6128,潮州,一等
2020-10-21,5050,3025,3028,6053,潮州,一等
2020-10-22,5050,3087,3189,6276,潮州,一等
2020-10-23,5050,3735,4743,8478,潮州,一等
2020-10-24,5050,3728,4144,7872,潮州,一等
2020-10-25,5050,4458,3530,7988,潮州,一等
2020-10-26,5050,3435,3083,6518,潮州,一等
2020-10-27,5050,3258,3041,6299,潮州,一等
2020-10-28,5050,3158,3305,6463,潮州,一等
2020-10-29,5050,2994,3050,6044,潮州,一等
2020-10-30,5050,3744,4847,8591,潮州,一等
2020-10-31,5050,3954,4094,8048,潮州,一等
2020-11-01,5050,4676,3670,8346,潮州,一等
2020-11-02,5050,3333,3095,6428,潮州,一等
2020-11-03,5050,2938,2907,5845,潮州,一等
2020-11-04,5050,3099,3036,6135,潮州,一等
2020-11-05,5050,3015,2991,6006,潮州,一等
2020-11-06,5050,3449,4290,7739,潮州,一等
2020-11-07,5050,3355,3650,7005,潮州,一等
2020-11-08,5050,4456,3563,8019,潮州,一等
2020-11-09,5050,3406,3171,6577,潮州,一等
2020-11-10,5050,3056,2968,6024,潮州,一等
2020-11-11,5050,3041,3092,6133,潮州,一等
2020-11-12,5050,3106,3266,6372,潮州,一等
2020-11-13,5050,4088,5148,9236,潮州,一等
2020-11-14,5050,4051,4133,8184,潮州,一等
2020-11-15,5050,4917,3826,8743,潮州,一等
2020-11-16,5050,3469,3129,6598,潮州,一等
2020-11-17,5050,3068,3053,6121,潮州,一等
2020-11-18,5050,3200,3707,6907,潮州,一等
2020-11-19,5050,3188,3297,6485,潮州,一等
2020-11-20,5050,3962,4831,8793,潮州,一等
2020-11-21,5050,3604,3891,7495,潮州,一等
2020-11-22,5050,4577,3584,8161,潮州,一等
2020-11-23,5050,3475,3135,6610,潮州,一等
2020-11-24,5050,3126,2954,6080,潮州,一等
2020-11-25,5050,2986,2998,5984,潮州,一等
2020-11-26,5050,3146,3360,6506,潮州,一等
2020-11-27,5050,3881,4791,8672,潮州,一等
2020-11-28,5050,3456,3789,7245,潮州,一等
2020-11-29,5050,4478,3460,7938,潮州,一等
2020-11-30,5050,3473,3200,6673,潮州,一等
2020-12-01,5050,3068,2948,6016,潮州,一等
2020-12-02,5050,2929,2967,5896,潮州,一等
2020-12-03,5050,3026,3156,6182,潮州,一等
2020-12-04,5050,3655,4745,8400,潮州,一等
2020-12-05,5050,4027,4416,8443,潮州,一等
2020-12-06,5050,5091,4164,9255,潮州,一等
2020-12-07,5050,3569,3260,6829,潮州,一等
2020-12-08,5050,3149,3067,6216,潮州,一等
2020-12-09,5050,3099,3072,6171,潮州,一等
2020-12-10,5050,3128,3265,6393,潮州,一等
2020-12-11,5050,3874,4908,8782,潮州,一等
2020-12-12,5050,4451,4823,9274,潮州,一等
2020-12-13,5050,5039,4207,9246,潮州,一等
2020-12-14,5050,3825,3503,7328,潮州,一等
2020-12-15,5050,3141,3102,6243,潮州,一等
2020-12-16,5050,3246,3273,6519,潮州,一等
2020-12-17,5050,3266,3458,6724,潮州,一等
2020-12-18,5050,4117,5121,9238,潮州,一等
2020-12-19,5050,3930,4158,8088,潮州,一等
2020-12-20,5050,4784,3870,8654,潮州,一等
2020-12-21,5050,3608,3351,6959,潮州,一等
2020-12-22,5050,3242,3146,6388,潮州,一等
2020-12-23,5050,5213,3420,8633,潮州,一等
2020-12-24,5050,3323,3532,6855,潮州,一等
2020-12-25,5050,3941,4677,8618,潮州,一等
2020-12-26,5050,3999,3979,7978,潮州,一等
2020-12-27,5050,4537,3607,8144,潮州,一等
2020-12-28,5050,3507,3366,6873,潮州,一等
2020-12-29,5050,3154,3038,6192,潮州,一等
2020-12-30,5050,3284,3449,6733,潮州,一等
2020-12-31,5050,4128,5316,9444,潮州,一等
2020-01-01,5060,59,75,134,崁頂,招呼
2020-01-02,5060,143,175,318,崁頂,招呼
2020-01-03,5060,170,174,344,崁頂,招呼
2020-01-04,5060,96,115,211,崁頂,招呼
2020-01-05,5060,50,59,109,崁頂,招呼
2020-01-06,5060,142,173,315,崁頂,招呼
2020-01-07,5060,151,179,330,崁頂,招呼
2020-01-08,5060,151,187,338,崁頂,招呼
2020-01-09,5060,140,183,323,崁頂,招呼
2020-01-10,5060,173,178,351,崁頂,招呼
2020-01-11,5060,39,44,83,崁頂,招呼
2020-01-12,5060,29,32,61,崁頂,招呼
2020-01-13,5060,151,159,310,崁頂,招呼
2020-01-14,5060,152,168,320,崁頂,招呼
2020-01-15,5060,156,198,354,崁頂,招呼
2020-01-16,5060,158,173,331,崁頂,招呼
2020-01-17,5060,176,184,360,崁頂,招呼
2020-01-18,5060,47,59,106,崁頂,招呼
2020-01-19,5060,50,60,110,崁頂,招呼
2020-01-20,5060,112,165,277,崁頂,招呼
2020-01-21,5060,103,117,220,崁頂,招呼
2020-01-22,5060,100,108,208,崁頂,招呼
2020-01-23,5060,22,44,66,崁頂,招呼
2020-01-24,5060,15,31,46,崁頂,招呼
2020-01-25,5060,55,51,106,崁頂,招呼
2020-01-26,5060,52,58,110,崁頂,招呼
2020-01-27,5060,38,42,80,崁頂,招呼
2020-01-28,5060,29,34,63,崁頂,招呼
2020-01-29,5060,30,30,60,崁頂,招呼
2020-01-30,5060,89,103,192,崁頂,招呼
2020-01-31,5060,79,71,150,崁頂,招呼
2020-02-01,5060,23,28,51,崁頂,招呼
2020-02-02,5060,29,20,49,崁頂,招呼
2020-02-03,5060,75,77,152,崁頂,招呼
2020-02-04,5060,77,85,162,崁頂,招呼
2020-02-05,5060,79,85,164,崁頂,招呼
2020-02-06,5060,56,66,122,崁頂,招呼
2020-02-07,5060,82,76,158,崁頂,招呼
2020-02-08,5060,19,28,47,崁頂,招呼
2020-02-09,5060,21,28,49,崁頂,招呼
2020-02-10,5060,36,48,84,崁頂,招呼
2020-02-11,5060,57,44,101,崁頂,招呼
2020-02-12,5060,38,28,66,崁頂,招呼
2020-02-13,5060,34,31,65,崁頂,招呼
2020-02-14,5060,34,32,66,崁頂,招呼
2020-02-15,5060,25,29,54,崁頂,招呼
2020-02-16,5060,22,32,54,崁頂,招呼
2020-02-17,5060,41,43,84,崁頂,招呼
2020-02-18,5060,40,40,80,崁頂,招呼
2020-02-19,5060,33,21,54,崁頂,招呼
2020-02-20,5060,39,35,74,崁頂,招呼
2020-02-21,5060,54,49,103,崁頂,招呼
2020-02-22,5060,16,20,36,崁頂,招呼
2020-02-23,5060,33,33,66,崁頂,招呼
2020-02-24,5060,36,38,74,崁頂,招呼
2020-02-25,5060,204,194,398,崁頂,招呼
2020-02-26,5060,169,191,360,崁頂,招呼
2020-02-27,5060,165,189,354,崁頂,招呼
2020-02-28,5060,73,98,171,崁頂,招呼
2020-02-29,5060,33,42,75,崁頂,招呼
2020-03-01,5060,34,52,86,崁頂,招呼
2020-03-02,5060,160,189,349,崁頂,招呼
2020-03-03,5060,167,189,356,崁頂,招呼
2020-03-04,5060,162,191,353,崁頂,招呼
2020-03-05,5060,157,184,341,崁頂,招呼
2020-03-06,5060,188,191,379,崁頂,招呼
2020-03-07,5060,81,93,174,崁頂,招呼
2020-03-08,5060,28,29,57,崁頂,招呼
2020-03-09,5060,160,178,338,崁頂,招呼
2020-03-10,5060,162,187,349,崁頂,招呼
2020-03-11,5060,149,183,332,崁頂,招呼
2020-03-12,5060,160,195,355,崁頂,招呼
2020-03-13,5060,168,192,360,崁頂,招呼
2020-03-14,5060,82,84,166,崁頂,招呼
2020-03-15,5060,40,42,82,崁頂,招呼
2020-03-16,5060,141,175,316,崁頂,招呼
2020-03-17,5060,157,192,349,崁頂,招呼
2020-03-18,5060,151,178,329,崁頂,招呼
2020-03-19,5060,151,178,329,崁頂,招呼
2020-03-20,5060,178,181,359,崁頂,招呼
2020-03-21,5060,59,93,152,崁頂,招呼
2020-03-22,5060,26,23,49,崁頂,招呼
2020-03-23,5060,145,174,319,崁頂,招呼
2020-03-24,5060,145,177,322,崁頂,招呼
2020-03-25,5060,162,185,347,崁頂,招呼
2020-03-26,5060,143,178,321,崁頂,招呼
2020-03-27,5060,164,180,344,崁頂,招呼
2020-03-28,5060,70,74,144,崁頂,招呼
2020-03-29,5060,28,21,49,崁頂,招呼
2020-03-30,5060,136,166,302,崁頂,招呼
2020-03-31,5060,140,173,313,崁頂,招呼
2020-04-01,5060,150,194,344,崁頂,招呼
2020-04-02,5060,67,92,159,崁頂,招呼
2020-04-03,5060,87,95,182,崁頂,招呼
2020-04-04,5060,18,25,43,崁頂,招呼
2020-04-05,5060,37,28,65,崁頂,招呼
2020-04-06,5060,133,172,305,崁頂,招呼
2020-04-07,5060,130,160,290,崁頂,招呼
2020-04-08,5060,145,175,320,崁頂,招呼
2020-04-09,5060,148,177,325,崁頂,招呼
2020-04-10,5060,176,180,356,崁頂,招呼
2020-04-11,5060,60,73,133,崁頂,招呼
2020-04-12,5060,47,41,88,崁頂,招呼
2020-04-13,5060,143,169,312,崁頂,招呼
2020-04-14,5060,145,170,315,崁頂,招呼
2020-04-15,5060,147,177,324,崁頂,招呼
2020-04-16,5060,150,177,327,崁頂,招呼
2020-04-17,5060,172,197,369,崁頂,招呼
2020-04-18,5060,66,84,150,崁頂,招呼
2020-04-19,5060,36,31,67,崁頂,招呼
2020-04-20,5060,143,171,314,崁頂,招呼
2020-04-21,5060,152,176,328,崁頂,招呼
2020-04-22,5060,144,169,313,崁頂,招呼
2020-04-23,5060,135,170,305,崁頂,招呼
2020-04-24,5060,159,176,335,崁頂,招呼
2020-04-25,5060,55,75,130,崁頂,招呼
2020-04-26,5060,26,30,56,崁頂,招呼
2020-04-27,5060,142,167,309,崁頂,招呼
2020-04-28,5060,150,175,325,崁頂,招呼
2020-04-29,5060,137,171,308,崁頂,招呼
2020-04-30,5060,141,185,326,崁頂,招呼
2020-05-01,5060,161,178,339,崁頂,招呼
2020-05-02,5060,64,71,135,崁頂,招呼
2020-05-03,5060,35,31,66,崁頂,招呼
2020-05-04,5060,139,175,314,崁頂,招呼
2020-05-05,5060,145,172,317,崁頂,招呼
2020-05-06,5060,129,171,300,崁頂,招呼
2020-05-07,5060,142,178,320,崁頂,招呼
2020-05-08,5060,155,188,343,崁頂,招呼
2020-05-09,5060,51,80,131,崁頂,招呼
2020-05-10,5060,66,70,136,崁頂,招呼
2020-05-11,5060,148,177,325,崁頂,招呼
2020-05-12,5060,142,171,313,崁頂,招呼
2020-05-13,5060,144,168,312,崁頂,招呼
2020-05-14,5060,145,180,325,崁頂,招呼
2020-05-15,5060,153,181,334,崁頂,招呼
2020-05-16,5060,24,25,49,崁頂,招呼
2020-05-17,5060,33,18,51,崁頂,招呼
2020-05-18,5060,178,172,350,崁頂,招呼
2020-05-19,5060,180,176,356,崁頂,招呼
2020-05-20,5060,177,172,349,崁頂,招呼
2020-05-21,5060,185,160,345,崁頂,招呼
2020-05-22,5060,141,136,277,崁頂,招呼
2020-05-23,5060,16,30,46,崁頂,招呼
2020-05-24,5060,33,40,73,崁頂,招呼
2020-05-25,5060,189,178,367,崁頂,招呼
2020-05-26,5060,181,173,354,崁頂,招呼
2020-05-27,5060,161,152,313,崁頂,招呼
2020-05-28,5060,182,152,334,崁頂,招呼
2020-05-29,5060,186,188,374,崁頂,招呼
2020-05-30,5060,31,41,72,崁頂,招呼
2020-05-31,5060,32,20,52,崁頂,招呼
2020-06-01,5060,175,179,354,崁頂,招呼
2020-06-02,5060,189,174,363,崁頂,招呼
2020-06-03,5060,187,181,368,崁頂,招呼
2020-06-04,5060,196,180,376,崁頂,招呼
2020-06-05,5060,185,186,371,崁頂,招呼
2020-06-06,5060,27,32,59,崁頂,招呼
2020-06-07,5060,30,29,59,崁頂,招呼
2020-06-08,5060,184,171,355,崁頂,招呼
2020-06-09,5060,181,178,359,崁頂,招呼
2020-06-10,5060,182,183,365,崁頂,招呼
2020-06-11,5060,187,179,366,崁頂,招呼
2020-06-12,5060,185,190,375,崁頂,招呼
2020-06-13,5060,33,40,73,崁頂,招呼
2020-06-14,5060,39,27,66,崁頂,招呼
2020-06-15,5060,203,186,389,崁頂,招呼
2020-06-16,5060,188,180,368,崁頂,招呼
2020-06-17,5060,195,187,382,崁頂,招呼
2020-06-18,5060,190,191,381,崁頂,招呼
2020-06-19,5060,195,182,377,崁頂,招呼
2020-06-20,5060,245,235,480,崁頂,招呼
2020-06-21,5060,22,20,42,崁頂,招呼
2020-06-22,5060,212,183,395,崁頂,招呼
2020-06-23,5060,189,179,368,崁頂,招呼
2020-06-24,5060,170,142,312,崁頂,招呼
2020-06-25,5060,47,63,110,崁頂,招呼
2020-06-26,5060,42,56,98,崁頂,招呼
2020-06-27,5060,32,34,66,崁頂,招呼
2020-06-28,5060,32,37,69,崁頂,招呼
2020-06-29,5060,151,158,309,崁頂,招呼
2020-06-30,5060,116,127,243,崁頂,招呼
2020-07-01,5060,130,130,260,崁頂,招呼
2020-07-02,5060,155,165,320,崁頂,招呼
2020-07-03,5060,155,151,306,崁頂,招呼
2020-07-04,5060,33,43,76,崁頂,招呼
2020-07-05,5060,25,26,51,崁頂,招呼
2020-07-06,5060,144,136,280,崁頂,招呼
2020-07-07,5060,149,144,293,崁頂,招呼
2020-07-08,5060,139,138,277,崁頂,招呼
2020-07-09,5060,141,147,288,崁頂,招呼
2020-07-10,5060,157,162,319,崁頂,招呼
2020-07-11,5060,35,32,67,崁頂,招呼
2020-07-12,5060,35,31,66,崁頂,招呼
2020-07-13,5060,138,147,285,崁頂,招呼
2020-07-14,5060,137,148,285,崁頂,招呼
2020-07-15,5060,53,53,106,崁頂,招呼
2020-07-16,5060,136,155,291,崁頂,招呼
2020-07-17,5060,126,116,242,崁頂,招呼
2020-07-18,5060,95,93,188,崁頂,招呼
2020-07-19,5060,33,31,64,崁頂,招呼
2020-07-20,5060,162,181,343,崁頂,招呼
2020-07-21,5060,176,185,361,崁頂,招呼
2020-07-22,5060,177,189,366,崁頂,招呼
2020-07-23,5060,172,181,353,崁頂,招呼
2020-07-24,5060,160,178,338,崁頂,招呼
2020-07-25,5060,59,66,125,崁頂,招呼
2020-07-26,5060,16,15,31,崁頂,招呼
2020-07-27,5060,151,91,242,崁頂,招呼
2020-07-28,5060,168,174,342,崁頂,招呼
2020-07-29,5060,176,171,347,崁頂,招呼
2020-07-30,5060,157,168,325,崁頂,招呼
2020-07-31,5060,163,157,320,崁頂,招呼
2020-08-01,5060,58,62,120,崁頂,招呼
2020-08-02,5060,23,30,53,崁頂,招呼
2020-08-03,5060,155,162,317,崁頂,招呼
2020-08-04,5060,159,152,311,崁頂,招呼
2020-08-05,5060,171,156,327,崁頂,招呼
2020-08-06,5060,175,183,358,崁頂,招呼
2020-08-07,5060,198,184,382,崁頂,招呼
2020-08-08,5060,47,53,100,崁頂,招呼
2020-08-09,5060,40,31,71,崁頂,招呼
2020-08-10,5060,110,101,211,崁頂,招呼
2020-08-11,5060,97,87,184,崁頂,招呼
2020-08-12,5060,99,96,195,崁頂,招呼
2020-08-13,5060,59,56,115,崁頂,招呼
2020-08-14,5060,64,54,118,崁頂,招呼
2020-08-15,5060,26,29,55,崁頂,招呼
2020-08-16,5060,34,32,66,崁頂,招呼
2020-08-17,5060,98,95,193,崁頂,招呼
2020-08-18,5060,102,99,201,崁頂,招呼
2020-08-19,5060,101,106,207,崁頂,招呼
2020-08-20,5060,113,107,220,崁頂,招呼
2020-08-21,5060,95,122,217,崁頂,招呼
2020-08-22,5060,54,59,113,崁頂,招呼
2020-08-23,5060,24,18,42,崁頂,招呼
2020-08-24,5060,111,96,207,崁頂,招呼
2020-08-25,5060,118,109,227,崁頂,招呼
2020-08-26,5060,97,93,190,崁頂,招呼
2020-08-27,5060,43,44,87,崁頂,招呼
2020-08-28,5060,164,168,332,崁頂,招呼
2020-08-29,5060,72,89,161,崁頂,招呼
2020-08-30,5060,54,51,105,崁頂,招呼
2020-08-31,5060,175,189,364,崁頂,招呼
2020-09-01,5060,216,211,427,崁頂,招呼
2020-09-02,5060,201,206,407,崁頂,招呼
2020-09-03,5060,207,186,393,崁頂,招呼
2020-09-04,5060,202,214,416,崁頂,招呼
2020-09-05,5060,88,102,190,崁頂,招呼
2020-09-06,5060,52,44,96,崁頂,招呼
2020-09-07,5060,177,191,368,崁頂,招呼
2020-09-08,5060,176,206,382,崁頂,招呼
2020-09-09,5060,170,194,364,崁頂,招呼
2020-09-10,5060,173,195,368,崁頂,招呼
2020-09-11,5060,194,193,387,崁頂,招呼
2020-09-12,5060,92,119,211,崁頂,招呼
2020-09-13,5060,43,40,83,崁頂,招呼
2020-09-14,5060,164,178,342,崁頂,招呼
2020-09-15,5060,164,182,346,崁頂,招呼
2020-09-16,5060,168,188,356,崁頂,招呼
2020-09-17,5060,168,191,359,崁頂,招呼
2020-09-18,5060,187,199,386,崁頂,招呼
2020-09-19,5060,76,92,168,崁頂,招呼
2020-09-20,5060,48,42,90,崁頂,招呼
2020-09-21,5060,159,179,338,崁頂,招呼
2020-09-22,5060,177,187,364,崁頂,招呼
2020-09-23,5060,154,193,347,崁頂,招呼
2020-09-24,5060,162,186,348,崁頂,招呼
2020-09-25,5060,250,252,502,崁頂,招呼
2020-09-26,5060,162,139,301,崁頂,招呼
2020-09-27,5060,39,42,81,崁頂,招呼
2020-09-28,5060,155,176,331,崁頂,招呼
2020-09-29,5060,164,189,353,崁頂,招呼
2020-09-30,5060,153,203,356,崁頂,招呼
2020-10-01,5060,96,113,209,崁頂,招呼
2020-10-02,5060,59,56,115,崁頂,招呼
2020-10-03,5060,35,39,74,崁頂,招呼
2020-10-04,5060,40,28,68,崁頂,招呼
2020-10-05,5060,171,178,349,崁頂,招呼
2020-10-06,5060,168,185,353,崁頂,招呼
2020-10-07,5060,176,200,376,崁頂,招呼
2020-10-08,5060,180,205,385,崁頂,招呼
2020-10-09,5060,90,122,212,崁頂,招呼
2020-10-10,5060,36,43,79,崁頂,招呼
2020-10-11,5060,35,26,61,崁頂,招呼
2020-10-12,5060,111,129,240,崁頂,招呼
2020-10-13,5060,109,112,221,崁頂,招呼
2020-10-14,5060,148,121,269,崁頂,招呼
2020-10-15,5060,168,198,366,崁頂,招呼
2020-10-16,5060,188,202,390,崁頂,招呼
2020-10-17,5060,42,47,89,崁頂,招呼
2020-10-18,5060,34,31,65,崁頂,招呼
2020-10-19,5060,169,186,355,崁頂,招呼
2020-10-20,5060,176,197,373,崁頂,招呼
2020-10-21,5060,164,198,362,崁頂,招呼
2020-10-22,5060,170,195,365,崁頂,招呼
2020-10-23,5060,197,203,400,崁頂,招呼
2020-10-24,5060,85,97,182,崁頂,招呼
2020-10-25,5060,44,47,91,崁頂,招呼
2020-10-26,5060,171,184,355,崁頂,招呼
2020-10-27,5060,167,199,366,崁頂,招呼
2020-10-28,5060,158,189,347,崁頂,招呼
2020-10-29,5060,169,186,355,崁頂,招呼
2020-10-30,5060,182,186,368,崁頂,招呼
2020-10-31,5060,82,97,179,崁頂,招呼
2020-11-01,5060,48,54,102,崁頂,招呼
2020-11-02,5060,173,183,356,崁頂,招呼
2020-11-03,5060,175,212,387,崁頂,招呼
2020-11-04,5060,168,182,350,崁頂,招呼
2020-11-05,5060,167,188,355,崁頂,招呼
2020-11-06,5060,175,181,356,崁頂,招呼
2020-11-07,5060,88,106,194,崁頂,招呼
2020-11-08,5060,70,59,129,崁頂,招呼
2020-11-09,5060,170,177,347,崁頂,招呼
2020-11-10,5060,177,194,371,崁頂,招呼
2020-11-11,5060,162,183,345,崁頂,招呼
2020-11-12,5060,177,201,378,崁頂,招呼
2020-11-13,5060,205,212,417,崁頂,招呼
2020-11-14,5060,90,89,179,崁頂,招呼
2020-11-15,5060,84,82,166,崁頂,招呼
2020-11-16,5060,167,173,340,崁頂,招呼
2020-11-17,5060,166,179,345,崁頂,招呼
2020-11-18,5060,180,187,367,崁頂,招呼
2020-11-19,5060,180,201,381,崁頂,招呼
2020-11-20,5060,203,204,407,崁頂,招呼
2020-11-21,5060,82,82,164,崁頂,招呼
2020-11-22,5060,52,46,98,崁頂,招呼
2020-11-23,5060,182,190,372,崁頂,招呼
2020-11-24,5060,184,188,372,崁頂,招呼
2020-11-25,5060,164,184,348,崁頂,招呼
2020-11-26,5060,182,187,369,崁頂,招呼
2020-11-27,5060,199,201,400,崁頂,招呼
2020-11-28,5060,81,98,179,崁頂,招呼
2020-11-29,5060,41,33,74,崁頂,招呼
2020-11-30,5060,175,185,360,崁頂,招呼
2020-12-01,5060,194,184,378,崁頂,招呼
2020-12-02,5060,182,178,360,崁頂,招呼
2020-12-03,5060,178,175,353,崁頂,招呼
2020-12-04,5060,195,191,386,崁頂,招呼
2020-12-05,5060,95,122,217,崁頂,招呼
2020-12-06,5060,40,27,67,崁頂,招呼
2020-12-07,5060,180,185,365,崁頂,招呼
2020-12-08,5060,183,199,382,崁頂,招呼
2020-12-09,5060,180,174,354,崁頂,招呼
2020-12-10,5060,161,182,343,崁頂,招呼
2020-12-11,5060,199,195,394,崁頂,招呼
2020-12-12,5060,403,402,805,崁頂,招呼
2020-12-13,5060,49,36,85,崁頂,招呼
2020-12-14,5060,96,90,186,崁頂,招呼
2020-12-15,5060,182,194,376,崁頂,招呼
2020-12-16,5060,186,188,374,崁頂,招呼
2020-12-17,5060,187,189,376,崁頂,招呼
2020-12-18,5060,210,205,415,崁頂,招呼
2020-12-19,5060,85,100,185,崁頂,招呼
2020-12-20,5060,41,29,70,崁頂,招呼
2020-12-21,5060,173,171,344,崁頂,招呼
2020-12-22,5060,185,198,383,崁頂,招呼
2020-12-23,5060,181,182,363,崁頂,招呼
2020-12-24,5060,175,188,363,崁頂,招呼
2020-12-25,5060,201,199,400,崁頂,招呼
2020-12-26,5060,41,89,130,崁頂,招呼
2020-12-27,5060,52,47,99,崁頂,招呼
2020-12-28,5060,181,176,357,崁頂,招呼
2020-12-29,5060,181,186,367,崁頂,招呼
2020-12-30,5060,159,173,332,崁頂,招呼
2020-12-31,5060,168,189,357,崁頂,招呼
2020-01-01,5070,465,618,1083,南州,三等
2020-01-02,5070,488,444,932,南州,三等
2020-01-03,5070,788,516,1304,南州,三等
2020-01-04,5070,382,481,863,南州,三等
2020-01-05,5070,495,501,996,南州,三等
2020-01-06,5070,476,452,928,南州,三等
2020-01-07,5070,520,477,997,南州,三等
2020-01-08,5070,485,417,902,南州,三等
2020-01-09,5070,476,485,961,南州,三等
2020-01-10,5070,756,782,1538,南州,三等
2020-01-11,5070,490,457,947,南州,三等
2020-01-12,5070,636,345,981,南州,三等
2020-01-13,5070,511,393,904,南州,三等
2020-01-14,5070,334,309,643,南州,三等
2020-01-15,5070,325,328,653,南州,三等
2020-01-16,5070,365,390,755,南州,三等
2020-01-17,5070,450,474,924,南州,三等
2020-01-18,5070,303,367,670,南州,三等
2020-01-19,5070,400,325,725,南州,三等
2020-01-20,5070,416,401,817,南州,三等
2020-01-21,5070,340,359,699,南州,三等
2020-01-22,5070,332,442,774,南州,三等
2020-01-23,5070,290,514,804,南州,三等
2020-01-24,5070,248,451,699,南州,三等
2020-01-25,5070,631,558,1189,南州,三等
2020-01-26,5070,520,446,966,南州,三等
2020-01-27,5070,610,480,1090,南州,三等
2020-01-28,5070,432,330,762,南州,三等
2020-01-29,5070,515,369,884,南州,三等
2020-01-30,5070,416,338,754,南州,三等
2020-01-31,5070,449,401,850,南州,三等
2020-02-01,5070,250,275,525,南州,三等
2020-02-02,5070,274,210,484,南州,三等
2020-02-03,5070,389,350,739,南州,三等
2020-02-04,5070,302,270,572,南州,三等
2020-02-05,5070,288,267,555,南州,三等
2020-02-06,5070,290,256,546,南州,三等
2020-02-07,5070,340,363,703,南州,三等
2020-02-08,5070,239,274,513,南州,三等
2020-02-09,5070,316,213,529,南州,三等
2020-02-10,5070,357,321,678,南州,三等
2020-02-11,5070,279,268,547,南州,三等
2020-02-12,5070,235,227,462,南州,三等
2020-02-13,5070,228,231,459,南州,三等
2020-02-14,5070,358,345,703,南州,三等
2020-02-15,5070,242,289,531,南州,三等
2020-02-16,5070,295,270,565,南州,三等
2020-02-17,5070,420,359,779,南州,三等
2020-02-18,5070,384,327,711,南州,三等
2020-02-19,5070,289,261,550,南州,三等
2020-02-20,5070,286,288,574,南州,三等
2020-02-21,5070,432,455,887,南州,三等
2020-02-22,5070,272,270,542,南州,三等
2020-02-23,5070,319,262,581,南州,三等
2020-02-24,5070,287,246,533,南州,三等
2020-02-25,5070,305,294,599,南州,三等
2020-02-26,5070,289,313,602,南州,三等
2020-02-27,5070,354,423,777,南州,三等
2020-02-28,5070,282,357,639,南州,三等
2020-02-29,5070,283,364,647,南州,三等
2020-03-01,5070,472,412,884,南州,三等
2020-03-02,5070,554,469,1023,南州,三等
2020-03-03,5070,461,456,917,南州,三等
2020-03-04,5070,437,429,866,南州,三等
2020-03-05,5070,472,452,924,南州,三等
2020-03-06,5070,834,571,1405,南州,三等
2020-03-07,5070,303,355,658,南州,三等
2020-03-08,5070,391,534,925,南州,三等
2020-03-09,5070,462,437,899,南州,三等
2020-03-10,5070,444,413,857,南州,三等
2020-03-11,5070,442,438,880,南州,三等
2020-03-12,5070,461,446,907,南州,三等
2020-03-13,5070,856,552,1408,南州,三等
2020-03-14,5070,307,380,687,南州,三等
2020-03-15,5070,428,549,977,南州,三等
2020-03-16,5070,490,491,981,南州,三等
2020-03-17,5070,431,406,837,南州,三等
2020-03-18,5070,433,400,833,南州,三等
2020-03-19,5070,464,446,910,南州,三等
2020-03-20,5070,813,584,1397,南州,三等
2020-03-21,5070,364,418,782,南州,三等
2020-03-22,5070,394,496,890,南州,三等
2020-03-23,5070,422,429,851,南州,三等
2020-03-24,5070,427,398,825,南州,三等
2020-03-25,5070,408,382,790,南州,三等
2020-03-26,5070,444,427,871,南州,三等
2020-03-27,5070,734,513,1247,南州,三等
2020-03-28,5070,311,377,688,南州,三等
2020-03-29,5070,340,438,778,南州,三等
2020-03-30,5070,453,445,898,南州,三等
2020-03-31,5070,378,381,759,南州,三等
2020-04-01,5070,947,618,1565,南州,三等
2020-04-02,5070,292,335,627,南州,三等
2020-04-03,5070,263,313,576,南州,三等
2020-04-04,5070,243,207,450,南州,三等
2020-04-05,5070,472,585,1057,南州,三等
2020-04-06,5070,485,430,915,南州,三等
2020-04-07,5070,420,380,800,南州,三等
2020-04-08,5070,437,396,833,南州,三等
2020-04-09,5070,461,428,889,南州,三等
2020-04-10,5070,801,479,1280,南州,三等
2020-04-11,5070,269,305,574,南州,三等
2020-04-12,5070,299,402,701,南州,三等
2020-04-13,5070,482,427,909,南州,三等
2020-04-14,5070,435,394,829,南州,三等
2020-04-15,5070,491,379,870,南州,三等
2020-04-16,5070,486,457,943,南州,三等
2020-04-17,5070,895,529,1424,南州,三等
2020-04-18,5070,252,319,571,南州,三等
2020-04-19,5070,323,453,776,南州,三等
2020-04-20,5070,474,428,902,南州,三等
2020-04-21,5070,457,405,862,南州,三等
2020-04-22,5070,430,383,813,南州,三等
2020-04-23,5070,435,399,834,南州,三等
2020-04-24,5070,618,468,1086,南州,三等
2020-04-25,5070,179,229,408,南州,三等
2020-04-26,5070,282,289,571,南州,三等
2020-04-27,5070,494,403,897,南州,三等
2020-04-28,5070,423,351,774,南州,三等
2020-04-29,5070,471,380,851,南州,三等
2020-04-30,5070,474,397,871,南州,三等
2020-05-01,5070,837,478,1315,南州,三等
2020-05-02,5070,278,309,587,南州,三等
2020-05-03,5070,393,484,877,南州,三等
2020-05-04,5070,453,430,883,南州,三等
2020-05-05,5070,412,395,807,南州,三等
2020-05-06,5070,426,389,815,南州,三等
2020-05-07,5070,433,423,856,南州,三等
2020-05-08,5070,887,563,1450,南州,三等
2020-05-09,5070,303,407,710,南州,三等
2020-05-10,5070,447,563,1010,南州,三等
2020-05-11,5070,499,456,955,南州,三等
2020-05-12,5070,462,436,898,南州,三等
2020-05-13,5070,483,401,884,南州,三等
2020-05-14,5070,488,462,950,南州,三等
2020-05-15,5070,832,572,1404,南州,三等
2020-05-16,5070,318,353,671,南州,三等
2020-05-17,5070,370,470,840,南州,三等
2020-05-18,5070,472,451,923,南州,三等
2020-05-19,5070,433,410,843,南州,三等
2020-05-20,5070,430,421,851,南州,三等
2020-05-21,5070,438,454,892,南州,三等
2020-05-22,5070,748,485,1233,南州,三等
2020-05-23,5070,290,296,586,南州,三等
2020-05-24,5070,334,473,807,南州,三等
2020-05-25,5070,471,483,954,南州,三等
2020-05-26,5070,440,430,870,南州,三等
2020-05-27,5070,434,380,814,南州,三等
2020-05-28,5070,442,460,902,南州,三等
2020-05-29,5070,872,567,1439,南州,三等
2020-05-30,5070,377,426,803,南州,三等
2020-05-31,5070,390,543,933,南州,三等
2020-06-01,5070,492,466,958,南州,三等
2020-06-02,5070,486,461,947,南州,三等
2020-06-03,5070,481,432,913,南州,三等
2020-06-04,5070,493,439,932,南州,三等
2020-06-05,5070,880,545,1425,南州,三等
2020-06-06,5070,303,368,671,南州,三等
2020-06-07,5070,422,548,970,南州,三等
2020-06-08,5070,499,473,972,南州,三等
2020-06-09,5070,456,419,875,南州,三等
2020-06-10,5070,479,456,935,南州,三等
2020-06-11,5070,523,487,1010,南州,三等
2020-06-12,5070,886,604,1490,南州,三等
2020-06-13,5070,417,475,892,南州,三等
2020-06-14,5070,455,535,990,南州,三等
2020-06-15,5070,562,502,1064,南州,三等
2020-06-16,5070,522,470,992,南州,三等
2020-06-17,5070,456,411,867,南州,三等
2020-06-18,5070,521,426,947,南州,三等
2020-06-19,5070,555,527,1082,南州,三等
2020-06-20,5070,594,489,1083,南州,三等
2020-06-21,5070,486,472,958,南州,三等
2020-06-22,5070,538,468,1006,南州,三等
2020-06-23,5070,451,489,940,南州,三等
2020-06-24,5070,942,650,1592,南州,三等
2020-06-25,5070,404,490,894,南州,三等
2020-06-26,5070,496,453,949,南州,三等
2020-06-27,5070,469,440,909,南州,三等
2020-06-28,5070,523,647,1170,南州,三等
2020-06-29,5070,578,469,1047,南州,三等
2020-06-30,5070,492,395,887,南州,三等
2020-07-01,5070,463,392,855,南州,三等
2020-07-02,5070,430,383,813,南州,三等
2020-07-03,5070,875,538,1413,南州,三等
2020-07-04,5070,330,366,696,南州,三等
2020-07-05,5070,370,341,711,南州,三等
2020-07-06,5070,634,581,1215,南州,三等
2020-07-07,5070,486,422,908,南州,三等
2020-07-08,5070,523,503,1026,南州,三等
2020-07-09,5070,443,411,854,南州,三等
2020-07-10,5070,522,513,1035,南州,三等
2020-07-11,5070,310,360,670,南州,三等
2020-07-12,5070,477,395,872,南州,三等
2020-07-13,5070,475,474,949,南州,三等
2020-07-14,5070,456,407,863,南州,三等
2020-07-15,5070,408,412,820,南州,三等
2020-07-16,5070,395,379,774,南州,三等
2020-07-17,5070,557,506,1063,南州,三等
2020-07-18,5070,363,371,734,南州,三等
2020-07-19,5070,421,428,849,南州,三等
2020-07-20,5070,556,501,1057,南州,三等
2020-07-21,5070,485,435,920,南州,三等
2020-07-22,5070,486,433,919,南州,三等
2020-07-23,5070,496,424,920,南州,三等
2020-07-24,5070,627,609,1236,南州,三等
2020-07-25,5070,396,383,779,南州,三等
2020-07-26,5070,430,418,848,南州,三等
2020-07-27,5070,566,486,1052,南州,三等
2020-07-28,5070,422,371,793,南州,三等
2020-07-29,5070,475,478,953,南州,三等
2020-07-30,5070,401,391,792,南州,三等
2020-07-31,5070,509,457,966,南州,三等
2020-08-01,5070,310,309,619,南州,三等
2020-08-02,5070,356,289,645,南州,三等
2020-08-03,5070,447,384,831,南州,三等
2020-08-04,5070,342,335,677,南州,三等
2020-08-05,5070,368,344,712,南州,三等
2020-08-06,5070,421,398,819,南州,三等
2020-08-07,5070,489,504,993,南州,三等
2020-08-08,5070,294,330,624,南州,三等
2020-08-09,5070,424,335,759,南州,三等
2020-08-10,5070,500,435,935,南州,三等
2020-08-11,5070,430,402,832,南州,三等
2020-08-12,5070,361,356,717,南州,三等
2020-08-13,5070,400,366,766,南州,三等
2020-08-14,5070,427,456,883,南州,三等
2020-08-15,5070,348,368,716,南州,三等
2020-08-16,5070,443,375,818,南州,三等
2020-08-17,5070,406,365,771,南州,三等
2020-08-18,5070,389,354,743,南州,三等
2020-08-19,5070,327,318,645,南州,三等
2020-08-20,5070,394,341,735,南州,三等
2020-08-21,5070,518,496,1014,南州,三等
2020-08-22,5070,296,301,597,南州,三等
2020-08-23,5070,381,258,639,南州,三等
2020-08-24,5070,390,359,749,南州,三等
2020-08-25,5070,401,377,778,南州,三等
2020-08-26,5070,264,257,521,南州,三等
2020-08-27,5070,299,310,609,南州,三等
2020-08-28,5070,403,440,843,南州,三等
2020-08-29,5070,304,332,636,南州,三等
2020-08-30,5070,348,248,596,南州,三等
2020-08-31,5070,414,396,810,南州,三等
2020-09-01,5070,310,336,646,南州,三等
2020-09-02,5070,323,310,633,南州,三等
2020-09-03,5070,373,331,704,南州,三等
2020-09-04,5070,368,399,767,南州,三等
2020-09-05,5070,298,321,619,南州,三等
2020-09-06,5070,366,249,615,南州,三等
2020-09-07,5070,385,358,743,南州,三等
2020-09-08,5070,320,299,619,南州,三等
2020-09-09,5070,308,316,624,南州,三等
2020-09-10,5070,322,339,661,南州,三等
2020-09-11,5070,376,432,808,南州,三等
2020-09-12,5070,278,277,555,南州,三等
2020-09-13,5070,437,332,769,南州,三等
2020-09-14,5070,425,374,799,南州,三等
2020-09-15,5070,334,323,657,南州,三等
2020-09-16,5070,304,296,600,南州,三等
2020-09-17,5070,343,327,670,南州,三等
2020-09-18,5070,467,554,1021,南州,三等
2020-09-19,5070,368,409,777,南州,三等
2020-09-20,5070,508,473,981,南州,三等
2020-09-21,5070,563,582,1145,南州,三等
2020-09-22,5070,563,509,1072,南州,三等
2020-09-23,5070,534,485,1019,南州,三等
2020-09-24,5070,508,458,966,南州,三等
2020-09-25,5070,545,537,1082,南州,三等
2020-09-26,5070,626,512,1138,南州,三等
2020-09-27,5070,558,605,1163,南州,三等
2020-09-28,5070,603,509,1112,南州,三等
2020-09-29,5070,486,458,944,南州,三等
2020-09-30,5070,1086,748,1834,南州,三等
2020-10-01,5070,464,539,1003,南州,三等
2020-10-02,5070,500,477,977,南州,三等
2020-10-03,5070,491,426,917,南州,三等
2020-10-04,5070,694,851,1545,南州,三等
2020-10-05,5070,599,497,1096,南州,三等
2020-10-06,5070,476,451,927,南州,三等
2020-10-07,5070,562,536,1098,南州,三等
2020-10-08,5070,983,643,1626,南州,三等
2020-10-09,5070,504,491,995,南州,三等
2020-10-10,5070,379,380,759,南州,三等
2020-10-11,5070,598,791,1389,南州,三等
2020-10-12,5070,595,492,1087,南州,三等
2020-10-13,5070,497,460,957,南州,三等
2020-10-14,5070,535,495,1030,南州,三等
2020-10-15,5070,544,528,1072,南州,三等
2020-10-16,5070,890,656,1546,南州,三等
2020-10-17,5070,561,529,1090,南州,三等
2020-10-18,5070,579,653,1232,南州,三等
2020-10-19,5070,521,488,1009,南州,三等
2020-10-20,5070,479,468,947,南州,三等
2020-10-21,5070,541,472,1013,南州,三等
2020-10-22,5070,552,515,1067,南州,三等
2020-10-23,5070,1002,623,1625,南州,三等
2020-10-24,5070,442,500,942,南州,三等
2020-10-25,5070,512,667,1179,南州,三等
2020-10-26,5070,565,490,1055,南州,三等
2020-10-27,5070,570,496,1066,南州,三等
2020-10-28,5070,520,478,998,南州,三等
2020-10-29,5070,497,502,999,南州,三等
2020-10-30,5070,909,558,1467,南州,三等
2020-10-31,5070,412,484,896,南州,三等
2020-11-01,5070,539,659,1198,南州,三等
2020-11-02,5070,586,525,1111,南州,三等
2020-11-03,5070,531,434,965,南州,三等
2020-11-04,5070,551,483,1034,南州,三等
2020-11-05,5070,604,526,1130,南州,三等
2020-11-06,5070,912,611,1523,南州,三等
2020-11-07,5070,408,451,859,南州,三等
2020-11-08,5070,621,750,1371,南州,三等
2020-11-09,5070,618,506,1124,南州,三等
2020-11-10,5070,553,448,1001,南州,三等
2020-11-11,5070,575,496,1071,南州,三等
2020-11-12,5070,578,533,1111,南州,三等
2020-11-13,5070,871,695,1566,南州,三等
2020-11-14,5070,402,492,894,南州,三等
2020-11-15,5070,608,607,1215,南州,三等
2020-11-16,5070,601,493,1094,南州,三等
2020-11-17,5070,535,484,1019,南州,三等
2020-11-18,5070,608,501,1109,南州,三等
2020-11-19,5070,522,510,1032,南州,三等
2020-11-20,5070,1096,632,1728,南州,三等
2020-11-21,5070,379,418,797,南州,三等
2020-11-22,5070,567,787,1354,南州,三等
2020-11-23,5070,548,517,1065,南州,三等
2020-11-24,5070,503,455,958,南州,三等
2020-11-25,5070,524,500,1024,南州,三等
2020-11-26,5070,566,485,1051,南州,三等
2020-11-27,5070,956,651,1607,南州,三等
2020-11-28,5070,458,483,941,南州,三等
2020-11-29,5070,566,710,1276,南州,三等
2020-11-30,5070,562,507,1069,南州,三等
2020-12-01,5070,517,502,1019,南州,三等
2020-12-02,5070,476,470,946,南州,三等
2020-12-03,5070,474,448,922,南州,三等
2020-12-04,5070,817,571,1388,南州,三等
2020-12-05,5070,495,540,1035,南州,三等
2020-12-06,5070,605,766,1371,南州,三等
2020-12-07,5070,550,508,1058,南州,三等
2020-12-08,5070,487,450,937,南州,三等
2020-12-09,5070,520,478,998,南州,三等
2020-12-10,5070,561,500,1061,南州,三等
2020-12-11,5070,990,654,1644,南州,三等
2020-12-12,5070,543,566,1109,南州,三等
2020-12-13,5070,586,650,1236,南州,三等
2020-12-14,5070,628,601,1229,南州,三等
2020-12-15,5070,461,462,923,南州,三等
2020-12-16,5070,551,510,1061,南州,三等
2020-12-17,5070,530,518,1048,南州,三等
2020-12-18,5070,1028,676,1704,南州,三等
2020-12-19,5070,429,461,890,南州,三等
2020-12-20,5070,522,698,1220,南州,三等
2020-12-21,5070,519,489,1008,南州,三等
2020-12-22,5070,519,473,992,南州,三等
2020-12-23,5070,506,470,976,南州,三等
2020-12-24,5070,575,552,1127,南州,三等
2020-12-25,5070,896,605,1501,南州,三等
2020-12-26,5070,476,505,981,南州,三等
2020-12-27,5070,557,698,1255,南州,三等
2020-12-28,5070,554,513,1067,南州,三等
2020-12-29,5070,472,428,900,南州,三等
2020-12-30,5070,604,485,1089,南州,三等
2020-12-31,5070,1144,677,1821,南州,三等
2020-01-01,5080,5,11,16,鎮安,招呼
2020-01-02,5080,4,2,6,鎮安,招呼
2020-01-03,5080,14,11,25,鎮安,招呼
2020-01-04,5080,10,13,23,鎮安,招呼
2020-01-05,5080,7,7,14,鎮安,招呼
2020-01-06,5080,11,1,12,鎮安,招呼
2020-01-07,5080,8,7,15,鎮安,招呼
2020-01-08,5080,11,7,18,鎮安,招呼
2020-01-09,5080,3,4,7,鎮安,招呼
2020-01-10,5080,7,21,28,鎮安,招呼
2020-01-11,5080,13,14,27,鎮安,招呼
2020-01-12,5080,13,7,20,鎮安,招呼
2020-01-13,5080,14,17,31,鎮安,招呼
2020-01-14,5080,9,7,16,鎮安,招呼
2020-01-15,5080,11,11,22,鎮安,招呼
2020-01-16,5080,11,18,29,鎮安,招呼
2020-01-17,5080,10,22,32,鎮安,招呼
2020-01-18,5080,12,8,20,鎮安,招呼
2020-01-19,5080,19,14,33,鎮安,招呼
2020-01-20,5080,13,12,25,鎮安,招呼
2020-01-21,5080,13,22,35,鎮安,招呼
2020-01-22,5080,13,13,26,鎮安,招呼
2020-01-23,5080,7,30,37,鎮安,招呼
2020-01-24,5080,5,27,32,鎮安,招呼
2020-01-25,5080,23,18,41,鎮安,招呼
2020-01-26,5080,21,37,58,鎮安,招呼
2020-01-27,5080,18,32,50,鎮安,招呼
2020-01-28,5080,32,25,57,鎮安,招呼
2020-01-29,5080,25,23,48,鎮安,招呼
2020-01-30,5080,11,10,21,鎮安,招呼
2020-01-31,5080,10,13,23,鎮安,招呼
2020-02-01,5080,10,18,28,鎮安,招呼
2020-02-02,5080,13,3,16,鎮安,招呼
2020-02-03,5080,19,14,33,鎮安,招呼
2020-02-04,5080,11,17,28,鎮安,招呼
2020-02-05,5080,18,21,39,鎮安,招呼
2020-02-06,5080,10,14,24,鎮安,招呼
2020-02-07,5080,13,20,33,鎮安,招呼
2020-02-08,5080,14,22,36,鎮安,招呼
2020-02-09,5080,13,10,23,鎮安,招呼
2020-02-10,5080,11,13,24,鎮安,招呼
2020-02-11,5080,10,16,26,鎮安,招呼
2020-02-12,5080,18,18,36,鎮安,招呼
2020-02-13,5080,16,18,34,鎮安,招呼
2020-02-14,5080,10,15,25,鎮安,招呼
2020-02-15,5080,5,7,12,鎮安,招呼
2020-02-16,5080,6,15,21,鎮安,招呼
2020-02-17,5080,15,12,27,鎮安,招呼
2020-02-18,5080,12,14,26,鎮安,招呼
2020-02-19,5080,12,18,30,鎮安,招呼
2020-02-20,5080,10,18,28,鎮安,招呼
2020-02-21,5080,20,22,42,鎮安,招呼
2020-02-22,5080,16,36,52,鎮安,招呼
2020-02-23,5080,13,13,26,鎮安,招呼
2020-02-24,5080,9,7,16,鎮安,招呼
2020-02-25,5080,15,18,33,鎮安,招呼
2020-02-26,5080,15,11,26,鎮安,招呼
2020-02-27,5080,14,19,33,鎮安,招呼
2020-02-28,5080,9,26,35,鎮安,招呼
2020-02-29,5080,12,47,59,鎮安,招呼
2020-03-01,5080,15,12,27,鎮安,招呼
2020-03-02,5080,13,13,26,鎮安,招呼
2020-03-03,5080,12,15,27,鎮安,招呼
2020-03-04,5080,12,11,23,鎮安,招呼
2020-03-05,5080,16,7,23,鎮安,招呼
2020-03-06,5080,13,17,30,鎮安,招呼
2020-03-07,5080,1,6,7,鎮安,招呼
2020-03-08,5080,13,13,26,鎮安,招呼
2020-03-09,5080,14,12,26,鎮安,招呼
2020-03-10,5080,12,9,21,鎮安,招呼
2020-03-11,5080,10,12,22,鎮安,招呼
2020-03-12,5080,17,11,28,鎮安,招呼
2020-03-13,5080,13,2,15,鎮安,招呼
2020-03-14,5080,4,3,7,鎮安,招呼
2020-03-15,5080,23,5,28,鎮安,招呼
2020-03-16,5080,13,2,15,鎮安,招呼
2020-03-17,5080,20,5,25,鎮安,招呼
2020-03-18,5080,15,2,17,鎮安,招呼
2020-03-19,5080,12,9,21,鎮安,招呼
2020-03-20,5080,13,7,20,鎮安,招呼
2020-03-21,5080,10,8,18,鎮安,招呼
2020-03-22,5080,11,8,19,鎮安,招呼
2020-03-23,5080,12,2,14,鎮安,招呼
2020-03-24,5080,14,3,17,鎮安,招呼
2020-03-25,5080,15,2,17,鎮安,招呼
2020-03-26,5080,11,4,15,鎮安,招呼
2020-03-27,5080,13,3,16,鎮安,招呼
2020-03-28,5080,7,9,16,鎮安,招呼
2020-03-29,5080,10,2,12,鎮安,招呼
2020-03-30,5080,10,3,13,鎮安,招呼
2020-03-31,5080,8,12,20,鎮安,招呼
2020-04-01,5080,13,13,26,鎮安,招呼
2020-04-02,5080,5,10,15,鎮安,招呼
2020-04-03,5080,6,8,14,鎮安,招呼
2020-04-04,5080,12,9,21,鎮安,招呼
2020-04-05,5080,26,7,33,鎮安,招呼
2020-04-06,5080,14,7,21,鎮安,招呼
2020-04-07,5080,10,4,14,鎮安,招呼
2020-04-08,5080,9,10,19,鎮安,招呼
2020-04-09,5080,10,12,22,鎮安,招呼
2020-04-10,5080,10,14,24,鎮安,招呼
2020-04-11,5080,7,13,20,鎮安,招呼
2020-04-12,5080,17,7,24,鎮安,招呼
2020-04-13,5080,13,12,25,鎮安,招呼
2020-04-14,5080,14,13,27,鎮安,招呼
2020-04-15,5080,13,14,27,鎮安,招呼
2020-04-16,5080,9,11,20,鎮安,招呼
2020-04-17,5080,19,23,42,鎮安,招呼
2020-04-18,5080,6,13,19,鎮安,招呼
2020-04-19,5080,13,9,22,鎮安,招呼
2020-04-20,5080,16,14,30,鎮安,招呼
2020-04-21,5080,11,11,22,鎮安,招呼
2020-04-22,5080,12,10,22,鎮安,招呼
2020-04-23,5080,11,7,18,鎮安,招呼
2020-04-24,5080,10,14,24,鎮安,招呼
2020-04-25,5080,8,8,16,鎮安,招呼
2020-04-26,5080,12,1,13,鎮安,招呼
2020-04-27,5080,10,12,22,鎮安,招呼
2020-04-28,5080,12,11,23,鎮安,招呼
2020-04-29,5080,8,11,19,鎮安,招呼
2020-04-30,5080,11,14,25,鎮安,招呼
2020-05-01,5080,12,16,28,鎮安,招呼
2020-05-02,5080,9,12,21,鎮安,招呼
2020-05-03,5080,12,3,15,鎮安,招呼
2020-05-04,5080,15,13,28,鎮安,招呼
2020-05-05,5080,15,11,26,鎮安,招呼
2020-05-06,5080,13,7,20,鎮安,招呼
2020-05-07,5080,16,13,29,鎮安,招呼
2020-05-08,5080,13,20,33,鎮安,招呼
2020-05-09,5080,11,15,26,鎮安,招呼
2020-05-10,5080,13,13,26,鎮安,招呼
2020-05-11,5080,26,21,47,鎮安,招呼
2020-05-12,5080,9,10,19,鎮安,招呼
2020-05-13,5080,13,10,23,鎮安,招呼
2020-05-14,5080,11,13,24,鎮安,招呼
2020-05-15,5080,16,23,39,鎮安,招呼
2020-05-16,5080,9,8,17,鎮安,招呼
2020-05-17,5080,7,9,16,鎮安,招呼
2020-05-18,5080,15,11,26,鎮安,招呼
2020-05-19,5080,13,10,23,鎮安,招呼
2020-05-20,5080,15,11,26,鎮安,招呼
2020-05-21,5080,6,10,16,鎮安,招呼
2020-05-22,5080,8,19,27,鎮安,招呼
2020-05-23,5080,6,10,16,鎮安,招呼
2020-05-24,5080,9,8,17,鎮安,招呼
2020-05-25,5080,17,15,32,鎮安,招呼
2020-05-26,5080,12,10,22,鎮安,招呼
2020-05-27,5080,9,9,18,鎮安,招呼
2020-05-28,5080,5,9,14,鎮安,招呼
2020-05-29,5080,17,17,34,鎮安,招呼
2020-05-30,5080,13,20,33,鎮安,招呼
2020-05-31,5080,19,21,40,鎮安,招呼
2020-06-01,5080,14,12,26,鎮安,招呼
2020-06-02,5080,11,12,23,鎮安,招呼
2020-06-03,5080,10,9,19,鎮安,招呼
2020-06-04,5080,8,13,21,鎮安,招呼
2020-06-05,5080,13,18,31,鎮安,招呼
2020-06-06,5080,6,33,39,鎮安,招呼
2020-06-07,5080,17,15,32,鎮安,招呼
2020-06-08,5080,19,16,35,鎮安,招呼
2020-06-09,5080,16,11,27,鎮安,招呼
2020-06-10,5080,17,16,33,鎮安,招呼
2020-06-11,5080,14,16,30,鎮安,招呼
2020-06-12,5080,12,16,28,鎮安,招呼
2020-06-13,5080,13,23,36,鎮安,招呼
2020-06-14,5080,15,10,25,鎮安,招呼
2020-06-15,5080,17,16,33,鎮安,招呼
2020-06-16,5080,11,14,25,鎮安,招呼
2020-06-17,5080,11,12,23,鎮安,招呼
2020-06-18,5080,6,11,17,鎮安,招呼
2020-06-19,5080,13,17,30,鎮安,招呼
2020-06-20,5080,13,19,32,鎮安,招呼
2020-06-21,5080,12,14,26,鎮安,招呼
2020-06-22,5080,12,18,30,鎮安,招呼
2020-06-23,5080,16,18,34,鎮安,招呼
2020-06-24,5080,10,23,33,鎮安,招呼
2020-06-25,5080,12,32,44,鎮安,招呼
2020-06-26,5080,24,27,51,鎮安,招呼
2020-06-27,5080,17,13,30,鎮安,招呼
2020-06-28,5080,33,16,49,鎮安,招呼
2020-06-29,5080,16,17,33,鎮安,招呼
2020-06-30,5080,16,12,28,鎮安,招呼
2020-07-01,5080,9,10,19,鎮安,招呼
2020-07-02,5080,9,10,19,鎮安,招呼
2020-07-03,5080,16,22,38,鎮安,招呼
2020-07-04,5080,10,14,24,鎮安,招呼
2020-07-05,5080,16,17,33,鎮安,招呼
2020-07-06,5080,15,19,34,鎮安,招呼
2020-07-07,5080,14,17,31,鎮安,招呼
2020-07-08,5080,15,19,34,鎮安,招呼
2020-07-09,5080,20,18,38,鎮安,招呼
2020-07-10,5080,24,21,45,鎮安,招呼
2020-07-11,5080,12,13,25,鎮安,招呼
2020-07-12,5080,9,7,16,鎮安,招呼
2020-07-13,5080,15,15,30,鎮安,招呼
2020-07-14,5080,13,26,39,鎮安,招呼
2020-07-15,5080,12,11,23,鎮安,招呼
2020-07-16,5080,16,13,29,鎮安,招呼
2020-07-17,5080,13,17,30,鎮安,招呼
2020-07-18,5080,13,19,32,鎮安,招呼
2020-07-19,5080,20,23,43,鎮安,招呼
2020-07-20,5080,17,12,29,鎮安,招呼
2020-07-21,5080,10,8,18,鎮安,招呼
2020-07-22,5080,16,14,30,鎮安,招呼
2020-07-23,5080,13,17,30,鎮安,招呼
2020-07-24,5080,13,17,30,鎮安,招呼
2020-07-25,5080,13,21,34,鎮安,招呼
2020-07-26,5080,25,15,40,鎮安,招呼
2020-07-27,5080,11,11,22,鎮安,招呼
2020-07-28,5080,11,11,22,鎮安,招呼
2020-07-29,5080,12,15,27,鎮安,招呼
2020-07-30,5080,10,11,21,鎮安,招呼
2020-07-31,5080,11,13,24,鎮安,招呼
2020-08-01,5080,12,9,21,鎮安,招呼
2020-08-02,5080,8,10,18,鎮安,招呼
2020-08-03,5080,14,19,33,鎮安,招呼
2020-08-04,5080,4,10,14,鎮安,招呼
2020-08-05,5080,12,16,28,鎮安,招呼
2020-08-06,5080,22,25,47,鎮安,招呼
2020-08-07,5080,13,17,30,鎮安,招呼
2020-08-08,5080,9,16,25,鎮安,招呼
2020-08-09,5080,22,20,42,鎮安,招呼
2020-08-10,5080,17,20,37,鎮安,招呼
2020-08-11,5080,13,7,20,鎮安,招呼
2020-08-12,5080,22,19,41,鎮安,招呼
2020-08-13,5080,14,11,25,鎮安,招呼
2020-08-14,5080,14,23,37,鎮安,招呼
2020-08-15,5080,18,20,38,鎮安,招呼
2020-08-16,5080,28,20,48,鎮安,招呼
2020-08-17,5080,12,19,31,鎮安,招呼
2020-08-18,5080,7,6,13,鎮安,招呼
2020-08-19,5080,12,12,24,鎮安,招呼
2020-08-20,5080,10,10,20,鎮安,招呼
2020-08-21,5080,9,13,22,鎮安,招呼
2020-08-22,5080,15,12,27,鎮安,招呼
2020-08-23,5080,15,10,25,鎮安,招呼
2020-08-24,5080,16,18,34,鎮安,招呼
2020-08-25,5080,17,21,38,鎮安,招呼
2020-08-26,5080,10,6,16,鎮安,招呼
2020-08-27,5080,9,10,19,鎮安,招呼
2020-08-28,5080,13,16,29,鎮安,招呼
2020-08-29,5080,13,18,31,鎮安,招呼
2020-08-30,5080,21,11,32,鎮安,招呼
2020-08-31,5080,20,12,32,鎮安,招呼
2020-09-01,5080,12,14,26,鎮安,招呼
2020-09-02,5080,16,19,35,鎮安,招呼
2020-09-03,5080,18,19,37,鎮安,招呼
2020-09-04,5080,16,27,43,鎮安,招呼
2020-09-05,5080,12,12,24,鎮安,招呼
2020-09-06,5080,16,16,32,鎮安,招呼
2020-09-07,5080,17,19,36,鎮安,招呼
2020-09-08,5080,13,11,24,鎮安,招呼
2020-09-09,5080,12,11,23,鎮安,招呼
2020-09-10,5080,12,10,22,鎮安,招呼
2020-09-11,5080,11,14,25,鎮安,招呼
2020-09-12,5080,12,17,29,鎮安,招呼
2020-09-13,5080,21,11,32,鎮安,招呼
2020-09-14,5080,17,10,27,鎮安,招呼
2020-09-15,5080,16,9,25,鎮安,招呼
2020-09-16,5080,17,16,33,鎮安,招呼
2020-09-17,5080,15,8,23,鎮安,招呼
2020-09-18,5080,16,22,38,鎮安,招呼
2020-09-19,5080,13,21,34,鎮安,招呼
2020-09-20,5080,18,14,32,鎮安,招呼
2020-09-21,5080,16,11,27,鎮安,招呼
2020-09-22,5080,16,11,27,鎮安,招呼
2020-09-23,5080,16,11,27,鎮安,招呼
2020-09-24,5080,19,14,33,鎮安,招呼
2020-09-25,5080,19,16,35,鎮安,招呼
2020-09-26,5080,11,13,24,鎮安,招呼
2020-09-27,5080,9,10,19,鎮安,招呼
2020-09-28,5080,21,18,39,鎮安,招呼
2020-09-29,5080,22,26,48,鎮安,招呼
2020-09-30,5080,19,35,54,鎮安,招呼
2020-10-01,5080,24,51,75,鎮安,招呼
2020-10-02,5080,26,37,63,鎮安,招呼
2020-10-03,5080,23,14,37,鎮安,招呼
2020-10-04,5080,26,10,36,鎮安,招呼
2020-10-05,5080,22,15,37,鎮安,招呼
2020-10-06,5080,20,13,33,鎮安,招呼
2020-10-07,5080,13,15,28,鎮安,招呼
2020-10-08,5080,16,20,36,鎮安,招呼
2020-10-09,5080,14,15,29,鎮安,招呼
2020-10-10,5080,14,12,26,鎮安,招呼
2020-10-11,5080,16,9,25,鎮安,招呼
2020-10-12,5080,19,23,42,鎮安,招呼
2020-10-13,5080,15,13,28,鎮安,招呼
2020-10-14,5080,17,22,39,鎮安,招呼
2020-10-15,5080,14,16,30,鎮安,招呼
2020-10-16,5080,17,18,35,鎮安,招呼
2020-10-17,5080,14,25,39,鎮安,招呼
2020-10-18,5080,14,11,25,鎮安,招呼
2020-10-19,5080,23,20,43,鎮安,招呼
2020-10-20,5080,19,18,37,鎮安,招呼
2020-10-21,5080,16,14,30,鎮安,招呼
2020-10-22,5080,16,20,36,鎮安,招呼
2020-10-23,5080,22,23,45,鎮安,招呼
2020-10-24,5080,17,17,34,鎮安,招呼
2020-10-25,5080,15,7,22,鎮安,招呼
2020-10-26,5080,19,13,32,鎮安,招呼
2020-10-27,5080,16,18,34,鎮安,招呼
2020-10-28,5080,12,15,27,鎮安,招呼
2020-10-29,5080,19,16,35,鎮安,招呼
2020-10-30,5080,25,27,52,鎮安,招呼
2020-10-31,5080,13,24,37,鎮安,招呼
2020-11-01,5080,17,14,31,鎮安,招呼
2020-11-02,5080,22,13,35,鎮安,招呼
2020-11-03,5080,12,18,30,鎮安,招呼
2020-11-04,5080,23,15,38,鎮安,招呼
2020-11-05,5080,14,15,29,鎮安,招呼
2020-11-06,5080,14,15,29,鎮安,招呼
2020-11-07,5080,9,13,22,鎮安,招呼
2020-11-08,5080,18,18,36,鎮安,招呼
2020-11-09,5080,22,19,41,鎮安,招呼
2020-11-10,5080,19,20,39,鎮安,招呼
2020-11-11,5080,18,17,35,鎮安,招呼
2020-11-12,5080,22,18,40,鎮安,招呼
2020-11-13,5080,17,20,37,鎮安,招呼
2020-11-14,5080,17,22,39,鎮安,招呼
2020-11-15,5080,14,8,22,鎮安,招呼
2020-11-16,5080,21,18,39,鎮安,招呼
2020-11-17,5080,17,15,32,鎮安,招呼
2020-11-18,5080,18,15,33,鎮安,招呼
2020-11-19,5080,17,18,35,鎮安,招呼
2020-11-20,5080,21,18,39,鎮安,招呼
2020-11-21,5080,40,16,56,鎮安,招呼
2020-11-22,5080,13,12,25,鎮安,招呼
2020-11-23,5080,21,17,38,鎮安,招呼
2020-11-24,5080,15,22,37,鎮安,招呼
2020-11-25,5080,17,17,34,鎮安,招呼
2020-11-26,5080,18,14,32,鎮安,招呼
2020-11-27,5080,15,26,41,鎮安,招呼
2020-11-28,5080,13,19,32,鎮安,招呼
2020-11-29,5080,16,17,33,鎮安,招呼
2020-11-30,5080,18,17,35,鎮安,招呼
2020-12-01,5080,18,12,30,鎮安,招呼
2020-12-02,5080,17,18,35,鎮安,招呼
2020-12-03,5080,19,15,34,鎮安,招呼
2020-12-04,5080,16,26,42,鎮安,招呼
2020-12-05,5080,13,22,35,鎮安,招呼
2020-12-06,5080,20,15,35,鎮安,招呼
2020-12-07,5080,21,12,33,鎮安,招呼
2020-12-08,5080,20,20,40,鎮安,招呼
2020-12-09,5080,15,12,27,鎮安,招呼
2020-12-10,5080,17,15,32,鎮安,招呼
2020-12-11,5080,14,25,39,鎮安,招呼
2020-12-12,5080,18,27,45,鎮安,招呼
2020-12-13,5080,47,41,88,鎮安,招呼
2020-12-14,5080,21,11,32,鎮安,招呼
2020-12-15,5080,16,16,32,鎮安,招呼
2020-12-16,5080,15,15,30,鎮安,招呼
2020-12-17,5080,18,19,37,鎮安,招呼
2020-12-18,5080,24,23,47,鎮安,招呼
2020-12-19,5080,17,22,39,鎮安,招呼
2020-12-20,5080,25,18,43,鎮安,招呼
2020-12-21,5080,21,13,34,鎮安,招呼
2020-12-22,5080,13,16,29,鎮安,招呼
2020-12-23,5080,14,46,60,鎮安,招呼
2020-12-24,5080,24,18,42,鎮安,招呼
2020-12-25,5080,18,26,44,鎮安,招呼
2020-12-26,5080,4,18,22,鎮安,招呼
2020-12-27,5080,21,13,34,鎮安,招呼
2020-12-28,5080,16,13,29,鎮安,招呼
2020-12-29,5080,18,23,41,鎮安,招呼
2020-12-30,5080,15,19,34,鎮安,招呼
2020-12-31,5080,19,40,59,鎮安,招呼
2020-01-01,5090,400,358,758,林邊,三等
2020-01-02,5090,422,372,794,林邊,三等
2020-01-03,5090,435,485,920,林邊,三等
2020-01-04,5090,366,398,764,林邊,三等
2020-01-05,5090,508,367,875,林邊,三等
2020-01-06,5090,385,354,739,林邊,三等
2020-01-07,5090,326,358,684,林邊,三等
2020-01-08,5090,349,329,678,林邊,三等
2020-01-09,5090,371,397,768,林邊,三等
2020-01-10,5090,413,725,1138,林邊,三等
2020-01-11,5090,480,472,952,林邊,三等
2020-01-12,5090,736,399,1135,林邊,三等
2020-01-13,5090,414,396,810,林邊,三等
2020-01-14,5090,377,354,731,林邊,三等
2020-01-15,5090,388,356,744,林邊,三等
2020-01-16,5090,401,415,816,林邊,三等
2020-01-17,5090,398,467,865,林邊,三等
2020-01-18,5090,396,424,820,林邊,三等
2020-01-19,5090,471,425,896,林邊,三等
2020-01-20,5090,399,360,759,林邊,三等
2020-01-21,5090,376,418,794,林邊,三等
2020-01-22,5090,400,536,936,林邊,三等
2020-01-23,5090,278,585,863,林邊,三等
2020-01-24,5090,279,538,817,林邊,三等
2020-01-25,5090,772,714,1486,林邊,三等
2020-01-26,5090,741,745,1486,林邊,三等
2020-01-27,5090,811,591,1402,林邊,三等
2020-01-28,5090,709,418,1127,林邊,三等
2020-01-29,5090,709,346,1055,林邊,三等
2020-01-30,5090,513,396,909,林邊,三等
2020-01-31,5090,434,403,837,林邊,三等
2020-02-01,5090,328,346,674,林邊,三等
2020-02-02,5090,406,310,716,林邊,三等
2020-02-03,5090,387,300,687,林邊,三等
2020-02-04,5090,351,334,685,林邊,三等
2020-02-05,5090,311,300,611,林邊,三等
2020-02-06,5090,326,277,603,林邊,三等
2020-02-07,5090,506,459,965,林邊,三等
2020-02-08,5090,303,329,632,林邊,三等
2020-02-09,5090,446,350,796,林邊,三等
2020-02-10,5090,350,270,620,林邊,三等
2020-02-11,5090,319,277,596,林邊,三等
2020-02-12,5090,253,268,521,林邊,三等
2020-02-13,5090,312,286,598,林邊,三等
2020-02-14,5090,321,333,654,林邊,三等
2020-02-15,5090,278,283,561,林邊,三等
2020-02-16,5090,335,314,649,林邊,三等
2020-02-17,5090,310,263,573,林邊,三等
2020-02-18,5090,283,260,543,林邊,三等
2020-02-19,5090,293,303,596,林邊,三等
2020-02-20,5090,343,317,660,林邊,三等
2020-02-21,5090,346,369,715,林邊,三等
2020-02-22,5090,300,317,617,林邊,三等
2020-02-23,5090,442,301,743,林邊,三等
2020-02-24,5090,323,239,562,林邊,三等
2020-02-25,5090,308,307,615,林邊,三等
2020-02-26,5090,334,324,658,林邊,三等
2020-02-27,5090,382,508,890,林邊,三等
2020-02-28,5090,351,396,747,林邊,三等
2020-02-29,5090,348,322,670,林邊,三等
2020-03-01,5090,509,226,735,林邊,三等
2020-03-02,5090,369,295,664,林邊,三等
2020-03-03,5090,307,296,603,林邊,三等
2020-03-04,5090,296,293,589,林邊,三等
2020-03-05,5090,291,344,635,林邊,三等
2020-03-06,5090,336,470,806,林邊,三等
2020-03-07,5090,264,277,541,林邊,三等
2020-03-08,5090,482,253,735,林邊,三等
2020-03-09,5090,350,340,690,林邊,三等
2020-03-10,5090,280,293,573,林邊,三等
2020-03-11,5090,325,331,656,林邊,三等
2020-03-12,5090,324,279,603,林邊,三等
2020-03-13,5090,370,502,872,林邊,三等
2020-03-14,5090,298,381,679,林邊,三等
2020-03-15,5090,463,250,713,林邊,三等
2020-03-16,5090,360,306,666,林邊,三等
2020-03-17,5090,289,284,573,林邊,三等
2020-03-18,5090,292,300,592,林邊,三等
2020-03-19,5090,313,301,614,林邊,三等
2020-03-20,5090,323,504,827,林邊,三等
2020-03-21,5090,230,276,506,林邊,三等
2020-03-22,5090,416,216,632,林邊,三等
2020-03-23,5090,299,253,552,林邊,三等
2020-03-24,5090,266,283,549,林邊,三等
2020-03-25,5090,275,293,568,林邊,三等
2020-03-26,5090,266,274,540,林邊,三等
2020-03-27,5090,339,475,814,林邊,三等
2020-03-28,5090,221,268,489,林邊,三等
2020-03-29,5090,322,180,502,林邊,三等
2020-03-30,5090,308,277,585,林邊,三等
2020-03-31,5090,284,304,588,林邊,三等
2020-04-01,5090,328,549,877,林邊,三等
2020-04-02,5090,267,416,683,林邊,三等
2020-04-03,5090,241,331,572,林邊,三等
2020-04-04,5090,310,242,552,林邊,三等
2020-04-05,5090,626,224,850,林邊,三等
2020-04-06,5090,390,294,684,林邊,三等
2020-04-07,5090,274,243,517,林邊,三等
2020-04-08,5090,250,252,502,林邊,三等
2020-04-09,5090,276,289,565,林邊,三等
2020-04-10,5090,309,383,692,林邊,三等
2020-04-11,5090,154,214,368,林邊,三等
2020-04-12,5090,341,197,538,林邊,三等
2020-04-13,5090,303,265,568,林邊,三等
2020-04-14,5090,265,259,524,林邊,三等
2020-04-15,5090,271,281,552,林邊,三等
2020-04-16,5090,295,282,577,林邊,三等
2020-04-17,5090,303,434,737,林邊,三等
2020-04-18,5090,200,252,452,林邊,三等
2020-04-19,5090,361,196,557,林邊,三等
2020-04-20,5090,321,300,621,林邊,三等
2020-04-21,5090,247,246,493,林邊,三等
2020-04-22,5090,268,264,532,林邊,三等
2020-04-23,5090,246,284,530,林邊,三等
2020-04-24,5090,281,397,678,林邊,三等
2020-04-25,5090,186,209,395,林邊,三等
2020-04-26,5090,293,175,468,林邊,三等
2020-04-27,5090,315,266,581,林邊,三等
2020-04-28,5090,279,252,531,林邊,三等
2020-04-29,5090,269,282,551,林邊,三等
2020-04-30,5090,266,313,579,林邊,三等
2020-05-01,5090,306,432,738,林邊,三等
2020-05-02,5090,219,275,494,林邊,三等
2020-05-03,5090,448,225,673,林邊,三等
2020-05-04,5090,325,285,610,林邊,三等
2020-05-05,5090,275,267,542,林邊,三等
2020-05-06,5090,289,313,602,林邊,三等
2020-05-07,5090,275,292,567,林邊,三等
2020-05-08,5090,357,562,919,林邊,三等
2020-05-09,5090,257,357,614,林邊,三等
2020-05-10,5090,504,246,750,林邊,三等
2020-05-11,5090,401,308,709,林邊,三等
2020-05-12,5090,338,327,665,林邊,三等
2020-05-13,5090,281,280,561,林邊,三等
2020-05-14,5090,310,323,633,林邊,三等
2020-05-15,5090,352,476,828,林邊,三等
2020-05-16,5090,227,250,477,林邊,三等
2020-05-17,5090,411,230,641,林邊,三等
2020-05-18,5090,371,356,727,林邊,三等
2020-05-19,5090,301,303,604,林邊,三等
2020-05-20,5090,283,268,551,林邊,三等
2020-05-21,5090,263,285,548,林邊,三等
2020-05-22,5090,282,378,660,林邊,三等
2020-05-23,5090,219,263,482,林邊,三等
2020-05-24,5090,432,289,721,林邊,三等
2020-05-25,5090,377,328,705,林邊,三等
2020-05-26,5090,355,303,658,林邊,三等
2020-05-27,5090,261,282,543,林邊,三等
2020-05-28,5090,296,334,630,林邊,三等
2020-05-29,5090,376,506,882,林邊,三等
2020-05-30,5090,285,312,597,林邊,三等
2020-05-31,5090,519,332,851,林邊,三等
2020-06-01,5090,347,335,682,林邊,三等
2020-06-02,5090,307,302,609,林邊,三等
2020-06-03,5090,320,320,640,林邊,三等
2020-06-04,5090,301,336,637,林邊,三等
2020-06-05,5090,382,521,903,林邊,三等
2020-06-06,5090,342,364,706,林邊,三等
2020-06-07,5090,610,347,957,林邊,三等
2020-06-08,5090,370,310,680,林邊,三等
2020-06-09,5090,353,331,684,林邊,三等
2020-06-10,5090,329,304,633,林邊,三等
2020-06-11,5090,344,351,695,林邊,三等
2020-06-12,5090,416,524,940,林邊,三等
2020-06-13,5090,311,399,710,林邊,三等
2020-06-14,5090,517,384,901,林邊,三等
2020-06-15,5090,378,351,729,林邊,三等
2020-06-16,5090,329,330,659,林邊,三等
2020-06-17,5090,349,322,671,林邊,三等
2020-06-18,5090,340,386,726,林邊,三等
2020-06-19,5090,334,369,703,林邊,三等
2020-06-20,5090,334,370,704,林邊,三等
2020-06-21,5090,392,313,705,林邊,三等
2020-06-22,5090,397,344,741,林邊,三等
2020-06-23,5090,308,347,655,林邊,三等
2020-06-24,5090,438,639,1077,林邊,三等
2020-06-25,5090,385,557,942,林邊,三等
2020-06-26,5090,464,457,921,林邊,三等
2020-06-27,5090,510,372,882,林邊,三等
2020-06-28,5090,701,360,1061,林邊,三等
2020-06-29,5090,451,343,794,林邊,三等
2020-06-30,5090,326,331,657,林邊,三等
2020-07-01,5090,308,321,629,林邊,三等
2020-07-02,5090,356,325,681,林邊,三等
2020-07-03,5090,387,455,842,林邊,三等
2020-07-04,5090,339,349,688,林邊,三等
2020-07-05,5090,379,306,685,林邊,三等
2020-07-06,5090,399,394,793,林邊,三等
2020-07-07,5090,395,394,789,林邊,三等
2020-07-08,5090,405,355,760,林邊,三等
2020-07-09,5090,345,363,708,林邊,三等
2020-07-10,5090,473,485,958,林邊,三等
2020-07-11,5090,349,387,736,林邊,三等
2020-07-12,5090,551,381,932,林邊,三等
2020-07-13,5090,371,360,731,林邊,三等
2020-07-14,5090,359,358,717,林邊,三等
2020-07-15,5090,379,360,739,林邊,三等
2020-07-16,5090,436,383,819,林邊,三等
2020-07-17,5090,490,534,1024,林邊,三等
2020-07-18,5090,452,596,1048,林邊,三等
2020-07-19,5090,505,440,945,林邊,三等
2020-07-20,5090,453,422,875,林邊,三等
2020-07-21,5090,459,375,834,林邊,三等
2020-07-22,5090,404,367,771,林邊,三等
2020-07-23,5090,416,368,784,林邊,三等
2020-07-24,5090,452,538,990,林邊,三等
2020-07-25,5090,431,464,895,林邊,三等
2020-07-26,5090,516,378,894,林邊,三等
2020-07-27,5090,469,428,897,林邊,三等
2020-07-28,5090,375,400,775,林邊,三等
2020-07-29,5090,394,366,760,林邊,三等
2020-07-30,5090,398,334,732,林邊,三等
2020-07-31,5090,463,503,966,林邊,三等
2020-08-01,5090,367,390,757,林邊,三等
2020-08-02,5090,478,365,843,林邊,三等
2020-08-03,5090,393,393,786,林邊,三等
2020-08-04,5090,350,314,664,林邊,三等
2020-08-05,5090,384,370,754,林邊,三等
2020-08-06,5090,487,413,900,林邊,三等
2020-08-07,5090,468,572,1040,林邊,三等
2020-08-08,5090,411,470,881,林邊,三等
2020-08-09,5090,630,466,1096,林邊,三等
2020-08-10,5090,441,383,824,林邊,三等
2020-08-11,5090,359,332,691,林邊,三等
2020-08-12,5090,372,371,743,林邊,三等
2020-08-13,5090,429,433,862,林邊,三等
2020-08-14,5090,508,527,1035,林邊,三等
2020-08-15,5090,418,448,866,林邊,三等
2020-08-16,5090,706,477,1183,林邊,三等
2020-08-17,5090,441,398,839,林邊,三等
2020-08-18,5090,427,383,810,林邊,三等
2020-08-19,5090,408,358,766,林邊,三等
2020-08-20,5090,401,390,791,林邊,三等
2020-08-21,5090,445,484,929,林邊,三等
2020-08-22,5090,425,385,810,林邊,三等
2020-08-23,5090,498,374,872,林邊,三等
2020-08-24,5090,413,371,784,林邊,三等
2020-08-25,5090,402,373,775,林邊,三等
2020-08-26,5090,335,348,683,林邊,三等
2020-08-27,5090,320,308,628,林邊,三等
2020-08-28,5090,410,483,893,林邊,三等
2020-08-29,5090,370,376,746,林邊,三等
2020-08-30,5090,475,368,843,林邊,三等
2020-08-31,5090,393,404,797,林邊,三等
2020-09-01,5090,350,358,708,林邊,三等
2020-09-02,5090,371,339,710,林邊,三等
2020-09-03,5090,394,383,777,林邊,三等
2020-09-04,5090,458,536,994,林邊,三等
2020-09-05,5090,349,376,725,林邊,三等
2020-09-06,5090,529,303,832,林邊,三等
2020-09-07,5090,388,397,785,林邊,三等
2020-09-08,5090,406,360,766,林邊,三等
2020-09-09,5090,351,335,686,林邊,三等
2020-09-10,5090,342,403,745,林邊,三等
2020-09-11,5090,411,534,945,林邊,三等
2020-09-12,5090,385,390,775,林邊,三等
2020-09-13,5090,541,353,894,林邊,三等
2020-09-14,5090,345,391,736,林邊,三等
2020-09-15,5090,336,323,659,林邊,三等
2020-09-16,5090,308,320,628,林邊,三等
2020-09-17,5090,350,344,694,林邊,三等
2020-09-18,5090,427,629,1056,林邊,三等
2020-09-19,5090,404,460,864,林邊,三等
2020-09-20,5090,543,393,936,林邊,三等
2020-09-21,5090,439,390,829,林邊,三等
2020-09-22,5090,382,365,747,林邊,三等
2020-09-23,5090,398,449,847,林邊,三等
2020-09-24,5090,363,347,710,林邊,三等
2020-09-25,5090,381,473,854,林邊,三等
2020-09-26,5090,336,408,744,林邊,三等
2020-09-27,5090,462,356,818,林邊,三等
2020-09-28,5090,363,360,723,林邊,三等
2020-09-29,5090,354,369,723,林邊,三等
2020-09-30,5090,398,706,1104,林邊,三等
2020-10-01,5090,440,739,1179,林邊,三等
2020-10-02,5090,588,530,1118,林邊,三等
2020-10-03,5090,649,467,1116,林邊,三等
2020-10-04,5090,831,304,1135,林邊,三等
2020-10-05,5090,493,389,882,林邊,三等
2020-10-06,5090,369,372,741,林邊,三等
2020-10-07,5090,382,423,805,林邊,三等
2020-10-08,5090,446,615,1061,林邊,三等
2020-10-09,5090,458,501,959,林邊,三等
2020-10-10,5090,395,369,764,林邊,三等
2020-10-11,5090,646,373,1019,林邊,三等
2020-10-12,5090,391,354,745,林邊,三等
2020-10-13,5090,361,362,723,林邊,三等
2020-10-14,5090,368,389,757,林邊,三等
2020-10-15,5090,389,422,811,林邊,三等
2020-10-16,5090,401,577,978,林邊,三等
2020-10-17,5090,452,447,899,林邊,三等
2020-10-18,5090,535,375,910,林邊,三等
2020-10-19,5090,391,396,787,林邊,三等
2020-10-20,5090,369,379,748,林邊,三等
2020-10-21,5090,403,357,760,林邊,三等
2020-10-22,5090,375,425,800,林邊,三等
2020-10-23,5090,434,582,1016,林邊,三等
2020-10-24,5090,379,417,796,林邊,三等
2020-10-25,5090,559,347,906,林邊,三等
2020-10-26,5090,423,389,812,林邊,三等
2020-10-27,5090,387,358,745,林邊,三等
2020-10-28,5090,350,352,702,林邊,三等
2020-10-29,5090,354,379,733,林邊,三等
2020-10-30,5090,455,611,1066,林邊,三等
2020-10-31,5090,466,423,889,林邊,三等
2020-11-01,5090,511,352,863,林邊,三等
2020-11-02,5090,424,373,797,林邊,三等
2020-11-03,5090,344,349,693,林邊,三等
2020-11-04,5090,329,342,671,林邊,三等
2020-11-05,5090,370,383,753,林邊,三等
2020-11-06,5090,410,531,941,林邊,三等
2020-11-07,5090,335,346,681,林邊,三等
2020-11-08,5090,566,385,951,林邊,三等
2020-11-09,5090,372,347,719,林邊,三等
2020-11-10,5090,338,360,698,林邊,三等
2020-11-11,5090,358,324,682,林邊,三等
2020-11-12,5090,369,394,763,林邊,三等
2020-11-13,5090,463,584,1047,林邊,三等
2020-11-14,5090,480,516,996,林邊,三等
2020-11-15,5090,645,444,1089,林邊,三等
2020-11-16,5090,393,334,727,林邊,三等
2020-11-17,5090,359,360,719,林邊,三等
2020-11-18,5090,359,364,723,林邊,三等
2020-11-19,5090,369,385,754,林邊,三等
2020-11-20,5090,466,597,1063,林邊,三等
2020-11-21,5090,407,443,850,林邊,三等
2020-11-22,5090,586,366,952,林邊,三等
2020-11-23,5090,393,373,766,林邊,三等
2020-11-24,5090,374,350,724,林邊,三等
2020-11-25,5090,380,371,751,林邊,三等
2020-11-26,5090,389,367,756,林邊,三等
2020-11-27,5090,475,619,1094,林邊,三等
2020-11-28,5090,435,488,923,林邊,三等
2020-11-29,5090,642,477,1119,林邊,三等
2020-11-30,5090,419,392,811,林邊,三等
2020-12-01,5090,397,366,763,林邊,三等
2020-12-02,5090,325,340,665,林邊,三等
2020-12-03,5090,376,367,743,林邊,三等
2020-12-04,5090,414,551,965,林邊,三等
2020-12-05,5090,430,484,914,林邊,三等
2020-12-06,5090,596,410,1006,林邊,三等
2020-12-07,5090,395,365,760,林邊,三等
2020-12-08,5090,378,365,743,林邊,三等
2020-12-09,5090,351,330,681,林邊,三等
2020-12-10,5090,327,386,713,林邊,三等
2020-12-11,5090,445,647,1092,林邊,三等
2020-12-12,5090,471,477,948,林邊,三等
2020-12-13,5090,664,489,1153,林邊,三等
2020-12-14,5090,436,399,835,林邊,三等
2020-12-15,5090,357,346,703,林邊,三等
2020-12-16,5090,378,357,735,林邊,三等
2020-12-17,5090,402,396,798,林邊,三等
2020-12-18,5090,415,581,996,林邊,三等
2020-12-19,5090,413,444,857,林邊,三等
2020-12-20,5090,564,366,930,林邊,三等
2020-12-21,5090,403,393,796,林邊,三等
2020-12-22,5090,392,376,768,林邊,三等
2020-12-23,5090,369,349,718,林邊,三等
2020-12-24,5090,446,468,914,林邊,三等
2020-12-25,5090,424,591,1015,林邊,三等
2020-12-26,5090,469,485,954,林邊,三等
2020-12-27,5090,570,462,1032,林邊,三等
2020-12-28,5090,434,395,829,林邊,三等
2020-12-29,5090,367,434,801,林邊,三等
2020-12-30,5090,351,392,743,林邊,三等
2020-12-31,5090,428,591,1019,林邊,三等
2020-01-01,5100,138,108,246,佳冬,甲簡
2020-01-02,5100,121,118,239,佳冬,甲簡
2020-01-03,5100,121,127,248,佳冬,甲簡
2020-01-04,5100,96,132,228,佳冬,甲簡
2020-01-05,5100,109,88,197,佳冬,甲簡
2020-01-06,5100,127,119,246,佳冬,甲簡
2020-01-07,5100,108,110,218,佳冬,甲簡
2020-01-08,5100,114,94,208,佳冬,甲簡
2020-01-09,5100,117,128,245,佳冬,甲簡
2020-01-10,5100,123,178,301,佳冬,甲簡
2020-01-11,5100,114,131,245,佳冬,甲簡
2020-01-12,5100,123,71,194,佳冬,甲簡
2020-01-13,5100,130,114,244,佳冬,甲簡
2020-01-14,5100,126,111,237,佳冬,甲簡
2020-01-15,5100,115,122,237,佳冬,甲簡
2020-01-16,5100,113,126,239,佳冬,甲簡
2020-01-17,5100,97,104,201,佳冬,甲簡
2020-01-18,5100,89,101,190,佳冬,甲簡
2020-01-19,5100,102,81,183,佳冬,甲簡
2020-01-20,5100,109,109,218,佳冬,甲簡
2020-01-21,5100,115,116,231,佳冬,甲簡
2020-01-22,5100,99,165,264,佳冬,甲簡
2020-01-23,5100,99,173,272,佳冬,甲簡
2020-01-24,5100,78,129,207,佳冬,甲簡
2020-01-25,5100,171,154,325,佳冬,甲簡
2020-01-26,5100,134,162,296,佳冬,甲簡
2020-01-27,5100,227,192,419,佳冬,甲簡
2020-01-28,5100,168,112,280,佳冬,甲簡
2020-01-29,5100,129,74,203,佳冬,甲簡
2020-01-30,5100,147,100,247,佳冬,甲簡
2020-01-31,5100,100,88,188,佳冬,甲簡
2020-02-01,5100,93,90,183,佳冬,甲簡
2020-02-02,5100,89,60,149,佳冬,甲簡
2020-02-03,5100,95,101,196,佳冬,甲簡
2020-02-04,5100,112,114,226,佳冬,甲簡
2020-02-05,5100,103,93,196,佳冬,甲簡
2020-02-06,5100,80,81,161,佳冬,甲簡
2020-02-07,5100,82,93,175,佳冬,甲簡
2020-02-08,5100,95,79,174,佳冬,甲簡
2020-02-09,5100,106,87,193,佳冬,甲簡
2020-02-10,5100,78,73,151,佳冬,甲簡
2020-02-11,5100,71,85,156,佳冬,甲簡
2020-02-12,5100,75,68,143,佳冬,甲簡
2020-02-13,5100,75,71,146,佳冬,甲簡
2020-02-14,5100,86,96,182,佳冬,甲簡
2020-02-15,5100,57,70,127,佳冬,甲簡
2020-02-16,5100,91,65,156,佳冬,甲簡
2020-02-17,5100,104,89,193,佳冬,甲簡
2020-02-18,5100,87,81,168,佳冬,甲簡
2020-02-19,5100,88,78,166,佳冬,甲簡
2020-02-20,5100,105,107,212,佳冬,甲簡
2020-02-21,5100,91,108,199,佳冬,甲簡
2020-02-22,5100,76,67,143,佳冬,甲簡
2020-02-23,5100,86,72,158,佳冬,甲簡
2020-02-24,5100,71,62,133,佳冬,甲簡
2020-02-25,5100,124,116,240,佳冬,甲簡
2020-02-26,5100,105,108,213,佳冬,甲簡
2020-02-27,5100,119,163,282,佳冬,甲簡
2020-02-28,5100,97,137,234,佳冬,甲簡
2020-02-29,5100,73,104,177,佳冬,甲簡
2020-03-01,5100,147,53,200,佳冬,甲簡
2020-03-02,5100,142,123,265,佳冬,甲簡
2020-03-03,5100,120,129,249,佳冬,甲簡
2020-03-04,5100,116,115,231,佳冬,甲簡
2020-03-05,5100,111,107,218,佳冬,甲簡
2020-03-06,5100,112,143,255,佳冬,甲簡
2020-03-07,5100,70,116,186,佳冬,甲簡
2020-03-08,5100,116,69,185,佳冬,甲簡
2020-03-09,5100,136,106,242,佳冬,甲簡
2020-03-10,5100,114,117,231,佳冬,甲簡
2020-03-11,5100,125,108,233,佳冬,甲簡
2020-03-12,5100,119,112,231,佳冬,甲簡
2020-03-13,5100,120,175,295,佳冬,甲簡
2020-03-14,5100,76,100,176,佳冬,甲簡
2020-03-15,5100,119,51,170,佳冬,甲簡
2020-03-16,5100,124,116,240,佳冬,甲簡
2020-03-17,5100,116,89,205,佳冬,甲簡
2020-03-18,5100,110,110,220,佳冬,甲簡
2020-03-19,5100,108,98,206,佳冬,甲簡
2020-03-20,5100,110,140,250,佳冬,甲簡
2020-03-21,5100,61,95,156,佳冬,甲簡
2020-03-22,5100,88,57,145,佳冬,甲簡
2020-03-23,5100,116,112,228,佳冬,甲簡
2020-03-24,5100,124,102,226,佳冬,甲簡
2020-03-25,5100,103,99,202,佳冬,甲簡
2020-03-26,5100,107,107,214,佳冬,甲簡
2020-03-27,5100,124,130,254,佳冬,甲簡
2020-03-28,5100,57,73,130,佳冬,甲簡
2020-03-29,5100,83,43,126,佳冬,甲簡
2020-03-30,5100,120,108,228,佳冬,甲簡
2020-03-31,5100,89,94,183,佳冬,甲簡
2020-04-01,5100,123,139,262,佳冬,甲簡
2020-04-02,5100,59,96,155,佳冬,甲簡
2020-04-03,5100,77,79,156,佳冬,甲簡
2020-04-04,5100,43,46,89,佳冬,甲簡
2020-04-05,5100,115,32,147,佳冬,甲簡
2020-04-06,5100,136,110,246,佳冬,甲簡
2020-04-07,5100,100,89,189,佳冬,甲簡
2020-04-08,5100,115,102,217,佳冬,甲簡
2020-04-09,5100,109,94,203,佳冬,甲簡
2020-04-10,5100,100,107,207,佳冬,甲簡
2020-04-11,5100,57,64,121,佳冬,甲簡
2020-04-12,5100,74,38,112,佳冬,甲簡
2020-04-13,5100,117,104,221,佳冬,甲簡
2020-04-14,5100,107,91,198,佳冬,甲簡
2020-04-15,5100,118,93,211,佳冬,甲簡
2020-04-16,5100,115,110,225,佳冬,甲簡
2020-04-17,5100,121,118,239,佳冬,甲簡
2020-04-18,5100,74,87,161,佳冬,甲簡
2020-04-19,5100,102,49,151,佳冬,甲簡
2020-04-20,5100,113,103,216,佳冬,甲簡
2020-04-21,5100,119,102,221,佳冬,甲簡
2020-04-22,5100,102,86,188,佳冬,甲簡
2020-04-23,5100,106,92,198,佳冬,甲簡
2020-04-24,5100,106,121,227,佳冬,甲簡
2020-04-25,5100,48,56,104,佳冬,甲簡
2020-04-26,5100,69,30,99,佳冬,甲簡
2020-04-27,5100,118,106,224,佳冬,甲簡
2020-04-28,5100,100,93,193,佳冬,甲簡
2020-04-29,5100,110,82,192,佳冬,甲簡
2020-04-30,5100,95,87,182,佳冬,甲簡
2020-05-01,5100,94,134,228,佳冬,甲簡
2020-05-02,5100,58,73,131,佳冬,甲簡
2020-05-03,5100,91,43,134,佳冬,甲簡
2020-05-04,5100,139,101,240,佳冬,甲簡
2020-05-05,5100,119,95,214,佳冬,甲簡
2020-05-06,5100,93,83,176,佳冬,甲簡
2020-05-07,5100,102,88,190,佳冬,甲簡
2020-05-08,5100,109,134,243,佳冬,甲簡
2020-05-09,5100,69,104,173,佳冬,甲簡
2020-05-10,5100,131,52,183,佳冬,甲簡
2020-05-11,5100,141,110,251,佳冬,甲簡
2020-05-12,5100,107,98,205,佳冬,甲簡
2020-05-13,5100,122,103,225,佳冬,甲簡
2020-05-14,5100,120,98,218,佳冬,甲簡
2020-05-15,5100,130,148,278,佳冬,甲簡
2020-05-16,5100,63,68,131,佳冬,甲簡
2020-05-17,5100,91,44,135,佳冬,甲簡
2020-05-18,5100,114,109,223,佳冬,甲簡
2020-05-19,5100,117,103,220,佳冬,甲簡
2020-05-20,5100,123,102,225,佳冬,甲簡
2020-05-21,5100,104,99,203,佳冬,甲簡
2020-05-22,5100,96,127,223,佳冬,甲簡
2020-05-23,5100,46,66,112,佳冬,甲簡
2020-05-24,5100,84,67,151,佳冬,甲簡
2020-05-25,5100,140,120,260,佳冬,甲簡
2020-05-26,5100,105,105,210,佳冬,甲簡
2020-05-27,5100,104,95,199,佳冬,甲簡
2020-05-28,5100,98,109,207,佳冬,甲簡
2020-05-29,5100,116,136,252,佳冬,甲簡
2020-05-30,5100,101,114,215,佳冬,甲簡
2020-05-31,5100,103,66,169,佳冬,甲簡
2020-06-01,5100,137,104,241,佳冬,甲簡
2020-06-02,5100,118,109,227,佳冬,甲簡
2020-06-03,5100,103,91,194,佳冬,甲簡
2020-06-04,5100,105,99,204,佳冬,甲簡
2020-06-05,5100,115,123,238,佳冬,甲簡
2020-06-06,5100,82,91,173,佳冬,甲簡
2020-06-07,5100,122,82,204,佳冬,甲簡
2020-06-08,5100,128,132,260,佳冬,甲簡
2020-06-09,5100,160,145,305,佳冬,甲簡
2020-06-10,5100,115,111,226,佳冬,甲簡
2020-06-11,5100,124,116,240,佳冬,甲簡
2020-06-12,5100,120,127,247,佳冬,甲簡
2020-06-13,5100,158,156,314,佳冬,甲簡
2020-06-14,5100,124,87,211,佳冬,甲簡
2020-06-15,5100,131,120,251,佳冬,甲簡
2020-06-16,5100,113,109,222,佳冬,甲簡
2020-06-17,5100,96,94,190,佳冬,甲簡
2020-06-18,5100,117,90,207,佳冬,甲簡
2020-06-19,5100,140,133,273,佳冬,甲簡
2020-06-20,5100,95,113,208,佳冬,甲簡
2020-06-21,5100,74,57,131,佳冬,甲簡
2020-06-22,5100,118,103,221,佳冬,甲簡
2020-06-23,5100,118,121,239,佳冬,甲簡
2020-06-24,5100,120,162,282,佳冬,甲簡
2020-06-25,5100,117,164,281,佳冬,甲簡
2020-06-26,5100,120,122,242,佳冬,甲簡
2020-06-27,5100,110,85,195,佳冬,甲簡
2020-06-28,5100,166,76,242,佳冬,甲簡
2020-06-29,5100,132,101,233,佳冬,甲簡
2020-06-30,5100,113,103,216,佳冬,甲簡
2020-07-01,5100,113,84,197,佳冬,甲簡
2020-07-02,5100,102,98,200,佳冬,甲簡
2020-07-03,5100,103,112,215,佳冬,甲簡
2020-07-04,5100,81,104,185,佳冬,甲簡
2020-07-05,5100,123,97,220,佳冬,甲簡
2020-07-06,5100,109,101,210,佳冬,甲簡
2020-07-07,5100,103,89,192,佳冬,甲簡
2020-07-08,5100,106,109,215,佳冬,甲簡
2020-07-09,5100,118,104,222,佳冬,甲簡
2020-07-10,5100,133,143,276,佳冬,甲簡
2020-07-11,5100,95,100,195,佳冬,甲簡
2020-07-12,5100,102,83,185,佳冬,甲簡
2020-07-13,5100,132,113,245,佳冬,甲簡
2020-07-14,5100,130,106,236,佳冬,甲簡
2020-07-15,5100,95,87,182,佳冬,甲簡
2020-07-16,5100,133,108,241,佳冬,甲簡
2020-07-17,5100,144,144,288,佳冬,甲簡
2020-07-18,5100,105,116,221,佳冬,甲簡
2020-07-19,5100,115,90,205,佳冬,甲簡
2020-07-20,5100,139,127,266,佳冬,甲簡
2020-07-21,5100,120,113,233,佳冬,甲簡
2020-07-22,5100,114,98,212,佳冬,甲簡
2020-07-23,5100,143,121,264,佳冬,甲簡
2020-07-24,5100,150,121,271,佳冬,甲簡
2020-07-25,5100,96,99,195,佳冬,甲簡
2020-07-26,5100,136,110,246,佳冬,甲簡
2020-07-27,5100,126,130,256,佳冬,甲簡
2020-07-28,5100,126,116,242,佳冬,甲簡
2020-07-29,5100,111,118,229,佳冬,甲簡
2020-07-30,5100,128,103,231,佳冬,甲簡
2020-07-31,5100,123,123,246,佳冬,甲簡
2020-08-01,5100,98,111,209,佳冬,甲簡
2020-08-02,5100,96,62,158,佳冬,甲簡
2020-08-03,5100,145,123,268,佳冬,甲簡
2020-08-04,5100,104,88,192,佳冬,甲簡
2020-08-05,5100,136,135,271,佳冬,甲簡
2020-08-06,5100,132,125,257,佳冬,甲簡
2020-08-07,5100,154,167,321,佳冬,甲簡
2020-08-08,5100,89,113,202,佳冬,甲簡
2020-08-09,5100,171,98,269,佳冬,甲簡
2020-08-10,5100,153,122,275,佳冬,甲簡
2020-08-11,5100,97,74,171,佳冬,甲簡
2020-08-12,5100,127,120,247,佳冬,甲簡
2020-08-13,5100,116,104,220,佳冬,甲簡
2020-08-14,5100,127,134,261,佳冬,甲簡
2020-08-15,5100,96,101,197,佳冬,甲簡
2020-08-16,5100,156,111,267,佳冬,甲簡
2020-08-17,5100,128,111,239,佳冬,甲簡
2020-08-18,5100,121,105,226,佳冬,甲簡
2020-08-19,5100,134,103,237,佳冬,甲簡
2020-08-20,5100,101,102,203,佳冬,甲簡
2020-08-21,5100,131,120,251,佳冬,甲簡
2020-08-22,5100,93,110,203,佳冬,甲簡
2020-08-23,5100,118,76,194,佳冬,甲簡
2020-08-24,5100,114,116,230,佳冬,甲簡
2020-08-25,5100,121,111,232,佳冬,甲簡
2020-08-26,5100,81,86,167,佳冬,甲簡
2020-08-27,5100,89,90,179,佳冬,甲簡
2020-08-28,5100,139,138,277,佳冬,甲簡
2020-08-29,5100,81,94,175,佳冬,甲簡
2020-08-30,5100,107,84,191,佳冬,甲簡
2020-08-31,5100,121,115,236,佳冬,甲簡
2020-09-01,5100,128,113,241,佳冬,甲簡
2020-09-02,5100,139,105,244,佳冬,甲簡
2020-09-03,5100,143,111,254,佳冬,甲簡
2020-09-04,5100,126,147,273,佳冬,甲簡
2020-09-05,5100,101,99,200,佳冬,甲簡
2020-09-06,5100,146,68,214,佳冬,甲簡
2020-09-07,5100,147,119,266,佳冬,甲簡
2020-09-08,5100,153,128,281,佳冬,甲簡
2020-09-09,5100,125,119,244,佳冬,甲簡
2020-09-10,5100,139,116,255,佳冬,甲簡
2020-09-11,5100,129,144,273,佳冬,甲簡
2020-09-12,5100,96,95,191,佳冬,甲簡
2020-09-13,5100,166,89,255,佳冬,甲簡
2020-09-14,5100,136,124,260,佳冬,甲簡
2020-09-15,5100,132,109,241,佳冬,甲簡
2020-09-16,5100,108,93,201,佳冬,甲簡
2020-09-17,5100,106,102,208,佳冬,甲簡
2020-09-18,5100,144,146,290,佳冬,甲簡
2020-09-19,5100,97,116,213,佳冬,甲簡
2020-09-20,5100,125,96,221,佳冬,甲簡
2020-09-21,5100,137,114,251,佳冬,甲簡
2020-09-22,5100,129,108,237,佳冬,甲簡
2020-09-23,5100,139,117,256,佳冬,甲簡
2020-09-24,5100,124,101,225,佳冬,甲簡
2020-09-25,5100,200,190,390,佳冬,甲簡
2020-09-26,5100,124,140,264,佳冬,甲簡
2020-09-27,5100,104,69,173,佳冬,甲簡
2020-09-28,5100,123,104,227,佳冬,甲簡
2020-09-29,5100,121,110,231,佳冬,甲簡
2020-09-30,5100,135,205,340,佳冬,甲簡
2020-10-01,5100,139,201,340,佳冬,甲簡
2020-10-02,5100,144,148,292,佳冬,甲簡
2020-10-03,5100,146,124,270,佳冬,甲簡
2020-10-04,5100,213,81,294,佳冬,甲簡
2020-10-05,5100,189,147,336,佳冬,甲簡
2020-10-06,5100,133,119,252,佳冬,甲簡
2020-10-07,5100,144,119,263,佳冬,甲簡
2020-10-08,5100,136,161,297,佳冬,甲簡
2020-10-09,5100,136,155,291,佳冬,甲簡
2020-10-10,5100,71,68,139,佳冬,甲簡
2020-10-11,5100,172,73,245,佳冬,甲簡
2020-10-12,5100,135,99,234,佳冬,甲簡
2020-10-13,5100,119,107,226,佳冬,甲簡
2020-10-14,5100,135,111,246,佳冬,甲簡
2020-10-15,5100,126,114,240,佳冬,甲簡
2020-10-16,5100,143,178,321,佳冬,甲簡
2020-10-17,5100,103,129,232,佳冬,甲簡
2020-10-18,5100,182,132,314,佳冬,甲簡
2020-10-19,5100,158,118,276,佳冬,甲簡
2020-10-20,5100,116,110,226,佳冬,甲簡
2020-10-21,5100,129,113,242,佳冬,甲簡
2020-10-22,5100,123,112,235,佳冬,甲簡
2020-10-23,5100,147,157,304,佳冬,甲簡
2020-10-24,5100,138,147,285,佳冬,甲簡
2020-10-25,5100,141,107,248,佳冬,甲簡
2020-10-26,5100,162,146,308,佳冬,甲簡
2020-10-27,5100,124,111,235,佳冬,甲簡
2020-10-28,5100,135,110,245,佳冬,甲簡
2020-10-29,5100,128,112,240,佳冬,甲簡
2020-10-30,5100,143,170,313,佳冬,甲簡
2020-10-31,5100,119,148,267,佳冬,甲簡
2020-11-01,5100,135,101,236,佳冬,甲簡
2020-11-02,5100,138,120,258,佳冬,甲簡
2020-11-03,5100,125,106,231,佳冬,甲簡
2020-11-04,5100,118,115,233,佳冬,甲簡
2020-11-05,5100,116,111,227,佳冬,甲簡
2020-11-06,5100,123,130,253,佳冬,甲簡
2020-11-07,5100,103,114,217,佳冬,甲簡
2020-11-08,5100,134,95,229,佳冬,甲簡
2020-11-09,5100,141,134,275,佳冬,甲簡
2020-11-10,5100,128,111,239,佳冬,甲簡
2020-11-11,5100,144,108,252,佳冬,甲簡
2020-11-12,5100,121,123,244,佳冬,甲簡
2020-11-13,5100,142,158,300,佳冬,甲簡
2020-11-14,5100,117,149,266,佳冬,甲簡
2020-11-15,5100,154,99,253,佳冬,甲簡
2020-11-16,5100,143,118,261,佳冬,甲簡
2020-11-17,5100,120,117,237,佳冬,甲簡
2020-11-18,5100,122,102,224,佳冬,甲簡
2020-11-19,5100,122,119,241,佳冬,甲簡
2020-11-20,5100,123,157,280,佳冬,甲簡
2020-11-21,5100,108,138,246,佳冬,甲簡
2020-11-22,5100,150,102,252,佳冬,甲簡
2020-11-23,5100,144,113,257,佳冬,甲簡
2020-11-24,5100,130,105,235,佳冬,甲簡
2020-11-25,5100,143,113,256,佳冬,甲簡
2020-11-26,5100,112,110,222,佳冬,甲簡
2020-11-27,5100,128,154,282,佳冬,甲簡
2020-11-28,5100,110,138,248,佳冬,甲簡
2020-11-29,5100,147,92,239,佳冬,甲簡
2020-11-30,5100,125,116,241,佳冬,甲簡
2020-12-01,5100,123,109,232,佳冬,甲簡
2020-12-02,5100,127,102,229,佳冬,甲簡
2020-12-03,5100,122,128,250,佳冬,甲簡
2020-12-04,5100,132,165,297,佳冬,甲簡
2020-12-05,5100,123,139,262,佳冬,甲簡
2020-12-06,5100,180,99,279,佳冬,甲簡
2020-12-07,5100,145,116,261,佳冬,甲簡
2020-12-08,5100,134,122,256,佳冬,甲簡
2020-12-09,5100,125,134,259,佳冬,甲簡
2020-12-10,5100,118,109,227,佳冬,甲簡
2020-12-11,5100,129,170,299,佳冬,甲簡
2020-12-12,5100,149,139,288,佳冬,甲簡
2020-12-13,5100,161,77,238,佳冬,甲簡
2020-12-14,5100,130,119,249,佳冬,甲簡
2020-12-15,5100,111,110,221,佳冬,甲簡
2020-12-16,5100,124,100,224,佳冬,甲簡
2020-12-17,5100,126,120,246,佳冬,甲簡
2020-12-18,5100,147,186,333,佳冬,甲簡
2020-12-19,5100,116,159,275,佳冬,甲簡
2020-12-20,5100,145,92,237,佳冬,甲簡
2020-12-21,5100,155,133,288,佳冬,甲簡
2020-12-22,5100,118,124,242,佳冬,甲簡
2020-12-23,5100,121,107,228,佳冬,甲簡
2020-12-24,5100,135,139,274,佳冬,甲簡
2020-12-25,5100,136,170,306,佳冬,甲簡
2020-12-26,5100,113,107,220,佳冬,甲簡
2020-12-27,5100,123,76,199,佳冬,甲簡
2020-12-28,5100,138,115,253,佳冬,甲簡
2020-12-29,5100,128,113,241,佳冬,甲簡
2020-12-30,5100,112,125,237,佳冬,甲簡
2020-12-31,5100,142,174,316,佳冬,甲簡
2020-01-01,5110,60,145,205,東海,招呼
2020-01-02,5110,45,42,87,東海,招呼
2020-01-03,5110,60,65,125,東海,招呼
2020-01-04,5110,50,53,103,東海,招呼
2020-01-05,5110,55,49,104,東海,招呼
2020-01-06,5110,54,56,110,東海,招呼
2020-01-07,5110,56,55,111,東海,招呼
2020-01-08,5110,63,69,132,東海,招呼
2020-01-09,5110,54,50,104,東海,招呼
2020-01-10,5110,60,90,150,東海,招呼
2020-01-11,5110,47,58,105,東海,招呼
2020-01-12,5110,81,75,156,東海,招呼
2020-01-13,5110,56,53,109,東海,招呼
2020-01-14,5110,52,59,111,東海,招呼
2020-01-15,5110,38,54,92,東海,招呼
2020-01-16,5110,67,62,129,東海,招呼
2020-01-17,5110,60,47,107,東海,招呼
2020-01-18,5110,39,60,99,東海,招呼
2020-01-19,5110,44,56,100,東海,招呼
2020-01-20,5110,63,91,154,東海,招呼
2020-01-21,5110,33,38,71,東海,招呼
2020-01-22,5110,41,71,112,東海,招呼
2020-01-23,5110,43,116,159,東海,招呼
2020-01-24,5110,42,60,102,東海,招呼
2020-01-25,5110,101,124,225,東海,招呼
2020-01-26,5110,107,155,262,東海,招呼
2020-01-27,5110,108,101,209,東海,招呼
2020-01-28,5110,65,82,147,東海,招呼
2020-01-29,5110,64,64,128,東海,招呼
2020-01-30,5110,45,39,84,東海,招呼
2020-01-31,5110,56,58,114,東海,招呼
2020-02-01,5110,45,38,83,東海,招呼
2020-02-02,5110,39,38,77,東海,招呼
2020-02-03,5110,36,50,86,東海,招呼
2020-02-04,5110,33,25,58,東海,招呼
2020-02-05,5110,37,46,83,東海,招呼
2020-02-06,5110,32,39,71,東海,招呼
2020-02-07,5110,38,47,85,東海,招呼
2020-02-08,5110,39,27,66,東海,招呼
2020-02-09,5110,33,43,76,東海,招呼
2020-02-10,5110,32,38,70,東海,招呼
2020-02-11,5110,29,27,56,東海,招呼
2020-02-12,5110,23,27,50,東海,招呼
2020-02-13,5110,30,34,64,東海,招呼
2020-02-14,5110,32,40,72,東海,招呼
2020-02-15,5110,23,23,46,東海,招呼
2020-02-16,5110,41,85,126,東海,招呼
2020-02-17,5110,35,29,64,東海,招呼
2020-02-18,5110,33,28,61,東海,招呼
2020-02-19,5110,29,30,59,東海,招呼
2020-02-20,5110,43,39,82,東海,招呼
2020-02-21,5110,39,46,85,東海,招呼
2020-02-22,5110,30,345,375,東海,招呼
2020-02-23,5110,44,55,99,東海,招呼
2020-02-24,5110,45,307,352,東海,招呼
2020-02-25,5110,71,358,429,東海,招呼
2020-02-26,5110,63,49,112,東海,招呼
2020-02-27,5110,68,80,148,東海,招呼
2020-02-28,5110,48,44,92,東海,招呼
2020-02-29,5110,33,108,141,東海,招呼
2020-03-01,5110,71,49,120,東海,招呼
2020-03-02,5110,61,49,110,東海,招呼
2020-03-03,5110,57,52,109,東海,招呼
2020-03-04,5110,55,44,99,東海,招呼
2020-03-05,5110,55,52,107,東海,招呼
2020-03-06,5110,64,68,132,東海,招呼
2020-03-07,5110,46,43,89,東海,招呼
2020-03-08,5110,58,51,109,東海,招呼
2020-03-09,5110,55,57,112,東海,招呼
2020-03-10,5110,56,42,98,東海,招呼
2020-03-11,5110,62,49,111,東海,招呼
2020-03-12,5110,55,58,113,東海,招呼
2020-03-13,5110,77,69,146,東海,招呼
2020-03-14,5110,32,50,82,東海,招呼
2020-03-15,5110,58,56,114,東海,招呼
2020-03-16,5110,59,53,112,東海,招呼
2020-03-17,5110,49,45,94,東海,招呼
2020-03-18,5110,47,79,126,東海,招呼
2020-03-19,5110,49,63,112,東海,招呼
2020-03-20,5110,64,79,143,東海,招呼
2020-03-21,5110,41,45,86,東海,招呼
2020-03-22,5110,47,65,112,東海,招呼
2020-03-23,5110,58,57,115,東海,招呼
2020-03-24,5110,61,56,117,東海,招呼
2020-03-25,5110,44,44,88,東海,招呼
2020-03-26,5110,55,50,105,東海,招呼
2020-03-27,5110,57,69,126,東海,招呼
2020-03-28,5110,33,35,68,東海,招呼
2020-03-29,5110,43,44,87,東海,招呼
2020-03-30,5110,56,45,101,東海,招呼
2020-03-31,5110,55,52,107,東海,招呼
2020-04-01,5110,48,67,115,東海,招呼
2020-04-02,5110,46,54,100,東海,招呼
2020-04-03,5110,37,68,105,東海,招呼
2020-04-04,5110,42,30,72,東海,招呼
2020-04-05,5110,53,51,104,東海,招呼
2020-04-06,5110,61,61,122,東海,招呼
2020-04-07,5110,49,46,95,東海,招呼
2020-04-08,5110,65,50,115,東海,招呼
2020-04-09,5110,55,48,103,東海,招呼
2020-04-10,5110,63,53,116,東海,招呼
2020-04-11,5110,30,44,74,東海,招呼
2020-04-12,5110,33,33,66,東海,招呼
2020-04-13,5110,61,60,121,東海,招呼
2020-04-14,5110,65,60,125,東海,招呼
2020-04-15,5110,53,63,116,東海,招呼
2020-04-16,5110,50,57,107,東海,招呼
2020-04-17,5110,75,68,143,東海,招呼
2020-04-18,5110,33,47,80,東海,招呼
2020-04-19,5110,28,73,101,東海,招呼
2020-04-20,5110,63,44,107,東海,招呼
2020-04-21,5110,52,50,102,東海,招呼
2020-04-22,5110,52,42,94,東海,招呼
2020-04-23,5110,55,52,107,東海,招呼
2020-04-24,5110,57,59,116,東海,招呼
2020-04-25,5110,36,48,84,東海,招呼
2020-04-26,5110,32,29,61,東海,招呼
2020-04-27,5110,51,46,97,東海,招呼
2020-04-28,5110,44,52,96,東海,招呼
2020-04-29,5110,41,33,74,東海,招呼
2020-04-30,5110,53,50,103,東海,招呼
2020-05-01,5110,60,61,121,東海,招呼
2020-05-02,5110,38,81,119,東海,招呼
2020-05-03,5110,54,43,97,東海,招呼
2020-05-04,5110,58,43,101,東海,招呼
2020-05-05,5110,53,45,98,東海,招呼
2020-05-06,5110,59,55,114,東海,招呼
2020-05-07,5110,59,55,114,東海,招呼
2020-05-08,5110,63,64,127,東海,招呼
2020-05-09,5110,43,74,117,東海,招呼
2020-05-10,5110,76,57,133,東海,招呼
2020-05-11,5110,70,59,129,東海,招呼
2020-05-12,5110,49,43,92,東海,招呼
2020-05-13,5110,56,54,110,東海,招呼
2020-05-14,5110,56,49,105,東海,招呼
2020-05-15,5110,68,80,148,東海,招呼
2020-05-16,5110,28,39,67,東海,招呼
2020-05-17,5110,42,35,77,東海,招呼
2020-05-18,5110,55,59,114,東海,招呼
2020-05-19,5110,53,49,102,東海,招呼
2020-05-20,5110,59,51,110,東海,招呼
2020-05-21,5110,48,48,96,東海,招呼
2020-05-22,5110,46,52,98,東海,招呼
2020-05-23,5110,36,58,94,東海,招呼
2020-05-24,5110,61,50,111,東海,招呼
2020-05-25,5110,61,52,113,東海,招呼
2020-05-26,5110,56,55,111,東海,招呼
2020-05-27,5110,49,60,109,東海,招呼
2020-05-28,5110,53,60,113,東海,招呼
2020-05-29,5110,60,71,131,東海,招呼
2020-05-30,5110,40,99,139,東海,招呼
2020-05-31,5110,43,51,94,東海,招呼
2020-06-01,5110,59,57,116,東海,招呼
2020-06-02,5110,51,47,98,東海,招呼
2020-06-03,5110,51,57,108,東海,招呼
2020-06-04,5110,57,60,117,東海,招呼
2020-06-05,5110,65,80,145,東海,招呼
2020-06-06,5110,40,78,118,東海,招呼
2020-06-07,5110,70,83,153,東海,招呼
2020-06-08,5110,54,51,105,東海,招呼
2020-06-09,5110,54,74,128,東海,招呼
2020-06-10,5110,60,128,188,東海,招呼
2020-06-11,5110,56,168,224,東海,招呼
2020-06-12,5110,54,119,173,東海,招呼
2020-06-13,5110,57,52,109,東海,招呼
2020-06-14,5110,57,67,124,東海,招呼
2020-06-15,5110,62,76,138,東海,招呼
2020-06-16,5110,55,58,113,東海,招呼
2020-06-17,5110,65,56,121,東海,招呼
2020-06-18,5110,54,75,129,東海,招呼
2020-06-19,5110,51,68,119,東海,招呼
2020-06-20,5110,67,71,138,東海,招呼
2020-06-21,5110,51,66,117,東海,招呼
2020-06-22,5110,63,61,124,東海,招呼
2020-06-23,5110,54,45,99,東海,招呼
2020-06-24,5110,56,71,127,東海,招呼
2020-06-25,5110,53,64,117,東海,招呼
2020-06-26,5110,61,67,128,東海,招呼
2020-06-27,5110,59,67,126,東海,招呼
2020-06-28,5110,65,153,218,東海,招呼
2020-06-29,5110,68,52,120,東海,招呼
2020-06-30,5110,62,51,113,東海,招呼
2020-07-01,5110,64,50,114,東海,招呼
2020-07-02,5110,48,57,105,東海,招呼
2020-07-03,5110,64,62,126,東海,招呼
2020-07-04,5110,36,37,73,東海,招呼
2020-07-05,5110,72,63,135,東海,招呼
2020-07-06,5110,47,56,103,東海,招呼
2020-07-07,5110,60,60,120,東海,招呼
2020-07-08,5110,48,69,117,東海,招呼
2020-07-09,5110,55,58,113,東海,招呼
2020-07-10,5110,70,56,126,東海,招呼
2020-07-11,5110,59,53,112,東海,招呼
2020-07-12,5110,54,74,128,東海,招呼
2020-07-13,5110,55,58,113,東海,招呼
2020-07-14,5110,62,60,122,東海,招呼
2020-07-15,5110,36,31,67,東海,招呼
2020-07-16,5110,53,54,107,東海,招呼
2020-07-17,5110,40,84,124,東海,招呼
2020-07-18,5110,61,59,120,東海,招呼
2020-07-19,5110,65,62,127,東海,招呼
2020-07-20,5110,79,70,149,東海,招呼
2020-07-21,5110,46,53,99,東海,招呼
2020-07-22,5110,55,53,108,東海,招呼
2020-07-23,5110,51,64,115,東海,招呼
2020-07-24,5110,76,61,137,東海,招呼
2020-07-25,5110,51,59,110,東海,招呼
2020-07-26,5110,56,66,122,東海,招呼
2020-07-27,5110,58,65,123,東海,招呼
2020-07-28,5110,55,37,92,東海,招呼
2020-07-29,5110,53,57,110,東海,招呼
2020-07-30,5110,51,51,102,東海,招呼
2020-07-31,5110,47,54,101,東海,招呼
2020-08-01,5110,54,65,119,東海,招呼
2020-08-02,5110,65,62,127,東海,招呼
2020-08-03,5110,54,57,111,東海,招呼
2020-08-04,5110,60,51,111,東海,招呼
2020-08-05,5110,59,71,130,東海,招呼
2020-08-06,5110,59,77,136,東海,招呼
2020-08-07,5110,75,80,155,東海,招呼
2020-08-08,5110,48,64,112,東海,招呼
2020-08-09,5110,50,44,94,東海,招呼
2020-08-10,5110,52,74,126,東海,招呼
2020-08-11,5110,53,39,92,東海,招呼
2020-08-12,5110,46,48,94,東海,招呼
2020-08-13,5110,46,51,97,東海,招呼
2020-08-14,5110,41,50,91,東海,招呼
2020-08-15,5110,31,46,77,東海,招呼
2020-08-16,5110,59,92,151,東海,招呼
2020-08-17,5110,51,47,98,東海,招呼
2020-08-18,5110,42,41,83,東海,招呼
2020-08-19,5110,59,51,110,東海,招呼
2020-08-20,5110,43,147,190,東海,招呼
2020-08-21,5110,58,51,109,東海,招呼
2020-08-22,5110,40,52,92,東海,招呼
2020-08-23,5110,45,46,91,東海,招呼
2020-08-24,5110,40,110,150,東海,招呼
2020-08-25,5110,54,47,101,東海,招呼
2020-08-26,5110,43,60,103,東海,招呼
2020-08-27,5110,41,59,100,東海,招呼
2020-08-28,5110,68,83,151,東海,招呼
2020-08-29,5110,50,77,127,東海,招呼
2020-08-30,5110,43,44,87,東海,招呼
2020-08-31,5110,65,53,118,東海,招呼
2020-09-01,5110,70,63,133,東海,招呼
2020-09-02,5110,66,63,129,東海,招呼
2020-09-03,5110,68,81,149,東海,招呼
2020-09-04,5110,67,71,138,東海,招呼
2020-09-05,5110,51,48,99,東海,招呼
2020-09-06,5110,49,54,103,東海,招呼
2020-09-07,5110,63,50,113,東海,招呼
2020-09-08,5110,72,54,126,東海,招呼
2020-09-09,5110,65,256,321,東海,招呼
2020-09-10,5110,68,69,137,東海,招呼
2020-09-11,5110,83,77,160,東海,招呼
2020-09-12,5110,39,51,90,東海,招呼
2020-09-13,5110,62,53,115,東海,招呼
2020-09-14,5110,63,39,102,東海,招呼
2020-09-15,5110,52,53,105,東海,招呼
2020-09-16,5110,54,47,101,東海,招呼
2020-09-17,5110,70,59,129,東海,招呼
2020-09-18,5110,58,59,117,東海,招呼
2020-09-19,5110,50,72,122,東海,招呼
2020-09-20,5110,79,85,164,東海,招呼
2020-09-21,5110,61,52,113,東海,招呼
2020-09-22,5110,67,48,115,東海,招呼
2020-09-23,5110,77,79,156,東海,招呼
2020-09-24,5110,67,59,126,東海,招呼
2020-09-25,5110,73,60,133,東海,招呼
2020-09-26,5110,56,70,126,東海,招呼
2020-09-27,5110,45,63,108,東海,招呼
2020-09-28,5110,67,43,110,東海,招呼
2020-09-29,5110,65,53,118,東海,招呼
2020-09-30,5110,71,82,153,東海,招呼
2020-10-01,5110,49,96,145,東海,招呼
2020-10-02,5110,84,90,174,東海,招呼
2020-10-03,5110,69,87,156,東海,招呼
2020-10-04,5110,101,67,168,東海,招呼
2020-10-05,5110,71,51,122,東海,招呼
2020-10-06,5110,65,47,112,東海,招呼
2020-10-07,5110,66,53,119,東海,招呼
2020-10-08,5110,78,82,160,東海,招呼
2020-10-09,5110,58,93,151,東海,招呼
2020-10-10,5110,45,205,250,東海,招呼
2020-10-11,5110,64,51,115,東海,招呼
2020-10-12,5110,59,45,104,東海,招呼
2020-10-13,5110,67,53,120,東海,招呼
2020-10-14,5110,59,58,117,東海,招呼
2020-10-15,5110,63,59,122,東海,招呼
2020-10-16,5110,68,70,138,東海,招呼
2020-10-17,5110,58,82,140,東海,招呼
2020-10-18,5110,60,67,127,東海,招呼
2020-10-19,5110,75,48,123,東海,招呼
2020-10-20,5110,70,50,120,東海,招呼
2020-10-21,5110,71,69,140,東海,招呼
2020-10-22,5110,67,62,129,東海,招呼
2020-10-23,5110,64,73,137,東海,招呼
2020-10-24,5110,68,542,610,東海,招呼
2020-10-25,5110,73,53,126,東海,招呼
2020-10-26,5110,82,74,156,東海,招呼
2020-10-27,5110,70,52,122,東海,招呼
2020-10-28,5110,68,50,118,東海,招呼
2020-10-29,5110,69,61,130,東海,招呼
2020-10-30,5110,76,72,148,東海,招呼
2020-10-31,5110,51,54,105,東海,招呼
2020-11-01,5110,65,70,135,東海,招呼
2020-11-02,5110,69,60,129,東海,招呼
2020-11-03,5110,67,48,115,東海,招呼
2020-11-04,5110,68,52,120,東海,招呼
2020-11-05,5110,70,58,128,東海,招呼
2020-11-06,5110,68,80,148,東海,招呼
2020-11-07,5110,62,62,124,東海,招呼
2020-11-08,5110,91,88,179,東海,招呼
2020-11-09,5110,75,55,130,東海,招呼
2020-11-10,5110,67,60,127,東海,招呼
2020-11-11,5110,75,70,145,東海,招呼
2020-11-12,5110,72,90,162,東海,招呼
2020-11-13,5110,86,77,163,東海,招呼
2020-11-14,5110,73,129,202,東海,招呼
2020-11-15,5110,65,54,119,東海,招呼
2020-11-16,5110,69,56,125,東海,招呼
2020-11-17,5110,72,59,131,東海,招呼
2020-11-18,5110,79,74,153,東海,招呼
2020-11-19,5110,80,75,155,東海,招呼
2020-11-20,5110,74,96,170,東海,招呼
2020-11-21,5110,57,76,133,東海,招呼
2020-11-22,5110,91,87,178,東海,招呼
2020-11-23,5110,81,104,185,東海,招呼
2020-11-24,5110,67,59,126,東海,招呼
2020-11-25,5110,65,48,113,東海,招呼
2020-11-26,5110,73,89,162,東海,招呼
2020-11-27,5110,80,146,226,東海,招呼
2020-11-28,5110,71,111,182,東海,招呼
2020-11-29,5110,57,77,134,東海,招呼
2020-11-30,5110,67,58,125,東海,招呼
2020-12-01,5110,60,50,110,東海,招呼
2020-12-02,5110,59,69,128,東海,招呼
2020-12-03,5110,58,151,209,東海,招呼
2020-12-04,5110,74,68,142,東海,招呼
2020-12-05,5110,75,201,276,東海,招呼
2020-12-06,5110,75,77,152,東海,招呼
2020-12-07,5110,73,63,136,東海,招呼
2020-12-08,5110,72,181,253,東海,招呼
2020-12-09,5110,57,91,148,東海,招呼
2020-12-10,5110,67,77,144,東海,招呼
2020-12-11,5110,87,133,220,東海,招呼
2020-12-12,5110,76,115,191,東海,招呼
2020-12-13,5110,95,156,251,東海,招呼
2020-12-14,5110,60,72,132,東海,招呼
2020-12-15,5110,70,85,155,東海,招呼
2020-12-16,5110,68,68,136,東海,招呼
2020-12-17,5110,69,91,160,東海,招呼
2020-12-18,5110,71,110,181,東海,招呼
2020-12-19,5110,57,675,732,東海,招呼
2020-12-20,5110,72,183,255,東海,招呼
2020-12-21,5110,66,238,304,東海,招呼
2020-12-22,5110,73,467,540,東海,招呼
2020-12-23,5110,73,787,860,東海,招呼
2020-12-24,5110,61,58,119,東海,招呼
2020-12-25,5110,98,98,196,東海,招呼
2020-12-26,5110,81,88,169,東海,招呼
2020-12-27,5110,58,77,135,東海,招呼
2020-12-28,5110,66,54,120,東海,招呼
2020-12-29,5110,60,54,114,東海,招呼
2020-12-30,5110,70,61,131,東海,招呼
2020-12-31,5110,83,96,179,東海,招呼
2020-01-01,5120,1298,1235,2533,枋寮,二等
2020-01-02,5120,691,638,1329,枋寮,二等
2020-01-03,5120,867,1035,1902,枋寮,二等
2020-01-04,5120,958,959,1917,枋寮,二等
2020-01-05,5120,1149,1113,2262,枋寮,二等
2020-01-06,5120,804,673,1477,枋寮,二等
2020-01-07,5120,620,632,1252,枋寮,二等
2020-01-08,5120,639,647,1286,枋寮,二等
2020-01-09,5120,607,635,1242,枋寮,二等
2020-01-10,5120,1024,1406,2430,枋寮,二等
2020-01-11,5120,1072,1216,2288,枋寮,二等
2020-01-12,5120,1319,1102,2421,枋寮,二等
2020-01-13,5120,813,843,1656,枋寮,二等
2020-01-14,5120,641,626,1267,枋寮,二等
2020-01-15,5120,743,767,1510,枋寮,二等
2020-01-16,5120,795,899,1694,枋寮,二等
2020-01-17,5120,1031,989,2020,枋寮,二等
2020-01-18,5120,943,1109,2052,枋寮,二等
2020-01-19,5120,1060,1095,2155,枋寮,二等
2020-01-20,5120,766,887,1653,枋寮,二等
2020-01-21,5120,905,1017,1922,枋寮,二等
2020-01-22,5120,1049,1174,2223,枋寮,二等
2020-01-23,5120,779,1195,1974,枋寮,二等
2020-01-24,5120,626,1157,1783,枋寮,二等
2020-01-25,5120,1515,1603,3118,枋寮,二等
2020-01-26,5120,1606,1667,3273,枋寮,二等
2020-01-27,5120,2082,1738,3820,枋寮,二等
2020-01-28,5120,1711,1224,2935,枋寮,二等
2020-01-29,5120,1581,1204,2785,枋寮,二等
2020-01-30,5120,1043,818,1861,枋寮,二等
2020-01-31,5120,1146,887,2033,枋寮,二等
2020-02-01,5120,970,978,1948,枋寮,二等
2020-02-02,5120,918,942,1860,枋寮,二等
2020-02-03,5120,963,812,1775,枋寮,二等
2020-02-04,5120,800,731,1531,枋寮,二等
2020-02-05,5120,794,709,1503,枋寮,二等
2020-02-06,5120,806,719,1525,枋寮,二等
2020-02-07,5120,901,917,1818,枋寮,二等
2020-02-08,5120,978,885,1863,枋寮,二等
2020-02-09,5120,1020,1012,2032,枋寮,二等
2020-02-10,5120,769,673,1442,枋寮,二等
2020-02-11,5120,646,686,1332,枋寮,二等
2020-02-12,5120,639,635,1274,枋寮,二等
2020-02-13,5120,727,646,1373,枋寮,二等
2020-02-14,5120,748,692,1440,枋寮,二等
2020-02-15,5120,786,791,1577,枋寮,二等
2020-02-16,5120,1000,978,1978,枋寮,二等
2020-02-17,5120,616,707,1323,枋寮,二等
2020-02-18,5120,633,657,1290,枋寮,二等
2020-02-19,5120,658,694,1352,枋寮,二等
2020-02-20,5120,712,696,1408,枋寮,二等
2020-02-21,5120,970,819,1789,枋寮,二等
2020-02-22,5120,662,757,1419,枋寮,二等
2020-02-23,5120,895,886,1781,枋寮,二等
2020-02-24,5120,749,658,1407,枋寮,二等
2020-02-25,5120,571,613,1184,枋寮,二等
2020-02-26,5120,551,604,1155,枋寮,二等
2020-02-27,5120,939,1143,2082,枋寮,二等
2020-02-28,5120,877,1227,2104,枋寮,二等
2020-02-29,5120,959,899,1858,枋寮,二等
2020-03-01,5120,1301,868,2169,枋寮,二等
2020-03-02,5120,600,639,1239,枋寮,二等
2020-03-03,5120,472,464,936,枋寮,二等
2020-03-04,5120,455,553,1008,枋寮,二等
2020-03-05,5120,574,558,1132,枋寮,二等
2020-03-06,5120,802,983,1785,枋寮,二等
2020-03-07,5120,607,707,1314,枋寮,二等
2020-03-08,5120,1036,828,1864,枋寮,二等
2020-03-09,5120,627,824,1451,枋寮,二等
2020-03-10,5120,554,553,1107,枋寮,二等
2020-03-11,5120,658,624,1282,枋寮,二等
2020-03-12,5120,692,598,1290,枋寮,二等
2020-03-13,5120,1063,1152,2215,枋寮,二等
2020-03-14,5120,600,748,1348,枋寮,二等
2020-03-15,5120,1007,755,1762,枋寮,二等
2020-03-16,5120,570,603,1173,枋寮,二等
2020-03-17,5120,530,521,1051,枋寮,二等
2020-03-18,5120,476,481,957,枋寮,二等
2020-03-19,5120,525,505,1030,枋寮,二等
2020-03-20,5120,762,1108,1870,枋寮,二等
2020-03-21,5120,517,682,1199,枋寮,二等
2020-03-22,5120,975,755,1730,枋寮,二等
2020-03-23,5120,558,543,1101,枋寮,二等
2020-03-24,5120,472,460,932,枋寮,二等
2020-03-25,5120,448,447,895,枋寮,二等
2020-03-26,5120,485,463,948,枋寮,二等
2020-03-27,5120,645,989,1634,枋寮,二等
2020-03-28,5120,455,580,1035,枋寮,二等
2020-03-29,5120,889,645,1534,枋寮,二等
2020-03-30,5120,528,579,1107,枋寮,二等
2020-03-31,5120,478,518,996,枋寮,二等
2020-04-01,5120,851,1244,2095,枋寮,二等
2020-04-02,5120,555,1050,1605,枋寮,二等
2020-04-03,5120,590,867,1457,枋寮,二等
2020-04-04,5120,743,602,1345,枋寮,二等
2020-04-05,5120,1430,807,2237,枋寮,二等
2020-04-06,5120,683,603,1286,枋寮,二等
2020-04-07,5120,465,429,894,枋寮,二等
2020-04-08,5120,442,408,850,枋寮,二等
2020-04-09,5120,390,394,784,枋寮,二等
2020-04-10,5120,689,853,1542,枋寮,二等
2020-04-11,5120,372,563,935,枋寮,二等
2020-04-12,5120,734,679,1413,枋寮,二等
2020-04-13,5120,653,495,1148,枋寮,二等
2020-04-14,5120,454,465,919,枋寮,二等
2020-04-15,5120,439,492,931,枋寮,二等
2020-04-16,5120,442,495,937,枋寮,二等
2020-04-17,5120,731,928,1659,枋寮,二等
2020-04-18,5120,449,579,1028,枋寮,二等
2020-04-19,5120,879,690,1569,枋寮,二等
2020-04-20,5120,522,515,1037,枋寮,二等
2020-04-21,5120,431,430,861,枋寮,二等
2020-04-22,5120,379,416,795,枋寮,二等
2020-04-23,5120,421,454,875,枋寮,二等
2020-04-24,5120,625,838,1463,枋寮,二等
2020-04-25,5120,400,444,844,枋寮,二等
2020-04-26,5120,633,596,1229,枋寮,二等
2020-04-27,5120,459,412,871,枋寮,二等
2020-04-28,5120,401,403,804,枋寮,二等
2020-04-29,5120,389,425,814,枋寮,二等
2020-04-30,5120,474,548,1022,枋寮,二等
2020-05-01,5120,608,1058,1666,枋寮,二等
2020-05-02,5120,538,618,1156,枋寮,二等
2020-05-03,5120,996,717,1713,枋寮,二等
2020-05-04,5120,503,452,955,枋寮,二等
2020-05-05,5120,497,495,992,枋寮,二等
2020-05-06,5120,451,459,910,枋寮,二等
2020-05-07,5120,458,474,932,枋寮,二等
2020-05-08,5120,680,1058,1738,枋寮,二等
2020-05-09,5120,512,709,1221,枋寮,二等
2020-05-10,5120,1099,756,1855,枋寮,二等
2020-05-11,5120,540,468,1008,枋寮,二等
2020-05-12,5120,444,475,919,枋寮,二等
2020-05-13,5120,463,521,984,枋寮,二等
2020-05-14,5120,496,549,1045,枋寮,二等
2020-05-15,5120,856,1048,1904,枋寮,二等
2020-05-16,5120,504,627,1131,枋寮,二等
2020-05-17,5120,863,811,1674,枋寮,二等
2020-05-18,5120,546,546,1092,枋寮,二等
2020-05-19,5120,464,465,929,枋寮,二等
2020-05-20,5120,429,485,914,枋寮,二等
2020-05-21,5120,501,454,955,枋寮,二等
2020-05-22,5120,661,851,1512,枋寮,二等
2020-05-23,5120,431,575,1006,枋寮,二等
2020-05-24,5120,920,792,1712,枋寮,二等
2020-05-25,5120,567,656,1223,枋寮,二等
2020-05-26,5120,508,512,1020,枋寮,二等
2020-05-27,5120,482,479,961,枋寮,二等
2020-05-28,5120,517,523,1040,枋寮,二等
2020-05-29,5120,751,1131,1882,枋寮,二等
2020-05-30,5120,720,838,1558,枋寮,二等
2020-05-31,5120,1218,911,2129,枋寮,二等
2020-06-01,5120,593,622,1215,枋寮,二等
2020-06-02,5120,617,596,1213,枋寮,二等
2020-06-03,5120,557,550,1107,枋寮,二等
2020-06-04,5120,628,566,1194,枋寮,二等
2020-06-05,5120,803,1099,1902,枋寮,二等
2020-06-06,5120,784,930,1714,枋寮,二等
2020-06-07,5120,1223,948,2171,枋寮,二等
2020-06-08,5120,634,735,1369,枋寮,二等
2020-06-09,5120,718,649,1367,枋寮,二等
2020-06-10,5120,543,565,1108,枋寮,二等
2020-06-11,5120,647,658,1305,枋寮,二等
2020-06-12,5120,908,1151,2059,枋寮,二等
2020-06-13,5120,876,975,1851,枋寮,二等
2020-06-14,5120,1231,999,2230,枋寮,二等
2020-06-15,5120,654,663,1317,枋寮,二等
2020-06-16,5120,650,648,1298,枋寮,二等
2020-06-17,5120,598,613,1211,枋寮,二等
2020-06-18,5120,727,692,1419,枋寮,二等
2020-06-19,5120,734,858,1592,枋寮,二等
2020-06-20,5120,865,990,1855,枋寮,二等
2020-06-21,5120,926,854,1780,枋寮,二等
2020-06-22,5120,749,809,1558,枋寮,二等
2020-06-23,5120,672,722,1394,枋寮,二等
2020-06-24,5120,1023,1335,2358,枋寮,二等
2020-06-25,5120,974,1334,2308,枋寮,二等
2020-06-26,5120,1239,1338,2577,枋寮,二等
2020-06-27,5120,1312,1073,2385,枋寮,二等
2020-06-28,5120,1629,1085,2714,枋寮,二等
2020-06-29,5120,869,835,1704,枋寮,二等
2020-06-30,5120,660,702,1362,枋寮,二等
2020-07-01,5120,712,682,1394,枋寮,二等
2020-07-02,5120,723,604,1327,枋寮,二等
2020-07-03,5120,903,1014,1917,枋寮,二等
2020-07-04,5120,831,846,1677,枋寮,二等
2020-07-05,5120,989,883,1872,枋寮,二等
2020-07-06,5120,701,896,1597,枋寮,二等
2020-07-07,5120,699,784,1483,枋寮,二等
2020-07-08,5120,660,652,1312,枋寮,二等
2020-07-09,5120,778,810,1588,枋寮,二等
2020-07-10,5120,1015,1044,2059,枋寮,二等
2020-07-11,5120,860,977,1837,枋寮,二等
2020-07-12,5120,1214,1240,2454,枋寮,二等
2020-07-13,5120,756,783,1539,枋寮,二等
2020-07-14,5120,780,737,1517,枋寮,二等
2020-07-15,5120,889,841,1730,枋寮,二等
2020-07-16,5120,860,897,1757,枋寮,二等
2020-07-17,5120,1644,1490,3134,枋寮,二等
2020-07-18,5120,1046,1149,2195,枋寮,二等
2020-07-19,5120,1224,1263,2487,枋寮,二等
2020-07-20,5120,1111,1190,2301,枋寮,二等
2020-07-21,5120,1033,901,1934,枋寮,二等
2020-07-22,5120,981,898,1879,枋寮,二等
2020-07-23,5120,999,911,1910,枋寮,二等
2020-07-24,5120,1151,1140,2291,枋寮,二等
2020-07-25,5120,953,1045,1998,枋寮,二等
2020-07-26,5120,1140,1074,2214,枋寮,二等
2020-07-27,5120,1008,957,1965,枋寮,二等
2020-07-28,5120,832,906,1738,枋寮,二等
2020-07-29,5120,929,797,1726,枋寮,二等
2020-07-30,5120,941,883,1824,枋寮,二等
2020-07-31,5120,1053,1091,2144,枋寮,二等
2020-08-01,5120,927,1024,1951,枋寮,二等
2020-08-02,5120,1060,932,1992,枋寮,二等
2020-08-03,5120,686,1054,1740,枋寮,二等
2020-08-04,5120,692,668,1360,枋寮,二等
2020-08-05,5120,780,854,1634,枋寮,二等
2020-08-06,5120,776,830,1606,枋寮,二等
2020-08-07,5120,1261,1227,2488,枋寮,二等
2020-08-08,5120,999,1096,2095,枋寮,二等
2020-08-09,5120,1300,1145,2445,枋寮,二等
2020-08-10,5120,804,1028,1832,枋寮,二等
2020-08-11,5120,766,974,1740,枋寮,二等
2020-08-12,5120,900,805,1705,枋寮,二等
2020-08-13,5120,895,757,1652,枋寮,二等
2020-08-14,5120,1262,1188,2450,枋寮,二等
2020-08-15,5120,1025,1096,2121,枋寮,二等
2020-08-16,5120,1421,1059,2480,枋寮,二等
2020-08-17,5120,1141,1239,2380,枋寮,二等
2020-08-18,5120,883,851,1734,枋寮,二等
2020-08-19,5120,973,868,1841,枋寮,二等
2020-08-20,5120,854,866,1720,枋寮,二等
2020-08-21,5120,1334,1299,2633,枋寮,二等
2020-08-22,5120,949,962,1911,枋寮,二等
2020-08-23,5120,1197,1019,2216,枋寮,二等
2020-08-24,5120,929,1202,2131,枋寮,二等
2020-08-25,5120,907,837,1744,枋寮,二等
2020-08-26,5120,831,866,1697,枋寮,二等
2020-08-27,5120,780,868,1648,枋寮,二等
2020-08-28,5120,1347,984,2331,枋寮,二等
2020-08-29,5120,812,856,1668,枋寮,二等
2020-08-30,5120,1162,925,2087,枋寮,二等
2020-08-31,5120,671,707,1378,枋寮,二等
2020-09-01,5120,578,656,1234,枋寮,二等
2020-09-02,5120,633,637,1270,枋寮,二等
2020-09-03,5120,1010,818,1828,枋寮,二等
2020-09-04,5120,1193,1142,2335,枋寮,二等
2020-09-05,5120,882,1016,1898,枋寮,二等
2020-09-06,5120,1227,1082,2309,枋寮,二等
2020-09-07,5120,690,910,1600,枋寮,二等
2020-09-08,5120,722,618,1340,枋寮,二等
2020-09-09,5120,717,620,1337,枋寮,二等
2020-09-10,5120,877,723,1600,枋寮,二等
2020-09-11,5120,1482,1165,2647,枋寮,二等
2020-09-12,5120,952,941,1893,枋寮,二等
2020-09-13,5120,1430,1376,2806,枋寮,二等
2020-09-14,5120,630,966,1596,枋寮,二等
2020-09-15,5120,786,549,1335,枋寮,二等
2020-09-16,5120,632,561,1193,枋寮,二等
2020-09-17,5120,798,673,1471,枋寮,二等
2020-09-18,5120,1485,1238,2723,枋寮,二等
2020-09-19,5120,1282,1127,2409,枋寮,二等
2020-09-20,5120,1547,1345,2892,枋寮,二等
2020-09-21,5120,683,927,1610,枋寮,二等
2020-09-22,5120,717,700,1417,枋寮,二等
2020-09-23,5120,829,692,1521,枋寮,二等
2020-09-24,5120,689,688,1377,枋寮,二等
2020-09-25,5120,936,878,1814,枋寮,二等
2020-09-26,5120,991,1050,2041,枋寮,二等
2020-09-27,5120,1205,983,2188,枋寮,二等
2020-09-28,5120,682,652,1334,枋寮,二等
2020-09-29,5120,868,957,1825,枋寮,二等
2020-09-30,5120,1080,1816,2896,枋寮,二等
2020-10-01,5120,1083,1594,2677,枋寮,二等
2020-10-02,5120,1403,1390,2793,枋寮,二等
2020-10-03,5120,1588,1201,2789,枋寮,二等
2020-10-04,5120,2022,1233,3255,枋寮,二等
2020-10-05,5120,981,744,1725,枋寮,二等
2020-10-06,5120,697,616,1313,枋寮,二等
2020-10-07,5120,976,663,1639,枋寮,二等
2020-10-08,5120,930,1397,2327,枋寮,二等
2020-10-09,5120,1406,1328,2734,枋寮,二等
2020-10-10,5120,1037,1220,2257,枋寮,二等
2020-10-11,5120,1745,1074,2819,枋寮,二等
2020-10-12,5120,759,737,1496,枋寮,二等
2020-10-13,5120,710,648,1358,枋寮,二等
2020-10-14,5120,777,708,1485,枋寮,二等
2020-10-15,5120,741,752,1493,枋寮,二等
2020-10-16,5120,1020,1292,2312,枋寮,二等
2020-10-17,5120,1029,1104,2133,枋寮,二等
2020-10-18,5120,1587,1143,2730,枋寮,二等
2020-10-19,5120,765,1076,1841,枋寮,二等
2020-10-20,5120,722,708,1430,枋寮,二等
2020-10-21,5120,1025,776,1801,枋寮,二等
2020-10-22,5120,963,794,1757,枋寮,二等
2020-10-23,5120,1087,1330,2417,枋寮,二等
2020-10-24,5120,1029,1123,2152,枋寮,二等
2020-10-25,5120,1412,1332,2744,枋寮,二等
2020-10-26,5120,930,946,1876,枋寮,二等
2020-10-27,5120,801,739,1540,枋寮,二等
2020-10-28,5120,933,685,1618,枋寮,二等
2020-10-29,5120,809,883,1692,枋寮,二等
2020-10-30,5120,1201,1372,2573,枋寮,二等
2020-10-31,5120,1063,1067,2130,枋寮,二等
2020-11-01,5120,1611,1224,2835,枋寮,二等
2020-11-02,5120,767,957,1724,枋寮,二等
2020-11-03,5120,747,681,1428,枋寮,二等
2020-11-04,5120,754,681,1435,枋寮,二等
2020-11-05,5120,866,824,1690,枋寮,二等
2020-11-06,5120,1087,1201,2288,枋寮,二等
2020-11-07,5120,982,1042,2024,枋寮,二等
2020-11-08,5120,1553,1274,2827,枋寮,二等
2020-11-09,5120,947,891,1838,枋寮,二等
2020-11-10,5120,821,844,1665,枋寮,二等
2020-11-11,5120,945,908,1853,枋寮,二等
2020-11-12,5120,987,882,1869,枋寮,二等
2020-11-13,5120,1158,1565,2723,枋寮,二等
2020-11-14,5120,1576,1648,3224,枋寮,二等
2020-11-15,5120,1878,1532,3410,枋寮,二等
2020-11-16,5120,991,1015,2006,枋寮,二等
2020-11-17,5120,1043,939,1982,枋寮,二等
2020-11-18,5120,1009,1016,2025,枋寮,二等
2020-11-19,5120,1058,1019,2077,枋寮,二等
2020-11-20,5120,1357,1706,3063,枋寮,二等
2020-11-21,5120,1497,1564,3061,枋寮,二等
2020-11-22,5120,1885,1554,3439,枋寮,二等
2020-11-23,5120,1234,1078,2312,枋寮,二等
2020-11-24,5120,1047,1054,2101,枋寮,二等
2020-11-25,5120,1118,968,2086,枋寮,二等
2020-11-26,5120,1080,1130,2210,枋寮,二等
2020-11-27,5120,1306,1790,3096,枋寮,二等
2020-11-28,5120,1376,1615,2991,枋寮,二等
2020-11-29,5120,1671,1468,3139,枋寮,二等
2020-11-30,5120,1089,1012,2101,枋寮,二等
2020-12-01,5120,1036,1047,2083,枋寮,二等
2020-12-02,5120,958,962,1920,枋寮,二等
2020-12-03,5120,897,1008,1905,枋寮,二等
2020-12-04,5120,1255,1724,2979,枋寮,二等
2020-12-05,5120,1665,1822,3487,枋寮,二等
2020-12-06,5120,2090,1801,3891,枋寮,二等
2020-12-07,5120,1302,1337,2639,枋寮,二等
2020-12-08,5120,1008,1070,2078,枋寮,二等
2020-12-09,5120,975,1107,2082,枋寮,二等
2020-12-10,5120,1038,1091,2129,枋寮,二等
2020-12-11,5120,1375,1818,3193,枋寮,二等
2020-12-12,5120,1855,2045,3900,枋寮,二等
2020-12-13,5120,2329,2109,4438,枋寮,二等
2020-12-14,5120,1370,1456,2826,枋寮,二等
2020-12-15,5120,1038,1149,2187,枋寮,二等
2020-12-16,5120,1224,1226,2450,枋寮,二等
2020-12-17,5120,1406,1379,2785,枋寮,二等
2020-12-18,5120,1522,1977,3499,枋寮,二等
2020-12-19,5120,1772,1842,3614,枋寮,二等
2020-12-20,5120,3142,2855,5997,枋寮,二等
2020-12-21,5120,1510,1479,2989,枋寮,二等
2020-12-22,5120,1775,1690,3465,枋寮,二等
2020-12-23,5120,855,874,1729,枋寮,二等
2020-12-24,5120,763,788,1551,枋寮,二等
2020-12-25,5120,963,1282,2245,枋寮,二等
2020-12-26,5120,1008,1112,2120,枋寮,二等
2020-12-27,5120,1475,1067,2542,枋寮,二等
2020-12-28,5120,752,735,1487,枋寮,二等
2020-12-29,5120,666,744,1410,枋寮,二等
2020-12-30,5120,788,885,1673,枋寮,二等
2020-12-31,5120,1074,1641,2715,枋寮,二等
2020-01-01,5130,103,3,106,加祿,三等
2020-01-02,5130,0,0,0,加祿,三等
2020-01-03,5130,14,1,15,加祿,三等
2020-01-04,5130,0,0,0,加祿,三等
2020-01-05,5130,6,0,6,加祿,三等
2020-01-06,5130,4,0,4,加祿,三等
2020-01-07,5130,0,0,0,加祿,三等
2020-01-08,5130,11,0,11,加祿,三等
2020-01-09,5130,0,1,1,加祿,三等
2020-01-10,5130,0,0,0,加祿,三等
2020-01-11,5130,1,2,3,加祿,三等
2020-01-12,5130,10,2,12,加祿,三等
2020-01-13,5130,4,0,4,加祿,三等
2020-01-14,5130,12,0,12,加祿,三等
2020-01-15,5130,1,0,1,加祿,三等
2020-01-16,5130,0,0,0,加祿,三等
2020-01-17,5130,0,0,0,加祿,三等
2020-01-18,5130,8,0,8,加祿,三等
2020-01-19,5130,20,1,21,加祿,三等
2020-01-20,5130,37,2,39,加祿,三等
2020-01-21,5130,8,1,9,加祿,三等
2020-01-22,5130,3,2,5,加祿,三等
2020-01-23,5130,75,0,75,加祿,三等
2020-01-24,5130,0,0,0,加祿,三等
2020-01-25,5130,12,0,12,加祿,三等
2020-01-26,5130,12,1,13,加祿,三等
2020-01-27,5130,17,1,18,加祿,三等
2020-01-28,5130,51,1,52,加祿,三等
2020-01-29,5130,33,3,36,加祿,三等
2020-01-30,5130,2,2,4,加祿,三等
2020-01-31,5130,3,0,3,加祿,三等
2020-02-01,5130,4,0,4,加祿,三等
2020-02-02,5130,8,0,8,加祿,三等
2020-02-03,5130,18,6,24,加祿,三等
2020-02-04,5130,0,0,0,加祿,三等
2020-02-05,5130,15,0,15,加祿,三等
2020-02-06,5130,15,9,24,加祿,三等
2020-02-07,5130,8,0,8,加祿,三等
2020-02-08,5130,0,0,0,加祿,三等
2020-02-09,5130,11,0,11,加祿,三等
2020-02-10,5130,9,3,12,加祿,三等
2020-02-11,5130,0,0,0,加祿,三等
2020-02-12,5130,0,0,0,加祿,三等
2020-02-13,5130,1,1,2,加祿,三等
2020-02-14,5130,22,1,23,加祿,三等
2020-02-15,5130,0,0,0,加祿,三等
2020-02-16,5130,46,3,49,加祿,三等
2020-02-17,5130,0,0,0,加祿,三等
2020-02-18,5130,0,0,0,加祿,三等
2020-02-19,5130,0,1,1,加祿,三等
2020-02-20,5130,10,3,13,加祿,三等
2020-02-21,5130,0,0,0,加祿,三等
2020-02-22,5130,391,0,391,加祿,三等
2020-02-23,5130,3,0,3,加祿,三等
2020-02-24,5130,249,0,249,加祿,三等
2020-02-25,5130,301,0,301,加祿,三等
2020-02-26,5130,0,0,0,加祿,三等
2020-02-27,5130,9,0,9,加祿,三等
2020-02-28,5130,0,0,0,加祿,三等
2020-02-29,5130,120,6,126,加祿,三等
2020-03-01,5130,1,0,1,加祿,三等
2020-03-02,5130,0,0,0,加祿,三等
2020-03-03,5130,13,0,13,加祿,三等
2020-03-04,5130,2,0,2,加祿,三等
2020-03-05,5130,0,0,0,加祿,三等
2020-03-06,5130,0,0,0,加祿,三等
2020-03-07,5130,0,0,0,加祿,三等
2020-03-08,5130,0,0,0,加祿,三等
2020-03-09,5130,0,0,0,加祿,三等
2020-03-10,5130,0,0,0,加祿,三等
2020-03-11,5130,2,1,3,加祿,三等
2020-03-12,5130,0,0,0,加祿,三等
2020-03-13,5130,0,0,0,加祿,三等
2020-03-14,5130,0,0,0,加祿,三等
2020-03-15,5130,0,1,1,加祿,三等
2020-03-16,5130,0,6,6,加祿,三等
2020-03-17,5130,0,0,0,加祿,三等
2020-03-18,5130,27,0,27,加祿,三等
2020-03-19,5130,19,0,19,加祿,三等
2020-03-20,5130,6,0,6,加祿,三等
2020-03-21,5130,0,0,0,加祿,三等
2020-03-22,5130,35,1,36,加祿,三等
2020-03-23,5130,0,0,0,加祿,三等
2020-03-24,5130,0,0,0,加祿,三等
2020-03-25,5130,0,0,0,加祿,三等
2020-03-26,5130,7,0,7,加祿,三等
2020-03-27,5130,0,0,0,加祿,三等
2020-03-28,5130,13,0,13,加祿,三等
2020-03-29,5130,0,1,1,加祿,三等
2020-03-30,5130,0,0,0,加祿,三等
2020-03-31,5130,0,1,1,加祿,三等
2020-04-01,5130,0,0,0,加祿,三等
2020-04-02,5130,0,0,0,加祿,三等
2020-04-03,5130,22,2,24,加祿,三等
2020-04-04,5130,8,5,13,加祿,三等
2020-04-05,5130,19,0,19,加祿,三等
2020-04-06,5130,3,0,3,加祿,三等
2020-04-07,5130,2,1,3,加祿,三等
2020-04-08,5130,0,0,0,加祿,三等
2020-04-09,5130,0,2,2,加祿,三等
2020-04-10,5130,0,0,0,加祿,三等
2020-04-11,5130,0,0,0,加祿,三等
2020-04-12,5130,0,0,0,加祿,三等
2020-04-13,5130,0,0,0,加祿,三等
2020-04-14,5130,7,0,7,加祿,三等
2020-04-15,5130,12,1,13,加祿,三等
2020-04-16,5130,0,0,0,加祿,三等
2020-04-17,5130,0,1,1,加祿,三等
2020-04-18,5130,0,0,0,加祿,三等
2020-04-19,5130,21,0,21,加祿,三等
2020-04-20,5130,0,0,0,加祿,三等
2020-04-21,5130,1,0,1,加祿,三等
2020-04-22,5130,0,0,0,加祿,三等
2020-04-23,5130,0,0,0,加祿,三等
2020-04-24,5130,0,0,0,加祿,三等
2020-04-25,5130,12,0,12,加祿,三等
2020-04-26,5130,0,0,0,加祿,三等
2020-04-27,5130,0,0,0,加祿,三等
2020-04-28,5130,10,0,10,加祿,三等
2020-04-29,5130,0,1,1,加祿,三等
2020-04-30,5130,0,1,1,加祿,三等
2020-05-01,5130,0,0,0,加祿,三等
2020-05-02,5130,37,0,37,加祿,三等
2020-05-03,5130,0,0,0,加祿,三等
2020-05-04,5130,0,2,2,加祿,三等
2020-05-05,5130,7,0,7,加祿,三等
2020-05-06,5130,0,0,0,加祿,三等
2020-05-07,5130,0,0,0,加祿,三等
2020-05-08,5130,9,0,9,加祿,三等
2020-05-09,5130,6,1,7,加祿,三等
2020-05-10,5130,0,2,2,加祿,三等
2020-05-11,5130,0,0,0,加祿,三等
2020-05-12,5130,0,0,0,加祿,三等
2020-05-13,5130,0,1,1,加祿,三等
2020-05-14,5130,4,0,4,加祿,三等
2020-05-15,5130,1,0,1,加祿,三等
2020-05-16,5130,0,0,0,加祿,三等
2020-05-17,5130,0,1,1,加祿,三等
2020-05-18,5130,0,0,0,加祿,三等
2020-05-19,5130,0,0,0,加祿,三等
2020-05-20,5130,5,0,5,加祿,三等
2020-05-21,5130,0,1,1,加祿,三等
2020-05-22,5130,0,0,0,加祿,三等
2020-05-23,5130,12,0,12,加祿,三等
2020-05-24,5130,0,0,0,加祿,三等
2020-05-25,5130,0,0,0,加祿,三等
2020-05-26,5130,0,0,0,加祿,三等
2020-05-27,5130,2,0,2,加祿,三等
2020-05-28,5130,9,0,9,加祿,三等
2020-05-29,5130,0,0,0,加祿,三等
2020-05-30,5130,62,0,62,加祿,三等
2020-05-31,5130,12,4,16,加祿,三等
2020-06-01,5130,0,0,0,加祿,三等
2020-06-02,5130,2,3,5,加祿,三等
2020-06-03,5130,5,0,5,加祿,三等
2020-06-04,5130,9,0,9,加祿,三等
2020-06-05,5130,13,0,13,加祿,三等
2020-06-06,5130,54,3,57,加祿,三等
2020-06-07,5130,20,0,20,加祿,三等
2020-06-08,5130,0,4,4,加祿,三等
2020-06-09,5130,21,0,21,加祿,三等
2020-06-10,5130,72,0,72,加祿,三等
2020-06-11,5130,114,0,114,加祿,三等
2020-06-12,5130,59,0,59,加祿,三等
2020-06-13,5130,2,5,7,加祿,三等
2020-06-14,5130,14,5,19,加祿,三等
2020-06-15,5130,0,0,0,加祿,三等
2020-06-16,5130,0,1,1,加祿,三等
2020-06-17,5130,0,0,0,加祿,三等
2020-06-18,5130,17,0,17,加祿,三等
2020-06-19,5130,0,0,0,加祿,三等
2020-06-20,5130,12,0,12,加祿,三等
2020-06-21,5130,0,0,0,加祿,三等
2020-06-22,5130,0,1,1,加祿,三等
2020-06-23,5130,1,0,1,加祿,三等
2020-06-24,5130,18,2,20,加祿,三等
2020-06-25,5130,15,2,17,加祿,三等
2020-06-26,5130,0,1,1,加祿,三等
2020-06-27,5130,18,4,22,加祿,三等
2020-06-28,5130,104,0,104,加祿,三等
2020-06-29,5130,0,0,0,加祿,三等
2020-06-30,5130,1,0,1,加祿,三等
2020-07-01,5130,4,1,5,加祿,三等
2020-07-02,5130,2,0,2,加祿,三等
2020-07-03,5130,0,1,1,加祿,三等
2020-07-04,5130,0,0,0,加祿,三等
2020-07-05,5130,0,4,4,加祿,三等
2020-07-06,5130,0,0,0,加祿,三等
2020-07-07,5130,13,85,98,加祿,三等
2020-07-08,5130,28,1,29,加祿,三等
2020-07-09,5130,6,2,8,加祿,三等
2020-07-10,5130,0,0,0,加祿,三等
2020-07-11,5130,0,0,0,加祿,三等
2020-07-12,5130,13,1,14,加祿,三等
2020-07-13,5130,9,0,9,加祿,三等
2020-07-14,5130,0,0,0,加祿,三等
2020-07-15,5130,0,0,0,加祿,三等
2020-07-16,5130,0,1,1,加祿,三等
2020-07-17,5130,35,0,35,加祿,三等
2020-07-18,5130,5,0,5,加祿,三等
2020-07-19,5130,5,0,5,加祿,三等
2020-07-20,5130,0,2,2,加祿,三等
2020-07-21,5130,78,12,90,加祿,三等
2020-07-22,5130,100,2,102,加祿,三等
2020-07-23,5130,1,1,2,加祿,三等
2020-07-24,5130,0,0,0,加祿,三等
2020-07-25,5130,16,2,18,加祿,三等
2020-07-26,5130,11,0,11,加祿,三等
2020-07-27,5130,0,0,0,加祿,三等
2020-07-28,5130,0,1,1,加祿,三等
2020-07-29,5130,16,0,16,加祿,三等
2020-07-30,5130,22,0,22,加祿,三等
2020-07-31,5130,0,0,0,加祿,三等
2020-08-01,5130,0,1,1,加祿,三等
2020-08-02,5130,6,0,6,加祿,三等
2020-08-03,5130,9,1,10,加祿,三等
2020-08-04,5130,2,1,3,加祿,三等
2020-08-05,5130,7,0,7,加祿,三等
2020-08-06,5130,0,0,0,加祿,三等
2020-08-07,5130,5,0,5,加祿,三等
2020-08-08,5130,17,8,25,加祿,三等
2020-08-09,5130,0,0,0,加祿,三等
2020-08-10,5130,12,1,13,加祿,三等
2020-08-11,5130,0,1,1,加祿,三等
2020-08-12,5130,3,2,5,加祿,三等
2020-08-13,5130,1,1,2,加祿,三等
2020-08-14,5130,0,0,0,加祿,三等
2020-08-15,5130,0,0,0,加祿,三等
2020-08-16,5130,39,2,41,加祿,三等
2020-08-17,5130,0,0,0,加祿,三等
2020-08-18,5130,9,1,10,加祿,三等
2020-08-19,5130,0,21,21,加祿,三等
2020-08-20,5130,99,2,101,加祿,三等
2020-08-21,5130,0,0,0,加祿,三等
2020-08-22,5130,4,2,6,加祿,三等
2020-08-23,5130,0,33,33,加祿,三等
2020-08-24,5130,89,0,89,加祿,三等
2020-08-25,5130,23,0,23,加祿,三等
2020-08-26,5130,11,0,11,加祿,三等
2020-08-27,5130,13,1,14,加祿,三等
2020-08-28,5130,0,0,0,加祿,三等
2020-08-29,5130,14,2,16,加祿,三等
2020-08-30,5130,3,0,3,加祿,三等
2020-08-31,5130,0,0,0,加祿,三等
2020-09-01,5130,0,0,0,加祿,三等
2020-09-02,5130,0,0,0,加祿,三等
2020-09-03,5130,68,1,69,加祿,三等
2020-09-04,5130,19,0,19,加祿,三等
2020-09-05,5130,0,3,3,加祿,三等
2020-09-06,5130,0,0,0,加祿,三等
2020-09-07,5130,1,1,2,加祿,三等
2020-09-08,5130,0,0,0,加祿,三等
2020-09-09,5130,211,1,212,加祿,三等
2020-09-10,5130,0,0,0,加祿,三等
2020-09-11,5130,11,0,11,加祿,三等
2020-09-12,5130,0,0,0,加祿,三等
2020-09-13,5130,0,0,0,加祿,三等
2020-09-14,5130,0,0,0,加祿,三等
2020-09-15,5130,1,1,2,加祿,三等
2020-09-16,5130,0,0,0,加祿,三等
2020-09-17,5130,1,0,1,加祿,三等
2020-09-18,5130,0,0,0,加祿,三等
2020-09-19,5130,21,0,21,加祿,三等
2020-09-20,5130,5,1,6,加祿,三等
2020-09-21,5130,0,1,1,加祿,三等
2020-09-22,5130,1,0,1,加祿,三等
2020-09-23,5130,11,2,13,加祿,三等
2020-09-24,5130,0,0,0,加祿,三等
2020-09-25,5130,0,0,0,加祿,三等
2020-09-26,5130,18,1,19,加祿,三等
2020-09-27,5130,0,0,0,加祿,三等
2020-09-28,5130,0,0,0,加祿,三等
2020-09-29,5130,3,0,3,加祿,三等
2020-09-30,5130,13,4,17,加祿,三等
2020-10-01,5130,19,1,20,加祿,三等
2020-10-02,5130,0,0,0,加祿,三等
2020-10-03,5130,22,0,22,加祿,三等
2020-10-04,5130,0,0,0,加祿,三等
2020-10-05,5130,6,0,6,加祿,三等
2020-10-06,5130,6,2,8,加祿,三等
2020-10-07,5130,0,0,0,加祿,三等
2020-10-08,5130,0,0,0,加祿,三等
2020-10-09,5130,47,0,47,加祿,三等
2020-10-10,5130,159,7,166,加祿,三等
2020-10-11,5130,12,1,13,加祿,三等
2020-10-12,5130,0,2,2,加祿,三等
2020-10-13,5130,0,0,0,加祿,三等
2020-10-14,5130,4,0,4,加祿,三等
2020-10-15,5130,0,1,1,加祿,三等
2020-10-16,5130,2,0,2,加祿,三等
2020-10-17,5130,33,5,38,加祿,三等
2020-10-18,5130,27,2,29,加祿,三等
2020-10-19,5130,0,0,0,加祿,三等
2020-10-20,5130,0,0,0,加祿,三等
2020-10-21,5130,25,0,25,加祿,三等
2020-10-22,5130,0,0,0,加祿,三等
2020-10-23,5130,11,0,11,加祿,三等
2020-10-24,5130,465,3,468,加祿,三等
2020-10-25,5130,2,2,4,加祿,三等
2020-10-26,5130,6,4,10,加祿,三等
2020-10-27,5130,0,0,0,加祿,三等
2020-10-28,5130,2,2,4,加祿,三等
2020-10-29,5130,0,0,0,加祿,三等
2020-10-30,5130,15,0,15,加祿,三等
2020-10-31,5130,19,2,21,加祿,三等
2020-11-01,5130,39,2,41,加祿,三等
2020-11-02,5130,0,2,2,加祿,三等
2020-11-03,5130,12,3,15,加祿,三等
2020-11-04,5130,0,0,0,加祿,三等
2020-11-05,5130,0,0,0,加祿,三等
2020-11-06,5130,11,0,11,加祿,三等
2020-11-07,5130,1,2,3,加祿,三等
2020-11-08,5130,14,0,14,加祿,三等
2020-11-09,5130,4,0,4,加祿,三等
2020-11-10,5130,0,0,0,加祿,三等
2020-11-11,5130,21,1,22,加祿,三等
2020-11-12,5130,25,0,25,加祿,三等
2020-11-13,5130,17,1,18,加祿,三等
2020-11-14,5130,69,3,72,加祿,三等
2020-11-15,5130,15,6,21,加祿,三等
2020-11-16,5130,8,1,9,加祿,三等
2020-11-17,5130,18,1,19,加祿,三等
2020-11-18,5130,15,1,16,加祿,三等
2020-11-19,5130,6,0,6,加祿,三等
2020-11-20,5130,51,8,59,加祿,三等
2020-11-21,5130,39,2,41,加祿,三等
2020-11-22,5130,34,7,41,加祿,三等
2020-11-23,5130,52,0,52,加祿,三等
2020-11-24,5130,0,2,2,加祿,三等
2020-11-25,5130,0,0,0,加祿,三等
2020-11-26,5130,32,0,32,加祿,三等
2020-11-27,5130,111,3,114,加祿,三等
2020-11-28,5130,166,7,173,加祿,三等
2020-11-29,5130,17,5,22,加祿,三等
2020-11-30,5130,21,1,22,加祿,三等
2020-12-01,5130,4,5,9,加祿,三等
2020-12-02,5130,19,3,22,加祿,三等
2020-12-03,5130,114,6,120,加祿,三等
2020-12-04,5130,9,0,9,加祿,三等
2020-12-05,5130,147,16,163,加祿,三等
2020-12-06,5130,47,14,61,加祿,三等
2020-12-07,5130,8,3,11,加祿,三等
2020-12-08,5130,138,4,142,加祿,三等
2020-12-09,5130,55,3,58,加祿,三等
2020-12-10,5130,27,5,32,加祿,三等
2020-12-11,5130,106,5,111,加祿,三等
2020-12-12,5130,166,62,228,加祿,三等
2020-12-13,5130,109,11,120,加祿,三等
2020-12-14,5130,22,6,28,加祿,三等
2020-12-15,5130,49,8,57,加祿,三等
2020-12-16,5130,34,9,43,加祿,三等
2020-12-17,5130,50,7,57,加祿,三等
2020-12-18,5130,101,12,113,加祿,三等
2020-12-19,5130,819,14,833,加祿,三等
2020-12-20,5130,174,1027,1201,加祿,三等
2020-12-21,5130,274,31,305,加祿,三等
2020-12-22,5130,768,143,911,加祿,三等
2020-12-23,5130,1195,3,1198,加祿,三等
2020-12-24,5130,4,3,7,加祿,三等
2020-12-25,5130,0,0,0,加祿,三等
2020-12-26,5130,63,1,64,加祿,三等
2020-12-27,5130,10,0,10,加祿,三等
2020-12-28,5130,4,0,4,加祿,三等
2020-12-29,5130,0,0,0,加祿,三等
2020-12-30,5130,0,0,0,加祿,三等
2020-12-31,5130,59,1,60,加祿,三等
2020-01-01,5140,0,1,1,內獅,招呼
2020-01-02,5140,0,0,0,內獅,招呼
2020-01-03,5140,0,0,0,內獅,招呼
2020-01-04,5140,0,3,3,內獅,招呼
2020-01-05,5140,0,0,0,內獅,招呼
2020-01-06,5140,0,0,0,內獅,招呼
2020-01-07,5140,0,0,0,內獅,招呼
2020-01-08,5140,0,0,0,內獅,招呼
2020-01-09,5140,0,0,0,內獅,招呼
2020-01-10,5140,0,1,1,內獅,招呼
2020-01-11,5140,0,0,0,內獅,招呼
2020-01-12,5140,0,0,0,內獅,招呼
2020-01-13,5140,0,0,0,內獅,招呼
2020-01-14,5140,0,0,0,內獅,招呼
2020-01-15,5140,0,0,0,內獅,招呼
2020-01-16,5140,0,0,0,內獅,招呼
2020-01-17,5140,0,0,0,內獅,招呼
2020-01-18,5140,0,0,0,內獅,招呼
2020-01-19,5140,0,1,1,內獅,招呼
2020-01-20,5140,0,1,1,內獅,招呼
2020-01-21,5140,0,3,3,內獅,招呼
2020-01-22,5140,0,0,0,內獅,招呼
2020-01-23,5140,0,0,0,內獅,招呼
2020-01-24,5140,0,0,0,內獅,招呼
2020-01-25,5140,0,4,4,內獅,招呼
2020-01-26,5140,1,3,4,內獅,招呼
2020-01-27,5140,3,0,3,內獅,招呼
2020-01-28,5140,0,1,1,內獅,招呼
2020-01-29,5140,0,0,0,內獅,招呼
2020-01-30,5140,0,0,0,內獅,招呼
2020-01-31,5140,0,1,1,內獅,招呼
2020-02-01,5140,0,1,1,內獅,招呼
2020-02-02,5140,0,0,0,內獅,招呼
2020-02-03,5140,0,1,1,內獅,招呼
2020-02-04,5140,0,0,0,內獅,招呼
2020-02-05,5140,0,1,1,內獅,招呼
2020-02-06,5140,0,0,0,內獅,招呼
2020-02-07,5140,0,0,0,內獅,招呼
2020-02-08,5140,0,0,0,內獅,招呼
2020-02-09,5140,1,0,1,內獅,招呼
2020-02-10,5140,0,0,0,內獅,招呼
2020-02-11,5140,0,0,0,內獅,招呼
2020-02-12,5140,0,0,0,內獅,招呼
2020-02-13,5140,0,0,0,內獅,招呼
2020-02-14,5140,0,0,0,內獅,招呼
2020-02-15,5140,0,0,0,內獅,招呼
2020-02-16,5140,0,0,0,內獅,招呼
2020-02-17,5140,0,0,0,內獅,招呼
2020-02-18,5140,0,0,0,內獅,招呼
2020-02-19,5140,0,0,0,內獅,招呼
2020-02-20,5140,1,1,2,內獅,招呼
2020-02-21,5140,0,0,0,內獅,招呼
2020-02-22,5140,0,1,1,內獅,招呼
2020-02-23,5140,0,1,1,內獅,招呼
2020-02-24,5140,1,0,1,內獅,招呼
2020-02-25,5140,0,0,0,內獅,招呼
2020-02-26,5140,0,0,0,內獅,招呼
2020-02-27,5140,0,0,0,內獅,招呼
2020-02-28,5140,0,1,1,內獅,招呼
2020-02-29,5140,3,2,5,內獅,招呼
2020-03-01,5140,0,0,0,內獅,招呼
2020-03-02,5140,0,0,0,內獅,招呼
2020-03-03,5140,0,0,0,內獅,招呼
2020-03-04,5140,0,0,0,內獅,招呼
2020-03-05,5140,0,0,0,內獅,招呼
2020-03-06,5140,0,0,0,內獅,招呼
2020-03-07,5140,0,0,0,內獅,招呼
2020-03-08,5140,0,0,0,內獅,招呼
2020-03-09,5140,0,0,0,內獅,招呼
2020-03-10,5140,0,0,0,內獅,招呼
2020-03-11,5140,0,0,0,內獅,招呼
2020-03-12,5140,0,0,0,內獅,招呼
2020-03-13,5140,0,0,0,內獅,招呼
2020-03-14,5140,0,0,0,內獅,招呼
2020-03-15,5140,3,2,5,內獅,招呼
2020-03-16,5140,0,0,0,內獅,招呼
2020-03-17,5140,0,0,0,內獅,招呼
2020-03-18,5140,0,0,0,內獅,招呼
2020-03-19,5140,0,0,0,內獅,招呼
2020-03-20,5140,0,0,0,內獅,招呼
2020-03-21,5140,0,0,0,內獅,招呼
2020-03-22,5140,0,0,0,內獅,招呼
2020-03-23,5140,1,0,1,內獅,招呼
2020-03-24,5140,2,0,2,內獅,招呼
2020-03-25,5140,0,0,0,內獅,招呼
2020-03-26,5140,0,0,0,內獅,招呼
2020-03-27,5140,0,0,0,內獅,招呼
2020-03-28,5140,0,0,0,內獅,招呼
2020-03-29,5140,0,0,0,內獅,招呼
2020-03-30,5140,0,0,0,內獅,招呼
2020-03-31,5140,0,0,0,內獅,招呼
2020-04-01,5140,0,0,0,內獅,招呼
2020-04-02,5140,0,0,0,內獅,招呼
2020-04-03,5140,0,0,0,內獅,招呼
2020-04-04,5140,0,1,1,內獅,招呼
2020-04-05,5140,0,0,0,內獅,招呼
2020-04-06,5140,0,1,1,內獅,招呼
2020-04-07,5140,0,0,0,內獅,招呼
2020-04-08,5140,0,0,0,內獅,招呼
2020-04-09,5140,0,0,0,內獅,招呼
2020-04-10,5140,0,0,0,內獅,招呼
2020-04-11,5140,0,0,0,內獅,招呼
2020-04-12,5140,0,0,0,內獅,招呼
2020-04-13,5140,0,0,0,內獅,招呼
2020-04-14,5140,0,0,0,內獅,招呼
2020-04-15,5140,1,0,1,內獅,招呼
2020-04-16,5140,0,0,0,內獅,招呼
2020-04-17,5140,0,0,0,內獅,招呼
2020-04-18,5140,0,0,0,內獅,招呼
2020-04-19,5140,0,0,0,內獅,招呼
2020-04-20,5140,0,0,0,內獅,招呼
2020-04-21,5140,0,1,1,內獅,招呼
2020-04-22,5140,0,0,0,內獅,招呼
2020-04-23,5140,0,0,0,內獅,招呼
2020-04-24,5140,0,0,0,內獅,招呼
2020-04-25,5140,0,0,0,內獅,招呼
2020-04-26,5140,0,0,0,內獅,招呼
2020-04-27,5140,0,0,0,內獅,招呼
2020-04-28,5140,0,0,0,內獅,招呼
2020-04-29,5140,0,1,1,內獅,招呼
2020-04-30,5140,0,0,0,內獅,招呼
2020-05-01,5140,0,0,0,內獅,招呼
2020-05-02,5140,0,0,0,內獅,招呼
2020-05-03,5140,0,2,2,內獅,招呼
2020-05-04,5140,0,1,1,內獅,招呼
2020-05-05,5140,1,5,6,內獅,招呼
2020-05-06,5140,0,0,0,內獅,招呼
2020-05-07,5140,0,0,0,內獅,招呼
2020-05-08,5140,0,0,0,內獅,招呼
2020-05-09,5140,0,0,0,內獅,招呼
2020-05-10,5140,0,0,0,內獅,招呼
2020-05-11,5140,1,0,1,內獅,招呼
2020-05-12,5140,0,0,0,內獅,招呼
2020-05-13,5140,0,0,0,內獅,招呼
2020-05-14,5140,0,0,0,內獅,招呼
2020-05-15,5140,0,1,1,內獅,招呼
2020-05-16,5140,0,0,0,內獅,招呼
2020-05-17,5140,0,0,0,內獅,招呼
2020-05-18,5140,0,0,0,內獅,招呼
2020-05-19,5140,0,0,0,內獅,招呼
2020-05-20,5140,0,0,0,內獅,招呼
2020-05-21,5140,0,0,0,內獅,招呼
2020-05-22,5140,0,0,0,內獅,招呼
2020-05-23,5140,0,0,0,內獅,招呼
2020-05-24,5140,0,0,0,內獅,招呼
2020-05-25,5140,0,0,0,內獅,招呼
2020-05-26,5140,0,0,0,內獅,招呼
2020-05-27,5140,0,0,0,內獅,招呼
2020-05-28,5140,0,0,0,內獅,招呼
2020-05-29,5140,0,0,0,內獅,招呼
2020-05-30,5140,0,0,0,內獅,招呼
2020-05-31,5140,0,0,0,內獅,招呼
2020-06-01,5140,0,0,0,內獅,招呼
2020-06-02,5140,2,2,4,內獅,招呼
2020-06-03,5140,0,0,0,內獅,招呼
2020-06-04,5140,0,0,0,內獅,招呼
2020-06-05,5140,0,0,0,內獅,招呼
2020-06-06,5140,0,1,1,內獅,招呼
2020-06-07,5140,0,0,0,內獅,招呼
2020-06-08,5140,0,0,0,內獅,招呼
2020-06-09,5140,0,0,0,內獅,招呼
2020-06-10,5140,0,0,0,內獅,招呼
2020-06-11,5140,0,0,0,內獅,招呼
2020-06-12,5140,0,0,0,內獅,招呼
2020-06-13,5140,0,0,0,內獅,招呼
2020-06-14,5140,1,2,3,內獅,招呼
2020-06-15,5140,0,2,2,內獅,招呼
2020-06-16,5140,0,0,0,內獅,招呼
2020-06-17,5140,0,0,0,內獅,招呼
2020-06-18,5140,0,0,0,內獅,招呼
2020-06-19,5140,0,0,0,內獅,招呼
2020-06-20,5140,0,1,1,內獅,招呼
2020-06-21,5140,0,0,0,內獅,招呼
2020-06-22,5140,0,0,0,內獅,招呼
2020-06-23,5140,1,0,1,內獅,招呼
2020-06-24,5140,0,1,1,內獅,招呼
2020-06-25,5140,0,2,2,內獅,招呼
2020-06-26,5140,0,0,0,內獅,招呼
2020-06-27,5140,0,2,2,內獅,招呼
2020-06-28,5140,3,0,3,內獅,招呼
2020-06-29,5140,0,0,0,內獅,招呼
2020-06-30,5140,0,0,0,內獅,招呼
2020-07-01,5140,0,1,1,內獅,招呼
2020-07-02,5140,0,1,1,內獅,招呼
2020-07-03,5140,1,1,2,內獅,招呼
2020-07-04,5140,0,0,0,內獅,招呼
2020-07-05,5140,0,1,1,內獅,招呼
2020-07-06,5140,0,2,2,內獅,招呼
2020-07-07,5140,0,0,0,內獅,招呼
2020-07-08,5140,0,0,0,內獅,招呼
2020-07-09,5140,0,0,0,內獅,招呼
2020-07-10,5140,0,0,0,內獅,招呼
2020-07-11,5140,0,0,0,內獅,招呼
2020-07-12,5140,0,0,0,內獅,招呼
2020-07-13,5140,0,0,0,內獅,招呼
2020-07-14,5140,0,0,0,內獅,招呼
2020-07-15,5140,8,11,19,內獅,招呼
2020-07-16,5140,0,0,0,內獅,招呼
2020-07-17,5140,0,0,0,內獅,招呼
2020-07-18,5140,0,0,0,內獅,招呼
2020-07-19,5140,0,0,0,內獅,招呼
2020-07-20,5140,0,1,1,內獅,招呼
2020-07-21,5140,0,0,0,內獅,招呼
2020-07-22,5140,0,0,0,內獅,招呼
2020-07-23,5140,0,0,0,內獅,招呼
2020-07-24,5140,0,0,0,內獅,招呼
2020-07-25,5140,0,0,0,內獅,招呼
2020-07-26,5140,0,0,0,內獅,招呼
2020-07-27,5140,0,0,0,內獅,招呼
2020-07-28,5140,0,0,0,內獅,招呼
2020-07-29,5140,0,1,1,內獅,招呼
2020-07-30,5140,0,0,0,內獅,招呼
2020-07-31,5140,0,1,1,內獅,招呼
2020-08-01,5140,0,3,3,內獅,招呼
2020-08-02,5140,0,0,0,內獅,招呼
2020-08-03,5140,1,0,1,內獅,招呼
2020-08-04,5140,0,0,0,內獅,招呼
2020-08-05,5140,0,0,0,內獅,招呼
2020-08-06,5140,1,0,1,內獅,招呼
2020-08-07,5140,0,0,0,內獅,招呼
2020-08-08,5140,2,0,2,內獅,招呼
2020-08-09,5140,1,0,1,內獅,招呼
2020-08-10,5140,0,0,0,內獅,招呼
2020-08-11,5140,0,0,0,內獅,招呼
2020-08-12,5140,0,0,0,內獅,招呼
2020-08-13,5140,0,1,1,內獅,招呼
2020-08-14,5140,0,0,0,內獅,招呼
2020-08-15,5140,0,2,2,內獅,招呼
2020-08-16,5140,7,7,14,內獅,招呼
2020-08-17,5140,0,1,1,內獅,招呼
2020-08-18,5140,0,0,0,內獅,招呼
2020-08-19,5140,0,1,1,內獅,招呼
2020-08-20,5140,0,0,0,內獅,招呼
2020-08-21,5140,0,3,3,內獅,招呼
2020-08-22,5140,0,0,0,內獅,招呼
2020-08-23,5140,0,0,0,內獅,招呼
2020-08-24,5140,0,0,0,內獅,招呼
2020-08-25,5140,0,0,0,內獅,招呼
2020-08-26,5140,4,0,4,內獅,招呼
2020-08-27,5140,0,0,0,內獅,招呼
2020-08-28,5140,0,0,0,內獅,招呼
2020-08-29,5140,0,1,1,內獅,招呼
2020-08-30,5140,0,0,0,內獅,招呼
2020-08-31,5140,0,1,1,內獅,招呼
2020-09-01,5140,0,0,0,內獅,招呼
2020-09-02,5140,0,0,0,內獅,招呼
2020-09-03,5140,0,0,0,內獅,招呼
2020-09-04,5140,0,0,0,內獅,招呼
2020-09-05,5140,0,0,0,內獅,招呼
2020-09-06,5140,0,1,1,內獅,招呼
2020-09-07,5140,0,0,0,內獅,招呼
2020-09-08,5140,0,1,1,內獅,招呼
2020-09-09,5140,0,0,0,內獅,招呼
2020-09-10,5140,2,0,2,內獅,招呼
2020-09-11,5140,0,0,0,內獅,招呼
2020-09-12,5140,0,0,0,內獅,招呼
2020-09-13,5140,0,0,0,內獅,招呼
2020-09-14,5140,0,0,0,內獅,招呼
2020-09-15,5140,0,0,0,內獅,招呼
2020-09-16,5140,1,0,1,內獅,招呼
2020-09-17,5140,0,0,0,內獅,招呼
2020-09-18,5140,0,0,0,內獅,招呼
2020-09-19,5140,8,2,10,內獅,招呼
2020-09-20,5140,0,0,0,內獅,招呼
2020-09-21,5140,1,0,1,內獅,招呼
2020-09-22,5140,0,0,0,內獅,招呼
2020-09-23,5140,0,0,0,內獅,招呼
2020-09-24,5140,0,0,0,內獅,招呼
2020-09-25,5140,0,0,0,內獅,招呼
2020-09-26,5140,0,2,2,內獅,招呼
2020-09-27,5140,0,0,0,內獅,招呼
2020-09-28,5140,0,0,0,內獅,招呼
2020-09-29,5140,0,0,0,內獅,招呼
2020-09-30,5140,0,0,0,內獅,招呼
2020-10-01,5140,0,0,0,內獅,招呼
2020-10-02,5140,1,0,1,內獅,招呼
2020-10-03,5140,0,4,4,內獅,招呼
2020-10-04,5140,1,2,3,內獅,招呼
2020-10-05,5140,0,0,0,內獅,招呼
2020-10-06,5140,0,0,0,內獅,招呼
2020-10-07,5140,0,0,0,內獅,招呼
2020-10-08,5140,0,0,0,內獅,招呼
2020-10-09,5140,0,8,8,內獅,招呼
2020-10-10,5140,0,8,8,內獅,招呼
2020-10-11,5140,0,0,0,內獅,招呼
2020-10-12,5140,0,0,0,內獅,招呼
2020-10-13,5140,0,0,0,內獅,招呼
2020-10-14,5140,0,1,1,內獅,招呼
2020-10-15,5140,0,0,0,內獅,招呼
2020-10-16,5140,0,0,0,內獅,招呼
2020-10-17,5140,0,0,0,內獅,招呼
2020-10-18,5140,0,0,0,內獅,招呼
2020-10-19,5140,0,0,0,內獅,招呼
2020-10-20,5140,0,1,1,內獅,招呼
2020-10-21,5140,0,0,0,內獅,招呼
2020-10-22,5140,0,0,0,內獅,招呼
2020-10-23,5140,0,2,2,內獅,招呼
2020-10-24,5140,0,0,0,內獅,招呼
2020-10-25,5140,0,0,0,內獅,招呼
2020-10-26,5140,0,0,0,內獅,招呼
2020-10-27,5140,0,0,0,內獅,招呼
2020-10-28,5140,0,0,0,內獅,招呼
2020-10-29,5140,0,0,0,內獅,招呼
2020-10-30,5140,1,0,1,內獅,招呼
2020-10-31,5140,0,2,2,內獅,招呼
2020-11-01,5140,0,0,0,內獅,招呼
2020-11-02,5140,0,0,0,內獅,招呼
2020-11-03,5140,0,0,0,內獅,招呼
2020-11-04,5140,0,1,1,內獅,招呼
2020-11-05,5140,0,0,0,內獅,招呼
2020-11-06,5140,0,0,0,內獅,招呼
2020-11-07,5140,0,0,0,內獅,招呼
2020-11-08,5140,1,0,1,內獅,招呼
2020-11-09,5140,0,0,0,內獅,招呼
2020-11-10,5140,0,0,0,內獅,招呼
2020-11-11,5140,0,1,1,內獅,招呼
2020-11-12,5140,0,0,0,內獅,招呼
2020-11-13,5140,1,1,2,內獅,招呼
2020-11-14,5140,2,3,5,內獅,招呼
2020-11-15,5140,0,3,3,內獅,招呼
2020-11-16,5140,0,1,1,內獅,招呼
2020-11-17,5140,1,3,4,內獅,招呼
2020-11-18,5140,0,1,1,內獅,招呼
2020-11-19,5140,0,2,2,內獅,招呼
2020-11-20,5140,1,2,3,內獅,招呼
2020-11-21,5140,0,0,0,內獅,招呼
2020-11-22,5140,1,4,5,內獅,招呼
2020-11-23,5140,0,1,1,內獅,招呼
2020-11-24,5140,1,1,2,內獅,招呼
2020-11-25,5140,0,0,0,內獅,招呼
2020-11-26,5140,0,0,0,內獅,招呼
2020-11-27,5140,1,1,2,內獅,招呼
2020-11-28,5140,1,5,6,內獅,招呼
2020-11-29,5140,2,0,2,內獅,招呼
2020-11-30,5140,1,30,31,內獅,招呼
2020-12-01,5140,0,0,0,內獅,招呼
2020-12-02,5140,2,2,4,內獅,招呼
2020-12-03,5140,4,5,9,內獅,招呼
2020-12-04,5140,0,0,0,內獅,招呼
2020-12-05,5140,1,2,3,內獅,招呼
2020-12-06,5140,6,6,12,內獅,招呼
2020-12-07,5140,0,1,1,內獅,招呼
2020-12-08,5140,1,3,4,內獅,招呼
2020-12-09,5140,4,5,9,內獅,招呼
2020-12-10,5140,1,2,3,內獅,招呼
2020-12-11,5140,2,2,4,內獅,招呼
2020-12-12,5140,34,32,66,內獅,招呼
2020-12-13,5140,4,10,14,內獅,招呼
2020-12-14,5140,4,5,9,內獅,招呼
2020-12-15,5140,4,9,13,內獅,招呼
2020-12-16,5140,6,5,11,內獅,招呼
2020-12-17,5140,6,10,16,內獅,招呼
2020-12-18,5140,7,4,11,內獅,招呼
2020-12-19,5140,5,12,17,內獅,招呼
2020-12-20,5140,1028,1026,2054,內獅,招呼
2020-12-21,5140,12,20,32,內獅,招呼
2020-12-22,5140,93,133,226,內獅,招呼
2020-12-23,5140,2,1500,1502,內獅,招呼
2020-12-24,5140,0,1,1,內獅,招呼
2020-12-25,5140,0,0,0,內獅,招呼
2020-12-26,5140,0,2,2,內獅,招呼
2020-12-27,5140,0,0,0,內獅,招呼
2020-12-28,5140,0,0,0,內獅,招呼
2020-12-29,5140,0,0,0,內獅,招呼
2020-12-30,5140,0,0,0,內獅,招呼
2020-12-31,5140,1,1,2,內獅,招呼
2020-01-01,5160,0,3,3,枋山,乙簡
2020-01-02,5160,0,1,1,枋山,乙簡
2020-01-03,5160,1,1,2,枋山,乙簡
2020-01-04,5160,4,3,7,枋山,乙簡
2020-01-05,5160,0,0,0,枋山,乙簡
2020-01-06,5160,0,0,0,枋山,乙簡
2020-01-07,5160,0,3,3,枋山,乙簡
2020-01-08,5160,1,2,3,枋山,乙簡
2020-01-09,5160,0,0,0,枋山,乙簡
2020-01-10,5160,0,0,0,枋山,乙簡
2020-01-11,5160,0,0,0,枋山,乙簡
2020-01-12,5160,2,0,2,枋山,乙簡
2020-01-13,5160,0,0,0,枋山,乙簡
2020-01-14,5160,0,0,0,枋山,乙簡
2020-01-15,5160,0,0,0,枋山,乙簡
2020-01-16,5160,0,1,1,枋山,乙簡
2020-01-17,5160,0,0,0,枋山,乙簡
2020-01-18,5160,0,2,2,枋山,乙簡
2020-01-19,5160,0,1,1,枋山,乙簡
2020-01-20,5160,0,4,4,枋山,乙簡
2020-01-21,5160,4,2,6,枋山,乙簡
2020-01-22,5160,0,2,2,枋山,乙簡
2020-01-23,5160,0,0,0,枋山,乙簡
2020-01-24,5160,3,1,4,枋山,乙簡
2020-01-25,5160,0,1,1,枋山,乙簡
2020-01-26,5160,0,2,2,枋山,乙簡
2020-01-27,5160,3,6,9,枋山,乙簡
2020-01-28,5160,25,33,58,枋山,乙簡
2020-01-29,5160,1,0,1,枋山,乙簡
2020-01-30,5160,0,1,1,枋山,乙簡
2020-01-31,5160,0,1,1,枋山,乙簡
2020-02-01,5160,0,1,1,枋山,乙簡
2020-02-02,5160,0,0,0,枋山,乙簡
2020-02-03,5160,0,5,5,枋山,乙簡
2020-02-04,5160,0,12,12,枋山,乙簡
2020-02-05,5160,0,14,14,枋山,乙簡
2020-02-06,5160,0,12,12,枋山,乙簡
2020-02-07,5160,2,0,2,枋山,乙簡
2020-02-08,5160,2,0,2,枋山,乙簡
2020-02-09,5160,0,1,1,枋山,乙簡
2020-02-10,5160,0,0,0,枋山,乙簡
2020-02-11,5160,0,1,1,枋山,乙簡
2020-02-12,5160,0,4,4,枋山,乙簡
2020-02-13,5160,1,0,1,枋山,乙簡
2020-02-14,5160,0,2,2,枋山,乙簡
2020-02-15,5160,1,11,12,枋山,乙簡
2020-02-16,5160,0,5,5,枋山,乙簡
2020-02-17,5160,2,0,2,枋山,乙簡
2020-02-18,5160,0,3,3,枋山,乙簡
2020-02-19,5160,0,0,0,枋山,乙簡
2020-02-20,5160,0,2,2,枋山,乙簡
2020-02-21,5160,0,2,2,枋山,乙簡
2020-02-22,5160,3,1,4,枋山,乙簡
2020-02-23,5160,0,1,1,枋山,乙簡
2020-02-24,5160,0,0,0,枋山,乙簡
2020-02-25,5160,1,2,3,枋山,乙簡
2020-02-26,5160,6,4,10,枋山,乙簡
2020-02-27,5160,0,0,0,枋山,乙簡
2020-02-28,5160,2,2,4,枋山,乙簡
2020-02-29,5160,5,10,15,枋山,乙簡
2020-03-01,5160,2,0,2,枋山,乙簡
2020-03-02,5160,0,0,0,枋山,乙簡
2020-03-03,5160,0,0,0,枋山,乙簡
2020-03-04,5160,0,4,4,枋山,乙簡
2020-03-05,5160,0,0,0,枋山,乙簡
2020-03-06,5160,0,13,13,枋山,乙簡
2020-03-07,5160,2,2,4,枋山,乙簡
2020-03-08,5160,0,6,6,枋山,乙簡
2020-03-09,5160,0,0,0,枋山,乙簡
2020-03-10,5160,0,0,0,枋山,乙簡
2020-03-11,5160,0,1,1,枋山,乙簡
2020-03-12,5160,0,0,0,枋山,乙簡
2020-03-13,5160,1,1,2,枋山,乙簡
2020-03-14,5160,0,1,1,枋山,乙簡
2020-03-15,5160,0,4,4,枋山,乙簡
2020-03-16,5160,0,1,1,枋山,乙簡
2020-03-17,5160,0,2,2,枋山,乙簡
2020-03-18,5160,0,0,0,枋山,乙簡
2020-03-19,5160,4,0,4,枋山,乙簡
2020-03-20,5160,0,1,1,枋山,乙簡
2020-03-21,5160,0,1,1,枋山,乙簡
2020-03-22,5160,0,1,1,枋山,乙簡
2020-03-23,5160,0,12,12,枋山,乙簡
2020-03-24,5160,1,1,2,枋山,乙簡
2020-03-25,5160,0,0,0,枋山,乙簡
2020-03-26,5160,2,0,2,枋山,乙簡
2020-03-27,5160,0,1,1,枋山,乙簡
2020-03-28,5160,2,1,3,枋山,乙簡
2020-03-29,5160,0,2,2,枋山,乙簡
2020-03-30,5160,0,0,0,枋山,乙簡
2020-03-31,5160,0,1,1,枋山,乙簡
2020-04-01,5160,0,0,0,枋山,乙簡
2020-04-02,5160,1,4,5,枋山,乙簡
2020-04-03,5160,0,1,1,枋山,乙簡
2020-04-04,5160,1,1,2,枋山,乙簡
2020-04-05,5160,0,5,5,枋山,乙簡
2020-04-06,5160,0,0,0,枋山,乙簡
2020-04-07,5160,0,0,0,枋山,乙簡
2020-04-08,5160,0,0,0,枋山,乙簡
2020-04-09,5160,0,1,1,枋山,乙簡
2020-04-10,5160,0,0,0,枋山,乙簡
2020-04-11,5160,0,0,0,枋山,乙簡
2020-04-12,5160,0,0,0,枋山,乙簡
2020-04-13,5160,0,0,0,枋山,乙簡
2020-04-14,5160,1,0,1,枋山,乙簡
2020-04-15,5160,0,0,0,枋山,乙簡
2020-04-16,5160,0,1,1,枋山,乙簡
2020-04-17,5160,0,0,0,枋山,乙簡
2020-04-18,5160,0,0,0,枋山,乙簡
2020-04-19,5160,0,0,0,枋山,乙簡
2020-04-20,5160,0,0,0,枋山,乙簡
2020-04-21,5160,0,0,0,枋山,乙簡
2020-04-22,5160,0,1,1,枋山,乙簡
2020-04-23,5160,0,0,0,枋山,乙簡
2020-04-24,5160,0,0,0,枋山,乙簡
2020-04-25,5160,0,0,0,枋山,乙簡
2020-04-26,5160,0,0,0,枋山,乙簡
2020-04-27,5160,0,0,0,枋山,乙簡
2020-04-28,5160,2,3,5,枋山,乙簡
2020-04-29,5160,0,0,0,枋山,乙簡
2020-04-30,5160,0,4,4,枋山,乙簡
2020-05-01,5160,0,1,1,枋山,乙簡
2020-05-02,5160,0,0,0,枋山,乙簡
2020-05-03,5160,0,33,33,枋山,乙簡
2020-05-04,5160,0,0,0,枋山,乙簡
2020-05-05,5160,0,7,7,枋山,乙簡
2020-05-06,5160,0,0,0,枋山,乙簡
2020-05-07,5160,1,1,2,枋山,乙簡
2020-05-08,5160,0,0,0,枋山,乙簡
2020-05-09,5160,0,0,0,枋山,乙簡
2020-05-10,5160,0,0,0,枋山,乙簡
2020-05-11,5160,0,0,0,枋山,乙簡
2020-05-12,5160,0,1,1,枋山,乙簡
2020-05-13,5160,0,1,1,枋山,乙簡
2020-05-14,5160,0,0,0,枋山,乙簡
2020-05-15,5160,0,0,0,枋山,乙簡
2020-05-16,5160,2,1,3,枋山,乙簡
2020-05-17,5160,0,5,5,枋山,乙簡
2020-05-18,5160,0,0,0,枋山,乙簡
2020-05-19,5160,1,1,2,枋山,乙簡
2020-05-20,5160,0,0,0,枋山,乙簡
2020-05-21,5160,0,1,1,枋山,乙簡
2020-05-22,5160,0,0,0,枋山,乙簡
2020-05-23,5160,0,2,2,枋山,乙簡
2020-05-24,5160,1,0,1,枋山,乙簡
2020-05-25,5160,0,2,2,枋山,乙簡
2020-05-26,5160,0,0,0,枋山,乙簡
2020-05-27,5160,2,0,2,枋山,乙簡
2020-05-28,5160,0,0,0,枋山,乙簡
2020-05-29,5160,0,0,0,枋山,乙簡
2020-05-30,5160,1,1,2,枋山,乙簡
2020-05-31,5160,4,2,6,枋山,乙簡
2020-06-01,5160,0,0,0,枋山,乙簡
2020-06-02,5160,0,5,5,枋山,乙簡
2020-06-03,5160,1,1,2,枋山,乙簡
2020-06-04,5160,0,0,0,枋山,乙簡
2020-06-05,5160,0,1,1,枋山,乙簡
2020-06-06,5160,0,2,2,枋山,乙簡
2020-06-07,5160,0,2,2,枋山,乙簡
2020-06-08,5160,1,0,1,枋山,乙簡
2020-06-09,5160,0,3,3,枋山,乙簡
2020-06-10,5160,0,0,0,枋山,乙簡
2020-06-11,5160,0,1,1,枋山,乙簡
2020-06-12,5160,0,1,1,枋山,乙簡
2020-06-13,5160,0,0,0,枋山,乙簡
2020-06-14,5160,0,5,5,枋山,乙簡
2020-06-15,5160,3,0,3,枋山,乙簡
2020-06-16,5160,0,0,0,枋山,乙簡
2020-06-17,5160,0,0,0,枋山,乙簡
2020-06-18,5160,0,1,1,枋山,乙簡
2020-06-19,5160,0,0,0,枋山,乙簡
2020-06-20,5160,0,0,0,枋山,乙簡
2020-06-21,5160,0,1,1,枋山,乙簡
2020-06-22,5160,2,0,2,枋山,乙簡
2020-06-23,5160,1,3,4,枋山,乙簡
2020-06-24,5160,2,2,4,枋山,乙簡
2020-06-25,5160,6,4,10,枋山,乙簡
2020-06-26,5160,0,0,0,枋山,乙簡
2020-06-27,5160,14,8,22,枋山,乙簡
2020-06-28,5160,0,1,1,枋山,乙簡
2020-06-29,5160,0,0,0,枋山,乙簡
2020-06-30,5160,12,0,12,枋山,乙簡
2020-07-01,5160,2,0,2,枋山,乙簡
2020-07-02,5160,1,0,1,枋山,乙簡
2020-07-03,5160,0,2,2,枋山,乙簡
2020-07-04,5160,3,0,3,枋山,乙簡
2020-07-05,5160,1,1,2,枋山,乙簡
2020-07-06,5160,0,1,1,枋山,乙簡
2020-07-07,5160,0,64,64,枋山,乙簡
2020-07-08,5160,0,3,3,枋山,乙簡
2020-07-09,5160,1,1,2,枋山,乙簡
2020-07-10,5160,1,1,2,枋山,乙簡
2020-07-11,5160,0,0,0,枋山,乙簡
2020-07-12,5160,1,1,2,枋山,乙簡
2020-07-13,5160,2,2,4,枋山,乙簡
2020-07-14,5160,7,0,7,枋山,乙簡
2020-07-15,5160,0,0,0,枋山,乙簡
2020-07-16,5160,0,1,1,枋山,乙簡
2020-07-17,5160,0,0,0,枋山,乙簡
2020-07-18,5160,0,0,0,枋山,乙簡
2020-07-19,5160,9,9,18,枋山,乙簡
2020-07-20,5160,11,17,28,枋山,乙簡
2020-07-21,5160,0,2,2,枋山,乙簡
2020-07-22,5160,3,4,7,枋山,乙簡
2020-07-23,5160,1,3,4,枋山,乙簡
2020-07-24,5160,0,1,1,枋山,乙簡
2020-07-25,5160,0,0,0,枋山,乙簡
2020-07-26,5160,3,1,4,枋山,乙簡
2020-07-27,5160,0,2,2,枋山,乙簡
2020-07-28,5160,0,0,0,枋山,乙簡
2020-07-29,5160,0,0,0,枋山,乙簡
2020-07-30,5160,0,6,6,枋山,乙簡
2020-07-31,5160,0,0,0,枋山,乙簡
2020-08-01,5160,3,7,10,枋山,乙簡
2020-08-02,5160,0,0,0,枋山,乙簡
2020-08-03,5160,0,0,0,枋山,乙簡
2020-08-04,5160,0,0,0,枋山,乙簡
2020-08-05,5160,0,0,0,枋山,乙簡
2020-08-06,5160,7,0,7,枋山,乙簡
2020-08-07,5160,0,0,0,枋山,乙簡
2020-08-08,5160,0,2,2,枋山,乙簡
2020-08-09,5160,11,11,22,枋山,乙簡
2020-08-10,5160,0,3,3,枋山,乙簡
2020-08-11,5160,0,5,5,枋山,乙簡
2020-08-12,5160,6,4,10,枋山,乙簡
2020-08-13,5160,3,1,4,枋山,乙簡
2020-08-14,5160,1,0,1,枋山,乙簡
2020-08-15,5160,0,0,0,枋山,乙簡
2020-08-16,5160,0,3,3,枋山,乙簡
2020-08-17,5160,0,0,0,枋山,乙簡
2020-08-18,5160,2,2,4,枋山,乙簡
2020-08-19,5160,1,3,4,枋山,乙簡
2020-08-20,5160,0,0,0,枋山,乙簡
2020-08-21,5160,0,2,2,枋山,乙簡
2020-08-22,5160,1,1,2,枋山,乙簡
2020-08-23,5160,4,0,4,枋山,乙簡
2020-08-24,5160,15,2,17,枋山,乙簡
2020-08-25,5160,0,0,0,枋山,乙簡
2020-08-26,5160,2,0,2,枋山,乙簡
2020-08-27,5160,4,4,8,枋山,乙簡
2020-08-28,5160,0,1,1,枋山,乙簡
2020-08-29,5160,3,1,4,枋山,乙簡
2020-08-30,5160,1,0,1,枋山,乙簡
2020-08-31,5160,1,1,2,枋山,乙簡
2020-09-01,5160,0,0,0,枋山,乙簡
2020-09-02,5160,0,1,1,枋山,乙簡
2020-09-03,5160,0,6,6,枋山,乙簡
2020-09-04,5160,0,1,1,枋山,乙簡
2020-09-05,5160,2,5,7,枋山,乙簡
2020-09-06,5160,2,2,4,枋山,乙簡
2020-09-07,5160,0,0,0,枋山,乙簡
2020-09-08,5160,2,2,4,枋山,乙簡
2020-09-09,5160,0,0,0,枋山,乙簡
2020-09-10,5160,0,0,0,枋山,乙簡
2020-09-11,5160,0,0,0,枋山,乙簡
2020-09-12,5160,0,3,3,枋山,乙簡
2020-09-13,5160,1,0,1,枋山,乙簡
2020-09-14,5160,0,0,0,枋山,乙簡
2020-09-15,5160,0,0,0,枋山,乙簡
2020-09-16,5160,0,1,1,枋山,乙簡
2020-09-17,5160,0,0,0,枋山,乙簡
2020-09-18,5160,1,1,2,枋山,乙簡
2020-09-19,5160,0,2,2,枋山,乙簡
2020-09-20,5160,3,3,6,枋山,乙簡
2020-09-21,5160,0,1,1,枋山,乙簡
2020-09-22,5160,2,1,3,枋山,乙簡
2020-09-23,5160,1,1,2,枋山,乙簡
2020-09-24,5160,0,0,0,枋山,乙簡
2020-09-25,5160,1,0,1,枋山,乙簡
2020-09-26,5160,0,2,2,枋山,乙簡
2020-09-27,5160,0,0,0,枋山,乙簡
2020-09-28,5160,0,0,0,枋山,乙簡
2020-09-29,5160,0,0,0,枋山,乙簡
2020-09-30,5160,0,1,1,枋山,乙簡
2020-10-01,5160,0,2,2,枋山,乙簡
2020-10-02,5160,10,14,24,枋山,乙簡
2020-10-03,5160,1,2,3,枋山,乙簡
2020-10-04,5160,0,0,0,枋山,乙簡
2020-10-05,5160,3,1,4,枋山,乙簡
2020-10-06,5160,0,4,4,枋山,乙簡
2020-10-07,5160,0,1,1,枋山,乙簡
2020-10-08,5160,1,1,2,枋山,乙簡
2020-10-09,5160,1,4,5,枋山,乙簡
2020-10-10,5160,2,2,4,枋山,乙簡
2020-10-11,5160,0,0,0,枋山,乙簡
2020-10-12,5160,0,3,3,枋山,乙簡
2020-10-13,5160,0,0,0,枋山,乙簡
2020-10-14,5160,1,2,3,枋山,乙簡
2020-10-15,5160,1,3,4,枋山,乙簡
2020-10-16,5160,0,2,2,枋山,乙簡
2020-10-17,5160,2,5,7,枋山,乙簡
2020-10-18,5160,0,0,0,枋山,乙簡
2020-10-19,5160,0,2,2,枋山,乙簡
2020-10-20,5160,1,1,2,枋山,乙簡
2020-10-21,5160,0,4,4,枋山,乙簡
2020-10-22,5160,0,1,1,枋山,乙簡
2020-10-23,5160,0,1,1,枋山,乙簡
2020-10-24,5160,0,0,0,枋山,乙簡
2020-10-25,5160,0,0,0,枋山,乙簡
2020-10-26,5160,0,2,2,枋山,乙簡
2020-10-27,5160,0,0,0,枋山,乙簡
2020-10-28,5160,0,2,2,枋山,乙簡
2020-10-29,5160,0,0,0,枋山,乙簡
2020-10-30,5160,0,2,2,枋山,乙簡
2020-10-31,5160,1,2,3,枋山,乙簡
2020-11-01,5160,4,3,7,枋山,乙簡
2020-11-02,5160,0,1,1,枋山,乙簡
2020-11-03,5160,0,0,0,枋山,乙簡
2020-11-04,5160,0,1,1,枋山,乙簡
2020-11-05,5160,0,0,0,枋山,乙簡
2020-11-06,5160,0,0,0,枋山,乙簡
2020-11-07,5160,1,13,14,枋山,乙簡
2020-11-08,5160,0,0,0,枋山,乙簡
2020-11-09,5160,0,1,1,枋山,乙簡
2020-11-10,5160,2,1,3,枋山,乙簡
2020-11-11,5160,0,1,1,枋山,乙簡
2020-11-12,5160,3,1,4,枋山,乙簡
2020-11-13,5160,1,4,5,枋山,乙簡
2020-11-14,5160,5,7,12,枋山,乙簡
2020-11-15,5160,0,3,3,枋山,乙簡
2020-11-16,5160,0,1,1,枋山,乙簡
2020-11-17,5160,2,2,4,枋山,乙簡
2020-11-18,5160,1,2,3,枋山,乙簡
2020-11-19,5160,1,1,2,枋山,乙簡
2020-11-20,5160,1,2,3,枋山,乙簡
2020-11-21,5160,1,2,3,枋山,乙簡
2020-11-22,5160,7,20,27,枋山,乙簡
2020-11-23,5160,0,1,1,枋山,乙簡
2020-11-24,5160,0,6,6,枋山,乙簡
2020-11-25,5160,3,0,3,枋山,乙簡
2020-11-26,5160,0,0,0,枋山,乙簡
2020-11-27,5160,1,5,6,枋山,乙簡
2020-11-28,5160,4,7,11,枋山,乙簡
2020-11-29,5160,1,20,21,枋山,乙簡
2020-11-30,5160,0,1,1,枋山,乙簡
2020-12-01,5160,0,3,3,枋山,乙簡
2020-12-02,5160,2,4,6,枋山,乙簡
2020-12-03,5160,4,6,10,枋山,乙簡
2020-12-04,5160,2,1,3,枋山,乙簡
2020-12-05,5160,2,31,33,枋山,乙簡
2020-12-06,5160,5,11,16,枋山,乙簡
2020-12-07,5160,0,2,2,枋山,乙簡
2020-12-08,5160,0,10,10,枋山,乙簡
2020-12-09,5160,7,2,9,枋山,乙簡
2020-12-10,5160,2,5,7,枋山,乙簡
2020-12-11,5160,4,5,9,枋山,乙簡
2020-12-12,5160,33,35,68,枋山,乙簡
2020-12-13,5160,7,10,17,枋山,乙簡
2020-12-14,5160,4,7,11,枋山,乙簡
2020-12-15,5160,5,4,9,枋山,乙簡
2020-12-16,5160,6,8,14,枋山,乙簡
2020-12-17,5160,6,6,12,枋山,乙簡
2020-12-18,5160,6,13,19,枋山,乙簡
2020-12-19,5160,5,14,19,枋山,乙簡
2020-12-20,5160,11,20,31,枋山,乙簡
2020-12-21,5160,18,18,36,枋山,乙簡
2020-12-22,5160,106,122,228,枋山,乙簡
2020-12-23,5160,0,506,506,枋山,乙簡
2020-12-24,5160,0,3,3,枋山,乙簡
2020-12-25,5160,0,0,0,枋山,乙簡
2020-12-26,5160,0,0,0,枋山,乙簡
2020-12-27,5160,0,6,6,枋山,乙簡
2020-12-28,5160,2,0,2,枋山,乙簡
2020-12-29,5160,0,0,0,枋山,乙簡
2020-12-30,5160,0,0,0,枋山,乙簡
2020-12-31,5160,1,1,2,枋山,乙簡
2020-01-01,5190,186,208,394,大武,三等
2020-01-02,5190,119,179,298,大武,三等
2020-01-03,5190,253,154,407,大武,三等
2020-01-04,5190,122,149,271,大武,三等
2020-01-05,5190,211,237,448,大武,三等
2020-01-06,5190,162,198,360,大武,三等
2020-01-07,5190,112,146,258,大武,三等
2020-01-08,5190,138,141,279,大武,三等
2020-01-09,5190,126,136,262,大武,三等
2020-01-10,5190,319,367,686,大武,三等
2020-01-11,5190,294,305,599,大武,三等
2020-01-12,5190,326,229,555,大武,三等
2020-01-13,5190,174,194,368,大武,三等
2020-01-14,5190,135,146,281,大武,三等
2020-01-15,5190,149,150,299,大武,三等
2020-01-16,5190,162,170,332,大武,三等
2020-01-17,5190,288,199,487,大武,三等
2020-01-18,5190,251,144,395,大武,三等
2020-01-19,5190,180,324,504,大武,三等
2020-01-20,5190,222,236,458,大武,三等
2020-01-21,5190,182,206,388,大武,三等
2020-01-22,5190,262,268,530,大武,三等
2020-01-23,5190,244,309,553,大武,三等
2020-01-24,5190,138,335,473,大武,三等
2020-01-25,5190,221,312,533,大武,三等
2020-01-26,5190,307,350,657,大武,三等
2020-01-27,5190,412,260,672,大武,三等
2020-01-28,5190,456,211,667,大武,三等
2020-01-29,5190,347,233,580,大武,三等
2020-01-30,5190,216,170,386,大武,三等
2020-01-31,5190,304,172,476,大武,三等
2020-02-01,5190,197,115,312,大武,三等
2020-02-02,5190,190,187,377,大武,三等
2020-02-03,5190,172,213,385,大武,三等
2020-02-04,5190,151,191,342,大武,三等
2020-02-05,5190,217,165,382,大武,三等
2020-02-06,5190,142,154,296,大武,三等
2020-02-07,5190,249,191,440,大武,三等
2020-02-08,5190,206,132,338,大武,三等
2020-02-09,5190,170,174,344,大武,三等
2020-02-10,5190,151,217,368,大武,三等
2020-02-11,5190,116,119,235,大武,三等
2020-02-12,5190,125,141,266,大武,三等
2020-02-13,5190,163,154,317,大武,三等
2020-02-14,5190,190,151,341,大武,三等
2020-02-15,5190,172,143,315,大武,三等
2020-02-16,5190,192,174,366,大武,三等
2020-02-17,5190,144,180,324,大武,三等
2020-02-18,5190,143,146,289,大武,三等
2020-02-19,5190,126,128,254,大武,三等
2020-02-20,5190,140,126,266,大武,三等
2020-02-21,5190,253,206,459,大武,三等
2020-02-22,5190,188,154,342,大武,三等
2020-02-23,5190,162,187,349,大武,三等
2020-02-24,5190,168,210,378,大武,三等
2020-02-25,5190,116,138,254,大武,三等
2020-02-26,5190,130,141,271,大武,三等
2020-02-27,5190,274,217,491,大武,三等
2020-02-28,5190,182,162,344,大武,三等
2020-02-29,5190,148,113,261,大武,三等
2020-03-01,5190,246,241,487,大武,三等
2020-03-02,5190,169,180,349,大武,三等
2020-03-03,5190,98,184,282,大武,三等
2020-03-04,5190,116,106,222,大武,三等
2020-03-05,5190,115,126,241,大武,三等
2020-03-06,5190,234,198,432,大武,三等
2020-03-07,5190,141,120,261,大武,三等
2020-03-08,5190,232,194,426,大武,三等
2020-03-09,5190,137,197,334,大武,三等
2020-03-10,5190,122,112,234,大武,三等
2020-03-11,5190,121,131,252,大武,三等
2020-03-12,5190,165,141,306,大武,三等
2020-03-13,5190,238,205,443,大武,三等
2020-03-14,5190,119,114,233,大武,三等
2020-03-15,5190,224,190,414,大武,三等
2020-03-16,5190,126,147,273,大武,三等
2020-03-17,5190,140,122,262,大武,三等
2020-03-18,5190,127,115,242,大武,三等
2020-03-19,5190,115,120,235,大武,三等
2020-03-20,5190,267,220,487,大武,三等
2020-03-21,5190,130,110,240,大武,三等
2020-03-22,5190,247,194,441,大武,三等
2020-03-23,5190,136,168,304,大武,三等
2020-03-24,5190,91,107,198,大武,三等
2020-03-25,5190,118,123,241,大武,三等
2020-03-26,5190,116,125,241,大武,三等
2020-03-27,5190,218,206,424,大武,三等
2020-03-28,5190,220,156,376,大武,三等
2020-03-29,5190,206,208,414,大武,三等
2020-03-30,5190,119,173,292,大武,三等
2020-03-31,5190,107,177,284,大武,三等
2020-04-01,5190,301,352,653,大武,三等
2020-04-02,5190,151,307,458,大武,三等
2020-04-03,5190,207,272,479,大武,三等
2020-04-04,5190,242,172,414,大武,三等
2020-04-05,5190,404,256,660,大武,三等
2020-04-06,5190,156,153,309,大武,三等
2020-04-07,5190,110,93,203,大武,三等
2020-04-08,5190,144,109,253,大武,三等
2020-04-09,5190,93,93,186,大武,三等
2020-04-10,5190,248,198,446,大武,三等
2020-04-11,5190,119,106,225,大武,三等
2020-04-12,5190,159,168,327,大武,三等
2020-04-13,5190,95,127,222,大武,三等
2020-04-14,5190,91,110,201,大武,三等
2020-04-15,5190,110,110,220,大武,三等
2020-04-16,5190,97,85,182,大武,三等
2020-04-17,5190,239,219,458,大武,三等
2020-04-18,5190,98,92,190,大武,三等
2020-04-19,5190,167,187,354,大武,三等
2020-04-20,5190,94,145,239,大武,三等
2020-04-21,5190,96,81,177,大武,三等
2020-04-22,5190,86,109,195,大武,三等
2020-04-23,5190,99,86,185,大武,三等
2020-04-24,5190,202,223,425,大武,三等
2020-04-25,5190,104,85,189,大武,三等
2020-04-26,5190,195,146,341,大武,三等
2020-04-27,5190,92,132,224,大武,三等
2020-04-28,5190,97,110,207,大武,三等
2020-04-29,5190,107,123,230,大武,三等
2020-04-30,5190,187,138,325,大武,三等
2020-05-01,5190,156,218,374,大武,三等
2020-05-02,5190,147,111,258,大武,三等
2020-05-03,5190,203,169,372,大武,三等
2020-05-04,5190,117,151,268,大武,三等
2020-05-05,5190,101,92,193,大武,三等
2020-05-06,5190,120,124,244,大武,三等
2020-05-07,5190,120,118,238,大武,三等
2020-05-08,5190,247,245,492,大武,三等
2020-05-09,5190,110,124,234,大武,三等
2020-05-10,5190,235,231,466,大武,三等
2020-05-11,5190,116,147,263,大武,三等
2020-05-12,5190,112,102,214,大武,三等
2020-05-13,5190,111,103,214,大武,三等
2020-05-14,5190,112,114,226,大武,三等
2020-05-15,5190,233,195,428,大武,三等
2020-05-16,5190,112,132,244,大武,三等
2020-05-17,5190,183,165,348,大武,三等
2020-05-18,5190,100,129,229,大武,三等
2020-05-19,5190,109,84,193,大武,三等
2020-05-20,5190,116,102,218,大武,三等
2020-05-21,5190,116,101,217,大武,三等
2020-05-22,5190,204,183,387,大武,三等
2020-05-23,5190,99,81,180,大武,三等
2020-05-24,5190,167,223,390,大武,三等
2020-05-25,5190,136,148,284,大武,三等
2020-05-26,5190,117,112,229,大武,三等
2020-05-27,5190,101,146,247,大武,三等
2020-05-28,5190,134,128,262,大武,三等
2020-05-29,5190,230,199,429,大武,三等
2020-05-30,5190,124,122,246,大武,三等
2020-05-31,5190,190,184,374,大武,三等
2020-06-01,5190,119,173,292,大武,三等
2020-06-02,5190,130,137,267,大武,三等
2020-06-03,5190,123,110,233,大武,三等
2020-06-04,5190,151,115,266,大武,三等
2020-06-05,5190,295,233,528,大武,三等
2020-06-06,5190,132,137,269,大武,三等
2020-06-07,5190,257,263,520,大武,三等
2020-06-08,5190,120,169,289,大武,三等
2020-06-09,5190,120,108,228,大武,三等
2020-06-10,5190,150,114,264,大武,三等
2020-06-11,5190,138,106,244,大武,三等
2020-06-12,5190,274,212,486,大武,三等
2020-06-13,5190,198,191,389,大武,三等
2020-06-14,5190,220,231,451,大武,三等
2020-06-15,5190,123,157,280,大武,三等
2020-06-16,5190,120,114,234,大武,三等
2020-06-17,5190,125,126,251,大武,三等
2020-06-18,5190,125,130,255,大武,三等
2020-06-19,5190,192,197,389,大武,三等
2020-06-20,5190,162,160,322,大武,三等
2020-06-21,5190,185,180,365,大武,三等
2020-06-22,5190,148,165,313,大武,三等
2020-06-23,5190,124,153,277,大武,三等
2020-06-24,5190,307,276,583,大武,三等
2020-06-25,5190,171,233,404,大武,三等
2020-06-26,5190,197,215,412,大武,三等
2020-06-27,5190,232,170,402,大武,三等
2020-06-28,5190,338,288,626,大武,三等
2020-06-29,5190,188,206,394,大武,三等
2020-06-30,5190,154,144,298,大武,三等
2020-07-01,5190,124,147,271,大武,三等
2020-07-02,5190,174,137,311,大武,三等
2020-07-03,5190,233,200,433,大武,三等
2020-07-04,5190,126,116,242,大武,三等
2020-07-05,5190,156,226,382,大武,三等
2020-07-06,5190,134,158,292,大武,三等
2020-07-07,5190,142,148,290,大武,三等
2020-07-08,5190,155,151,306,大武,三等
2020-07-09,5190,183,173,356,大武,三等
2020-07-10,5190,266,217,483,大武,三等
2020-07-11,5190,128,138,266,大武,三等
2020-07-12,5190,210,218,428,大武,三等
2020-07-13,5190,147,192,339,大武,三等
2020-07-14,5190,136,165,301,大武,三等
2020-07-15,5190,139,161,300,大武,三等
2020-07-16,5190,181,171,352,大武,三等
2020-07-17,5190,291,204,495,大武,三等
2020-07-18,5190,146,155,301,大武,三等
2020-07-19,5190,247,246,493,大武,三等
2020-07-20,5190,236,205,441,大武,三等
2020-07-21,5190,157,130,287,大武,三等
2020-07-22,5190,150,147,297,大武,三等
2020-07-23,5190,166,161,327,大武,三等
2020-07-24,5190,235,261,496,大武,三等
2020-07-25,5190,160,205,365,大武,三等
2020-07-26,5190,235,213,448,大武,三等
2020-07-27,5190,190,168,358,大武,三等
2020-07-28,5190,132,225,357,大武,三等
2020-07-29,5190,141,136,277,大武,三等
2020-07-30,5190,159,162,321,大武,三等
2020-07-31,5190,271,228,499,大武,三等
2020-08-01,5190,133,116,249,大武,三等
2020-08-02,5190,180,217,397,大武,三等
2020-08-03,5190,152,227,379,大武,三等
2020-08-04,5190,159,143,302,大武,三等
2020-08-05,5190,158,146,304,大武,三等
2020-08-06,5190,155,125,280,大武,三等
2020-08-07,5190,266,233,499,大武,三等
2020-08-08,5190,132,201,333,大武,三等
2020-08-09,5190,275,265,540,大武,三等
2020-08-10,5190,161,151,312,大武,三等
2020-08-11,5190,155,173,328,大武,三等
2020-08-12,5190,127,130,257,大武,三等
2020-08-13,5190,171,182,353,大武,三等
2020-08-14,5190,288,210,498,大武,三等
2020-08-15,5190,163,144,307,大武,三等
2020-08-16,5190,203,245,448,大武,三等
2020-08-17,5190,173,196,369,大武,三等
2020-08-18,5190,140,205,345,大武,三等
2020-08-19,5190,136,150,286,大武,三等
2020-08-20,5190,182,196,378,大武,三等
2020-08-21,5190,247,367,614,大武,三等
2020-08-22,5190,267,173,440,大武,三等
2020-08-23,5190,270,207,477,大武,三等
2020-08-24,5190,209,249,458,大武,三等
2020-08-25,5190,153,141,294,大武,三等
2020-08-26,5190,150,161,311,大武,三等
2020-08-27,5190,189,178,367,大武,三等
2020-08-28,5190,224,238,462,大武,三等
2020-08-29,5190,145,119,264,大武,三等
2020-08-30,5190,206,240,446,大武,三等
2020-08-31,5190,155,144,299,大武,三等
2020-09-01,5190,103,115,218,大武,三等
2020-09-02,5190,188,127,315,大武,三等
2020-09-03,5190,119,121,240,大武,三等
2020-09-04,5190,232,194,426,大武,三等
2020-09-05,5190,160,159,319,大武,三等
2020-09-06,5190,225,263,488,大武,三等
2020-09-07,5190,125,167,292,大武,三等
2020-09-08,5190,119,122,241,大武,三等
2020-09-09,5190,138,141,279,大武,三等
2020-09-10,5190,134,97,231,大武,三等
2020-09-11,5190,220,176,396,大武,三等
2020-09-12,5190,144,151,295,大武,三等
2020-09-13,5190,200,206,406,大武,三等
2020-09-14,5190,90,129,219,大武,三等
2020-09-15,5190,106,198,304,大武,三等
2020-09-16,5190,107,126,233,大武,三等
2020-09-17,5190,105,89,194,大武,三等
2020-09-18,5190,235,238,473,大武,三等
2020-09-19,5190,130,116,246,大武,三等
2020-09-20,5190,195,226,421,大武,三等
2020-09-21,5190,93,131,224,大武,三等
2020-09-22,5190,105,122,227,大武,三等
2020-09-23,5190,106,93,199,大武,三等
2020-09-24,5190,108,113,221,大武,三等
2020-09-25,5190,180,166,346,大武,三等
2020-09-26,5190,175,150,325,大武,三等
2020-09-27,5190,154,214,368,大武,三等
2020-09-28,5190,138,147,285,大武,三等
2020-09-29,5190,117,116,233,大武,三等
2020-09-30,5190,293,339,632,大武,三等
2020-10-01,5190,181,331,512,大武,三等
2020-10-02,5190,183,189,372,大武,三等
2020-10-03,5190,211,145,356,大武,三等
2020-10-04,5190,429,285,714,大武,三等
2020-10-05,5190,160,172,332,大武,三等
2020-10-06,5190,102,112,214,大武,三等
2020-10-07,5190,128,116,244,大武,三等
2020-10-08,5190,256,298,554,大武,三等
2020-10-09,5190,224,304,528,大武,三等
2020-10-10,5190,197,150,347,大武,三等
2020-10-11,5190,300,270,570,大武,三等
2020-10-12,5190,151,158,309,大武,三等
2020-10-13,5190,129,114,243,大武,三等
2020-10-14,5190,106,111,217,大武,三等
2020-10-15,5190,117,132,249,大武,三等
2020-10-16,5190,234,195,429,大武,三等
2020-10-17,5190,149,180,329,大武,三等
2020-10-18,5190,211,215,426,大武,三等
2020-10-19,5190,129,133,262,大武,三等
2020-10-20,5190,119,114,233,大武,三等
2020-10-21,5190,93,123,216,大武,三等
2020-10-22,5190,100,152,252,大武,三等
2020-10-23,5190,247,234,481,大武,三等
2020-10-24,5190,167,138,305,大武,三等
2020-10-25,5190,212,251,463,大武,三等
2020-10-26,5190,133,174,307,大武,三等
2020-10-27,5190,118,114,232,大武,三等
2020-10-28,5190,129,118,247,大武,三等
2020-10-29,5190,164,108,272,大武,三等
2020-10-30,5190,281,229,510,大武,三等
2020-10-31,5190,121,129,250,大武,三等
2020-11-01,5190,249,253,502,大武,三等
2020-11-02,5190,121,135,256,大武,三等
2020-11-03,5190,103,110,213,大武,三等
2020-11-04,5190,137,126,263,大武,三等
2020-11-05,5190,118,112,230,大武,三等
2020-11-06,5190,219,171,390,大武,三等
2020-11-07,5190,134,138,272,大武,三等
2020-11-08,5190,245,182,427,大武,三等
2020-11-09,5190,119,130,249,大武,三等
2020-11-10,5190,141,118,259,大武,三等
2020-11-11,5190,118,121,239,大武,三等
2020-11-12,5190,129,126,255,大武,三等
2020-11-13,5190,242,261,503,大武,三等
2020-11-14,5190,139,144,283,大武,三等
2020-11-15,5190,324,274,598,大武,三等
2020-11-16,5190,145,151,296,大武,三等
2020-11-17,5190,140,136,276,大武,三等
2020-11-18,5190,136,135,271,大武,三等
2020-11-19,5190,143,156,299,大武,三等
2020-11-20,5190,245,248,493,大武,三等
2020-11-21,5190,181,186,367,大武,三等
2020-11-22,5190,309,240,549,大武,三等
2020-11-23,5190,155,155,310,大武,三等
2020-11-24,5190,146,153,299,大武,三等
2020-11-25,5190,141,125,266,大武,三等
2020-11-26,5190,170,140,310,大武,三等
2020-11-27,5190,239,243,482,大武,三等
2020-11-28,5190,226,249,475,大武,三等
2020-11-29,5190,321,236,557,大武,三等
2020-11-30,5190,131,189,320,大武,三等
2020-12-01,5190,141,175,316,大武,三等
2020-12-02,5190,139,152,291,大武,三等
2020-12-03,5190,136,136,272,大武,三等
2020-12-04,5190,281,254,535,大武,三等
2020-12-05,5190,195,207,402,大武,三等
2020-12-06,5190,307,338,645,大武,三等
2020-12-07,5190,161,192,353,大武,三等
2020-12-08,5190,146,130,276,大武,三等
2020-12-09,5190,142,104,246,大武,三等
2020-12-10,5190,135,129,264,大武,三等
2020-12-11,5190,288,262,550,大武,三等
2020-12-12,5190,318,271,589,大武,三等
2020-12-13,5190,315,289,604,大武,三等
2020-12-14,5190,198,217,415,大武,三等
2020-12-15,5190,167,131,298,大武,三等
2020-12-16,5190,108,126,234,大武,三等
2020-12-17,5190,182,179,361,大武,三等
2020-12-18,5190,230,307,537,大武,三等
2020-12-19,5190,275,255,530,大武,三等
2020-12-20,5190,1383,1239,2622,大武,三等
2020-12-21,5190,176,187,363,大武,三等
2020-12-22,5190,217,256,473,大武,三等
2020-12-23,5190,156,156,312,大武,三等
2020-12-24,5190,154,124,278,大武,三等
2020-12-25,5190,317,257,574,大武,三等
2020-12-26,5190,155,139,294,大武,三等
2020-12-27,5190,229,210,439,大武,三等
2020-12-28,5190,157,200,357,大武,三等
2020-12-29,5190,162,165,327,大武,三等
2020-12-30,5190,187,158,345,大武,三等
2020-12-31,5190,257,254,511,大武,三等
2020-01-01,5200,25,13,38,瀧溪,乙簡
2020-01-02,5200,15,26,41,瀧溪,乙簡
2020-01-03,5200,25,30,55,瀧溪,乙簡
2020-01-04,5200,26,55,81,瀧溪,乙簡
2020-01-05,5200,28,13,41,瀧溪,乙簡
2020-01-06,5200,8,16,24,瀧溪,乙簡
2020-01-07,5200,17,21,38,瀧溪,乙簡
2020-01-08,5200,9,24,33,瀧溪,乙簡
2020-01-09,5200,9,13,22,瀧溪,乙簡
2020-01-10,5200,24,43,67,瀧溪,乙簡
2020-01-11,5200,18,45,63,瀧溪,乙簡
2020-01-12,5200,49,23,72,瀧溪,乙簡
2020-01-13,5200,20,18,38,瀧溪,乙簡
2020-01-14,5200,13,17,30,瀧溪,乙簡
2020-01-15,5200,21,17,38,瀧溪,乙簡
2020-01-16,5200,19,21,40,瀧溪,乙簡
2020-01-17,5200,21,15,36,瀧溪,乙簡
2020-01-18,5200,10,16,26,瀧溪,乙簡
2020-01-19,5200,17,19,36,瀧溪,乙簡
2020-01-20,5200,19,21,40,瀧溪,乙簡
2020-01-21,5200,20,16,36,瀧溪,乙簡
2020-01-22,5200,20,24,44,瀧溪,乙簡
2020-01-23,5200,12,29,41,瀧溪,乙簡
2020-01-24,5200,31,48,79,瀧溪,乙簡
2020-01-25,5200,41,64,105,瀧溪,乙簡
2020-01-26,5200,51,46,97,瀧溪,乙簡
2020-01-27,5200,78,48,126,瀧溪,乙簡
2020-01-28,5200,54,20,74,瀧溪,乙簡
2020-01-29,5200,61,24,85,瀧溪,乙簡
2020-01-30,5200,49,21,70,瀧溪,乙簡
2020-01-31,5200,13,178,191,瀧溪,乙簡
2020-02-01,5200,20,11,31,瀧溪,乙簡
2020-02-02,5200,16,16,32,瀧溪,乙簡
2020-02-03,5200,14,11,25,瀧溪,乙簡
2020-02-04,5200,9,12,21,瀧溪,乙簡
2020-02-05,5200,13,13,26,瀧溪,乙簡
2020-02-06,5200,7,15,22,瀧溪,乙簡
2020-02-07,5200,25,11,36,瀧溪,乙簡
2020-02-08,5200,24,20,44,瀧溪,乙簡
2020-02-09,5200,9,21,30,瀧溪,乙簡
2020-02-10,5200,18,29,47,瀧溪,乙簡
2020-02-11,5200,24,10,34,瀧溪,乙簡
2020-02-12,5200,15,10,25,瀧溪,乙簡
2020-02-13,5200,10,4,14,瀧溪,乙簡
2020-02-14,5200,20,12,32,瀧溪,乙簡
2020-02-15,5200,27,26,53,瀧溪,乙簡
2020-02-16,5200,27,15,42,瀧溪,乙簡
2020-02-17,5200,25,22,47,瀧溪,乙簡
2020-02-18,5200,27,7,34,瀧溪,乙簡
2020-02-19,5200,15,16,31,瀧溪,乙簡
2020-02-20,5200,12,25,37,瀧溪,乙簡
2020-02-21,5200,18,19,37,瀧溪,乙簡
2020-02-22,5200,16,6,22,瀧溪,乙簡
2020-02-23,5200,22,30,52,瀧溪,乙簡
2020-02-24,5200,19,17,36,瀧溪,乙簡
2020-02-25,5200,17,17,34,瀧溪,乙簡
2020-02-26,5200,12,15,27,瀧溪,乙簡
2020-02-27,5200,17,49,66,瀧溪,乙簡
2020-02-28,5200,26,33,59,瀧溪,乙簡
2020-02-29,5200,25,53,78,瀧溪,乙簡
2020-03-01,5200,47,19,66,瀧溪,乙簡
2020-03-02,5200,15,12,27,瀧溪,乙簡
2020-03-03,5200,17,16,33,瀧溪,乙簡
2020-03-04,5200,6,11,17,瀧溪,乙簡
2020-03-05,5200,12,20,32,瀧溪,乙簡
2020-03-06,5200,20,28,48,瀧溪,乙簡
2020-03-07,5200,20,13,33,瀧溪,乙簡
2020-03-08,5200,29,13,42,瀧溪,乙簡
2020-03-09,5200,15,9,24,瀧溪,乙簡
2020-03-10,5200,11,10,21,瀧溪,乙簡
2020-03-11,5200,11,11,22,瀧溪,乙簡
2020-03-12,5200,16,13,29,瀧溪,乙簡
2020-03-13,5200,23,45,68,瀧溪,乙簡
2020-03-14,5200,5,20,25,瀧溪,乙簡
2020-03-15,5200,30,22,52,瀧溪,乙簡
2020-03-16,5200,21,14,35,瀧溪,乙簡
2020-03-17,5200,18,9,27,瀧溪,乙簡
2020-03-18,5200,11,16,27,瀧溪,乙簡
2020-03-19,5200,8,14,22,瀧溪,乙簡
2020-03-20,5200,20,32,52,瀧溪,乙簡
2020-03-21,5200,15,22,37,瀧溪,乙簡
2020-03-22,5200,27,11,38,瀧溪,乙簡
2020-03-23,5200,12,11,23,瀧溪,乙簡
2020-03-24,5200,7,9,16,瀧溪,乙簡
2020-03-25,5200,10,13,23,瀧溪,乙簡
2020-03-26,5200,21,20,41,瀧溪,乙簡
2020-03-27,5200,18,34,52,瀧溪,乙簡
2020-03-28,5200,20,25,45,瀧溪,乙簡
2020-03-29,5200,46,13,59,瀧溪,乙簡
2020-03-30,5200,13,16,29,瀧溪,乙簡
2020-03-31,5200,9,13,22,瀧溪,乙簡
2020-04-01,5200,52,46,98,瀧溪,乙簡
2020-04-02,5200,17,62,79,瀧溪,乙簡
2020-04-03,5200,18,47,65,瀧溪,乙簡
2020-04-04,5200,43,20,63,瀧溪,乙簡
2020-04-05,5200,71,17,88,瀧溪,乙簡
2020-04-06,5200,36,17,53,瀧溪,乙簡
2020-04-07,5200,24,15,39,瀧溪,乙簡
2020-04-08,5200,9,13,22,瀧溪,乙簡
2020-04-09,5200,18,11,29,瀧溪,乙簡
2020-04-10,5200,13,29,42,瀧溪,乙簡
2020-04-11,5200,17,10,27,瀧溪,乙簡
2020-04-12,5200,18,13,31,瀧溪,乙簡
2020-04-13,5200,18,9,27,瀧溪,乙簡
2020-04-14,5200,6,12,18,瀧溪,乙簡
2020-04-15,5200,8,13,21,瀧溪,乙簡
2020-04-16,5200,14,18,32,瀧溪,乙簡
2020-04-17,5200,16,34,50,瀧溪,乙簡
2020-04-18,5200,16,16,32,瀧溪,乙簡
2020-04-19,5200,27,12,39,瀧溪,乙簡
2020-04-20,5200,14,10,24,瀧溪,乙簡
2020-04-21,5200,11,8,19,瀧溪,乙簡
2020-04-22,5200,9,7,16,瀧溪,乙簡
2020-04-23,5200,10,9,19,瀧溪,乙簡
2020-04-24,5200,13,19,32,瀧溪,乙簡
2020-04-25,5200,14,15,29,瀧溪,乙簡
2020-04-26,5200,16,17,33,瀧溪,乙簡
2020-04-27,5200,6,5,11,瀧溪,乙簡
2020-04-28,5200,12,8,20,瀧溪,乙簡
2020-04-29,5200,11,6,17,瀧溪,乙簡
2020-04-30,5200,9,10,19,瀧溪,乙簡
2020-05-01,5200,13,23,36,瀧溪,乙簡
2020-05-02,5200,14,20,34,瀧溪,乙簡
2020-05-03,5200,32,14,46,瀧溪,乙簡
2020-05-04,5200,15,9,24,瀧溪,乙簡
2020-05-05,5200,6,9,15,瀧溪,乙簡
2020-05-06,5200,5,9,14,瀧溪,乙簡
2020-05-07,5200,15,18,33,瀧溪,乙簡
2020-05-08,5200,15,31,46,瀧溪,乙簡
2020-05-09,5200,11,28,39,瀧溪,乙簡
2020-05-10,5200,66,18,84,瀧溪,乙簡
2020-05-11,5200,13,9,22,瀧溪,乙簡
2020-05-12,5200,7,10,17,瀧溪,乙簡
2020-05-13,5200,15,10,25,瀧溪,乙簡
2020-05-14,5200,17,6,23,瀧溪,乙簡
2020-05-15,5200,11,30,41,瀧溪,乙簡
2020-05-16,5200,15,16,31,瀧溪,乙簡
2020-05-17,5200,29,15,44,瀧溪,乙簡
2020-05-18,5200,11,12,23,瀧溪,乙簡
2020-05-19,5200,17,15,32,瀧溪,乙簡
2020-05-20,5200,3,16,19,瀧溪,乙簡
2020-05-21,5200,17,15,32,瀧溪,乙簡
2020-05-22,5200,7,30,37,瀧溪,乙簡
2020-05-23,5200,5,13,18,瀧溪,乙簡
2020-05-24,5200,24,8,32,瀧溪,乙簡
2020-05-25,5200,10,18,28,瀧溪,乙簡
2020-05-26,5200,9,9,18,瀧溪,乙簡
2020-05-27,5200,8,10,18,瀧溪,乙簡
2020-05-28,5200,19,13,32,瀧溪,乙簡
2020-05-29,5200,14,36,50,瀧溪,乙簡
2020-05-30,5200,8,17,25,瀧溪,乙簡
2020-05-31,5200,38,25,63,瀧溪,乙簡
2020-06-01,5200,13,12,25,瀧溪,乙簡
2020-06-02,5200,9,17,26,瀧溪,乙簡
2020-06-03,5200,13,14,27,瀧溪,乙簡
2020-06-04,5200,10,14,24,瀧溪,乙簡
2020-06-05,5200,18,39,57,瀧溪,乙簡
2020-06-06,5200,19,28,47,瀧溪,乙簡
2020-06-07,5200,54,28,82,瀧溪,乙簡
2020-06-08,5200,7,17,24,瀧溪,乙簡
2020-06-09,5200,11,10,21,瀧溪,乙簡
2020-06-10,5200,10,11,21,瀧溪,乙簡
2020-06-11,5200,14,15,29,瀧溪,乙簡
2020-06-12,5200,27,41,68,瀧溪,乙簡
2020-06-13,5200,17,15,32,瀧溪,乙簡
2020-06-14,5200,42,22,64,瀧溪,乙簡
2020-06-15,5200,23,25,48,瀧溪,乙簡
2020-06-16,5200,15,12,27,瀧溪,乙簡
2020-06-17,5200,21,15,36,瀧溪,乙簡
2020-06-18,5200,16,21,37,瀧溪,乙簡
2020-06-19,5200,20,31,51,瀧溪,乙簡
2020-06-20,5200,16,17,33,瀧溪,乙簡
2020-06-21,5200,38,17,55,瀧溪,乙簡
2020-06-22,5200,16,27,43,瀧溪,乙簡
2020-06-23,5200,30,20,50,瀧溪,乙簡
2020-06-24,5200,22,38,60,瀧溪,乙簡
2020-06-25,5200,16,38,54,瀧溪,乙簡
2020-06-26,5200,19,35,54,瀧溪,乙簡
2020-06-27,5200,56,55,111,瀧溪,乙簡
2020-06-28,5200,53,24,77,瀧溪,乙簡
2020-06-29,5200,33,24,57,瀧溪,乙簡
2020-06-30,5200,23,27,50,瀧溪,乙簡
2020-07-01,5200,17,23,40,瀧溪,乙簡
2020-07-02,5200,14,20,34,瀧溪,乙簡
2020-07-03,5200,14,18,32,瀧溪,乙簡
2020-07-04,5200,13,17,30,瀧溪,乙簡
2020-07-05,5200,19,19,38,瀧溪,乙簡
2020-07-06,5200,16,18,34,瀧溪,乙簡
2020-07-07,5200,23,21,44,瀧溪,乙簡
2020-07-08,5200,10,15,25,瀧溪,乙簡
2020-07-09,5200,14,10,24,瀧溪,乙簡
2020-07-10,5200,27,29,56,瀧溪,乙簡
2020-07-11,5200,31,23,54,瀧溪,乙簡
2020-07-12,5200,60,30,90,瀧溪,乙簡
2020-07-13,5200,18,26,44,瀧溪,乙簡
2020-07-14,5200,16,19,35,瀧溪,乙簡
2020-07-15,5200,16,24,40,瀧溪,乙簡
2020-07-16,5200,13,34,47,瀧溪,乙簡
2020-07-17,5200,21,45,66,瀧溪,乙簡
2020-07-18,5200,25,27,52,瀧溪,乙簡
2020-07-19,5200,36,24,60,瀧溪,乙簡
2020-07-20,5200,16,19,35,瀧溪,乙簡
2020-07-21,5200,13,14,27,瀧溪,乙簡
2020-07-22,5200,24,30,54,瀧溪,乙簡
2020-07-23,5200,22,23,45,瀧溪,乙簡
2020-07-24,5200,28,47,75,瀧溪,乙簡
2020-07-25,5200,37,30,67,瀧溪,乙簡
2020-07-26,5200,54,23,77,瀧溪,乙簡
2020-07-27,5200,14,17,31,瀧溪,乙簡
2020-07-28,5200,29,18,47,瀧溪,乙簡
2020-07-29,5200,15,16,31,瀧溪,乙簡
2020-07-30,5200,4,12,16,瀧溪,乙簡
2020-07-31,5200,18,22,40,瀧溪,乙簡
2020-08-01,5200,29,32,61,瀧溪,乙簡
2020-08-02,5200,17,42,59,瀧溪,乙簡
2020-08-03,5200,16,14,30,瀧溪,乙簡
2020-08-04,5200,16,8,24,瀧溪,乙簡
2020-08-05,5200,9,28,37,瀧溪,乙簡
2020-08-06,5200,23,17,40,瀧溪,乙簡
2020-08-07,5200,12,13,25,瀧溪,乙簡
2020-08-08,5200,18,23,41,瀧溪,乙簡
2020-08-09,5200,42,31,73,瀧溪,乙簡
2020-08-10,5200,22,25,47,瀧溪,乙簡
2020-08-11,5200,26,32,58,瀧溪,乙簡
2020-08-12,5200,26,17,43,瀧溪,乙簡
2020-08-13,5200,27,22,49,瀧溪,乙簡
2020-08-14,5200,32,25,57,瀧溪,乙簡
2020-08-15,5200,29,21,50,瀧溪,乙簡
2020-08-16,5200,33,27,60,瀧溪,乙簡
2020-08-17,5200,20,31,51,瀧溪,乙簡
2020-08-18,5200,21,15,36,瀧溪,乙簡
2020-08-19,5200,18,17,35,瀧溪,乙簡
2020-08-20,5200,18,34,52,瀧溪,乙簡
2020-08-21,5200,23,27,50,瀧溪,乙簡
2020-08-22,5200,17,30,47,瀧溪,乙簡
2020-08-23,5200,82,45,127,瀧溪,乙簡
2020-08-24,5200,35,29,64,瀧溪,乙簡
2020-08-25,5200,32,23,55,瀧溪,乙簡
2020-08-26,5200,34,26,60,瀧溪,乙簡
2020-08-27,5200,11,15,26,瀧溪,乙簡
2020-08-28,5200,32,26,58,瀧溪,乙簡
2020-08-29,5200,10,11,21,瀧溪,乙簡
2020-08-30,5200,38,23,61,瀧溪,乙簡
2020-08-31,5200,24,13,37,瀧溪,乙簡
2020-09-01,5200,12,19,31,瀧溪,乙簡
2020-09-02,5200,13,13,26,瀧溪,乙簡
2020-09-03,5200,12,18,30,瀧溪,乙簡
2020-09-04,5200,24,30,54,瀧溪,乙簡
2020-09-05,5200,12,19,31,瀧溪,乙簡
2020-09-06,5200,46,18,64,瀧溪,乙簡
2020-09-07,5200,13,28,41,瀧溪,乙簡
2020-09-08,5200,16,17,33,瀧溪,乙簡
2020-09-09,5200,23,29,52,瀧溪,乙簡
2020-09-10,5200,19,33,52,瀧溪,乙簡
2020-09-11,5200,47,31,78,瀧溪,乙簡
2020-09-12,5200,17,14,31,瀧溪,乙簡
2020-09-13,5200,38,30,68,瀧溪,乙簡
2020-09-14,5200,21,22,43,瀧溪,乙簡
2020-09-15,5200,16,17,33,瀧溪,乙簡
2020-09-16,5200,14,13,27,瀧溪,乙簡
2020-09-17,5200,9,16,25,瀧溪,乙簡
2020-09-18,5200,37,25,62,瀧溪,乙簡
2020-09-19,5200,32,25,57,瀧溪,乙簡
2020-09-20,5200,32,16,48,瀧溪,乙簡
2020-09-21,5200,17,16,33,瀧溪,乙簡
2020-09-22,5200,13,23,36,瀧溪,乙簡
2020-09-23,5200,11,15,26,瀧溪,乙簡
2020-09-24,5200,14,26,40,瀧溪,乙簡
2020-09-25,5200,19,18,37,瀧溪,乙簡
2020-09-26,5200,20,24,44,瀧溪,乙簡
2020-09-27,5200,46,17,63,瀧溪,乙簡
2020-09-28,5200,16,17,33,瀧溪,乙簡
2020-09-29,5200,15,10,25,瀧溪,乙簡
2020-09-30,5200,26,45,71,瀧溪,乙簡
2020-10-01,5200,20,55,75,瀧溪,乙簡
2020-10-02,5200,23,100,123,瀧溪,乙簡
2020-10-03,5200,53,19,72,瀧溪,乙簡
2020-10-04,5200,80,31,111,瀧溪,乙簡
2020-10-05,5200,18,17,35,瀧溪,乙簡
2020-10-06,5200,13,12,25,瀧溪,乙簡
2020-10-07,5200,18,20,38,瀧溪,乙簡
2020-10-08,5200,18,43,61,瀧溪,乙簡
2020-10-09,5200,42,52,94,瀧溪,乙簡
2020-10-10,5200,16,27,43,瀧溪,乙簡
2020-10-11,5200,58,25,83,瀧溪,乙簡
2020-10-12,5200,13,11,24,瀧溪,乙簡
2020-10-13,5200,18,15,33,瀧溪,乙簡
2020-10-14,5200,19,13,32,瀧溪,乙簡
2020-10-15,5200,19,21,40,瀧溪,乙簡
2020-10-16,5200,20,43,63,瀧溪,乙簡
2020-10-17,5200,17,13,30,瀧溪,乙簡
2020-10-18,5200,36,21,57,瀧溪,乙簡
2020-10-19,5200,9,10,19,瀧溪,乙簡
2020-10-20,5200,51,16,67,瀧溪,乙簡
2020-10-21,5200,19,21,40,瀧溪,乙簡
2020-10-22,5200,13,43,56,瀧溪,乙簡
2020-10-23,5200,34,41,75,瀧溪,乙簡
2020-10-24,5200,20,19,39,瀧溪,乙簡
2020-10-25,5200,46,8,54,瀧溪,乙簡
2020-10-26,5200,22,14,36,瀧溪,乙簡
2020-10-27,5200,21,22,43,瀧溪,乙簡
2020-10-28,5200,19,118,137,瀧溪,乙簡
2020-10-29,5200,11,16,27,瀧溪,乙簡
2020-10-30,5200,54,55,109,瀧溪,乙簡
2020-10-31,5200,27,35,62,瀧溪,乙簡
2020-11-01,5200,35,13,48,瀧溪,乙簡
2020-11-02,5200,18,16,34,瀧溪,乙簡
2020-11-03,5200,8,15,23,瀧溪,乙簡
2020-11-04,5200,14,81,95,瀧溪,乙簡
2020-11-05,5200,11,18,29,瀧溪,乙簡
2020-11-06,5200,24,25,49,瀧溪,乙簡
2020-11-07,5200,14,20,34,瀧溪,乙簡
2020-11-08,5200,32,16,48,瀧溪,乙簡
2020-11-09,5200,23,17,40,瀧溪,乙簡
2020-11-10,5200,17,9,26,瀧溪,乙簡
2020-11-11,5200,19,20,39,瀧溪,乙簡
2020-11-12,5200,12,15,27,瀧溪,乙簡
2020-11-13,5200,19,23,42,瀧溪,乙簡
2020-11-14,5200,18,28,46,瀧溪,乙簡
2020-11-15,5200,28,15,43,瀧溪,乙簡
2020-11-16,5200,17,10,27,瀧溪,乙簡
2020-11-17,5200,12,9,21,瀧溪,乙簡
2020-11-18,5200,30,16,46,瀧溪,乙簡
2020-11-19,5200,21,19,40,瀧溪,乙簡
2020-11-20,5200,19,26,45,瀧溪,乙簡
2020-11-21,5200,13,14,27,瀧溪,乙簡
2020-11-22,5200,33,19,52,瀧溪,乙簡
2020-11-23,5200,17,101,118,瀧溪,乙簡
2020-11-24,5200,10,11,21,瀧溪,乙簡
2020-11-25,5200,17,18,35,瀧溪,乙簡
2020-11-26,5200,10,14,24,瀧溪,乙簡
2020-11-27,5200,19,23,42,瀧溪,乙簡
2020-11-28,5200,21,34,55,瀧溪,乙簡
2020-11-29,5200,41,29,70,瀧溪,乙簡
2020-11-30,5200,23,18,41,瀧溪,乙簡
2020-12-01,5200,17,11,28,瀧溪,乙簡
2020-12-02,5200,19,22,41,瀧溪,乙簡
2020-12-03,5200,27,30,57,瀧溪,乙簡
2020-12-04,5200,23,37,60,瀧溪,乙簡
2020-12-05,5200,18,23,41,瀧溪,乙簡
2020-12-06,5200,51,26,77,瀧溪,乙簡
2020-12-07,5200,17,20,37,瀧溪,乙簡
2020-12-08,5200,9,11,20,瀧溪,乙簡
2020-12-09,5200,15,19,34,瀧溪,乙簡
2020-12-10,5200,18,20,38,瀧溪,乙簡
2020-12-11,5200,25,30,55,瀧溪,乙簡
2020-12-12,5200,65,60,125,瀧溪,乙簡
2020-12-13,5200,53,69,122,瀧溪,乙簡
2020-12-14,5200,28,19,47,瀧溪,乙簡
2020-12-15,5200,16,17,33,瀧溪,乙簡
2020-12-16,5200,15,24,39,瀧溪,乙簡
2020-12-17,5200,24,18,42,瀧溪,乙簡
2020-12-18,5200,26,44,70,瀧溪,乙簡
2020-12-19,5200,40,33,73,瀧溪,乙簡
2020-12-20,5200,55,32,87,瀧溪,乙簡
2020-12-21,5200,23,32,55,瀧溪,乙簡
2020-12-22,5200,80,97,177,瀧溪,乙簡
2020-12-23,5200,19,21,40,瀧溪,乙簡
2020-12-24,5200,13,19,32,瀧溪,乙簡
2020-12-25,5200,29,37,66,瀧溪,乙簡
2020-12-26,5200,15,28,43,瀧溪,乙簡
2020-12-27,5200,35,24,59,瀧溪,乙簡
2020-12-28,5200,18,13,31,瀧溪,乙簡
2020-12-29,5200,12,10,22,瀧溪,乙簡
2020-12-30,5200,19,23,42,瀧溪,乙簡
2020-12-31,5200,25,33,58,瀧溪,乙簡
2020-01-01,5210,598,504,1102,金崙,三等
2020-01-02,5210,390,365,755,金崙,三等
2020-01-03,5210,473,516,989,金崙,三等
2020-01-04,5210,580,597,1177,金崙,三等
2020-01-05,5210,855,537,1392,金崙,三等
2020-01-06,5210,438,421,859,金崙,三等
2020-01-07,5210,523,532,1055,金崙,三等
2020-01-08,5210,462,405,867,金崙,三等
2020-01-09,5210,423,391,814,金崙,三等
2020-01-10,5210,384,333,717,金崙,三等
2020-01-11,5210,163,234,397,金崙,三等
2020-01-12,5210,691,426,1117,金崙,三等
2020-01-13,5210,417,396,813,金崙,三等
2020-01-14,5210,429,410,839,金崙,三等
2020-01-15,5210,476,452,928,金崙,三等
2020-01-16,5210,381,387,768,金崙,三等
2020-01-17,5210,367,326,693,金崙,三等
2020-01-18,5210,342,380,722,金崙,三等
2020-01-19,5210,496,419,915,金崙,三等
2020-01-20,5210,390,359,749,金崙,三等
2020-01-21,5210,382,386,768,金崙,三等
2020-01-22,5210,245,245,490,金崙,三等
2020-01-23,5210,181,241,422,金崙,三等
2020-01-24,5210,88,119,207,金崙,三等
2020-01-25,5210,221,338,559,金崙,三等
2020-01-26,5210,382,410,792,金崙,三等
2020-01-27,5210,465,437,902,金崙,三等
2020-01-28,5210,491,370,861,金崙,三等
2020-01-29,5210,337,276,613,金崙,三等
2020-01-30,5210,438,401,839,金崙,三等
2020-01-31,5210,438,377,815,金崙,三等
2020-02-01,5210,360,331,691,金崙,三等
2020-02-02,5210,524,390,914,金崙,三等
2020-02-03,5210,355,369,724,金崙,三等
2020-02-04,5210,364,393,757,金崙,三等
2020-02-05,5210,318,317,635,金崙,三等
2020-02-06,5210,328,320,648,金崙,三等
2020-02-07,5210,265,240,505,金崙,三等
2020-02-08,5210,312,365,677,金崙,三等
2020-02-09,5210,528,434,962,金崙,三等
2020-02-10,5210,372,300,672,金崙,三等
2020-02-11,5210,247,246,493,金崙,三等
2020-02-12,5210,271,235,506,金崙,三等
2020-02-13,5210,264,264,528,金崙,三等
2020-02-14,5210,273,263,536,金崙,三等
2020-02-15,5210,277,296,573,金崙,三等
2020-02-16,5210,461,375,836,金崙,三等
2020-02-17,5210,395,268,663,金崙,三等
2020-02-18,5210,210,205,415,金崙,三等
2020-02-19,5210,175,187,362,金崙,三等
2020-02-20,5210,290,264,554,金崙,三等
2020-02-21,5210,238,223,461,金崙,三等
2020-02-22,5210,302,352,654,金崙,三等
2020-02-23,5210,425,338,763,金崙,三等
2020-02-24,5210,262,211,473,金崙,三等
2020-02-25,5210,219,223,442,金崙,三等
2020-02-26,5210,209,181,390,金崙,三等
2020-02-27,5210,262,287,549,金崙,三等
2020-02-28,5210,320,426,746,金崙,三等
2020-02-29,5210,396,318,714,金崙,三等
2020-03-01,5210,397,285,682,金崙,三等
2020-03-02,5210,215,175,390,金崙,三等
2020-03-03,5210,175,188,363,金崙,三等
2020-03-04,5210,158,168,326,金崙,三等
2020-03-05,5210,193,180,373,金崙,三等
2020-03-06,5210,159,182,341,金崙,三等
2020-03-07,5210,160,225,385,金崙,三等
2020-03-08,5210,394,247,641,金崙,三等
2020-03-09,5210,248,227,475,金崙,三等
2020-03-10,5210,218,209,427,金崙,三等
2020-03-11,5210,194,175,369,金崙,三等
2020-03-12,5210,192,215,407,金崙,三等
2020-03-13,5210,178,204,382,金崙,三等
2020-03-14,5210,267,272,539,金崙,三等
2020-03-15,5210,431,362,793,金崙,三等
2020-03-16,5210,252,201,453,金崙,三等
2020-03-17,5210,219,217,436,金崙,三等
2020-03-18,5210,163,171,334,金崙,三等
2020-03-19,5210,186,148,334,金崙,三等
2020-03-20,5210,216,237,453,金崙,三等
2020-03-21,5210,154,179,333,金崙,三等
2020-03-22,5210,314,257,571,金崙,三等
2020-03-23,5210,229,188,417,金崙,三等
2020-03-24,5210,162,134,296,金崙,三等
2020-03-25,5210,100,95,195,金崙,三等
2020-03-26,5210,127,101,228,金崙,三等
2020-03-27,5210,156,204,360,金崙,三等
2020-03-28,5210,170,187,357,金崙,三等
2020-03-29,5210,245,199,444,金崙,三等
2020-03-30,5210,164,155,319,金崙,三等
2020-03-31,5210,178,171,349,金崙,三等
2020-04-01,5210,137,243,380,金崙,三等
2020-04-02,5210,161,283,444,金崙,三等
2020-04-03,5210,208,159,367,金崙,三等
2020-04-04,5210,170,134,304,金崙,三等
2020-04-05,5210,258,149,407,金崙,三等
2020-04-06,5210,190,125,315,金崙,三等
2020-04-07,5210,113,111,224,金崙,三等
2020-04-08,5210,88,89,177,金崙,三等
2020-04-09,5210,134,126,260,金崙,三等
2020-04-10,5210,104,148,252,金崙,三等
2020-04-11,5210,121,145,266,金崙,三等
2020-04-12,5210,208,125,333,金崙,三等
2020-04-13,5210,144,106,250,金崙,三等
2020-04-14,5210,114,115,229,金崙,三等
2020-04-15,5210,98,112,210,金崙,三等
2020-04-16,5210,131,107,238,金崙,三等
2020-04-17,5210,110,182,292,金崙,三等
2020-04-18,5210,161,178,339,金崙,三等
2020-04-19,5210,255,182,437,金崙,三等
2020-04-20,5210,163,144,307,金崙,三等
2020-04-21,5210,132,142,274,金崙,三等
2020-04-22,5210,115,84,199,金崙,三等
2020-04-23,5210,112,102,214,金崙,三等
2020-04-24,5210,123,139,262,金崙,三等
2020-04-25,5210,105,122,227,金崙,三等
2020-04-26,5210,200,155,355,金崙,三等
2020-04-27,5210,142,118,260,金崙,三等
2020-04-28,5210,127,126,253,金崙,三等
2020-04-29,5210,111,109,220,金崙,三等
2020-04-30,5210,155,153,308,金崙,三等
2020-05-01,5210,156,196,352,金崙,三等
2020-05-02,5210,153,170,323,金崙,三等
2020-05-03,5210,247,141,388,金崙,三等
2020-05-04,5210,162,179,341,金崙,三等
2020-05-05,5210,209,175,384,金崙,三等
2020-05-06,5210,156,159,315,金崙,三等
2020-05-07,5210,147,131,278,金崙,三等
2020-05-08,5210,160,224,384,金崙,三等
2020-05-09,5210,165,170,335,金崙,三等
2020-05-10,5210,312,221,533,金崙,三等
2020-05-11,5210,196,188,384,金崙,三等
2020-05-12,5210,184,183,367,金崙,三等
2020-05-13,5210,216,195,411,金崙,三等
2020-05-14,5210,161,147,308,金崙,三等
2020-05-15,5210,167,221,388,金崙,三等
2020-05-16,5210,178,185,363,金崙,三等
2020-05-17,5210,321,236,557,金崙,三等
2020-05-18,5210,231,186,417,金崙,三等
2020-05-19,5210,185,176,361,金崙,三等
2020-05-20,5210,194,212,406,金崙,三等
2020-05-21,5210,170,184,354,金崙,三等
2020-05-22,5210,143,140,283,金崙,三等
2020-05-23,5210,150,183,333,金崙,三等
2020-05-24,5210,400,341,741,金崙,三等
2020-05-25,5210,248,211,459,金崙,三等
2020-05-26,5210,205,235,440,金崙,三等
2020-05-27,5210,177,147,324,金崙,三等
2020-05-28,5210,226,218,444,金崙,三等
2020-05-29,5210,229,254,483,金崙,三等
2020-05-30,5210,323,357,680,金崙,三等
2020-05-31,5210,498,413,911,金崙,三等
2020-06-01,5210,308,258,566,金崙,三等
2020-06-02,5210,290,301,591,金崙,三等
2020-06-03,5210,253,251,504,金崙,三等
2020-06-04,5210,272,271,543,金崙,三等
2020-06-05,5210,231,259,490,金崙,三等
2020-06-06,5210,274,263,537,金崙,三等
2020-06-07,5210,546,490,1036,金崙,三等
2020-06-08,5210,373,352,725,金崙,三等
2020-06-09,5210,390,388,778,金崙,三等
2020-06-10,5210,267,225,492,金崙,三等
2020-06-11,5210,264,276,540,金崙,三等
2020-06-12,5210,313,323,636,金崙,三等
2020-06-13,5210,378,456,834,金崙,三等
2020-06-14,5210,507,396,903,金崙,三等
2020-06-15,5210,341,291,632,金崙,三等
2020-06-16,5210,305,309,614,金崙,三等
2020-06-17,5210,326,302,628,金崙,三等
2020-06-18,5210,319,305,624,金崙,三等
2020-06-19,5210,278,292,570,金崙,三等
2020-06-20,5210,259,316,575,金崙,三等
2020-06-21,5210,417,388,805,金崙,三等
2020-06-22,5210,374,344,718,金崙,三等
2020-06-23,5210,322,343,665,金崙,三等
2020-06-24,5210,213,216,429,金崙,三等
2020-06-25,5210,198,269,467,金崙,三等
2020-06-26,5210,497,496,993,金崙,三等
2020-06-27,5210,485,432,917,金崙,三等
2020-06-28,5210,495,360,855,金崙,三等
2020-06-29,5210,386,388,774,金崙,三等
2020-06-30,5210,425,362,787,金崙,三等
2020-07-01,5210,222,250,472,金崙,三等
2020-07-02,5210,344,353,697,金崙,三等
2020-07-03,5210,311,342,653,金崙,三等
2020-07-04,5210,342,358,700,金崙,三等
2020-07-05,5210,462,388,850,金崙,三等
2020-07-06,5210,366,350,716,金崙,三等
2020-07-07,5210,404,382,786,金崙,三等
2020-07-08,5210,270,271,541,金崙,三等
2020-07-09,5210,353,366,719,金崙,三等
2020-07-10,5210,299,314,613,金崙,三等
2020-07-11,5210,401,392,793,金崙,三等
2020-07-12,5210,518,446,964,金崙,三等
2020-07-13,5210,450,381,831,金崙,三等
2020-07-14,5210,336,320,656,金崙,三等
2020-07-15,5210,375,365,740,金崙,三等
2020-07-16,5210,354,403,757,金崙,三等
2020-07-17,5210,366,379,745,金崙,三等
2020-07-18,5210,355,358,713,金崙,三等
2020-07-19,5210,517,431,948,金崙,三等
2020-07-20,5210,432,434,866,金崙,三等
2020-07-21,5210,326,319,645,金崙,三等
2020-07-22,5210,368,355,723,金崙,三等
2020-07-23,5210,401,367,768,金崙,三等
2020-07-24,5210,309,300,609,金崙,三等
2020-07-25,5210,402,427,829,金崙,三等
2020-07-26,5210,500,397,897,金崙,三等
2020-07-27,5210,403,325,728,金崙,三等
2020-07-28,5210,338,335,673,金崙,三等
2020-07-29,5210,293,299,592,金崙,三等
2020-07-30,5210,338,328,666,金崙,三等
2020-07-31,5210,329,362,691,金崙,三等
2020-08-01,5210,325,351,676,金崙,三等
2020-08-02,5210,485,389,874,金崙,三等
2020-08-03,5210,341,293,634,金崙,三等
2020-08-04,5210,227,208,435,金崙,三等
2020-08-05,5210,246,249,495,金崙,三等
2020-08-06,5210,409,417,826,金崙,三等
2020-08-07,5210,265,273,538,金崙,三等
2020-08-08,5210,345,361,706,金崙,三等
2020-08-09,5210,640,495,1135,金崙,三等
2020-08-10,5210,392,315,707,金崙,三等
2020-08-11,5210,297,300,597,金崙,三等
2020-08-12,5210,327,345,672,金崙,三等
2020-08-13,5210,358,325,683,金崙,三等
2020-08-14,5210,318,383,701,金崙,三等
2020-08-15,5210,316,329,645,金崙,三等
2020-08-16,5210,589,489,1078,金崙,三等
2020-08-17,5210,437,409,846,金崙,三等
2020-08-18,5210,457,419,876,金崙,三等
2020-08-19,5210,213,240,453,金崙,三等
2020-08-20,5210,405,422,827,金崙,三等
2020-08-21,5210,456,481,937,金崙,三等
2020-08-22,5210,351,422,773,金崙,三等
2020-08-23,5210,487,386,873,金崙,三等
2020-08-24,5210,426,389,815,金崙,三等
2020-08-25,5210,385,356,741,金崙,三等
2020-08-26,5210,340,300,640,金崙,三等
2020-08-27,5210,351,332,683,金崙,三等
2020-08-28,5210,304,304,608,金崙,三等
2020-08-29,5210,368,346,714,金崙,三等
2020-08-30,5210,439,328,767,金崙,三等
2020-08-31,5210,281,260,541,金崙,三等
2020-09-01,5210,192,157,349,金崙,三等
2020-09-02,5210,110,107,217,金崙,三等
2020-09-03,5210,310,348,658,金崙,三等
2020-09-04,5210,295,322,617,金崙,三等
2020-09-05,5210,399,404,803,金崙,三等
2020-09-06,5210,589,420,1009,金崙,三等
2020-09-07,5210,340,330,670,金崙,三等
2020-09-08,5210,363,355,718,金崙,三等
2020-09-09,5210,299,290,589,金崙,三等
2020-09-10,5210,339,328,667,金崙,三等
2020-09-11,5210,358,365,723,金崙,三等
2020-09-12,5210,430,518,948,金崙,三等
2020-09-13,5210,622,440,1062,金崙,三等
2020-09-14,5210,334,320,654,金崙,三等
2020-09-15,5210,320,324,644,金崙,三等
2020-09-16,5210,268,276,544,金崙,三等
2020-09-17,5210,281,282,563,金崙,三等
2020-09-18,5210,320,353,673,金崙,三等
2020-09-19,5210,444,580,1024,金崙,三等
2020-09-20,5210,644,441,1085,金崙,三等
2020-09-21,5210,433,406,839,金崙,三等
2020-09-22,5210,361,301,662,金崙,三等
2020-09-23,5210,288,329,617,金崙,三等
2020-09-24,5210,400,376,776,金崙,三等
2020-09-25,5210,228,250,478,金崙,三等
2020-09-26,5210,415,430,845,金崙,三等
2020-09-27,5210,663,504,1167,金崙,三等
2020-09-28,5210,421,401,822,金崙,三等
2020-09-29,5210,452,393,845,金崙,三等
2020-09-30,5210,212,246,458,金崙,三等
2020-10-01,5210,160,234,394,金崙,三等
2020-10-02,5210,467,557,1024,金崙,三等
2020-10-03,5210,593,436,1029,金崙,三等
2020-10-04,5210,426,276,702,金崙,三等
2020-10-05,5210,377,346,723,金崙,三等
2020-10-06,5210,461,477,938,金崙,三等
2020-10-07,5210,450,414,864,金崙,三等
2020-10-08,5210,388,338,726,金崙,三等
2020-10-09,5210,363,501,864,金崙,三等
2020-10-10,5210,661,547,1208,金崙,三等
2020-10-11,5210,561,389,950,金崙,三等
2020-10-12,5210,421,356,777,金崙,三等
2020-10-13,5210,454,446,900,金崙,三等
2020-10-14,5210,463,425,888,金崙,三等
2020-10-15,5210,408,383,791,金崙,三等
2020-10-16,5210,351,410,761,金崙,三等
2020-10-17,5210,479,539,1018,金崙,三等
2020-10-18,5210,805,629,1434,金崙,三等
2020-10-19,5210,483,445,928,金崙,三等
2020-10-20,5210,456,393,849,金崙,三等
2020-10-21,5210,396,449,845,金崙,三等
2020-10-22,5210,533,475,1008,金崙,三等
2020-10-23,5210,447,435,882,金崙,三等
2020-10-24,5210,416,466,882,金崙,三等
2020-10-25,5210,770,556,1326,金崙,三等
2020-10-26,5210,540,439,979,金崙,三等
2020-10-27,5210,513,534,1047,金崙,三等
2020-10-28,5210,478,503,981,金崙,三等
2020-10-29,5210,521,518,1039,金崙,三等
2020-10-30,5210,432,475,907,金崙,三等
2020-10-31,5210,568,631,1199,金崙,三等
2020-11-01,5210,827,579,1406,金崙,三等
2020-11-02,5210,531,466,997,金崙,三等
2020-11-03,5210,494,490,984,金崙,三等
2020-11-04,5210,515,460,975,金崙,三等
2020-11-05,5210,446,441,887,金崙,三等
2020-11-06,5210,341,428,769,金崙,三等
2020-11-07,5210,495,574,1069,金崙,三等
2020-11-08,5210,836,533,1369,金崙,三等
2020-11-09,5210,513,467,980,金崙,三等
2020-11-10,5210,523,514,1037,金崙,三等
2020-11-11,5210,524,533,1057,金崙,三等
2020-11-12,5210,614,577,1191,金崙,三等
2020-11-13,5210,357,444,801,金崙,三等
2020-11-14,5210,731,702,1433,金崙,三等
2020-11-15,5210,878,655,1533,金崙,三等
2020-11-16,5210,576,510,1086,金崙,三等
2020-11-17,5210,684,647,1331,金崙,三等
2020-11-18,5210,552,578,1130,金崙,三等
2020-11-19,5210,648,603,1251,金崙,三等
2020-11-20,5210,533,557,1090,金崙,三等
2020-11-21,5210,716,734,1450,金崙,三等
2020-11-22,5210,846,721,1567,金崙,三等
2020-11-23,5210,596,570,1166,金崙,三等
2020-11-24,5210,602,568,1170,金崙,三等
2020-11-25,5210,555,543,1098,金崙,三等
2020-11-26,5210,624,590,1214,金崙,三等
2020-11-27,5210,608,612,1220,金崙,三等
2020-11-28,5210,720,741,1461,金崙,三等
2020-11-29,5210,1104,773,1877,金崙,三等
2020-11-30,5210,608,561,1169,金崙,三等
2020-12-01,5210,626,583,1209,金崙,三等
2020-12-02,5210,608,597,1205,金崙,三等
2020-12-03,5210,678,656,1334,金崙,三等
2020-12-04,5210,518,538,1056,金崙,三等
2020-12-05,5210,752,790,1542,金崙,三等
2020-12-06,5210,1081,860,1941,金崙,三等
2020-12-07,5210,766,737,1503,金崙,三等
2020-12-08,5210,653,562,1215,金崙,三等
2020-12-09,5210,577,615,1192,金崙,三等
2020-12-10,5210,717,665,1382,金崙,三等
2020-12-11,5210,581,588,1169,金崙,三等
2020-12-12,5210,772,843,1615,金崙,三等
2020-12-13,5210,1222,983,2205,金崙,三等
2020-12-14,5210,680,603,1283,金崙,三等
2020-12-15,5210,509,516,1025,金崙,三等
2020-12-16,5210,616,570,1186,金崙,三等
2020-12-17,5210,667,674,1341,金崙,三等
2020-12-18,5210,712,706,1418,金崙,三等
2020-12-19,5210,747,862,1609,金崙,三等
2020-12-20,5210,1148,845,1993,金崙,三等
2020-12-21,5210,589,581,1170,金崙,三等
2020-12-22,5210,775,835,1610,金崙,三等
2020-12-23,5210,655,692,1347,金崙,三等
2020-12-24,5210,731,692,1423,金崙,三等
2020-12-25,5210,494,497,991,金崙,三等
2020-12-26,5210,873,817,1690,金崙,三等
2020-12-27,5210,983,821,1804,金崙,三等
2020-12-28,5210,653,606,1259,金崙,三等
2020-12-29,5210,641,617,1258,金崙,三等
2020-12-30,5210,656,692,1348,金崙,三等
2020-12-31,5210,382,353,735,金崙,三等
2020-01-01,5220,258,154,412,太麻里,三等
2020-01-02,5220,118,90,208,太麻里,三等
2020-01-03,5220,139,154,293,太麻里,三等
2020-01-04,5220,131,175,306,太麻里,三等
2020-01-05,5220,213,110,323,太麻里,三等
2020-01-06,5220,84,200,284,太麻里,三等
2020-01-07,5220,125,127,252,太麻里,三等
2020-01-08,5220,107,90,197,太麻里,三等
2020-01-09,5220,106,165,271,太麻里,三等
2020-01-10,5220,198,284,482,太麻里,三等
2020-01-11,5220,202,240,442,太麻里,三等
2020-01-12,5220,292,170,462,太麻里,三等
2020-01-13,5220,135,152,287,太麻里,三等
2020-01-14,5220,132,115,247,太麻里,三等
2020-01-15,5220,117,130,247,太麻里,三等
2020-01-16,5220,94,97,191,太麻里,三等
2020-01-17,5220,117,166,283,太麻里,三等
2020-01-18,5220,141,150,291,太麻里,三等
2020-01-19,5220,144,174,318,太麻里,三等
2020-01-20,5220,167,253,420,太麻里,三等
2020-01-21,5220,165,159,324,太麻里,三等
2020-01-22,5220,253,282,535,太麻里,三等
2020-01-23,5220,135,301,436,太麻里,三等
2020-01-24,5220,119,327,446,太麻里,三等
2020-01-25,5220,268,359,627,太麻里,三等
2020-01-26,5220,401,349,750,太麻里,三等
2020-01-27,5220,362,325,687,太麻里,三等
2020-01-28,5220,373,190,563,太麻里,三等
2020-01-29,5220,361,177,538,太麻里,三等
2020-01-30,5220,309,177,486,太麻里,三等
2020-01-31,5220,248,164,412,太麻里,三等
2020-02-01,5220,195,413,608,太麻里,三等
2020-02-02,5220,250,232,482,太麻里,三等
2020-02-03,5220,193,210,403,太麻里,三等
2020-02-04,5220,139,146,285,太麻里,三等
2020-02-05,5220,153,166,319,太麻里,三等
2020-02-06,5220,136,146,282,太麻里,三等
2020-02-07,5220,188,227,415,太麻里,三等
2020-02-08,5220,112,122,234,太麻里,三等
2020-02-09,5220,194,145,339,太麻里,三等
2020-02-10,5220,123,121,244,太麻里,三等
2020-02-11,5220,112,93,205,太麻里,三等
2020-02-12,5220,93,86,179,太麻里,三等
2020-02-13,5220,108,99,207,太麻里,三等
2020-02-14,5220,96,118,214,太麻里,三等
2020-02-15,5220,128,123,251,太麻里,三等
2020-02-16,5220,130,165,295,太麻里,三等
2020-02-17,5220,109,105,214,太麻里,三等
2020-02-18,5220,122,102,224,太麻里,三等
2020-02-19,5220,79,116,195,太麻里,三等
2020-02-20,5220,118,122,240,太麻里,三等
2020-02-21,5220,212,198,410,太麻里,三等
2020-02-22,5220,113,133,246,太麻里,三等
2020-02-23,5220,157,144,301,太麻里,三等
2020-02-24,5220,121,131,252,太麻里,三等
2020-02-25,5220,119,147,266,太麻里,三等
2020-02-26,5220,114,96,210,太麻里,三等
2020-02-27,5220,169,178,347,太麻里,三等
2020-02-28,5220,161,235,396,太麻里,三等
2020-02-29,5220,166,160,326,太麻里,三等
2020-03-01,5220,305,150,455,太麻里,三等
2020-03-02,5220,81,94,175,太麻里,三等
2020-03-03,5220,112,68,180,太麻里,三等
2020-03-04,5220,61,98,159,太麻里,三等
2020-03-05,5220,81,75,156,太麻里,三等
2020-03-06,5220,110,183,293,太麻里,三等
2020-03-07,5220,95,106,201,太麻里,三等
2020-03-08,5220,179,122,301,太麻里,三等
2020-03-09,5220,76,99,175,太麻里,三等
2020-03-10,5220,71,74,145,太麻里,三等
2020-03-11,5220,82,70,152,太麻里,三等
2020-03-12,5220,69,117,186,太麻里,三等
2020-03-13,5220,151,221,372,太麻里,三等
2020-03-14,5220,120,108,228,太麻里,三等
2020-03-15,5220,185,133,318,太麻里,三等
2020-03-16,5220,116,123,239,太麻里,三等
2020-03-17,5220,72,86,158,太麻里,三等
2020-03-18,5220,95,70,165,太麻里,三等
2020-03-19,5220,65,77,142,太麻里,三等
2020-03-20,5220,124,149,273,太麻里,三等
2020-03-21,5220,87,152,239,太麻里,三等
2020-03-22,5220,233,122,355,太麻里,三等
2020-03-23,5220,107,88,195,太麻里,三等
2020-03-24,5220,57,68,125,太麻里,三等
2020-03-25,5220,65,55,120,太麻里,三等
2020-03-26,5220,73,74,147,太麻里,三等
2020-03-27,5220,105,151,256,太麻里,三等
2020-03-28,5220,88,114,202,太麻里,三等
2020-03-29,5220,172,109,281,太麻里,三等
2020-03-30,5220,93,137,230,太麻里,三等
2020-03-31,5220,92,93,185,太麻里,三等
2020-04-01,5220,149,232,381,太麻里,三等
2020-04-02,5220,114,214,328,太麻里,三等
2020-04-03,5220,129,182,311,太麻里,三等
2020-04-04,5220,184,119,303,太麻里,三等
2020-04-05,5220,322,155,477,太麻里,三等
2020-04-06,5220,128,83,211,太麻里,三等
2020-04-07,5220,70,50,120,太麻里,三等
2020-04-08,5220,63,52,115,太麻里,三等
2020-04-09,5220,59,54,113,太麻里,三等
2020-04-10,5220,116,107,223,太麻里,三等
2020-04-11,5220,47,52,99,太麻里,三等
2020-04-12,5220,103,102,205,太麻里,三等
2020-04-13,5220,83,69,152,太麻里,三等
2020-04-14,5220,56,61,117,太麻里,三等
2020-04-15,5220,51,62,113,太麻里,三等
2020-04-16,5220,60,47,107,太麻里,三等
2020-04-17,5220,97,124,221,太麻里,三等
2020-04-18,5220,53,67,120,太麻里,三等
2020-04-19,5220,144,93,237,太麻里,三等
2020-04-20,5220,76,78,154,太麻里,三等
2020-04-21,5220,51,57,108,太麻里,三等
2020-04-22,5220,47,51,98,太麻里,三等
2020-04-23,5220,49,63,112,太麻里,三等
2020-04-24,5220,109,120,229,太麻里,三等
2020-04-25,5220,59,65,124,太麻里,三等
2020-04-26,5220,103,89,192,太麻里,三等
2020-04-27,5220,82,74,156,太麻里,三等
2020-04-28,5220,59,58,117,太麻里,三等
2020-04-29,5220,58,56,114,太麻里,三等
2020-04-30,5220,85,84,169,太麻里,三等
2020-05-01,5220,97,161,258,太麻里,三等
2020-05-02,5220,92,89,181,太麻里,三等
2020-05-03,5220,196,105,301,太麻里,三等
2020-05-04,5220,100,104,204,太麻里,三等
2020-05-05,5220,101,60,161,太麻里,三等
2020-05-06,5220,62,65,127,太麻里,三等
2020-05-07,5220,57,68,125,太麻里,三等
2020-05-08,5220,127,176,303,太麻里,三等
2020-05-09,5220,86,134,220,太麻里,三等
2020-05-10,5220,218,150,368,太麻里,三等
2020-05-11,5220,120,84,204,太麻里,三等
2020-05-12,5220,56,75,131,太麻里,三等
2020-05-13,5220,72,64,136,太麻里,三等
2020-05-14,5220,93,78,171,太麻里,三等
2020-05-15,5220,111,161,272,太麻里,三等
2020-05-16,5220,78,93,171,太麻里,三等
2020-05-17,5220,151,99,250,太麻里,三等
2020-05-18,5220,88,95,183,太麻里,三等
2020-05-19,5220,85,89,174,太麻里,三等
2020-05-20,5220,104,90,194,太麻里,三等
2020-05-21,5220,83,73,156,太麻里,三等
2020-05-22,5220,107,160,267,太麻里,三等
2020-05-23,5220,78,86,164,太麻里,三等
2020-05-24,5220,145,121,266,太麻里,三等
2020-05-25,5220,99,118,217,太麻里,三等
2020-05-26,5220,101,88,189,太麻里,三等
2020-05-27,5220,87,90,177,太麻里,三等
2020-05-28,5220,83,73,156,太麻里,三等
2020-05-29,5220,177,180,357,太麻里,三等
2020-05-30,5220,130,173,303,太麻里,三等
2020-05-31,5220,240,219,459,太麻里,三等
2020-06-01,5220,121,92,213,太麻里,三等
2020-06-02,5220,82,150,232,太麻里,三等
2020-06-03,5220,142,145,287,太麻里,三等
2020-06-04,5220,113,84,197,太麻里,三等
2020-06-05,5220,160,148,308,太麻里,三等
2020-06-06,5220,143,165,308,太麻里,三等
2020-06-07,5220,231,216,447,太麻里,三等
2020-06-08,5220,140,125,265,太麻里,三等
2020-06-09,5220,115,128,243,太麻里,三等
2020-06-10,5220,124,157,281,太麻里,三等
2020-06-11,5220,127,133,260,太麻里,三等
2020-06-12,5220,221,206,427,太麻里,三等
2020-06-13,5220,185,201,386,太麻里,三等
2020-06-14,5220,235,186,421,太麻里,三等
2020-06-15,5220,136,133,269,太麻里,三等
2020-06-16,5220,142,173,315,太麻里,三等
2020-06-17,5220,103,107,210,太麻里,三等
2020-06-18,5220,234,218,452,太麻里,三等
2020-06-19,5220,141,167,308,太麻里,三等
2020-06-20,5220,204,192,396,太麻里,三等
2020-06-21,5220,210,163,373,太麻里,三等
2020-06-22,5220,123,135,258,太麻里,三等
2020-06-23,5220,125,126,251,太麻里,三等
2020-06-24,5220,177,205,382,太麻里,三等
2020-06-25,5220,184,270,454,太麻里,三等
2020-06-26,5220,173,210,383,太麻里,三等
2020-06-27,5220,262,209,471,太麻里,三等
2020-06-28,5220,279,213,492,太麻里,三等
2020-06-29,5220,159,129,288,太麻里,三等
2020-06-30,5220,132,128,260,太麻里,三等
2020-07-01,5220,129,131,260,太麻里,三等
2020-07-02,5220,156,98,254,太麻里,三等
2020-07-03,5220,191,235,426,太麻里,三等
2020-07-04,5220,125,150,275,太麻里,三等
2020-07-05,5220,187,139,326,太麻里,三等
2020-07-06,5220,153,173,326,太麻里,三等
2020-07-07,5220,122,143,265,太麻里,三等
2020-07-08,5220,112,103,215,太麻里,三等
2020-07-09,5220,149,125,274,太麻里,三等
2020-07-10,5220,175,181,356,太麻里,三等
2020-07-11,5220,122,173,295,太麻里,三等
2020-07-12,5220,189,146,335,太麻里,三等
2020-07-13,5220,139,160,299,太麻里,三等
2020-07-14,5220,140,148,288,太麻里,三等
2020-07-15,5220,173,216,389,太麻里,三等
2020-07-16,5220,183,162,345,太麻里,三等
2020-07-17,5220,168,241,409,太麻里,三等
2020-07-18,5220,135,193,328,太麻里,三等
2020-07-19,5220,312,289,601,太麻里,三等
2020-07-20,5220,208,195,403,太麻里,三等
2020-07-21,5220,167,126,293,太麻里,三等
2020-07-22,5220,170,158,328,太麻里,三等
2020-07-23,5220,141,177,318,太麻里,三等
2020-07-24,5220,224,224,448,太麻里,三等
2020-07-25,5220,191,276,467,太麻里,三等
2020-07-26,5220,269,181,450,太麻里,三等
2020-07-27,5220,183,214,397,太麻里,三等
2020-07-28,5220,171,178,349,太麻里,三等
2020-07-29,5220,164,261,425,太麻里,三等
2020-07-30,5220,162,183,345,太麻里,三等
2020-07-31,5220,231,268,499,太麻里,三等
2020-08-01,5220,199,231,430,太麻里,三等
2020-08-02,5220,313,259,572,太麻里,三等
2020-08-03,5220,139,109,248,太麻里,三等
2020-08-04,5220,147,165,312,太麻里,三等
2020-08-05,5220,99,131,230,太麻里,三等
2020-08-06,5220,149,204,353,太麻里,三等
2020-08-07,5220,253,229,482,太麻里,三等
2020-08-08,5220,186,209,395,太麻里,三等
2020-08-09,5220,270,231,501,太麻里,三等
2020-08-10,5220,164,126,290,太麻里,三等
2020-08-11,5220,148,158,306,太麻里,三等
2020-08-12,5220,156,143,299,太麻里,三等
2020-08-13,5220,152,173,325,太麻里,三等
2020-08-14,5220,298,261,559,太麻里,三等
2020-08-15,5220,188,312,500,太麻里,三等
2020-08-16,5220,324,363,687,太麻里,三等
2020-08-17,5220,234,202,436,太麻里,三等
2020-08-18,5220,210,180,390,太麻里,三等
2020-08-19,5220,189,158,347,太麻里,三等
2020-08-20,5220,206,168,374,太麻里,三等
2020-08-21,5220,260,254,514,太麻里,三等
2020-08-22,5220,208,296,504,太麻里,三等
2020-08-23,5220,345,327,672,太麻里,三等
2020-08-24,5220,206,203,409,太麻里,三等
2020-08-25,5220,213,146,359,太麻里,三等
2020-08-26,5220,217,169,386,太麻里,三等
2020-08-27,5220,153,137,290,太麻里,三等
2020-08-28,5220,194,193,387,太麻里,三等
2020-08-29,5220,185,258,443,太麻里,三等
2020-08-30,5220,250,236,486,太麻里,三等
2020-08-31,5220,120,141,261,太麻里,三等
2020-09-01,5220,109,121,230,太麻里,三等
2020-09-02,5220,113,95,208,太麻里,三等
2020-09-03,5220,144,172,316,太麻里,三等
2020-09-04,5220,190,332,522,太麻里,三等
2020-09-05,5220,191,220,411,太麻里,三等
2020-09-06,5220,258,201,459,太麻里,三等
2020-09-07,5220,152,146,298,太麻里,三等
2020-09-08,5220,189,134,323,太麻里,三等
2020-09-09,5220,129,103,232,太麻里,三等
2020-09-10,5220,117,116,233,太麻里,三等
2020-09-11,5220,182,238,420,太麻里,三等
2020-09-12,5220,181,196,377,太麻里,三等
2020-09-13,5220,319,158,477,太麻里,三等
2020-09-14,5220,143,145,288,太麻里,三等
2020-09-15,5220,93,145,238,太麻里,三等
2020-09-16,5220,125,137,262,太麻里,三等
2020-09-17,5220,136,135,271,太麻里,三等
2020-09-18,5220,186,235,421,太麻里,三等
2020-09-19,5220,202,240,442,太麻里,三等
2020-09-20,5220,298,202,500,太麻里,三等
2020-09-21,5220,115,257,372,太麻里,三等
2020-09-22,5220,142,181,323,太麻里,三等
2020-09-23,5220,145,135,280,太麻里,三等
2020-09-24,5220,122,146,268,太麻里,三等
2020-09-25,5220,160,167,327,太麻里,三等
2020-09-26,5220,132,168,300,太麻里,三等
2020-09-27,5220,203,190,393,太麻里,三等
2020-09-28,5220,148,128,276,太麻里,三等
2020-09-29,5220,134,86,220,太麻里,三等
2020-09-30,5220,183,319,502,太麻里,三等
2020-10-01,5220,128,296,424,太麻里,三等
2020-10-02,5220,199,330,529,太麻里,三等
2020-10-03,5220,261,212,473,太麻里,三等
2020-10-04,5220,400,203,603,太麻里,三等
2020-10-05,5220,189,171,360,太麻里,三等
2020-10-06,5220,104,149,253,太麻里,三等
2020-10-07,5220,111,149,260,太麻里,三等
2020-10-08,5220,209,238,447,太麻里,三等
2020-10-09,5220,223,399,622,太麻里,三等
2020-10-10,5220,171,190,361,太麻里,三等
2020-10-11,5220,345,223,568,太麻里,三等
2020-10-12,5220,130,218,348,太麻里,三等
2020-10-13,5220,133,139,272,太麻里,三等
2020-10-14,5220,98,101,199,太麻里,三等
2020-10-15,5220,113,145,258,太麻里,三等
2020-10-16,5220,228,194,422,太麻里,三等
2020-10-17,5220,123,172,295,太麻里,三等
2020-10-18,5220,213,287,500,太麻里,三等
2020-10-19,5220,164,119,283,太麻里,三等
2020-10-20,5220,111,187,298,太麻里,三等
2020-10-21,5220,108,117,225,太麻里,三等
2020-10-22,5220,109,292,401,太麻里,三等
2020-10-23,5220,192,278,470,太麻里,三等
2020-10-24,5220,152,158,310,太麻里,三等
2020-10-25,5220,215,157,372,太麻里,三等
2020-10-26,5220,122,125,247,太麻里,三等
2020-10-27,5220,97,142,239,太麻里,三等
2020-10-28,5220,127,153,280,太麻里,三等
2020-10-29,5220,132,103,235,太麻里,三等
2020-10-30,5220,179,203,382,太麻里,三等
2020-10-31,5220,136,171,307,太麻里,三等
2020-11-01,5220,239,205,444,太麻里,三等
2020-11-02,5220,158,139,297,太麻里,三等
2020-11-03,5220,133,102,235,太麻里,三等
2020-11-04,5220,102,76,178,太麻里,三等
2020-11-05,5220,289,105,394,太麻里,三等
2020-11-06,5220,193,196,389,太麻里,三等
2020-11-07,5220,134,194,328,太麻里,三等
2020-11-08,5220,242,192,434,太麻里,三等
2020-11-09,5220,144,128,272,太麻里,三等
2020-11-10,5220,100,75,175,太麻里,三等
2020-11-11,5220,94,96,190,太麻里,三等
2020-11-12,5220,127,158,285,太麻里,三等
2020-11-13,5220,180,227,407,太麻里,三等
2020-11-14,5220,235,145,380,太麻里,三等
2020-11-15,5220,247,224,471,太麻里,三等
2020-11-16,5220,152,181,333,太麻里,三等
2020-11-17,5220,100,113,213,太麻里,三等
2020-11-18,5220,143,119,262,太麻里,三等
2020-11-19,5220,156,167,323,太麻里,三等
2020-11-20,5220,173,250,423,太麻里,三等
2020-11-21,5220,219,296,515,太麻里,三等
2020-11-22,5220,250,227,477,太麻里,三等
2020-11-23,5220,172,164,336,太麻里,三等
2020-11-24,5220,103,153,256,太麻里,三等
2020-11-25,5220,119,178,297,太麻里,三等
2020-11-26,5220,139,165,304,太麻里,三等
2020-11-27,5220,226,210,436,太麻里,三等
2020-11-28,5220,210,198,408,太麻里,三等
2020-11-29,5220,241,189,430,太麻里,三等
2020-11-30,5220,146,144,290,太麻里,三等
2020-12-01,5220,110,116,226,太麻里,三等
2020-12-02,5220,107,117,224,太麻里,三等
2020-12-03,5220,150,144,294,太麻里,三等
2020-12-04,5220,157,216,373,太麻里,三等
2020-12-05,5220,196,219,415,太麻里,三等
2020-12-06,5220,270,271,541,太麻里,三等
2020-12-07,5220,208,217,425,太麻里,三等
2020-12-08,5220,141,122,263,太麻里,三等
2020-12-09,5220,122,137,259,太麻里,三等
2020-12-10,5220,155,112,267,太麻里,三等
2020-12-11,5220,180,278,458,太麻里,三等
2020-12-12,5220,221,241,462,太麻里,三等
2020-12-13,5220,350,335,685,太麻里,三等
2020-12-14,5220,170,143,313,太麻里,三等
2020-12-15,5220,179,153,332,太麻里,三等
2020-12-16,5220,114,150,264,太麻里,三等
2020-12-17,5220,204,188,392,太麻里,三等
2020-12-18,5220,240,234,474,太麻里,三等
2020-12-19,5220,190,259,449,太麻里,三等
2020-12-20,5220,1356,2435,3791,太麻里,三等
2020-12-21,5220,151,203,354,太麻里,三等
2020-12-22,5220,242,220,462,太麻里,三等
2020-12-23,5220,180,145,325,太麻里,三等
2020-12-24,5220,106,197,303,太麻里,三等
2020-12-25,5220,156,186,342,太麻里,三等
2020-12-26,5220,148,268,416,太麻里,三等
2020-12-27,5220,245,164,409,太麻里,三等
2020-12-28,5220,178,179,357,太麻里,三等
2020-12-29,5220,123,127,250,太麻里,三等
2020-12-30,5220,130,182,312,太麻里,三等
2020-12-31,5220,175,326,501,太麻里,三等
2020-01-01,5230,745,584,1329,知本,三等
2020-01-02,5230,598,494,1092,知本,三等
2020-01-03,5230,996,561,1557,知本,三等
2020-01-04,5230,869,576,1445,知本,三等
2020-01-05,5230,1006,808,1814,知本,三等
2020-01-06,5230,775,589,1364,知本,三等
2020-01-07,5230,660,578,1238,知本,三等
2020-01-08,5230,544,537,1081,知本,三等
2020-01-09,5230,838,525,1363,知本,三等
2020-01-10,5230,921,743,1664,知本,三等
2020-01-11,5230,594,679,1273,知本,三等
2020-01-12,5230,818,990,1808,知本,三等
2020-01-13,5230,639,775,1414,知本,三等
2020-01-14,5230,575,601,1176,知本,三等
2020-01-15,5230,698,611,1309,知本,三等
2020-01-16,5230,717,618,1335,知本,三等
2020-01-17,5230,828,760,1588,知本,三等
2020-01-18,5230,862,763,1625,知本,三等
2020-01-19,5230,812,878,1690,知本,三等
2020-01-20,5230,747,741,1488,知本,三等
2020-01-21,5230,764,747,1511,知本,三等
2020-01-22,5230,824,811,1635,知本,三等
2020-01-23,5230,624,824,1448,知本,三等
2020-01-24,5230,348,685,1033,知本,三等
2020-01-25,5230,644,840,1484,知本,三等
2020-01-26,5230,901,975,1876,知本,三等
2020-01-27,5230,923,839,1762,知本,三等
2020-01-28,5230,1077,738,1815,知本,三等
2020-01-29,5230,1086,783,1869,知本,三等
2020-01-30,5230,657,751,1408,知本,三等
2020-01-31,5230,776,765,1541,知本,三等
2020-02-01,5230,937,665,1602,知本,三等
2020-02-02,5230,745,747,1492,知本,三等
2020-02-03,5230,600,642,1242,知本,三等
2020-02-04,5230,533,471,1004,知本,三等
2020-02-05,5230,524,552,1076,知本,三等
2020-02-06,5230,565,459,1024,知本,三等
2020-02-07,5230,568,643,1211,知本,三等
2020-02-08,5230,397,758,1155,知本,三等
2020-02-09,5230,789,977,1766,知本,三等
2020-02-10,5230,605,546,1151,知本,三等
2020-02-11,5230,493,471,964,知本,三等
2020-02-12,5230,491,410,901,知本,三等
2020-02-13,5230,505,614,1119,知本,三等
2020-02-14,5230,543,430,973,知本,三等
2020-02-15,5230,472,430,902,知本,三等
2020-02-16,5230,607,694,1301,知本,三等
2020-02-17,5230,491,474,965,知本,三等
2020-02-18,5230,462,424,886,知本,三等
2020-02-19,5230,381,368,749,知本,三等
2020-02-20,5230,396,349,745,知本,三等
2020-02-21,5230,578,608,1186,知本,三等
2020-02-22,5230,554,651,1205,知本,三等
2020-02-23,5230,605,953,1558,知本,三等
2020-02-24,5230,472,816,1288,知本,三等
2020-02-25,5230,332,332,664,知本,三等
2020-02-26,5230,417,407,824,知本,三等
2020-02-27,5230,860,533,1393,知本,三等
2020-02-28,5230,640,613,1253,知本,三等
2020-02-29,5230,489,402,891,知本,三等
2020-03-01,5230,882,882,1764,知本,三等
2020-03-02,5230,368,500,868,知本,三等
2020-03-03,5230,261,269,530,知本,三等
2020-03-04,5230,272,291,563,知本,三等
2020-03-05,5230,353,330,683,知本,三等
2020-03-06,5230,595,402,997,知本,三等
2020-03-07,5230,426,564,990,知本,三等
2020-03-08,5230,497,615,1112,知本,三等
2020-03-09,5230,315,384,699,知本,三等
2020-03-10,5230,283,329,612,知本,三等
2020-03-11,5230,336,207,543,知本,三等
2020-03-12,5230,379,288,667,知本,三等
2020-03-13,5230,748,479,1227,知本,三等
2020-03-14,5230,367,458,825,知本,三等
2020-03-15,5230,615,772,1387,知本,三等
2020-03-16,5230,381,449,830,知本,三等
2020-03-17,5230,277,337,614,知本,三等
2020-03-18,5230,281,254,535,知本,三等
2020-03-19,5230,316,290,606,知本,三等
2020-03-20,5230,698,488,1186,知本,三等
2020-03-21,5230,411,429,840,知本,三等
2020-03-22,5230,578,617,1195,知本,三等
2020-03-23,5230,299,322,621,知本,三等
2020-03-24,5230,239,245,484,知本,三等
2020-03-25,5230,272,212,484,知本,三等
2020-03-26,5230,315,302,617,知本,三等
2020-03-27,5230,527,394,921,知本,三等
2020-03-28,5230,352,373,725,知本,三等
2020-03-29,5230,430,441,871,知本,三等
2020-03-30,5230,291,308,599,知本,三等
2020-03-31,5230,412,273,685,知本,三等
2020-04-01,5230,1331,660,1991,知本,三等
2020-04-02,5230,654,570,1224,知本,三等
2020-04-03,5230,340,391,731,知本,三等
2020-04-04,5230,386,272,658,知本,三等
2020-04-05,5230,895,1309,2204,知本,三等
2020-04-06,5230,385,652,1037,知本,三等
2020-04-07,5230,191,255,446,知本,三等
2020-04-08,5230,178,163,341,知本,三等
2020-04-09,5230,241,172,413,知本,三等
2020-04-10,5230,415,302,717,知本,三等
2020-04-11,5230,198,207,405,知本,三等
2020-04-12,5230,363,403,766,知本,三等
2020-04-13,5230,239,274,513,知本,三等
2020-04-14,5230,169,212,381,知本,三等
2020-04-15,5230,232,237,469,知本,三等
2020-04-16,5230,254,170,424,知本,三等
2020-04-17,5230,557,319,876,知本,三等
2020-04-18,5230,237,217,454,知本,三等
2020-04-19,5230,420,784,1204,知本,三等
2020-04-20,5230,829,675,1504,知本,三等
2020-04-21,5230,251,196,447,知本,三等
2020-04-22,5230,195,189,384,知本,三等
2020-04-23,5230,275,207,482,知本,三等
2020-04-24,5230,406,328,734,知本,三等
2020-04-25,5230,245,261,506,知本,三等
2020-04-26,5230,392,429,821,知本,三等
2020-04-27,5230,244,275,519,知本,三等
2020-04-28,5230,217,226,443,知本,三等
2020-04-29,5230,252,200,452,知本,三等
2020-04-30,5230,388,268,656,知本,三等
2020-05-01,5230,514,415,929,知本,三等
2020-05-02,5230,236,229,465,知本,三等
2020-05-03,5230,505,523,1028,知本,三等
2020-05-04,5230,257,366,623,知本,三等
2020-05-05,5230,227,235,462,知本,三等
2020-05-06,5230,253,211,464,知本,三等
2020-05-07,5230,375,256,631,知本,三等
2020-05-08,5230,969,547,1516,知本,三等
2020-05-09,5230,376,308,684,知本,三等
2020-05-10,5230,553,792,1345,知本,三等
2020-05-11,5230,330,578,908,知本,三等
2020-05-12,5230,290,355,645,知本,三等
2020-05-13,5230,346,299,645,知本,三等
2020-05-14,5230,384,274,658,知本,三等
2020-05-15,5230,624,404,1028,知本,三等
2020-05-16,5230,323,353,676,知本,三等
2020-05-17,5230,488,670,1158,知本,三等
2020-05-18,5230,353,425,778,知本,三等
2020-05-19,5230,295,293,588,知本,三等
2020-05-20,5230,316,266,582,知本,三等
2020-05-21,5230,337,228,565,知本,三等
2020-05-22,5230,550,409,959,知本,三等
2020-05-23,5230,341,397,738,知本,三等
2020-05-24,5230,577,644,1221,知本,三等
2020-05-25,5230,335,451,786,知本,三等
2020-05-26,5230,341,310,651,知本,三等
2020-05-27,5230,346,356,702,知本,三等
2020-05-28,5230,456,295,751,知本,三等
2020-05-29,5230,599,500,1099,知本,三等
2020-05-30,5230,464,429,893,知本,三等
2020-05-31,5230,712,774,1486,知本,三等
2020-06-01,5230,438,506,944,知本,三等
2020-06-02,5230,398,370,768,知本,三等
2020-06-03,5230,412,372,784,知本,三等
2020-06-04,5230,477,284,761,知本,三等
2020-06-05,5230,941,480,1421,知本,三等
2020-06-06,5230,376,490,866,知本,三等
2020-06-07,5230,640,1000,1640,知本,三等
2020-06-08,5230,474,575,1049,知本,三等
2020-06-09,5230,378,353,731,知本,三等
2020-06-10,5230,402,362,764,知本,三等
2020-06-11,5230,413,392,805,知本,三等
2020-06-12,5230,679,532,1211,知本,三等
2020-06-13,5230,531,460,991,知本,三等
2020-06-14,5230,654,785,1439,知本,三等
2020-06-15,5230,427,576,1003,知本,三等
2020-06-16,5230,410,368,778,知本,三等
2020-06-17,5230,407,353,760,知本,三等
2020-06-18,5230,441,396,837,知本,三等
2020-06-19,5230,505,487,992,知本,三等
2020-06-20,5230,516,424,940,知本,三等
2020-06-21,5230,509,553,1062,知本,三等
2020-06-22,5230,370,511,881,知本,三等
2020-06-23,5230,488,395,883,知本,三等
2020-06-24,5230,863,761,1624,知本,三等
2020-06-25,5230,759,746,1505,知本,三等
2020-06-26,5230,636,572,1208,知本,三等
2020-06-27,5230,673,464,1137,知本,三等
2020-06-28,5230,983,911,1894,知本,三等
2020-06-29,5230,607,707,1314,知本,三等
2020-06-30,5230,603,406,1009,知本,三等
2020-07-01,5230,483,439,922,知本,三等
2020-07-02,5230,436,381,817,知本,三等
2020-07-03,5230,592,466,1058,知本,三等
2020-07-04,5230,444,520,964,知本,三等
2020-07-05,5230,632,641,1273,知本,三等
2020-07-06,5230,397,474,871,知本,三等
2020-07-07,5230,433,511,944,知本,三等
2020-07-08,5230,549,474,1023,知本,三等
2020-07-09,5230,446,375,821,知本,三等
2020-07-10,5230,607,668,1275,知本,三等
2020-07-11,5230,578,482,1060,知本,三等
2020-07-12,5230,657,753,1410,知本,三等
2020-07-13,5230,487,562,1049,知本,三等
2020-07-14,5230,430,624,1054,知本,三等
2020-07-15,5230,544,667,1211,知本,三等
2020-07-16,5230,600,601,1201,知本,三等
2020-07-17,5230,916,803,1719,知本,三等
2020-07-18,5230,639,566,1205,知本,三等
2020-07-19,5230,875,919,1794,知本,三等
2020-07-20,5230,485,575,1060,知本,三等
2020-07-21,5230,545,504,1049,知本,三等
2020-07-22,5230,435,498,933,知本,三等
2020-07-23,5230,547,487,1034,知本,三等
2020-07-24,5230,720,589,1309,知本,三等
2020-07-25,5230,586,498,1084,知本,三等
2020-07-26,5230,604,685,1289,知本,三等
2020-07-27,5230,488,612,1100,知本,三等
2020-07-28,5230,581,540,1121,知本,三等
2020-07-29,5230,525,541,1066,知本,三等
2020-07-30,5230,471,407,878,知本,三等
2020-07-31,5230,620,534,1154,知本,三等
2020-08-01,5230,510,483,993,知本,三等
2020-08-02,5230,671,816,1487,知本,三等
2020-08-03,5230,572,515,1087,知本,三等
2020-08-04,5230,410,445,855,知本,三等
2020-08-05,5230,458,495,953,知本,三等
2020-08-06,5230,496,410,906,知本,三等
2020-08-07,5230,678,683,1361,知本,三等
2020-08-08,5230,677,662,1339,知本,三等
2020-08-09,5230,790,847,1637,知本,三等
2020-08-10,5230,514,654,1168,知本,三等
2020-08-11,5230,484,417,901,知本,三等
2020-08-12,5230,496,496,992,知本,三等
2020-08-13,5230,536,466,1002,知本,三等
2020-08-14,5230,800,729,1529,知本,三等
2020-08-15,5230,587,611,1198,知本,三等
2020-08-16,5230,683,881,1564,知本,三等
2020-08-17,5230,652,655,1307,知本,三等
2020-08-18,5230,542,552,1094,知本,三等
2020-08-19,5230,513,437,950,知本,三等
2020-08-20,5230,617,562,1179,知本,三等
2020-08-21,5230,760,651,1411,知本,三等
2020-08-22,5230,603,585,1188,知本,三等
2020-08-23,5230,782,837,1619,知本,三等
2020-08-24,5230,611,588,1199,知本,三等
2020-08-25,5230,490,561,1051,知本,三等
2020-08-26,5230,533,502,1035,知本,三等
2020-08-27,5230,550,384,934,知本,三等
2020-08-28,5230,615,614,1229,知本,三等
2020-08-29,5230,439,417,856,知本,三等
2020-08-30,5230,704,688,1392,知本,三等
2020-08-31,5230,392,369,761,知本,三等
2020-09-01,5230,366,361,727,知本,三等
2020-09-02,5230,309,311,620,知本,三等
2020-09-03,5230,331,464,795,知本,三等
2020-09-04,5230,611,508,1119,知本,三等
2020-09-05,5230,504,481,985,知本,三等
2020-09-06,5230,686,698,1384,知本,三等
2020-09-07,5230,465,464,929,知本,三等
2020-09-08,5230,384,435,819,知本,三等
2020-09-09,5230,480,553,1033,知本,三等
2020-09-10,5230,415,624,1039,知本,三等
2020-09-11,5230,545,701,1246,知本,三等
2020-09-12,5230,667,720,1387,知本,三等
2020-09-13,5230,747,978,1725,知本,三等
2020-09-14,5230,363,440,803,知本,三等
2020-09-15,5230,422,398,820,知本,三等
2020-09-16,5230,392,351,743,知本,三等
2020-09-17,5230,540,609,1149,知本,三等
2020-09-18,5230,808,879,1687,知本,三等
2020-09-19,5230,676,613,1289,知本,三等
2020-09-20,5230,683,899,1582,知本,三等
2020-09-21,5230,466,530,996,知本,三等
2020-09-22,5230,428,474,902,知本,三等
2020-09-23,5230,497,551,1048,知本,三等
2020-09-24,5230,396,375,771,知本,三等
2020-09-25,5230,566,540,1106,知本,三等
2020-09-26,5230,544,488,1032,知本,三等
2020-09-27,5230,590,671,1261,知本,三等
2020-09-28,5230,415,597,1012,知本,三等
2020-09-29,5230,611,479,1090,知本,三等
2020-09-30,5230,1617,797,2414,知本,三等
2020-10-01,5230,1226,822,2048,知本,三等
2020-10-02,5230,533,641,1174,知本,三等
2020-10-03,5230,729,543,1272,知本,三等
2020-10-04,5230,1212,2051,3263,知本,三等
2020-10-05,5230,631,971,1602,知本,三等
2020-10-06,5230,464,601,1065,知本,三等
2020-10-07,5230,581,567,1148,知本,三等
2020-10-08,5230,1319,805,2124,知本,三等
2020-10-09,5230,923,796,1719,知本,三等
2020-10-10,5230,534,504,1038,知本,三等
2020-10-11,5230,1017,1385,2402,知本,三等
2020-10-12,5230,556,714,1270,知本,三等
2020-10-13,5230,564,613,1177,知本,三等
2020-10-14,5230,602,759,1361,知本,三等
2020-10-15,5230,534,422,956,知本,三等
2020-10-16,5230,1017,837,1854,知本,三等
2020-10-17,5230,594,547,1141,知本,三等
2020-10-18,5230,728,1019,1747,知本,三等
2020-10-19,5230,662,753,1415,知本,三等
2020-10-20,5230,587,640,1227,知本,三等
2020-10-21,5230,601,600,1201,知本,三等
2020-10-22,5230,761,461,1222,知本,三等
2020-10-23,5230,1041,658,1699,知本,三等
2020-10-24,5230,659,604,1263,知本,三等
2020-10-25,5230,713,1069,1782,知本,三等
2020-10-26,5230,600,674,1274,知本,三等
2020-10-27,5230,591,711,1302,知本,三等
2020-10-28,5230,714,740,1454,知本,三等
2020-10-29,5230,757,569,1326,知本,三等
2020-10-30,5230,1010,738,1748,知本,三等
2020-10-31,5230,688,620,1308,知本,三等
2020-11-01,5230,858,971,1829,知本,三等
2020-11-02,5230,574,721,1295,知本,三等
2020-11-03,5230,519,382,901,知本,三等
2020-11-04,5230,465,430,895,知本,三等
2020-11-05,5230,649,498,1147,知本,三等
2020-11-06,5230,1048,692,1740,知本,三等
2020-11-07,5230,640,795,1435,知本,三等
2020-11-08,5230,859,1187,2046,知本,三等
2020-11-09,5230,559,651,1210,知本,三等
2020-11-10,5230,507,730,1237,知本,三等
2020-11-11,5230,524,538,1062,知本,三等
2020-11-12,5230,587,495,1082,知本,三等
2020-11-13,5230,927,712,1639,知本,三等
2020-11-14,5230,634,678,1312,知本,三等
2020-11-15,5230,923,1120,2043,知本,三等
2020-11-16,5230,653,757,1410,知本,三等
2020-11-17,5230,606,576,1182,知本,三等
2020-11-18,5230,640,605,1245,知本,三等
2020-11-19,5230,804,672,1476,知本,三等
2020-11-20,5230,1127,941,2068,知本,三等
2020-11-21,5230,755,671,1426,知本,三等
2020-11-22,5230,1064,1302,2366,知本,三等
2020-11-23,5230,696,791,1487,知本,三等
2020-11-24,5230,604,602,1206,知本,三等
2020-11-25,5230,569,603,1172,知本,三等
2020-11-26,5230,737,543,1280,知本,三等
2020-11-27,5230,1093,747,1840,知本,三等
2020-11-28,5230,646,641,1287,知本,三等
2020-11-29,5230,1000,1271,2271,知本,三等
2020-11-30,5230,732,846,1578,知本,三等
2020-12-01,5230,626,461,1087,知本,三等
2020-12-02,5230,561,524,1085,知本,三等
2020-12-03,5230,626,540,1166,知本,三等
2020-12-04,5230,1022,730,1752,知本,三等
2020-12-05,5230,655,983,1638,知本,三等
2020-12-06,5230,1054,1290,2344,知本,三等
2020-12-07,5230,702,899,1601,知本,三等
2020-12-08,5230,681,628,1309,知本,三等
2020-12-09,5230,547,522,1069,知本,三等
2020-12-10,5230,697,658,1355,知本,三等
2020-12-11,5230,1178,744,1922,知本,三等
2020-12-12,5230,783,789,1572,知本,三等
2020-12-13,5230,992,1206,2198,知本,三等
2020-12-14,5230,776,925,1701,知本,三等
2020-12-15,5230,535,491,1026,知本,三等
2020-12-16,5230,546,642,1188,知本,三等
2020-12-17,5230,852,600,1452,知本,三等
2020-12-18,5230,1064,1017,2081,知本,三等
2020-12-19,5230,861,700,1561,知本,三等
2020-12-20,5230,3023,2248,5271,知本,三等
2020-12-21,5230,641,738,1379,知本,三等
2020-12-22,5230,772,796,1568,知本,三等
2020-12-23,5230,763,788,1551,知本,三等
2020-12-24,5230,810,659,1469,知本,三等
2020-12-25,5230,1031,893,1924,知本,三等
2020-12-26,5230,1057,1008,2065,知本,三等
2020-12-27,5230,1182,1304,2486,知本,三等
2020-12-28,5230,761,798,1559,知本,三等
2020-12-29,5230,775,706,1481,知本,三等
2020-12-30,5230,746,850,1596,知本,三等
2020-12-31,5230,1434,968,2402,知本,三等
2020-01-01,5240,7,12,19,康樂,乙簡
2020-01-02,5240,21,27,48,康樂,乙簡
2020-01-03,5240,9,8,17,康樂,乙簡
2020-01-04,5240,5,16,21,康樂,乙簡
2020-01-05,5240,16,16,32,康樂,乙簡
2020-01-06,5240,6,9,15,康樂,乙簡
2020-01-07,5240,18,20,38,康樂,乙簡
2020-01-08,5240,5,8,13,康樂,乙簡
2020-01-09,5240,21,25,46,康樂,乙簡
2020-01-10,5240,18,15,33,康樂,乙簡
2020-01-11,5240,8,15,23,康樂,乙簡
2020-01-12,5240,12,11,23,康樂,乙簡
2020-01-13,5240,6,12,18,康樂,乙簡
2020-01-14,5240,14,10,24,康樂,乙簡
2020-01-15,5240,5,13,18,康樂,乙簡
2020-01-16,5240,12,21,33,康樂,乙簡
2020-01-17,5240,9,7,16,康樂,乙簡
2020-01-18,5240,13,12,25,康樂,乙簡
2020-01-19,5240,11,13,24,康樂,乙簡
2020-01-20,5240,8,8,16,康樂,乙簡
2020-01-21,5240,50,42,92,康樂,乙簡
2020-01-22,5240,7,11,18,康樂,乙簡
2020-01-23,5240,10,11,21,康樂,乙簡
2020-01-24,5240,4,11,15,康樂,乙簡
2020-01-25,5240,8,24,32,康樂,乙簡
2020-01-26,5240,4,7,11,康樂,乙簡
2020-01-27,5240,15,8,23,康樂,乙簡
2020-01-28,5240,3,16,19,康樂,乙簡
2020-01-29,5240,11,18,29,康樂,乙簡
2020-01-30,5240,17,26,43,康樂,乙簡
2020-01-31,5240,7,9,16,康樂,乙簡
2020-02-01,5240,10,9,19,康樂,乙簡
2020-02-02,5240,4,7,11,康樂,乙簡
2020-02-03,5240,5,8,13,康樂,乙簡
2020-02-04,5240,13,17,30,康樂,乙簡
2020-02-05,5240,19,7,26,康樂,乙簡
2020-02-06,5240,2,15,17,康樂,乙簡
2020-02-07,5240,5,10,15,康樂,乙簡
2020-02-08,5240,9,15,24,康樂,乙簡
2020-02-09,5240,8,8,16,康樂,乙簡
2020-02-10,5240,3,5,8,康樂,乙簡
2020-02-11,5240,10,6,16,康樂,乙簡
2020-02-12,5240,6,11,17,康樂,乙簡
2020-02-13,5240,4,2,6,康樂,乙簡
2020-02-14,5240,9,20,29,康樂,乙簡
2020-02-15,5240,1,17,18,康樂,乙簡
2020-02-16,5240,7,11,18,康樂,乙簡
2020-02-17,5240,6,8,14,康樂,乙簡
2020-02-18,5240,11,5,16,康樂,乙簡
2020-02-19,5240,4,10,14,康樂,乙簡
2020-02-20,5240,10,6,16,康樂,乙簡
2020-02-21,5240,12,8,20,康樂,乙簡
2020-02-22,5240,8,12,20,康樂,乙簡
2020-02-23,5240,13,8,21,康樂,乙簡
2020-02-24,5240,5,6,11,康樂,乙簡
2020-02-25,5240,8,8,16,康樂,乙簡
2020-02-26,5240,6,5,11,康樂,乙簡
2020-02-27,5240,16,28,44,康樂,乙簡
2020-02-28,5240,8,4,12,康樂,乙簡
2020-02-29,5240,10,8,18,康樂,乙簡
2020-03-01,5240,31,10,41,康樂,乙簡
2020-03-02,5240,3,5,8,康樂,乙簡
2020-03-03,5240,17,18,35,康樂,乙簡
2020-03-04,5240,4,7,11,康樂,乙簡
2020-03-05,5240,13,17,30,康樂,乙簡
2020-03-06,5240,7,16,23,康樂,乙簡
2020-03-07,5240,5,3,8,康樂,乙簡
2020-03-08,5240,16,11,27,康樂,乙簡
2020-03-09,5240,1,4,5,康樂,乙簡
2020-03-10,5240,15,17,32,康樂,乙簡
2020-03-11,5240,7,7,14,康樂,乙簡
2020-03-12,5240,12,12,24,康樂,乙簡
2020-03-13,5240,8,19,27,康樂,乙簡
2020-03-14,5240,4,7,11,康樂,乙簡
2020-03-15,5240,13,7,20,康樂,乙簡
2020-03-16,5240,4,9,13,康樂,乙簡
2020-03-17,5240,20,15,35,康樂,乙簡
2020-03-18,5240,8,6,14,康樂,乙簡
2020-03-19,5240,14,10,24,康樂,乙簡
2020-03-20,5240,6,14,20,康樂,乙簡
2020-03-21,5240,3,13,16,康樂,乙簡
2020-03-22,5240,15,6,21,康樂,乙簡
2020-03-23,5240,3,7,10,康樂,乙簡
2020-03-24,5240,18,19,37,康樂,乙簡
2020-03-25,5240,1,3,4,康樂,乙簡
2020-03-26,5240,7,11,18,康樂,乙簡
2020-03-27,5240,6,13,19,康樂,乙簡
2020-03-28,5240,4,4,8,康樂,乙簡
2020-03-29,5240,6,5,11,康樂,乙簡
2020-03-30,5240,4,10,14,康樂,乙簡
2020-03-31,5240,15,18,33,康樂,乙簡
2020-04-01,5240,7,11,18,康樂,乙簡
2020-04-02,5240,10,11,21,康樂,乙簡
2020-04-03,5240,5,5,10,康樂,乙簡
2020-04-04,5240,8,4,12,康樂,乙簡
2020-04-05,5240,19,10,29,康樂,乙簡
2020-04-06,5240,6,9,15,康樂,乙簡
2020-04-07,5240,14,15,29,康樂,乙簡
2020-04-08,5240,5,3,8,康樂,乙簡
2020-04-09,5240,12,17,29,康樂,乙簡
2020-04-10,5240,7,7,14,康樂,乙簡
2020-04-11,5240,0,3,3,康樂,乙簡
2020-04-12,5240,13,9,22,康樂,乙簡
2020-04-13,5240,7,4,11,康樂,乙簡
2020-04-14,5240,8,5,13,康樂,乙簡
2020-04-15,5240,5,4,9,康樂,乙簡
2020-04-16,5240,16,15,31,康樂,乙簡
2020-04-17,5240,5,13,18,康樂,乙簡
2020-04-18,5240,7,12,19,康樂,乙簡
2020-04-19,5240,11,8,19,康樂,乙簡
2020-04-20,5240,9,9,18,康樂,乙簡
2020-04-21,5240,15,20,35,康樂,乙簡
2020-04-22,5240,3,7,10,康樂,乙簡
2020-04-23,5240,17,19,36,康樂,乙簡
2020-04-24,5240,7,13,20,康樂,乙簡
2020-04-25,5240,0,3,3,康樂,乙簡
2020-04-26,5240,5,6,11,康樂,乙簡
2020-04-27,5240,7,10,17,康樂,乙簡
2020-04-28,5240,16,19,35,康樂,乙簡
2020-04-29,5240,1,4,5,康樂,乙簡
2020-04-30,5240,18,17,35,康樂,乙簡
2020-05-01,5240,6,7,13,康樂,乙簡
2020-05-02,5240,0,5,5,康樂,乙簡
2020-05-03,5240,9,7,16,康樂,乙簡
2020-05-04,5240,6,6,12,康樂,乙簡
2020-05-05,5240,18,19,37,康樂,乙簡
2020-05-06,5240,8,3,11,康樂,乙簡
2020-05-07,5240,14,16,30,康樂,乙簡
2020-05-08,5240,3,15,18,康樂,乙簡
2020-05-09,5240,3,18,21,康樂,乙簡
2020-05-10,5240,13,11,24,康樂,乙簡
2020-05-11,5240,7,8,15,康樂,乙簡
2020-05-12,5240,15,19,34,康樂,乙簡
2020-05-13,5240,4,8,12,康樂,乙簡
2020-05-14,5240,4,5,9,康樂,乙簡
2020-05-15,5240,6,11,17,康樂,乙簡
2020-05-16,5240,3,9,12,康樂,乙簡
2020-05-17,5240,13,11,24,康樂,乙簡
2020-05-18,5240,7,8,15,康樂,乙簡
2020-05-19,5240,17,14,31,康樂,乙簡
2020-05-20,5240,1,4,5,康樂,乙簡
2020-05-21,5240,16,17,33,康樂,乙簡
2020-05-22,5240,5,12,17,康樂,乙簡
2020-05-23,5240,2,5,7,康樂,乙簡
2020-05-24,5240,11,8,19,康樂,乙簡
2020-05-25,5240,3,3,6,康樂,乙簡
2020-05-26,5240,14,16,30,康樂,乙簡
2020-05-27,5240,3,2,5,康樂,乙簡
2020-05-28,5240,17,20,37,康樂,乙簡
2020-05-29,5240,22,29,51,康樂,乙簡
2020-05-30,5240,6,12,18,康樂,乙簡
2020-05-31,5240,10,7,17,康樂,乙簡
2020-06-01,5240,7,3,10,康樂,乙簡
2020-06-02,5240,10,12,22,康樂,乙簡
2020-06-03,5240,1,4,5,康樂,乙簡
2020-06-04,5240,18,6,24,康樂,乙簡
2020-06-05,5240,9,15,24,康樂,乙簡
2020-06-06,5240,7,6,13,康樂,乙簡
2020-06-07,5240,15,16,31,康樂,乙簡
2020-06-08,5240,3,2,5,康樂,乙簡
2020-06-09,5240,16,12,28,康樂,乙簡
2020-06-10,5240,2,2,4,康樂,乙簡
2020-06-11,5240,5,7,12,康樂,乙簡
2020-06-12,5240,7,7,14,康樂,乙簡
2020-06-13,5240,2,18,20,康樂,乙簡
2020-06-14,5240,9,6,15,康樂,乙簡
2020-06-15,5240,5,5,10,康樂,乙簡
2020-06-16,5240,1,3,4,康樂,乙簡
2020-06-17,5240,6,2,8,康樂,乙簡
2020-06-18,5240,5,5,10,康樂,乙簡
2020-06-19,5240,4,7,11,康樂,乙簡
2020-06-20,5240,2,4,6,康樂,乙簡
2020-06-21,5240,14,11,25,康樂,乙簡
2020-06-22,5240,7,6,13,康樂,乙簡
2020-06-23,5240,5,3,8,康樂,乙簡
2020-06-24,5240,10,16,26,康樂,乙簡
2020-06-25,5240,6,12,18,康樂,乙簡
2020-06-26,5240,5,6,11,康樂,乙簡
2020-06-27,5240,8,7,15,康樂,乙簡
2020-06-28,5240,19,12,31,康樂,乙簡
2020-06-29,5240,4,2,6,康樂,乙簡
2020-06-30,5240,5,2,7,康樂,乙簡
2020-07-01,5240,4,6,10,康樂,乙簡
2020-07-02,5240,7,7,14,康樂,乙簡
2020-07-03,5240,9,12,21,康樂,乙簡
2020-07-04,5240,5,6,11,康樂,乙簡
2020-07-05,5240,2,5,7,康樂,乙簡
2020-07-06,5240,5,7,12,康樂,乙簡
2020-07-07,5240,4,6,10,康樂,乙簡
2020-07-08,5240,3,2,5,康樂,乙簡
2020-07-09,5240,2,1,3,康樂,乙簡
2020-07-10,5240,8,3,11,康樂,乙簡
2020-07-11,5240,2,11,13,康樂,乙簡
2020-07-12,5240,5,7,12,康樂,乙簡
2020-07-13,5240,2,11,13,康樂,乙簡
2020-07-14,5240,4,28,32,康樂,乙簡
2020-07-15,5240,4,7,11,康樂,乙簡
2020-07-16,5240,12,9,21,康樂,乙簡
2020-07-17,5240,13,11,24,康樂,乙簡
2020-07-18,5240,3,9,12,康樂,乙簡
2020-07-19,5240,26,12,38,康樂,乙簡
2020-07-20,5240,4,7,11,康樂,乙簡
2020-07-21,5240,5,7,12,康樂,乙簡
2020-07-22,5240,3,4,7,康樂,乙簡
2020-07-23,5240,7,9,16,康樂,乙簡
2020-07-24,5240,30,8,38,康樂,乙簡
2020-07-25,5240,7,10,17,康樂,乙簡
2020-07-26,5240,11,12,23,康樂,乙簡
2020-07-27,5240,22,35,57,康樂,乙簡
2020-07-28,5240,4,4,8,康樂,乙簡
2020-07-29,5240,6,4,10,康樂,乙簡
2020-07-30,5240,10,17,27,康樂,乙簡
2020-07-31,5240,10,6,16,康樂,乙簡
2020-08-01,5240,5,8,13,康樂,乙簡
2020-08-02,5240,8,13,21,康樂,乙簡
2020-08-03,5240,5,26,31,康樂,乙簡
2020-08-04,5240,5,3,8,康樂,乙簡
2020-08-05,5240,3,5,8,康樂,乙簡
2020-08-06,5240,12,9,21,康樂,乙簡
2020-08-07,5240,12,8,20,康樂,乙簡
2020-08-08,5240,3,10,13,康樂,乙簡
2020-08-09,5240,45,7,52,康樂,乙簡
2020-08-10,5240,7,7,14,康樂,乙簡
2020-08-11,5240,6,12,18,康樂,乙簡
2020-08-12,5240,4,17,21,康樂,乙簡
2020-08-13,5240,7,7,14,康樂,乙簡
2020-08-14,5240,18,12,30,康樂,乙簡
2020-08-15,5240,1,11,12,康樂,乙簡
2020-08-16,5240,9,13,22,康樂,乙簡
2020-08-17,5240,4,7,11,康樂,乙簡
2020-08-18,5240,5,15,20,康樂,乙簡
2020-08-19,5240,5,9,14,康樂,乙簡
2020-08-20,5240,4,3,7,康樂,乙簡
2020-08-21,5240,8,4,12,康樂,乙簡
2020-08-22,5240,4,10,14,康樂,乙簡
2020-08-23,5240,11,16,27,康樂,乙簡
2020-08-24,5240,7,10,17,康樂,乙簡
2020-08-25,5240,8,5,13,康樂,乙簡
2020-08-26,5240,6,7,13,康樂,乙簡
2020-08-27,5240,2,9,11,康樂,乙簡
2020-08-28,5240,14,6,20,康樂,乙簡
2020-08-29,5240,2,12,14,康樂,乙簡
2020-08-30,5240,4,14,18,康樂,乙簡
2020-08-31,5240,1,9,10,康樂,乙簡
2020-09-01,5240,16,15,31,康樂,乙簡
2020-09-02,5240,2,9,11,康樂,乙簡
2020-09-03,5240,15,18,33,康樂,乙簡
2020-09-04,5240,7,6,13,康樂,乙簡
2020-09-05,5240,5,5,10,康樂,乙簡
2020-09-06,5240,5,3,8,康樂,乙簡
2020-09-07,5240,3,5,8,康樂,乙簡
2020-09-08,5240,25,23,48,康樂,乙簡
2020-09-09,5240,4,3,7,康樂,乙簡
2020-09-10,5240,19,20,39,康樂,乙簡
2020-09-11,5240,11,7,18,康樂,乙簡
2020-09-12,5240,2,6,8,康樂,乙簡
2020-09-13,5240,10,14,24,康樂,乙簡
2020-09-14,5240,5,2,7,康樂,乙簡
2020-09-15,5240,16,13,29,康樂,乙簡
2020-09-16,5240,2,6,8,康樂,乙簡
2020-09-17,5240,15,16,31,康樂,乙簡
2020-09-18,5240,10,9,19,康樂,乙簡
2020-09-19,5240,9,6,15,康樂,乙簡
2020-09-20,5240,14,17,31,康樂,乙簡
2020-09-21,5240,4,11,15,康樂,乙簡
2020-09-22,5240,22,15,37,康樂,乙簡
2020-09-23,5240,11,11,22,康樂,乙簡
2020-09-24,5240,16,17,33,康樂,乙簡
2020-09-25,5240,4,6,10,康樂,乙簡
2020-09-26,5240,5,8,13,康樂,乙簡
2020-09-27,5240,6,4,10,康樂,乙簡
2020-09-28,5240,3,6,9,康樂,乙簡
2020-09-29,5240,13,19,32,康樂,乙簡
2020-09-30,5240,10,20,30,康樂,乙簡
2020-10-01,5240,3,19,22,康樂,乙簡
2020-10-02,5240,7,18,25,康樂,乙簡
2020-10-03,5240,9,14,23,康樂,乙簡
2020-10-04,5240,14,15,29,康樂,乙簡
2020-10-05,5240,9,8,17,康樂,乙簡
2020-10-06,5240,17,18,35,康樂,乙簡
2020-10-07,5240,7,5,12,康樂,乙簡
2020-10-08,5240,19,30,49,康樂,乙簡
2020-10-09,5240,6,10,16,康樂,乙簡
2020-10-10,5240,3,8,11,康樂,乙簡
2020-10-11,5240,15,16,31,康樂,乙簡
2020-10-12,5240,2,7,9,康樂,乙簡
2020-10-13,5240,16,22,38,康樂,乙簡
2020-10-14,5240,4,9,13,康樂,乙簡
2020-10-15,5240,1,4,5,康樂,乙簡
2020-10-16,5240,8,8,16,康樂,乙簡
2020-10-17,5240,1,8,9,康樂,乙簡
2020-10-18,5240,8,9,17,康樂,乙簡
2020-10-19,5240,1,7,8,康樂,乙簡
2020-10-20,5240,19,14,33,康樂,乙簡
2020-10-21,5240,3,4,7,康樂,乙簡
2020-10-22,5240,17,21,38,康樂,乙簡
2020-10-23,5240,11,17,28,康樂,乙簡
2020-10-24,5240,39,27,66,康樂,乙簡
2020-10-25,5240,39,26,65,康樂,乙簡
2020-10-26,5240,4,5,9,康樂,乙簡
2020-10-27,5240,16,19,35,康樂,乙簡
2020-10-28,5240,3,9,12,康樂,乙簡
2020-10-29,5240,18,21,39,康樂,乙簡
2020-10-30,5240,5,9,14,康樂,乙簡
2020-10-31,5240,3,8,11,康樂,乙簡
2020-11-01,5240,9,22,31,康樂,乙簡
2020-11-02,5240,4,5,9,康樂,乙簡
2020-11-03,5240,4,1,5,康樂,乙簡
2020-11-04,5240,6,9,15,康樂,乙簡
2020-11-05,5240,3,8,11,康樂,乙簡
2020-11-06,5240,5,6,11,康樂,乙簡
2020-11-07,5240,10,10,20,康樂,乙簡
2020-11-08,5240,8,14,22,康樂,乙簡
2020-11-09,5240,1,14,15,康樂,乙簡
2020-11-10,5240,3,3,6,康樂,乙簡
2020-11-11,5240,8,12,20,康樂,乙簡
2020-11-12,5240,9,9,18,康樂,乙簡
2020-11-13,5240,10,16,26,康樂,乙簡
2020-11-14,5240,2,15,17,康樂,乙簡
2020-11-15,5240,11,14,25,康樂,乙簡
2020-11-16,5240,3,7,10,康樂,乙簡
2020-11-17,5240,3,8,11,康樂,乙簡
2020-11-18,5240,3,4,7,康樂,乙簡
2020-11-19,5240,3,6,9,康樂,乙簡
2020-11-20,5240,10,24,34,康樂,乙簡
2020-11-21,5240,4,8,12,康樂,乙簡
2020-11-22,5240,31,21,52,康樂,乙簡
2020-11-23,5240,4,6,10,康樂,乙簡
2020-11-24,5240,4,6,10,康樂,乙簡
2020-11-25,5240,3,7,10,康樂,乙簡
2020-11-26,5240,12,16,28,康樂,乙簡
2020-11-27,5240,6,26,32,康樂,乙簡
2020-11-28,5240,5,18,23,康樂,乙簡
2020-11-29,5240,14,12,26,康樂,乙簡
2020-11-30,5240,19,17,36,康樂,乙簡
2020-12-01,5240,3,5,8,康樂,乙簡
2020-12-02,5240,10,4,14,康樂,乙簡
2020-12-03,5240,7,16,23,康樂,乙簡
2020-12-04,5240,14,22,36,康樂,乙簡
2020-12-05,5240,6,25,31,康樂,乙簡
2020-12-06,5240,11,19,30,康樂,乙簡
2020-12-07,5240,4,5,9,康樂,乙簡
2020-12-08,5240,5,14,19,康樂,乙簡
2020-12-09,5240,5,8,13,康樂,乙簡
2020-12-10,5240,4,12,16,康樂,乙簡
2020-12-11,5240,13,22,35,康樂,乙簡
2020-12-12,5240,48,76,124,康樂,乙簡
2020-12-13,5240,31,20,51,康樂,乙簡
2020-12-14,5240,8,13,21,康樂,乙簡
2020-12-15,5240,13,22,35,康樂,乙簡
2020-12-16,5240,7,14,21,康樂,乙簡
2020-12-17,5240,11,13,24,康樂,乙簡
2020-12-18,5240,16,40,56,康樂,乙簡
2020-12-19,5240,21,50,71,康樂,乙簡
2020-12-20,5240,28,38,66,康樂,乙簡
2020-12-21,5240,21,32,53,康樂,乙簡
2020-12-22,5240,67,175,242,康樂,乙簡
2020-12-23,5240,2,20,22,康樂,乙簡
2020-12-24,5240,5,3,8,康樂,乙簡
2020-12-25,5240,5,15,20,康樂,乙簡
2020-12-26,5240,5,12,17,康樂,乙簡
2020-12-27,5240,6,3,9,康樂,乙簡
2020-12-28,5240,4,2,6,康樂,乙簡
2020-12-29,5240,6,3,9,康樂,乙簡
2020-12-30,5240,6,12,18,康樂,乙簡
2020-12-31,5240,4,14,18,康樂,乙簡
2020-01-01,6000,6227,4374,10601,臺東,一等
2020-01-02,6000,4618,3503,8121,臺東,一等
2020-01-03,6000,5090,4865,9955,臺東,一等
2020-01-04,6000,4559,4367,8926,臺東,一等
2020-01-05,6000,5554,5178,10732,臺東,一等
2020-01-06,6000,3790,3748,7538,臺東,一等
2020-01-07,6000,3379,3644,7023,臺東,一等
2020-01-08,6000,3704,3502,7206,臺東,一等
2020-01-09,6000,3941,3809,7750,臺東,一等
2020-01-10,6000,7138,8883,16021,臺東,一等
2020-01-11,6000,5541,6464,12005,臺東,一等
2020-01-12,6000,7474,7107,14581,臺東,一等
2020-01-13,6000,4623,5057,9680,臺東,一等
2020-01-14,6000,4460,4294,8754,臺東,一等
2020-01-15,6000,4571,4129,8700,臺東,一等
2020-01-16,6000,5054,4355,9409,臺東,一等
2020-01-17,6000,5709,5549,11258,臺東,一等
2020-01-18,6000,4637,5272,9909,臺東,一等
2020-01-19,6000,5987,6249,12236,臺東,一等
2020-01-20,6000,4822,5522,10344,臺東,一等
2020-01-21,6000,5077,6107,11184,臺東,一等
2020-01-22,6000,6599,9349,15948,臺東,一等
2020-01-23,6000,5737,9923,15660,臺東,一等
2020-01-24,6000,3669,8329,11998,臺東,一等
2020-01-25,6000,6049,10208,16257,臺東,一等
2020-01-26,6000,9193,10819,20012,臺東,一等
2020-01-27,6000,12108,8996,21104,臺東,一等
2020-01-28,6000,13196,6913,20109,臺東,一等
2020-01-29,6000,12438,7982,20420,臺東,一等
2020-01-30,6000,8115,6068,14183,臺東,一等
2020-01-31,6000,6896,5345,12241,臺東,一等
2020-02-01,6000,6218,4866,11084,臺東,一等
2020-02-02,6000,6972,5818,12790,臺東,一等
2020-02-03,6000,4663,4787,9450,臺東,一等
2020-02-04,6000,4542,4288,8830,臺東,一等
2020-02-05,6000,4627,4231,8858,臺東,一等
2020-02-06,6000,4265,4609,8874,臺東,一等
2020-02-07,6000,6002,6781,12783,臺東,一等
2020-02-08,6000,3865,6199,10064,臺東,一等
2020-02-09,6000,7945,5928,13873,臺東,一等
2020-02-10,6000,5880,4448,10328,臺東,一等
2020-02-11,6000,3783,3712,7495,臺東,一等
2020-02-12,6000,3523,3477,7000,臺東,一等
2020-02-13,6000,3922,3537,7459,臺東,一等
2020-02-14,6000,4784,4642,9426,臺東,一等
2020-02-15,6000,4006,3640,7646,臺東,一等
2020-02-16,6000,4825,4304,9129,臺東,一等
2020-02-17,6000,3516,3727,7243,臺東,一等
2020-02-18,6000,3328,3418,6746,臺東,一等
2020-02-19,6000,3555,3342,6897,臺東,一等
2020-02-20,6000,3887,3728,7615,臺東,一等
2020-02-21,6000,5047,5181,10228,臺東,一等
2020-02-22,6000,3748,4260,8008,臺東,一等
2020-02-23,6000,5799,4944,10743,臺東,一等
2020-02-24,6000,3775,3836,7611,臺東,一等
2020-02-25,6000,3153,3120,6273,臺東,一等
2020-02-26,6000,3259,3280,6539,臺東,一等
2020-02-27,6000,5802,6552,12354,臺東,一等
2020-02-28,6000,4349,8092,12441,臺東,一等
2020-02-29,6000,4690,3637,8327,臺東,一等
2020-03-01,6000,11243,6328,17571,臺東,一等
2020-03-02,6000,3647,3219,6866,臺東,一等
2020-03-03,6000,2539,2495,5034,臺東,一等
2020-03-04,6000,2418,2747,5165,臺東,一等
2020-03-05,6000,2837,2841,5678,臺東,一等
2020-03-06,6000,4425,4398,8823,臺東,一等
2020-03-07,6000,3043,3460,6503,臺東,一等
2020-03-08,6000,5212,4850,10062,臺東,一等
2020-03-09,6000,3113,3040,6153,臺東,一等
2020-03-10,6000,2696,2707,5403,臺東,一等
2020-03-11,6000,2470,2741,5211,臺東,一等
2020-03-12,6000,2939,3090,6029,臺東,一等
2020-03-13,6000,5118,5118,10236,臺東,一等
2020-03-14,6000,3073,3702,6775,臺東,一等
2020-03-15,6000,5633,4907,10540,臺東,一等
2020-03-16,6000,3393,3112,6505,臺東,一等
2020-03-17,6000,2591,2728,5319,臺東,一等
2020-03-18,6000,2632,2554,5186,臺東,一等
2020-03-19,6000,2734,2991,5725,臺東,一等
2020-03-20,6000,4975,5101,10076,臺東,一等
2020-03-21,6000,3177,3906,7083,臺東,一等
2020-03-22,6000,5573,4319,9892,臺東,一等
2020-03-23,6000,3422,2984,6406,臺東,一等
2020-03-24,6000,2946,2317,5263,臺東,一等
2020-03-25,6000,3995,2459,6454,臺東,一等
2020-03-26,6000,4315,2797,7112,臺東,一等
2020-03-27,6000,6147,5274,11421,臺東,一等
2020-03-28,6000,3982,3849,7831,臺東,一等
2020-03-29,6000,5348,4244,9592,臺東,一等
2020-03-30,6000,3679,3187,6866,臺東,一等
2020-03-31,6000,3658,3668,7326,臺東,一等
2020-04-01,6000,6216,8180,14396,臺東,一等
2020-04-02,6000,4130,9255,13385,臺東,一等
2020-04-03,6000,4026,4757,8783,臺東,一等
2020-04-04,6000,6496,2741,9237,臺東,一等
2020-04-05,6000,11959,6179,18138,臺東,一等
2020-04-06,6000,5011,3140,8151,臺東,一等
2020-04-07,6000,2543,2151,4694,臺東,一等
2020-04-08,6000,2077,2050,4127,臺東,一等
2020-04-09,6000,2203,2050,4253,臺東,一等
2020-04-10,6000,3770,3949,7719,臺東,一等
2020-04-11,6000,2041,2451,4492,臺東,一等
2020-04-12,6000,3542,3363,6905,臺東,一等
2020-04-13,6000,2887,2571,5458,臺東,一等
2020-04-14,6000,2195,2113,4308,臺東,一等
2020-04-15,6000,2047,2204,4251,臺東,一等
2020-04-16,6000,2324,2330,4654,臺東,一等
2020-04-17,6000,3888,4200,8088,臺東,一等
2020-04-18,6000,2350,2743,5093,臺東,一等
2020-04-19,6000,4413,3974,8387,臺東,一等
2020-04-20,6000,3179,2806,5985,臺東,一等
2020-04-21,6000,2130,2110,4240,臺東,一等
2020-04-22,6000,2006,2076,4082,臺東,一等
2020-04-23,6000,2323,2375,4698,臺東,一等
2020-04-24,6000,3824,4503,8327,臺東,一等
2020-04-25,6000,1923,2578,4501,臺東,一等
2020-04-26,6000,4616,3230,7846,臺東,一等
2020-04-27,6000,2618,2486,5104,臺東,一等
2020-04-28,6000,2110,2162,4272,臺東,一等
2020-04-29,6000,2120,2562,4682,臺東,一等
2020-04-30,6000,3171,3996,7167,臺東,一等
2020-05-01,6000,3743,5907,9650,臺東,一等
2020-05-02,6000,2520,2499,5019,臺東,一等
2020-05-03,6000,7222,4101,11323,臺東,一等
2020-05-04,6000,3102,2628,5730,臺東,一等
2020-05-05,6000,2325,2315,4640,臺東,一等
2020-05-06,6000,2245,2384,4629,臺東,一等
2020-05-07,6000,2694,2723,5417,臺東,一等
2020-05-08,6000,5169,5459,10628,臺東,一等
2020-05-09,6000,2554,3283,5837,臺東,一等
2020-05-10,6000,5456,4573,10029,臺東,一等
2020-05-11,6000,3506,3146,6652,臺東,一等
2020-05-12,6000,2476,2593,5069,臺東,一等
2020-05-13,6000,2378,2582,4960,臺東,一等
2020-05-14,6000,2690,3037,5727,臺東,一等
2020-05-15,6000,4905,4950,9855,臺東,一等
2020-05-16,6000,2850,3279,6129,臺東,一等
2020-05-17,6000,5176,4177,9353,臺東,一等
2020-05-18,6000,3393,3065,6458,臺東,一等
2020-05-19,6000,2695,2455,5150,臺東,一等
2020-05-20,6000,2558,2720,5278,臺東,一等
2020-05-21,6000,2995,3153,6148,臺東,一等
2020-05-22,6000,4677,4952,9629,臺東,一等
2020-05-23,6000,2820,3421,6241,臺東,一等
2020-05-24,6000,5228,4214,9442,臺東,一等
2020-05-25,6000,3706,3577,7283,臺東,一等
2020-05-26,6000,2732,2873,5605,臺東,一等
2020-05-27,6000,2804,2837,5641,臺東,一等
2020-05-28,6000,3023,3231,6254,臺東,一等
2020-05-29,6000,4940,5499,10439,臺東,一等
2020-05-30,6000,3486,4140,7626,臺東,一等
2020-05-31,6000,6261,4942,11203,臺東,一等
2020-06-01,6000,3997,3688,7685,臺東,一等
2020-06-02,6000,3206,3080,6286,臺東,一等
2020-06-03,6000,3116,2929,6045,臺東,一等
2020-06-04,6000,3462,3521,6983,臺東,一等
2020-06-05,6000,5862,5843,11705,臺東,一等
2020-06-06,6000,3846,4608,8454,臺東,一等
2020-06-07,6000,6353,6033,12386,臺東,一等
2020-06-08,6000,4235,4302,8537,臺東,一等
2020-06-09,6000,3444,3277,6721,臺東,一等
2020-06-10,6000,3405,3492,6897,臺東,一等
2020-06-11,6000,3660,4432,8092,臺東,一等
2020-06-12,6000,6024,6377,12401,臺東,一等
2020-06-13,6000,4405,5461,9866,臺東,一等
2020-06-14,6000,6930,6211,13141,臺東,一等
2020-06-15,6000,4973,4810,9783,臺東,一等
2020-06-16,6000,4049,3820,7869,臺東,一等
2020-06-17,6000,3785,3918,7703,臺東,一等
2020-06-18,6000,4087,4664,8751,臺東,一等
2020-06-19,6000,4954,6108,11062,臺東,一等
2020-06-20,6000,4717,5742,10459,臺東,一等
2020-06-21,6000,6287,6107,12394,臺東,一等
2020-06-22,6000,5019,5176,10195,臺東,一等
2020-06-23,6000,4787,4810,9597,臺東,一等
2020-06-24,6000,7878,9970,17848,臺東,一等
2020-06-25,6000,6250,11859,18109,臺東,一等
2020-06-26,6000,5227,6972,12199,臺東,一等
2020-06-27,6000,9197,5542,14739,臺東,一等
2020-06-28,6000,14476,8637,23113,臺東,一等
2020-06-29,6000,6892,5535,12427,臺東,一等
2020-06-30,6000,5050,4415,9465,臺東,一等
2020-07-01,6000,4243,4601,8844,臺東,一等
2020-07-02,6000,4585,4360,8945,臺東,一等
2020-07-03,6000,6425,7149,13574,臺東,一等
2020-07-04,6000,4503,5968,10471,臺東,一等
2020-07-05,6000,7573,6531,14104,臺東,一等
2020-07-06,6000,5679,5680,11359,臺東,一等
2020-07-07,6000,5145,4956,10101,臺東,一等
2020-07-08,6000,5145,5021,10166,臺東,一等
2020-07-09,6000,5353,5530,10883,臺東,一等
2020-07-10,6000,7264,9301,16565,臺東,一等
2020-07-11,6000,5651,7508,13159,臺東,一等
2020-07-12,6000,9838,7656,17494,臺東,一等
2020-07-13,6000,7368,5833,13201,臺東,一等
2020-07-14,6000,5908,5621,11529,臺東,一等
2020-07-15,6000,6092,6668,12760,臺東,一等
2020-07-16,6000,5826,7412,13238,臺東,一等
2020-07-17,6000,8392,9463,17855,臺東,一等
2020-07-18,6000,7574,8712,16286,臺東,一等
2020-07-19,6000,10731,8845,19576,臺東,一等
2020-07-20,6000,8044,7351,15395,臺東,一等
2020-07-21,6000,6868,6183,13051,臺東,一等
2020-07-22,6000,6308,6614,12922,臺東,一等
2020-07-23,6000,6407,7484,13891,臺東,一等
2020-07-24,6000,8611,9742,18353,臺東,一等
2020-07-25,6000,8003,8312,16315,臺東,一等
2020-07-26,6000,10766,8614,19380,臺東,一等
2020-07-27,6000,7831,7020,14851,臺東,一等
2020-07-28,6000,6582,6012,12594,臺東,一等
2020-07-29,6000,5960,6429,12389,臺東,一等
2020-07-30,6000,6507,6869,13376,臺東,一等
2020-07-31,6000,8212,9356,17568,臺東,一等
2020-08-01,6000,7138,8533,15671,臺東,一等
2020-08-02,6000,10586,8663,19249,臺東,一等
2020-08-03,6000,7363,6642,14005,臺東,一等
2020-08-04,6000,7652,5917,13569,臺東,一等
2020-08-05,6000,6294,6004,12298,臺東,一等
2020-08-06,6000,6710,6350,13060,臺東,一等
2020-08-07,6000,8731,8882,17613,臺東,一等
2020-08-08,6000,6427,7745,14172,臺東,一等
2020-08-09,6000,9819,8792,18611,臺東,一等
2020-08-10,6000,7874,7513,15387,臺東,一等
2020-08-11,6000,6648,6734,13382,臺東,一等
2020-08-12,6000,6520,6747,13267,臺東,一等
2020-08-13,6000,7481,7236,14717,臺東,一等
2020-08-14,6000,9321,10716,20037,臺東,一等
2020-08-15,6000,8256,9435,17691,臺東,一等
2020-08-16,6000,11974,9931,21905,臺東,一等
2020-08-17,6000,9120,7797,16917,臺東,一等
2020-08-18,6000,7811,6290,14101,臺東,一等
2020-08-19,6000,6622,6475,13097,臺東,一等
2020-08-20,6000,6427,7479,13906,臺東,一等
2020-08-21,6000,8663,10111,18774,臺東,一等
2020-08-22,6000,7383,8672,16055,臺東,一等
2020-08-23,6000,10726,8753,19479,臺東,一等
2020-08-24,6000,9401,7958,17359,臺東,一等
2020-08-25,6000,6532,6245,12777,臺東,一等
2020-08-26,6000,6450,6319,12769,臺東,一等
2020-08-27,6000,6401,6241,12642,臺東,一等
2020-08-28,6000,7958,8774,16732,臺東,一等
2020-08-29,6000,6460,7621,14081,臺東,一等
2020-08-30,6000,9735,7699,17434,臺東,一等
2020-08-31,6000,7393,5415,12808,臺東,一等
2020-09-01,6000,5186,4894,10080,臺東,一等
2020-09-02,6000,4274,4550,8824,臺東,一等
2020-09-03,6000,5138,5833,10971,臺東,一等
2020-09-04,6000,6971,7604,14575,臺東,一等
2020-09-05,6000,6033,6701,12734,臺東,一等
2020-09-06,6000,9102,7298,16400,臺東,一等
2020-09-07,6000,6188,5362,11550,臺東,一等
2020-09-08,6000,4882,4799,9681,臺東,一等
2020-09-09,6000,4890,5243,10133,臺東,一等
2020-09-10,6000,5350,5197,10547,臺東,一等
2020-09-11,6000,7485,8555,16040,臺東,一等
2020-09-12,6000,5292,6037,11329,臺東,一等
2020-09-13,6000,9449,7424,16873,臺東,一等
2020-09-14,6000,5395,4698,10093,臺東,一等
2020-09-15,6000,4094,4502,8596,臺東,一等
2020-09-16,6000,4032,4360,8392,臺東,一等
2020-09-17,6000,4441,5818,10259,臺東,一等
2020-09-18,6000,7500,8606,16106,臺東,一等
2020-09-19,6000,6300,7461,13761,臺東,一等
2020-09-20,6000,10150,8195,18345,臺東,一等
2020-09-21,6000,6698,5644,12342,臺東,一等
2020-09-22,6000,5459,4843,10302,臺東,一等
2020-09-23,6000,4764,4808,9572,臺東,一等
2020-09-24,6000,5217,4999,10216,臺東,一等
2020-09-25,6000,5641,6645,12286,臺東,一等
2020-09-26,6000,5345,6371,11716,臺東,一等
2020-09-27,6000,7201,6143,13344,臺東,一等
2020-09-28,6000,5745,4916,10661,臺東,一等
2020-09-29,6000,4622,5072,9694,臺東,一等
2020-09-30,6000,8424,11113,19537,臺東,一等
2020-10-01,6000,7242,13269,20511,臺東,一等
2020-10-02,6000,5173,7163,12336,臺東,一等
2020-10-03,6000,10288,5609,15897,臺東,一等
2020-10-04,6000,16613,9896,26509,臺東,一等
2020-10-05,6000,6812,5386,12198,臺東,一等
2020-10-06,6000,4320,4393,8713,臺東,一等
2020-10-07,6000,4380,4585,8965,臺東,一等
2020-10-08,6000,7284,9101,16385,臺東,一等
2020-10-09,6000,6586,10987,17573,臺東,一等
2020-10-10,6000,6229,4680,10909,臺東,一等
2020-10-11,6000,13999,8768,22767,臺東,一等
2020-10-12,6000,5792,4976,10768,臺東,一等
2020-10-13,6000,5178,4098,9276,臺東,一等
2020-10-14,6000,4290,4292,8582,臺東,一等
2020-10-15,6000,4910,5232,10142,臺東,一等
2020-10-16,6000,6836,8581,15417,臺東,一等
2020-10-17,6000,5793,7283,13076,臺東,一等
2020-10-18,6000,9639,7487,17126,臺東,一等
2020-10-19,6000,6176,4976,11152,臺東,一等
2020-10-20,6000,4826,4557,9383,臺東,一等
2020-10-21,6000,4742,4741,9483,臺東,一等
2020-10-22,6000,5151,5137,10288,臺東,一等
2020-10-23,6000,7066,8574,15640,臺東,一等
2020-10-24,6000,5703,7343,13046,臺東,一等
2020-10-25,6000,10309,7788,18097,臺東,一等
2020-10-26,6000,6665,5257,11922,臺東,一等
2020-10-27,6000,4529,4132,8661,臺東,一等
2020-10-28,6000,4240,4402,8642,臺東,一等
2020-10-29,6000,4705,4580,9285,臺東,一等
2020-10-30,6000,6915,7178,14093,臺東,一等
2020-10-31,6000,5662,5951,11613,臺東,一等
2020-11-01,6000,8341,6920,15261,臺東,一等
2020-11-02,6000,4907,4184,9091,臺東,一等
2020-11-03,6000,3483,3629,7112,臺東,一等
2020-11-04,6000,3258,3607,6865,臺東,一等
2020-11-05,6000,4077,5091,9168,臺東,一等
2020-11-06,6000,6569,6780,13349,臺東,一等
2020-11-07,6000,4963,5639,10602,臺東,一等
2020-11-08,6000,7656,6669,14325,臺東,一等
2020-11-09,6000,6279,4427,10706,臺東,一等
2020-11-10,6000,3450,3516,6966,臺東,一等
2020-11-11,6000,3973,3966,7939,臺東,一等
2020-11-12,6000,4195,4767,8962,臺東,一等
2020-11-13,6000,6604,9435,16039,臺東,一等
2020-11-14,6000,5627,7668,13295,臺東,一等
2020-11-15,6000,11251,7162,18413,臺東,一等
2020-11-16,6000,5648,4980,10628,臺東,一等
2020-11-17,6000,4418,4103,8521,臺東,一等
2020-11-18,6000,4396,4513,8909,臺東,一等
2020-11-19,6000,4543,5220,9763,臺東,一等
2020-11-20,6000,7089,8079,15168,臺東,一等
2020-11-21,6000,5821,6325,12146,臺東,一等
2020-11-22,6000,9077,6904,15981,臺東,一等
2020-11-23,6000,5543,4830,10373,臺東,一等
2020-11-24,6000,4360,3921,8281,臺東,一等
2020-11-25,6000,3752,4266,8018,臺東,一等
2020-11-26,6000,4839,5194,10033,臺東,一等
2020-11-27,6000,7569,7995,15564,臺東,一等
2020-11-28,6000,5844,6098,11942,臺東,一等
2020-11-29,6000,8868,7055,15923,臺東,一等
2020-11-30,6000,5681,5298,10979,臺東,一等
2020-12-01,6000,3434,3330,6764,臺東,一等
2020-12-02,6000,3217,3567,6784,臺東,一等
2020-12-03,6000,3890,4225,8115,臺東,一等
2020-12-04,6000,6857,6854,13711,臺東,一等
2020-12-05,6000,5563,6815,12378,臺東,一等
2020-12-06,6000,8720,7700,16420,臺東,一等
2020-12-07,6000,5235,4900,10135,臺東,一等
2020-12-08,6000,3767,4211,7978,臺東,一等
2020-12-09,6000,3905,4062,7967,臺東,一等
2020-12-10,6000,4427,4211,8638,臺東,一等
2020-12-11,6000,7278,7681,14959,臺東,一等
2020-12-12,6000,5702,6329,12031,臺東,一等
2020-12-13,6000,8868,7806,16674,臺東,一等
2020-12-14,6000,5107,5034,10141,臺東,一等
2020-12-15,6000,3853,3744,7597,臺東,一等
2020-12-16,6000,3700,4314,8014,臺東,一等
2020-12-17,6000,4568,4835,9403,臺東,一等
2020-12-18,6000,7167,7465,14632,臺東,一等
2020-12-19,6000,5996,6312,12308,臺東,一等
2020-12-20,6000,9412,7294,16706,臺東,一等
2020-12-21,6000,4989,5069,10058,臺東,一等
2020-12-22,6000,4287,4311,8598,臺東,一等
2020-12-23,6000,4317,4452,8769,臺東,一等
2020-12-24,6000,4394,4670,9064,臺東,一等
2020-12-25,6000,6674,6595,13269,臺東,一等
2020-12-26,6000,5620,6145,11765,臺東,一等
2020-12-27,6000,7997,7374,15371,臺東,一等
2020-12-28,6000,4762,5009,9771,臺東,一等
2020-12-29,6000,4410,5196,9606,臺東,一等
2020-12-30,6000,4500,9027,13527,臺東,一等
2020-12-31,6000,6864,16613,23477,臺東,一等
2020-01-01,6010,3,3,6,山里,乙簡
2020-01-02,6010,3,4,7,山里,乙簡
2020-01-03,6010,2,6,8,山里,乙簡
2020-01-04,6010,5,9,14,山里,乙簡
2020-01-05,6010,4,8,12,山里,乙簡
2020-01-06,6010,6,5,11,山里,乙簡
2020-01-07,6010,2,7,9,山里,乙簡
2020-01-08,6010,8,6,14,山里,乙簡
2020-01-09,6010,6,7,13,山里,乙簡
2020-01-10,6010,4,10,14,山里,乙簡
2020-01-11,6010,5,6,11,山里,乙簡
2020-01-12,6010,4,11,15,山里,乙簡
2020-01-13,6010,6,6,12,山里,乙簡
2020-01-14,6010,6,8,14,山里,乙簡
2020-01-15,6010,3,9,12,山里,乙簡
2020-01-16,6010,6,8,14,山里,乙簡
2020-01-17,6010,13,13,26,山里,乙簡
2020-01-18,6010,4,7,11,山里,乙簡
2020-01-19,6010,24,25,49,山里,乙簡
2020-01-20,6010,7,11,18,山里,乙簡
2020-01-21,6010,7,14,21,山里,乙簡
2020-01-22,6010,6,8,14,山里,乙簡
2020-01-23,6010,1,5,6,山里,乙簡
2020-01-24,6010,7,12,19,山里,乙簡
2020-01-25,6010,5,4,9,山里,乙簡
2020-01-26,6010,4,12,16,山里,乙簡
2020-01-27,6010,8,4,12,山里,乙簡
2020-01-28,6010,7,13,20,山里,乙簡
2020-01-29,6010,7,2,9,山里,乙簡
2020-01-30,6010,7,8,15,山里,乙簡
2020-01-31,6010,5,6,11,山里,乙簡
2020-02-01,6010,1,7,8,山里,乙簡
2020-02-02,6010,7,15,22,山里,乙簡
2020-02-03,6010,3,5,8,山里,乙簡
2020-02-04,6010,6,3,9,山里,乙簡
2020-02-05,6010,3,7,10,山里,乙簡
2020-02-06,6010,3,4,7,山里,乙簡
2020-02-07,6010,6,9,15,山里,乙簡
2020-02-08,6010,2,3,5,山里,乙簡
2020-02-09,6010,3,7,10,山里,乙簡
2020-02-10,6010,5,6,11,山里,乙簡
2020-02-11,6010,4,8,12,山里,乙簡
2020-02-12,6010,1,3,4,山里,乙簡
2020-02-13,6010,4,11,15,山里,乙簡
2020-02-14,6010,6,4,10,山里,乙簡
2020-02-15,6010,2,8,10,山里,乙簡
2020-02-16,6010,16,8,24,山里,乙簡
2020-02-17,6010,3,11,14,山里,乙簡
2020-02-18,6010,5,4,9,山里,乙簡
2020-02-19,6010,3,3,6,山里,乙簡
2020-02-20,6010,5,5,10,山里,乙簡
2020-02-21,6010,3,5,8,山里,乙簡
2020-02-22,6010,0,11,11,山里,乙簡
2020-02-23,6010,7,12,19,山里,乙簡
2020-02-24,6010,6,10,16,山里,乙簡
2020-02-25,6010,4,12,16,山里,乙簡
2020-02-26,6010,19,21,40,山里,乙簡
2020-02-27,6010,2,8,10,山里,乙簡
2020-02-28,6010,3,7,10,山里,乙簡
2020-02-29,6010,4,13,17,山里,乙簡
2020-03-01,6010,4,10,14,山里,乙簡
2020-03-02,6010,3,9,12,山里,乙簡
2020-03-03,6010,4,6,10,山里,乙簡
2020-03-04,6010,5,7,12,山里,乙簡
2020-03-05,6010,2,4,6,山里,乙簡
2020-03-06,6010,4,8,12,山里,乙簡
2020-03-07,6010,3,5,8,山里,乙簡
2020-03-08,6010,2,4,6,山里,乙簡
2020-03-09,6010,5,6,11,山里,乙簡
2020-03-10,6010,3,7,10,山里,乙簡
2020-03-11,6010,1,5,6,山里,乙簡
2020-03-12,6010,3,6,9,山里,乙簡
2020-03-13,6010,2,7,9,山里,乙簡
2020-03-14,6010,2,5,7,山里,乙簡
2020-03-15,6010,6,7,13,山里,乙簡
2020-03-16,6010,3,2,5,山里,乙簡
2020-03-17,6010,4,5,9,山里,乙簡
2020-03-18,6010,2,3,5,山里,乙簡
2020-03-19,6010,1,4,5,山里,乙簡
2020-03-20,6010,2,5,7,山里,乙簡
2020-03-21,6010,2,4,6,山里,乙簡
2020-03-22,6010,2,1,3,山里,乙簡
2020-03-23,6010,2,8,10,山里,乙簡
2020-03-24,6010,2,2,4,山里,乙簡
2020-03-25,6010,2,11,13,山里,乙簡
2020-03-26,6010,2,4,6,山里,乙簡
2020-03-27,6010,5,11,16,山里,乙簡
2020-03-28,6010,0,4,4,山里,乙簡
2020-03-29,6010,6,9,15,山里,乙簡
2020-03-30,6010,4,4,8,山里,乙簡
2020-03-31,6010,3,12,15,山里,乙簡
2020-04-01,6010,2,10,12,山里,乙簡
2020-04-02,6010,2,4,6,山里,乙簡
2020-04-03,6010,8,6,14,山里,乙簡
2020-04-04,6010,7,1,8,山里,乙簡
2020-04-05,6010,3,6,9,山里,乙簡
2020-04-06,6010,2,3,5,山里,乙簡
2020-04-07,6010,3,6,9,山里,乙簡
2020-04-08,6010,2,5,7,山里,乙簡
2020-04-09,6010,2,8,10,山里,乙簡
2020-04-10,6010,1,7,8,山里,乙簡
2020-04-11,6010,6,2,8,山里,乙簡
2020-04-12,6010,5,9,14,山里,乙簡
2020-04-13,6010,3,4,7,山里,乙簡
2020-04-14,6010,6,7,13,山里,乙簡
2020-04-15,6010,2,5,7,山里,乙簡
2020-04-16,6010,2,3,5,山里,乙簡
2020-04-17,6010,2,4,6,山里,乙簡
2020-04-18,6010,1,4,5,山里,乙簡
2020-04-19,6010,3,4,7,山里,乙簡
2020-04-20,6010,7,12,19,山里,乙簡
2020-04-21,6010,6,4,10,山里,乙簡
2020-04-22,6010,0,4,4,山里,乙簡
2020-04-23,6010,3,2,5,山里,乙簡
2020-04-24,6010,1,6,7,山里,乙簡
2020-04-25,6010,1,22,23,山里,乙簡
2020-04-26,6010,4,7,11,山里,乙簡
2020-04-27,6010,6,10,16,山里,乙簡
2020-04-28,6010,3,3,6,山里,乙簡
2020-04-29,6010,1,1,2,山里,乙簡
2020-04-30,6010,6,8,14,山里,乙簡
2020-05-01,6010,4,9,13,山里,乙簡
2020-05-02,6010,2,6,8,山里,乙簡
2020-05-03,6010,1,10,11,山里,乙簡
2020-05-04,6010,2,2,4,山里,乙簡
2020-05-05,6010,3,5,8,山里,乙簡
2020-05-06,6010,2,4,6,山里,乙簡
2020-05-07,6010,2,6,8,山里,乙簡
2020-05-08,6010,2,5,7,山里,乙簡
2020-05-09,6010,1,5,6,山里,乙簡
2020-05-10,6010,6,1,7,山里,乙簡
2020-05-11,6010,4,4,8,山里,乙簡
2020-05-12,6010,5,8,13,山里,乙簡
2020-05-13,6010,2,5,7,山里,乙簡
2020-05-14,6010,2,3,5,山里,乙簡
2020-05-15,6010,8,6,14,山里,乙簡
2020-05-16,6010,3,5,8,山里,乙簡
2020-05-17,6010,1,5,6,山里,乙簡
2020-05-18,6010,3,2,5,山里,乙簡
2020-05-19,6010,6,4,10,山里,乙簡
2020-05-20,6010,2,7,9,山里,乙簡
2020-05-21,6010,5,6,11,山里,乙簡
2020-05-22,6010,3,4,7,山里,乙簡
2020-05-23,6010,0,3,3,山里,乙簡
2020-05-24,6010,3,6,9,山里,乙簡
2020-05-25,6010,3,2,5,山里,乙簡
2020-05-26,6010,3,6,9,山里,乙簡
2020-05-27,6010,2,3,5,山里,乙簡
2020-05-28,6010,2,4,6,山里,乙簡
2020-05-29,6010,3,7,10,山里,乙簡
2020-05-30,6010,4,10,14,山里,乙簡
2020-05-31,6010,12,12,24,山里,乙簡
2020-06-01,6010,1,2,3,山里,乙簡
2020-06-02,6010,4,4,8,山里,乙簡
2020-06-03,6010,5,7,12,山里,乙簡
2020-06-04,6010,2,5,7,山里,乙簡
2020-06-05,6010,3,7,10,山里,乙簡
2020-06-06,6010,2,4,6,山里,乙簡
2020-06-07,6010,0,3,3,山里,乙簡
2020-06-08,6010,5,2,7,山里,乙簡
2020-06-09,6010,5,5,10,山里,乙簡
2020-06-10,6010,1,1,2,山里,乙簡
2020-06-11,6010,2,6,8,山里,乙簡
2020-06-12,6010,3,4,7,山里,乙簡
2020-06-13,6010,0,1,1,山里,乙簡
2020-06-14,6010,4,3,7,山里,乙簡
2020-06-15,6010,7,3,10,山里,乙簡
2020-06-16,6010,2,5,7,山里,乙簡
2020-06-17,6010,5,4,9,山里,乙簡
2020-06-18,6010,5,6,11,山里,乙簡
2020-06-19,6010,6,5,11,山里,乙簡
2020-06-20,6010,2,4,6,山里,乙簡
2020-06-21,6010,3,4,7,山里,乙簡
2020-06-22,6010,7,6,13,山里,乙簡
2020-06-23,6010,1,5,6,山里,乙簡
2020-06-24,6010,0,12,12,山里,乙簡
2020-06-25,6010,3,5,8,山里,乙簡
2020-06-26,6010,4,5,9,山里,乙簡
2020-06-27,6010,6,7,13,山里,乙簡
2020-06-28,6010,10,16,26,山里,乙簡
2020-06-29,6010,9,10,19,山里,乙簡
2020-06-30,6010,3,5,8,山里,乙簡
2020-07-01,6010,4,4,8,山里,乙簡
2020-07-02,6010,4,7,11,山里,乙簡
2020-07-03,6010,17,19,36,山里,乙簡
2020-07-04,6010,4,8,12,山里,乙簡
2020-07-05,6010,3,5,8,山里,乙簡
2020-07-06,6010,4,4,8,山里,乙簡
2020-07-07,6010,2,6,8,山里,乙簡
2020-07-08,6010,3,3,6,山里,乙簡
2020-07-09,6010,5,10,15,山里,乙簡
2020-07-10,6010,3,6,9,山里,乙簡
2020-07-11,6010,10,10,20,山里,乙簡
2020-07-12,6010,13,14,27,山里,乙簡
2020-07-13,6010,4,3,7,山里,乙簡
2020-07-14,6010,10,7,17,山里,乙簡
2020-07-15,6010,2,5,7,山里,乙簡
2020-07-16,6010,6,7,13,山里,乙簡
2020-07-17,6010,5,9,14,山里,乙簡
2020-07-18,6010,10,13,23,山里,乙簡
2020-07-19,6010,4,8,12,山里,乙簡
2020-07-20,6010,2,5,7,山里,乙簡
2020-07-21,6010,6,5,11,山里,乙簡
2020-07-22,6010,5,2,7,山里,乙簡
2020-07-23,6010,5,8,13,山里,乙簡
2020-07-24,6010,5,7,12,山里,乙簡
2020-07-25,6010,13,22,35,山里,乙簡
2020-07-26,6010,18,18,36,山里,乙簡
2020-07-27,6010,6,9,15,山里,乙簡
2020-07-28,6010,3,3,6,山里,乙簡
2020-07-29,6010,5,6,11,山里,乙簡
2020-07-30,6010,4,5,9,山里,乙簡
2020-07-31,6010,2,7,9,山里,乙簡
2020-08-01,6010,8,12,20,山里,乙簡
2020-08-02,6010,3,11,14,山里,乙簡
2020-08-03,6010,4,5,9,山里,乙簡
2020-08-04,6010,4,4,8,山里,乙簡
2020-08-05,6010,5,12,17,山里,乙簡
2020-08-06,6010,4,5,9,山里,乙簡
2020-08-07,6010,5,9,14,山里,乙簡
2020-08-08,6010,5,8,13,山里,乙簡
2020-08-09,6010,1,4,5,山里,乙簡
2020-08-10,6010,12,5,17,山里,乙簡
2020-08-11,6010,5,4,9,山里,乙簡
2020-08-12,6010,7,7,14,山里,乙簡
2020-08-13,6010,1,6,7,山里,乙簡
2020-08-14,6010,5,5,10,山里,乙簡
2020-08-15,6010,2,4,6,山里,乙簡
2020-08-16,6010,4,11,15,山里,乙簡
2020-08-17,6010,4,2,6,山里,乙簡
2020-08-18,6010,4,6,10,山里,乙簡
2020-08-19,6010,1,9,10,山里,乙簡
2020-08-20,6010,7,6,13,山里,乙簡
2020-08-21,6010,6,6,12,山里,乙簡
2020-08-22,6010,10,10,20,山里,乙簡
2020-08-23,6010,8,18,26,山里,乙簡
2020-08-24,6010,4,10,14,山里,乙簡
2020-08-25,6010,5,16,21,山里,乙簡
2020-08-26,6010,3,6,9,山里,乙簡
2020-08-27,6010,4,5,9,山里,乙簡
2020-08-28,6010,4,9,13,山里,乙簡
2020-08-29,6010,4,8,12,山里,乙簡
2020-08-30,6010,3,4,7,山里,乙簡
2020-08-31,6010,4,4,8,山里,乙簡
2020-09-01,6010,0,3,3,山里,乙簡
2020-09-02,6010,4,5,9,山里,乙簡
2020-09-03,6010,2,3,5,山里,乙簡
2020-09-04,6010,4,9,13,山里,乙簡
2020-09-05,6010,5,10,15,山里,乙簡
2020-09-06,6010,2,6,8,山里,乙簡
2020-09-07,6010,5,1,6,山里,乙簡
2020-09-08,6010,5,5,10,山里,乙簡
2020-09-09,6010,1,4,5,山里,乙簡
2020-09-10,6010,2,4,6,山里,乙簡
2020-09-11,6010,3,4,7,山里,乙簡
2020-09-12,6010,3,4,7,山里,乙簡
2020-09-13,6010,2,4,6,山里,乙簡
2020-09-14,6010,8,12,20,山里,乙簡
2020-09-15,6010,5,7,12,山里,乙簡
2020-09-16,6010,6,2,8,山里,乙簡
2020-09-17,6010,3,6,9,山里,乙簡
2020-09-18,6010,1,6,7,山里,乙簡
2020-09-19,6010,5,4,9,山里,乙簡
2020-09-20,6010,5,5,10,山里,乙簡
2020-09-21,6010,5,4,9,山里,乙簡
2020-09-22,6010,4,7,11,山里,乙簡
2020-09-23,6010,6,9,15,山里,乙簡
2020-09-24,6010,3,6,9,山里,乙簡
2020-09-25,6010,3,13,16,山里,乙簡
2020-09-26,6010,4,7,11,山里,乙簡
2020-09-27,6010,12,6,18,山里,乙簡
2020-09-28,6010,7,9,16,山里,乙簡
2020-09-29,6010,9,16,25,山里,乙簡
2020-09-30,6010,3,6,9,山里,乙簡
2020-10-01,6010,6,14,20,山里,乙簡
2020-10-02,6010,6,7,13,山里,乙簡
2020-10-03,6010,4,7,11,山里,乙簡
2020-10-04,6010,8,3,11,山里,乙簡
2020-10-05,6010,5,5,10,山里,乙簡
2020-10-06,6010,9,9,18,山里,乙簡
2020-10-07,6010,4,8,12,山里,乙簡
2020-10-08,6010,2,9,11,山里,乙簡
2020-10-09,6010,4,5,9,山里,乙簡
2020-10-10,6010,9,11,20,山里,乙簡
2020-10-11,6010,3,4,7,山里,乙簡
2020-10-12,6010,6,10,16,山里,乙簡
2020-10-13,6010,7,7,14,山里,乙簡
2020-10-14,6010,5,6,11,山里,乙簡
2020-10-15,6010,3,7,10,山里,乙簡
2020-10-16,6010,3,7,10,山里,乙簡
2020-10-17,6010,3,7,10,山里,乙簡
2020-10-18,6010,3,2,5,山里,乙簡
2020-10-19,6010,5,4,9,山里,乙簡
2020-10-20,6010,3,7,10,山里,乙簡
2020-10-21,6010,0,2,2,山里,乙簡
2020-10-22,6010,2,9,11,山里,乙簡
2020-10-23,6010,2,4,6,山里,乙簡
2020-10-24,6010,6,13,19,山里,乙簡
2020-10-25,6010,45,37,82,山里,乙簡
2020-10-26,6010,10,7,17,山里,乙簡
2020-10-27,6010,4,6,10,山里,乙簡
2020-10-28,6010,1,2,3,山里,乙簡
2020-10-29,6010,6,10,16,山里,乙簡
2020-10-30,6010,3,5,8,山里,乙簡
2020-10-31,6010,17,13,30,山里,乙簡
2020-11-01,6010,2,5,7,山里,乙簡
2020-11-02,6010,0,5,5,山里,乙簡
2020-11-03,6010,4,6,10,山里,乙簡
2020-11-04,6010,1,2,3,山里,乙簡
2020-11-05,6010,4,5,9,山里,乙簡
2020-11-06,6010,3,4,7,山里,乙簡
2020-11-07,6010,1,3,4,山里,乙簡
2020-11-08,6010,4,7,11,山里,乙簡
2020-11-09,6010,4,11,15,山里,乙簡
2020-11-10,6010,5,7,12,山里,乙簡
2020-11-11,6010,33,33,66,山里,乙簡
2020-11-12,6010,33,8,41,山里,乙簡
2020-11-13,6010,2,6,8,山里,乙簡
2020-11-14,6010,2,1,3,山里,乙簡
2020-11-15,6010,6,12,18,山里,乙簡
2020-11-16,6010,6,6,12,山里,乙簡
2020-11-17,6010,8,9,17,山里,乙簡
2020-11-18,6010,5,10,15,山里,乙簡
2020-11-19,6010,3,8,11,山里,乙簡
2020-11-20,6010,3,61,64,山里,乙簡
2020-11-21,6010,5,4,9,山里,乙簡
2020-11-22,6010,8,8,16,山里,乙簡
2020-11-23,6010,10,8,18,山里,乙簡
2020-11-24,6010,2,10,12,山里,乙簡
2020-11-25,6010,5,8,13,山里,乙簡
2020-11-26,6010,5,4,9,山里,乙簡
2020-11-27,6010,9,9,18,山里,乙簡
2020-11-28,6010,2,7,9,山里,乙簡
2020-11-29,6010,12,15,27,山里,乙簡
2020-11-30,6010,6,6,12,山里,乙簡
2020-12-01,6010,4,4,8,山里,乙簡
2020-12-02,6010,5,10,15,山里,乙簡
2020-12-03,6010,3,4,7,山里,乙簡
2020-12-04,6010,2,4,6,山里,乙簡
2020-12-05,6010,2,7,9,山里,乙簡
2020-12-06,6010,7,9,16,山里,乙簡
2020-12-07,6010,4,3,7,山里,乙簡
2020-12-08,6010,17,20,37,山里,乙簡
2020-12-09,6010,5,11,16,山里,乙簡
2020-12-10,6010,5,5,10,山里,乙簡
2020-12-11,6010,6,8,14,山里,乙簡
2020-12-12,6010,2,9,11,山里,乙簡
2020-12-13,6010,2,5,7,山里,乙簡
2020-12-14,6010,12,10,22,山里,乙簡
2020-12-15,6010,7,12,19,山里,乙簡
2020-12-16,6010,4,8,12,山里,乙簡
2020-12-17,6010,2,2,4,山里,乙簡
2020-12-18,6010,6,9,15,山里,乙簡
2020-12-19,6010,6,9,15,山里,乙簡
2020-12-20,6010,4,3,7,山里,乙簡
2020-12-21,6010,5,8,13,山里,乙簡
2020-12-22,6010,4,5,9,山里,乙簡
2020-12-23,6010,3,3,6,山里,乙簡
2020-12-24,6010,3,5,8,山里,乙簡
2020-12-25,6010,5,8,13,山里,乙簡
2020-12-26,6010,6,8,14,山里,乙簡
2020-12-27,6010,9,11,20,山里,乙簡
2020-12-28,6010,6,7,13,山里,乙簡
2020-12-29,6010,2,3,5,山里,乙簡
2020-12-30,6010,4,10,14,山里,乙簡
2020-12-31,6010,2,8,10,山里,乙簡
2020-01-01,6020,201,120,321,鹿野,三等
2020-01-02,6020,232,155,387,鹿野,三等
2020-01-03,6020,176,190,366,鹿野,三等
2020-01-04,6020,182,182,364,鹿野,三等
2020-01-05,6020,179,132,311,鹿野,三等
2020-01-06,6020,186,162,348,鹿野,三等
2020-01-07,6020,198,168,366,鹿野,三等
2020-01-08,6020,176,164,340,鹿野,三等
2020-01-09,6020,166,171,337,鹿野,三等
2020-01-10,6020,228,304,532,鹿野,三等
2020-01-11,6020,244,251,495,鹿野,三等
2020-01-12,6020,270,161,431,鹿野,三等
2020-01-13,6020,225,232,457,鹿野,三等
2020-01-14,6020,226,197,423,鹿野,三等
2020-01-15,6020,243,191,434,鹿野,三等
2020-01-16,6020,251,257,508,鹿野,三等
2020-01-17,6020,202,245,447,鹿野,三等
2020-01-18,6020,163,226,389,鹿野,三等
2020-01-19,6020,294,160,454,鹿野,三等
2020-01-20,6020,207,201,408,鹿野,三等
2020-01-21,6020,189,257,446,鹿野,三等
2020-01-22,6020,199,291,490,鹿野,三等
2020-01-23,6020,156,390,546,鹿野,三等
2020-01-24,6020,108,286,394,鹿野,三等
2020-01-25,6020,370,358,728,鹿野,三等
2020-01-26,6020,315,348,663,鹿野,三等
2020-01-27,6020,458,293,751,鹿野,三等
2020-01-28,6020,437,166,603,鹿野,三等
2020-01-29,6020,402,162,564,鹿野,三等
2020-01-30,6020,314,326,640,鹿野,三等
2020-01-31,6020,307,237,544,鹿野,三等
2020-02-01,6020,216,138,354,鹿野,三等
2020-02-02,6020,185,152,337,鹿野,三等
2020-02-03,6020,284,196,480,鹿野,三等
2020-02-04,6020,159,166,325,鹿野,三等
2020-02-05,6020,174,132,306,鹿野,三等
2020-02-06,6020,191,155,346,鹿野,三等
2020-02-07,6020,202,232,434,鹿野,三等
2020-02-08,6020,199,170,369,鹿野,三等
2020-02-09,6020,319,122,441,鹿野,三等
2020-02-10,6020,244,142,386,鹿野,三等
2020-02-11,6020,153,158,311,鹿野,三等
2020-02-12,6020,160,134,294,鹿野,三等
2020-02-13,6020,165,139,304,鹿野,三等
2020-02-14,6020,149,137,286,鹿野,三等
2020-02-15,6020,127,140,267,鹿野,三等
2020-02-16,6020,171,133,304,鹿野,三等
2020-02-17,6020,137,115,252,鹿野,三等
2020-02-18,6020,131,146,277,鹿野,三等
2020-02-19,6020,132,106,238,鹿野,三等
2020-02-20,6020,144,160,304,鹿野,三等
2020-02-21,6020,169,233,402,鹿野,三等
2020-02-22,6020,209,186,395,鹿野,三等
2020-02-23,6020,283,133,416,鹿野,三等
2020-02-24,6020,182,214,396,鹿野,三等
2020-02-25,6020,173,144,317,鹿野,三等
2020-02-26,6020,167,190,357,鹿野,三等
2020-02-27,6020,153,227,380,鹿野,三等
2020-02-28,6020,147,206,353,鹿野,三等
2020-02-29,6020,183,142,325,鹿野,三等
2020-03-01,6020,350,129,479,鹿野,三等
2020-03-02,6020,193,154,347,鹿野,三等
2020-03-03,6020,157,114,271,鹿野,三等
2020-03-04,6020,137,153,290,鹿野,三等
2020-03-05,6020,126,162,288,鹿野,三等
2020-03-06,6020,183,248,431,鹿野,三等
2020-03-07,6020,134,137,271,鹿野,三等
2020-03-08,6020,226,135,361,鹿野,三等
2020-03-09,6020,208,147,355,鹿野,三等
2020-03-10,6020,160,141,301,鹿野,三等
2020-03-11,6020,119,113,232,鹿野,三等
2020-03-12,6020,133,124,257,鹿野,三等
2020-03-13,6020,166,221,387,鹿野,三等
2020-03-14,6020,101,137,238,鹿野,三等
2020-03-15,6020,223,114,337,鹿野,三等
2020-03-16,6020,141,132,273,鹿野,三等
2020-03-17,6020,139,134,273,鹿野,三等
2020-03-18,6020,136,120,256,鹿野,三等
2020-03-19,6020,127,151,278,鹿野,三等
2020-03-20,6020,165,240,405,鹿野,三等
2020-03-21,6020,163,123,286,鹿野,三等
2020-03-22,6020,249,84,333,鹿野,三等
2020-03-23,6020,146,228,374,鹿野,三等
2020-03-24,6020,122,107,229,鹿野,三等
2020-03-25,6020,136,117,253,鹿野,三等
2020-03-26,6020,135,142,277,鹿野,三等
2020-03-27,6020,137,238,375,鹿野,三等
2020-03-28,6020,127,164,291,鹿野,三等
2020-03-29,6020,219,85,304,鹿野,三等
2020-03-30,6020,174,133,307,鹿野,三等
2020-03-31,6020,165,157,322,鹿野,三等
2020-04-01,6020,159,274,433,鹿野,三等
2020-04-02,6020,111,324,435,鹿野,三等
2020-04-03,6020,155,192,347,鹿野,三等
2020-04-04,6020,358,113,471,鹿野,三等
2020-04-05,6020,374,97,471,鹿野,三等
2020-04-06,6020,238,133,371,鹿野,三等
2020-04-07,6020,140,98,238,鹿野,三等
2020-04-08,6020,123,128,251,鹿野,三等
2020-04-09,6020,128,120,248,鹿野,三等
2020-04-10,6020,157,177,334,鹿野,三等
2020-04-11,6020,131,93,224,鹿野,三等
2020-04-12,6020,111,81,192,鹿野,三等
2020-04-13,6020,129,169,298,鹿野,三等
2020-04-14,6020,123,113,236,鹿野,三等
2020-04-15,6020,117,127,244,鹿野,三等
2020-04-16,6020,128,134,262,鹿野,三等
2020-04-17,6020,147,208,355,鹿野,三等
2020-04-18,6020,85,116,201,鹿野,三等
2020-04-19,6020,174,101,275,鹿野,三等
2020-04-20,6020,152,122,274,鹿野,三等
2020-04-21,6020,123,100,223,鹿野,三等
2020-04-22,6020,119,135,254,鹿野,三等
2020-04-23,6020,128,120,248,鹿野,三等
2020-04-24,6020,158,209,367,鹿野,三等
2020-04-25,6020,119,152,271,鹿野,三等
2020-04-26,6020,206,82,288,鹿野,三等
2020-04-27,6020,164,185,349,鹿野,三等
2020-04-28,6020,116,137,253,鹿野,三等
2020-04-29,6020,129,124,253,鹿野,三等
2020-04-30,6020,130,145,275,鹿野,三等
2020-05-01,6020,152,218,370,鹿野,三等
2020-05-02,6020,98,81,179,鹿野,三等
2020-05-03,6020,211,80,291,鹿野,三等
2020-05-04,6020,155,121,276,鹿野,三等
2020-05-05,6020,136,113,249,鹿野,三等
2020-05-06,6020,142,123,265,鹿野,三等
2020-05-07,6020,118,139,257,鹿野,三等
2020-05-08,6020,166,227,393,鹿野,三等
2020-05-09,6020,105,113,218,鹿野,三等
2020-05-10,6020,258,104,362,鹿野,三等
2020-05-11,6020,184,175,359,鹿野,三等
2020-05-12,6020,176,135,311,鹿野,三等
2020-05-13,6020,134,141,275,鹿野,三等
2020-05-14,6020,152,147,299,鹿野,三等
2020-05-15,6020,163,222,385,鹿野,三等
2020-05-16,6020,115,157,272,鹿野,三等
2020-05-17,6020,219,121,340,鹿野,三等
2020-05-18,6020,161,155,316,鹿野,三等
2020-05-19,6020,121,127,248,鹿野,三等
2020-05-20,6020,131,143,274,鹿野,三等
2020-05-21,6020,150,131,281,鹿野,三等
2020-05-22,6020,141,176,317,鹿野,三等
2020-05-23,6020,92,85,177,鹿野,三等
2020-05-24,6020,151,86,237,鹿野,三等
2020-05-25,6020,158,189,347,鹿野,三等
2020-05-26,6020,162,143,305,鹿野,三等
2020-05-27,6020,137,107,244,鹿野,三等
2020-05-28,6020,142,153,295,鹿野,三等
2020-05-29,6020,154,241,395,鹿野,三等
2020-05-30,6020,140,207,347,鹿野,三等
2020-05-31,6020,318,114,432,鹿野,三等
2020-06-01,6020,185,124,309,鹿野,三等
2020-06-02,6020,133,109,242,鹿野,三等
2020-06-03,6020,239,241,480,鹿野,三等
2020-06-04,6020,132,127,259,鹿野,三等
2020-06-05,6020,166,194,360,鹿野,三等
2020-06-06,6020,120,176,296,鹿野,三等
2020-06-07,6020,232,123,355,鹿野,三等
2020-06-08,6020,182,113,295,鹿野,三等
2020-06-09,6020,160,160,320,鹿野,三等
2020-06-10,6020,226,118,344,鹿野,三等
2020-06-11,6020,157,161,318,鹿野,三等
2020-06-12,6020,174,227,401,鹿野,三等
2020-06-13,6020,242,236,478,鹿野,三等
2020-06-14,6020,238,110,348,鹿野,三等
2020-06-15,6020,188,233,421,鹿野,三等
2020-06-16,6020,154,153,307,鹿野,三等
2020-06-17,6020,212,208,420,鹿野,三等
2020-06-18,6020,174,143,317,鹿野,三等
2020-06-19,6020,177,195,372,鹿野,三等
2020-06-20,6020,191,266,457,鹿野,三等
2020-06-21,6020,263,196,459,鹿野,三等
2020-06-22,6020,220,253,473,鹿野,三等
2020-06-23,6020,150,179,329,鹿野,三等
2020-06-24,6020,246,316,562,鹿野,三等
2020-06-25,6020,164,268,432,鹿野,三等
2020-06-26,6020,227,197,424,鹿野,三等
2020-06-27,6020,252,124,376,鹿野,三等
2020-06-28,6020,336,115,451,鹿野,三等
2020-06-29,6020,231,162,393,鹿野,三等
2020-06-30,6020,153,159,312,鹿野,三等
2020-07-01,6020,147,166,313,鹿野,三等
2020-07-02,6020,174,156,330,鹿野,三等
2020-07-03,6020,192,210,402,鹿野,三等
2020-07-04,6020,131,173,304,鹿野,三等
2020-07-05,6020,183,145,328,鹿野,三等
2020-07-06,6020,220,217,437,鹿野,三等
2020-07-07,6020,209,170,379,鹿野,三等
2020-07-08,6020,176,227,403,鹿野,三等
2020-07-09,6020,258,217,475,鹿野,三等
2020-07-10,6020,240,327,567,鹿野,三等
2020-07-11,6020,474,749,1223,鹿野,三等
2020-07-12,6020,462,264,726,鹿野,三等
2020-07-13,6020,372,377,749,鹿野,三等
2020-07-14,6020,315,304,619,鹿野,三等
2020-07-15,6020,240,316,556,鹿野,三等
2020-07-16,6020,243,342,585,鹿野,三等
2020-07-17,6020,302,578,880,鹿野,三等
2020-07-18,6020,371,377,748,鹿野,三等
2020-07-19,6020,399,356,755,鹿野,三等
2020-07-20,6020,472,414,886,鹿野,三等
2020-07-21,6020,309,321,630,鹿野,三等
2020-07-22,6020,259,309,568,鹿野,三等
2020-07-23,6020,286,354,640,鹿野,三等
2020-07-24,6020,331,413,744,鹿野,三等
2020-07-25,6020,582,663,1245,鹿野,三等
2020-07-26,6020,421,319,740,鹿野,三等
2020-07-27,6020,326,299,625,鹿野,三等
2020-07-28,6020,276,273,549,鹿野,三等
2020-07-29,6020,341,319,660,鹿野,三等
2020-07-30,6020,299,334,633,鹿野,三等
2020-07-31,6020,327,357,684,鹿野,三等
2020-08-01,6020,332,405,737,鹿野,三等
2020-08-02,6020,398,286,684,鹿野,三等
2020-08-03,6020,375,297,672,鹿野,三等
2020-08-04,6020,245,199,444,鹿野,三等
2020-08-05,6020,233,271,504,鹿野,三等
2020-08-06,6020,263,236,499,鹿野,三等
2020-08-07,6020,282,373,655,鹿野,三等
2020-08-08,6020,307,390,697,鹿野,三等
2020-08-09,6020,447,270,717,鹿野,三等
2020-08-10,6020,307,369,676,鹿野,三等
2020-08-11,6020,273,296,569,鹿野,三等
2020-08-12,6020,287,288,575,鹿野,三等
2020-08-13,6020,219,294,513,鹿野,三等
2020-08-14,6020,324,334,658,鹿野,三等
2020-08-15,6020,374,425,799,鹿野,三等
2020-08-16,6020,553,1127,1680,鹿野,三等
2020-08-17,6020,412,413,825,鹿野,三等
2020-08-18,6020,308,318,626,鹿野,三等
2020-08-19,6020,292,266,558,鹿野,三等
2020-08-20,6020,250,290,540,鹿野,三等
2020-08-21,6020,283,341,624,鹿野,三等
2020-08-22,6020,354,426,780,鹿野,三等
2020-08-23,6020,436,291,727,鹿野,三等
2020-08-24,6020,303,300,603,鹿野,三等
2020-08-25,6020,308,262,570,鹿野,三等
2020-08-26,6020,266,293,559,鹿野,三等
2020-08-27,6020,288,361,649,鹿野,三等
2020-08-28,6020,325,342,667,鹿野,三等
2020-08-29,6020,317,452,769,鹿野,三等
2020-08-30,6020,511,447,958,鹿野,三等
2020-08-31,6020,348,172,520,鹿野,三等
2020-09-01,6020,189,162,351,鹿野,三等
2020-09-02,6020,200,194,394,鹿野,三等
2020-09-03,6020,165,179,344,鹿野,三等
2020-09-04,6020,228,236,464,鹿野,三等
2020-09-05,6020,454,468,922,鹿野,三等
2020-09-06,6020,254,157,411,鹿野,三等
2020-09-07,6020,189,170,359,鹿野,三等
2020-09-08,6020,219,171,390,鹿野,三等
2020-09-09,6020,180,160,340,鹿野,三等
2020-09-10,6020,156,228,384,鹿野,三等
2020-09-11,6020,198,189,387,鹿野,三等
2020-09-12,6020,144,157,301,鹿野,三等
2020-09-13,6020,300,136,436,鹿野,三等
2020-09-14,6020,207,168,375,鹿野,三等
2020-09-15,6020,158,173,331,鹿野,三等
2020-09-16,6020,175,141,316,鹿野,三等
2020-09-17,6020,164,200,364,鹿野,三等
2020-09-18,6020,232,254,486,鹿野,三等
2020-09-19,6020,532,576,1108,鹿野,三等
2020-09-20,6020,313,166,479,鹿野,三等
2020-09-21,6020,256,227,483,鹿野,三等
2020-09-22,6020,229,157,386,鹿野,三等
2020-09-23,6020,174,207,381,鹿野,三等
2020-09-24,6020,184,170,354,鹿野,三等
2020-09-25,6020,170,195,365,鹿野,三等
2020-09-26,6020,179,184,363,鹿野,三等
2020-09-27,6020,427,175,602,鹿野,三等
2020-09-28,6020,223,188,411,鹿野,三等
2020-09-29,6020,177,211,388,鹿野,三等
2020-09-30,6020,200,313,513,鹿野,三等
2020-10-01,6020,174,296,470,鹿野,三等
2020-10-02,6020,201,194,395,鹿野,三等
2020-10-03,6020,277,177,454,鹿野,三等
2020-10-04,6020,347,227,574,鹿野,三等
2020-10-05,6020,211,193,404,鹿野,三等
2020-10-06,6020,239,156,395,鹿野,三等
2020-10-07,6020,124,162,286,鹿野,三等
2020-10-08,6020,199,243,442,鹿野,三等
2020-10-09,6020,244,256,500,鹿野,三等
2020-10-10,6020,220,191,411,鹿野,三等
2020-10-11,6020,304,181,485,鹿野,三等
2020-10-12,6020,233,258,491,鹿野,三等
2020-10-13,6020,164,153,317,鹿野,三等
2020-10-14,6020,149,192,341,鹿野,三等
2020-10-15,6020,199,211,410,鹿野,三等
2020-10-16,6020,188,312,500,鹿野,三等
2020-10-17,6020,229,134,363,鹿野,三等
2020-10-18,6020,187,176,363,鹿野,三等
2020-10-19,6020,210,157,367,鹿野,三等
2020-10-20,6020,278,262,540,鹿野,三等
2020-10-21,6020,253,235,488,鹿野,三等
2020-10-22,6020,163,274,437,鹿野,三等
2020-10-23,6020,213,333,546,鹿野,三等
2020-10-24,6020,221,198,419,鹿野,三等
2020-10-25,6020,402,175,577,鹿野,三等
2020-10-26,6020,332,181,513,鹿野,三等
2020-10-27,6020,164,149,313,鹿野,三等
2020-10-28,6020,171,207,378,鹿野,三等
2020-10-29,6020,167,154,321,鹿野,三等
2020-10-30,6020,243,229,472,鹿野,三等
2020-10-31,6020,153,269,422,鹿野,三等
2020-11-01,6020,262,204,466,鹿野,三等
2020-11-02,6020,187,195,382,鹿野,三等
2020-11-03,6020,190,186,376,鹿野,三等
2020-11-04,6020,147,162,309,鹿野,三等
2020-11-05,6020,175,137,312,鹿野,三等
2020-11-06,6020,196,211,407,鹿野,三等
2020-11-07,6020,152,275,427,鹿野,三等
2020-11-08,6020,225,121,346,鹿野,三等
2020-11-09,6020,196,288,484,鹿野,三等
2020-11-10,6020,177,153,330,鹿野,三等
2020-11-11,6020,223,184,407,鹿野,三等
2020-11-12,6020,214,154,368,鹿野,三等
2020-11-13,6020,205,253,458,鹿野,三等
2020-11-14,6020,146,172,318,鹿野,三等
2020-11-15,6020,260,201,461,鹿野,三等
2020-11-16,6020,253,202,455,鹿野,三等
2020-11-17,6020,199,197,396,鹿野,三等
2020-11-18,6020,250,204,454,鹿野,三等
2020-11-19,6020,233,286,519,鹿野,三等
2020-11-20,6020,250,265,515,鹿野,三等
2020-11-21,6020,226,207,433,鹿野,三等
2020-11-22,6020,298,151,449,鹿野,三等
2020-11-23,6020,226,256,482,鹿野,三等
2020-11-24,6020,160,139,299,鹿野,三等
2020-11-25,6020,184,153,337,鹿野,三等
2020-11-26,6020,214,224,438,鹿野,三等
2020-11-27,6020,249,296,545,鹿野,三等
2020-11-28,6020,148,183,331,鹿野,三等
2020-11-29,6020,305,153,458,鹿野,三等
2020-11-30,6020,244,210,454,鹿野,三等
2020-12-01,6020,159,164,323,鹿野,三等
2020-12-02,6020,190,152,342,鹿野,三等
2020-12-03,6020,164,173,337,鹿野,三等
2020-12-04,6020,173,219,392,鹿野,三等
2020-12-05,6020,155,266,421,鹿野,三等
2020-12-06,6020,296,236,532,鹿野,三等
2020-12-07,6020,239,182,421,鹿野,三等
2020-12-08,6020,213,148,361,鹿野,三等
2020-12-09,6020,178,144,322,鹿野,三等
2020-12-10,6020,161,162,323,鹿野,三等
2020-12-11,6020,203,320,523,鹿野,三等
2020-12-12,6020,151,216,367,鹿野,三等
2020-12-13,6020,284,211,495,鹿野,三等
2020-12-14,6020,233,213,446,鹿野,三等
2020-12-15,6020,193,167,360,鹿野,三等
2020-12-16,6020,183,132,315,鹿野,三等
2020-12-17,6020,166,223,389,鹿野,三等
2020-12-18,6020,220,358,578,鹿野,三等
2020-12-19,6020,224,198,422,鹿野,三等
2020-12-20,6020,314,209,523,鹿野,三等
2020-12-21,6020,290,325,615,鹿野,三等
2020-12-22,6020,186,151,337,鹿野,三等
2020-12-23,6020,168,150,318,鹿野,三等
2020-12-24,6020,196,226,422,鹿野,三等
2020-12-25,6020,222,249,471,鹿野,三等
2020-12-26,6020,160,167,327,鹿野,三等
2020-12-27,6020,256,159,415,鹿野,三等
2020-12-28,6020,305,318,623,鹿野,三等
2020-12-29,6020,206,200,406,鹿野,三等
2020-12-30,6020,165,210,375,鹿野,三等
2020-12-31,6020,207,245,452,鹿野,三等
2020-01-01,6030,27,19,46,瑞源,三等
2020-01-02,6030,34,58,92,瑞源,三等
2020-01-03,6030,65,40,105,瑞源,三等
2020-01-04,6030,35,45,80,瑞源,三等
2020-01-05,6030,21,16,37,瑞源,三等
2020-01-06,6030,54,45,99,瑞源,三等
2020-01-07,6030,38,53,91,瑞源,三等
2020-01-08,6030,64,45,109,瑞源,三等
2020-01-09,6030,58,57,115,瑞源,三等
2020-01-10,6030,34,71,105,瑞源,三等
2020-01-11,6030,15,29,44,瑞源,三等
2020-01-12,6030,47,19,66,瑞源,三等
2020-01-13,6030,31,44,75,瑞源,三等
2020-01-14,6030,67,47,114,瑞源,三等
2020-01-15,6030,29,55,84,瑞源,三等
2020-01-16,6030,78,57,135,瑞源,三等
2020-01-17,6030,37,39,76,瑞源,三等
2020-01-18,6030,22,43,65,瑞源,三等
2020-01-19,6030,51,23,74,瑞源,三等
2020-01-20,6030,40,47,87,瑞源,三等
2020-01-21,6030,26,45,71,瑞源,三等
2020-01-22,6030,30,37,67,瑞源,三等
2020-01-23,6030,38,41,79,瑞源,三等
2020-01-24,6030,12,49,61,瑞源,三等
2020-01-25,6030,28,24,52,瑞源,三等
2020-01-26,6030,38,39,77,瑞源,三等
2020-01-27,6030,99,44,143,瑞源,三等
2020-01-28,6030,38,19,57,瑞源,三等
2020-01-29,6030,44,34,78,瑞源,三等
2020-01-30,6030,34,23,57,瑞源,三等
2020-01-31,6030,52,23,75,瑞源,三等
2020-02-01,6030,18,28,46,瑞源,三等
2020-02-02,6030,67,12,79,瑞源,三等
2020-02-03,6030,16,39,55,瑞源,三等
2020-02-04,6030,18,23,41,瑞源,三等
2020-02-05,6030,45,25,70,瑞源,三等
2020-02-06,6030,33,27,60,瑞源,三等
2020-02-07,6030,17,25,42,瑞源,三等
2020-02-08,6030,33,27,60,瑞源,三等
2020-02-09,6030,22,20,42,瑞源,三等
2020-02-10,6030,29,25,54,瑞源,三等
2020-02-11,6030,18,26,44,瑞源,三等
2020-02-12,6030,18,14,32,瑞源,三等
2020-02-13,6030,33,23,56,瑞源,三等
2020-02-14,6030,26,26,52,瑞源,三等
2020-02-15,6030,32,32,64,瑞源,三等
2020-02-16,6030,33,26,59,瑞源,三等
2020-02-17,6030,18,21,39,瑞源,三等
2020-02-18,6030,38,22,60,瑞源,三等
2020-02-19,6030,23,23,46,瑞源,三等
2020-02-20,6030,29,30,59,瑞源,三等
2020-02-21,6030,43,22,65,瑞源,三等
2020-02-22,6030,25,24,49,瑞源,三等
2020-02-23,6030,18,13,31,瑞源,三等
2020-02-24,6030,14,18,32,瑞源,三等
2020-02-25,6030,28,43,71,瑞源,三等
2020-02-26,6030,76,48,124,瑞源,三等
2020-02-27,6030,25,56,81,瑞源,三等
2020-02-28,6030,46,46,92,瑞源,三等
2020-02-29,6030,18,12,30,瑞源,三等
2020-03-01,6030,16,12,28,瑞源,三等
2020-03-02,6030,62,49,111,瑞源,三等
2020-03-03,6030,47,51,98,瑞源,三等
2020-03-04,6030,45,46,91,瑞源,三等
2020-03-05,6030,56,55,111,瑞源,三等
2020-03-06,6030,53,65,118,瑞源,三等
2020-03-07,6030,17,20,37,瑞源,三等
2020-03-08,6030,35,18,53,瑞源,三等
2020-03-09,6030,61,50,111,瑞源,三等
2020-03-10,6030,52,49,101,瑞源,三等
2020-03-11,6030,53,43,96,瑞源,三等
2020-03-12,6030,59,64,123,瑞源,三等
2020-03-13,6030,59,69,128,瑞源,三等
2020-03-14,6030,15,22,37,瑞源,三等
2020-03-15,6030,18,14,32,瑞源,三等
2020-03-16,6030,52,40,92,瑞源,三等
2020-03-17,6030,45,43,88,瑞源,三等
2020-03-18,6030,46,44,90,瑞源,三等
2020-03-19,6030,56,49,105,瑞源,三等
2020-03-20,6030,39,59,98,瑞源,三等
2020-03-21,6030,14,16,30,瑞源,三等
2020-03-22,6030,33,17,50,瑞源,三等
2020-03-23,6030,53,53,106,瑞源,三等
2020-03-24,6030,48,36,84,瑞源,三等
2020-03-25,6030,49,48,97,瑞源,三等
2020-03-26,6030,47,48,95,瑞源,三等
2020-03-27,6030,49,55,104,瑞源,三等
2020-03-28,6030,20,20,40,瑞源,三等
2020-03-29,6030,38,33,71,瑞源,三等
2020-03-30,6030,37,40,77,瑞源,三等
2020-03-31,6030,56,44,100,瑞源,三等
2020-04-01,6030,39,60,99,瑞源,三等
2020-04-02,6030,23,32,55,瑞源,三等
2020-04-03,6030,23,23,46,瑞源,三等
2020-04-04,6030,21,21,42,瑞源,三等
2020-04-05,6030,37,11,48,瑞源,三等
2020-04-06,6030,52,41,93,瑞源,三等
2020-04-07,6030,44,37,81,瑞源,三等
2020-04-08,6030,32,48,80,瑞源,三等
2020-04-09,6030,64,48,112,瑞源,三等
2020-04-10,6030,39,60,99,瑞源,三等
2020-04-11,6030,11,11,22,瑞源,三等
2020-04-12,6030,10,10,20,瑞源,三等
2020-04-13,6030,53,49,102,瑞源,三等
2020-04-14,6030,43,45,88,瑞源,三等
2020-04-15,6030,43,54,97,瑞源,三等
2020-04-16,6030,47,46,93,瑞源,三等
2020-04-17,6030,40,52,92,瑞源,三等
2020-04-18,6030,23,29,52,瑞源,三等
2020-04-19,6030,21,10,31,瑞源,三等
2020-04-20,6030,47,43,90,瑞源,三等
2020-04-21,6030,38,35,73,瑞源,三等
2020-04-22,6030,41,52,93,瑞源,三等
2020-04-23,6030,46,42,88,瑞源,三等
2020-04-24,6030,44,62,106,瑞源,三等
2020-04-25,6030,15,15,30,瑞源,三等
2020-04-26,6030,15,8,23,瑞源,三等
2020-04-27,6030,46,42,88,瑞源,三等
2020-04-28,6030,37,39,76,瑞源,三等
2020-04-29,6030,45,43,88,瑞源,三等
2020-04-30,6030,49,51,100,瑞源,三等
2020-05-01,6030,42,59,101,瑞源,三等
2020-05-02,6030,9,25,34,瑞源,三等
2020-05-03,6030,32,18,50,瑞源,三等
2020-05-04,6030,53,40,93,瑞源,三等
2020-05-05,6030,43,46,89,瑞源,三等
2020-05-06,6030,50,40,90,瑞源,三等
2020-05-07,6030,51,60,111,瑞源,三等
2020-05-08,6030,42,58,100,瑞源,三等
2020-05-09,6030,22,25,47,瑞源,三等
2020-05-10,6030,23,15,38,瑞源,三等
2020-05-11,6030,56,58,114,瑞源,三等
2020-05-12,6030,37,34,71,瑞源,三等
2020-05-13,6030,41,45,86,瑞源,三等
2020-05-14,6030,33,38,71,瑞源,三等
2020-05-15,6030,48,45,93,瑞源,三等
2020-05-16,6030,22,28,50,瑞源,三等
2020-05-17,6030,23,22,45,瑞源,三等
2020-05-18,6030,53,51,104,瑞源,三等
2020-05-19,6030,42,43,85,瑞源,三等
2020-05-20,6030,46,48,94,瑞源,三等
2020-05-21,6030,43,46,89,瑞源,三等
2020-05-22,6030,46,58,104,瑞源,三等
2020-05-23,6030,23,23,46,瑞源,三等
2020-05-24,6030,30,19,49,瑞源,三等
2020-05-25,6030,62,38,100,瑞源,三等
2020-05-26,6030,46,41,87,瑞源,三等
2020-05-27,6030,38,45,83,瑞源,三等
2020-05-28,6030,44,51,95,瑞源,三等
2020-05-29,6030,44,56,100,瑞源,三等
2020-05-30,6030,16,24,40,瑞源,三等
2020-05-31,6030,25,11,36,瑞源,三等
2020-06-01,6030,39,51,90,瑞源,三等
2020-06-02,6030,64,44,108,瑞源,三等
2020-06-03,6030,43,50,93,瑞源,三等
2020-06-04,6030,28,47,75,瑞源,三等
2020-06-05,6030,58,62,120,瑞源,三等
2020-06-06,6030,32,26,58,瑞源,三等
2020-06-07,6030,22,21,43,瑞源,三等
2020-06-08,6030,48,40,88,瑞源,三等
2020-06-09,6030,39,52,91,瑞源,三等
2020-06-10,6030,35,42,77,瑞源,三等
2020-06-11,6030,61,50,111,瑞源,三等
2020-06-12,6030,43,68,111,瑞源,三等
2020-06-13,6030,51,43,94,瑞源,三等
2020-06-14,6030,13,35,48,瑞源,三等
2020-06-15,6030,46,40,86,瑞源,三等
2020-06-16,6030,38,47,85,瑞源,三等
2020-06-17,6030,39,48,87,瑞源,三等
2020-06-18,6030,68,80,148,瑞源,三等
2020-06-19,6030,44,42,86,瑞源,三等
2020-06-20,6030,25,33,58,瑞源,三等
2020-06-21,6030,17,9,26,瑞源,三等
2020-06-22,6030,50,36,86,瑞源,三等
2020-06-23,6030,36,36,72,瑞源,三等
2020-06-24,6030,40,67,107,瑞源,三等
2020-06-25,6030,27,40,67,瑞源,三等
2020-06-26,6030,29,25,54,瑞源,三等
2020-06-27,6030,26,13,39,瑞源,三等
2020-06-28,6030,31,11,42,瑞源,三等
2020-06-29,6030,49,37,86,瑞源,三等
2020-06-30,6030,44,43,87,瑞源,三等
2020-07-01,6030,26,41,67,瑞源,三等
2020-07-02,6030,51,41,92,瑞源,三等
2020-07-03,6030,33,54,87,瑞源,三等
2020-07-04,6030,16,28,44,瑞源,三等
2020-07-05,6030,48,9,57,瑞源,三等
2020-07-06,6030,34,44,78,瑞源,三等
2020-07-07,6030,53,40,93,瑞源,三等
2020-07-08,6030,21,30,51,瑞源,三等
2020-07-09,6030,59,52,111,瑞源,三等
2020-07-10,6030,41,56,97,瑞源,三等
2020-07-11,6030,18,33,51,瑞源,三等
2020-07-12,6030,56,36,92,瑞源,三等
2020-07-13,6030,38,46,84,瑞源,三等
2020-07-14,6030,51,43,94,瑞源,三等
2020-07-15,6030,31,41,72,瑞源,三等
2020-07-16,6030,31,40,71,瑞源,三等
2020-07-17,6030,26,30,56,瑞源,三等
2020-07-18,6030,10,22,32,瑞源,三等
2020-07-19,6030,42,20,62,瑞源,三等
2020-07-20,6030,37,29,66,瑞源,三等
2020-07-21,6030,35,29,64,瑞源,三等
2020-07-22,6030,27,20,47,瑞源,三等
2020-07-23,6030,11,15,26,瑞源,三等
2020-07-24,6030,61,30,91,瑞源,三等
2020-07-25,6030,23,31,54,瑞源,三等
2020-07-26,6030,12,11,23,瑞源,三等
2020-07-27,6030,48,22,70,瑞源,三等
2020-07-28,6030,14,11,25,瑞源,三等
2020-07-29,6030,38,22,60,瑞源,三等
2020-07-30,6030,17,23,40,瑞源,三等
2020-07-31,6030,45,22,67,瑞源,三等
2020-08-01,6030,21,20,41,瑞源,三等
2020-08-02,6030,65,25,90,瑞源,三等
2020-08-03,6030,29,24,53,瑞源,三等
2020-08-04,6030,44,24,68,瑞源,三等
2020-08-05,6030,28,29,57,瑞源,三等
2020-08-06,6030,49,33,82,瑞源,三等
2020-08-07,6030,47,30,77,瑞源,三等
2020-08-08,6030,28,23,51,瑞源,三等
2020-08-09,6030,47,14,61,瑞源,三等
2020-08-10,6030,24,21,45,瑞源,三等
2020-08-11,6030,16,27,43,瑞源,三等
2020-08-12,6030,51,23,74,瑞源,三等
2020-08-13,6030,28,23,51,瑞源,三等
2020-08-14,6030,19,37,56,瑞源,三等
2020-08-15,6030,20,26,46,瑞源,三等
2020-08-16,6030,55,23,78,瑞源,三等
2020-08-17,6030,24,20,44,瑞源,三等
2020-08-18,6030,23,26,49,瑞源,三等
2020-08-19,6030,22,19,41,瑞源,三等
2020-08-20,6030,15,18,33,瑞源,三等
2020-08-21,6030,19,27,46,瑞源,三等
2020-08-22,6030,14,15,29,瑞源,三等
2020-08-23,6030,18,18,36,瑞源,三等
2020-08-24,6030,40,23,63,瑞源,三等
2020-08-25,6030,44,24,68,瑞源,三等
2020-08-26,6030,20,21,41,瑞源,三等
2020-08-27,6030,19,19,38,瑞源,三等
2020-08-28,6030,18,21,39,瑞源,三等
2020-08-29,6030,23,25,48,瑞源,三等
2020-08-30,6030,18,16,34,瑞源,三等
2020-08-31,6030,50,49,99,瑞源,三等
2020-09-01,6030,36,55,91,瑞源,三等
2020-09-02,6030,29,46,75,瑞源,三等
2020-09-03,6030,33,44,77,瑞源,三等
2020-09-04,6030,72,41,113,瑞源,三等
2020-09-05,6030,21,32,53,瑞源,三等
2020-09-06,6030,35,31,66,瑞源,三等
2020-09-07,6030,47,42,89,瑞源,三等
2020-09-08,6030,34,45,79,瑞源,三等
2020-09-09,6030,29,42,71,瑞源,三等
2020-09-10,6030,68,52,120,瑞源,三等
2020-09-11,6030,36,59,95,瑞源,三等
2020-09-12,6030,21,21,42,瑞源,三等
2020-09-13,6030,37,23,60,瑞源,三等
2020-09-14,6030,44,42,86,瑞源,三等
2020-09-15,6030,30,44,74,瑞源,三等
2020-09-16,6030,49,37,86,瑞源,三等
2020-09-17,6030,31,59,90,瑞源,三等
2020-09-18,6030,62,50,112,瑞源,三等
2020-09-19,6030,12,13,25,瑞源,三等
2020-09-20,6030,31,17,48,瑞源,三等
2020-09-21,6030,44,42,86,瑞源,三等
2020-09-22,6030,45,41,86,瑞源,三等
2020-09-23,6030,45,44,89,瑞源,三等
2020-09-24,6030,39,39,78,瑞源,三等
2020-09-25,6030,43,40,83,瑞源,三等
2020-09-26,6030,33,39,72,瑞源,三等
2020-09-27,6030,21,20,41,瑞源,三等
2020-09-28,6030,51,51,102,瑞源,三等
2020-09-29,6030,40,36,76,瑞源,三等
2020-09-30,6030,43,75,118,瑞源,三等
2020-10-01,6030,19,27,46,瑞源,三等
2020-10-02,6030,22,23,45,瑞源,三等
2020-10-03,6030,38,24,62,瑞源,三等
2020-10-04,6030,44,10,54,瑞源,三等
2020-10-05,6030,53,47,100,瑞源,三等
2020-10-06,6030,44,45,89,瑞源,三等
2020-10-07,6030,34,37,71,瑞源,三等
2020-10-08,6030,39,53,92,瑞源,三等
2020-10-09,6030,24,23,47,瑞源,三等
2020-10-10,6030,33,24,57,瑞源,三等
2020-10-11,6030,37,12,49,瑞源,三等
2020-10-12,6030,44,39,83,瑞源,三等
2020-10-13,6030,37,52,89,瑞源,三等
2020-10-14,6030,35,46,81,瑞源,三等
2020-10-15,6030,48,43,91,瑞源,三等
2020-10-16,6030,45,61,106,瑞源,三等
2020-10-17,6030,18,16,34,瑞源,三等
2020-10-18,6030,33,18,51,瑞源,三等
2020-10-19,6030,47,41,88,瑞源,三等
2020-10-20,6030,45,45,90,瑞源,三等
2020-10-21,6030,31,35,66,瑞源,三等
2020-10-22,6030,53,46,99,瑞源,三等
2020-10-23,6030,51,63,114,瑞源,三等
2020-10-24,6030,39,49,88,瑞源,三等
2020-10-25,6030,30,14,44,瑞源,三等
2020-10-26,6030,51,55,106,瑞源,三等
2020-10-27,6030,51,40,91,瑞源,三等
2020-10-28,6030,36,39,75,瑞源,三等
2020-10-29,6030,52,43,95,瑞源,三等
2020-10-30,6030,43,60,103,瑞源,三等
2020-10-31,6030,31,22,53,瑞源,三等
2020-11-01,6030,44,27,71,瑞源,三等
2020-11-02,6030,42,38,80,瑞源,三等
2020-11-03,6030,44,45,89,瑞源,三等
2020-11-04,6030,49,35,84,瑞源,三等
2020-11-05,6030,45,50,95,瑞源,三等
2020-11-06,6030,30,55,85,瑞源,三等
2020-11-07,6030,26,30,56,瑞源,三等
2020-11-08,6030,31,26,57,瑞源,三等
2020-11-09,6030,48,36,84,瑞源,三等
2020-11-10,6030,42,36,78,瑞源,三等
2020-11-11,6030,43,37,80,瑞源,三等
2020-11-12,6030,46,49,95,瑞源,三等
2020-11-13,6030,46,64,110,瑞源,三等
2020-11-14,6030,27,31,58,瑞源,三等
2020-11-15,6030,32,14,46,瑞源,三等
2020-11-16,6030,42,36,78,瑞源,三等
2020-11-17,6030,49,43,92,瑞源,三等
2020-11-18,6030,39,45,84,瑞源,三等
2020-11-19,6030,51,44,95,瑞源,三等
2020-11-20,6030,45,59,104,瑞源,三等
2020-11-21,6030,25,19,44,瑞源,三等
2020-11-22,6030,27,26,53,瑞源,三等
2020-11-23,6030,39,45,84,瑞源,三等
2020-11-24,6030,40,48,88,瑞源,三等
2020-11-25,6030,31,36,67,瑞源,三等
2020-11-26,6030,36,43,79,瑞源,三等
2020-11-27,6030,42,59,101,瑞源,三等
2020-11-28,6030,22,27,49,瑞源,三等
2020-11-29,6030,34,16,50,瑞源,三等
2020-11-30,6030,46,41,87,瑞源,三等
2020-12-01,6030,44,48,92,瑞源,三等
2020-12-02,6030,45,49,94,瑞源,三等
2020-12-03,6030,59,48,107,瑞源,三等
2020-12-04,6030,52,43,95,瑞源,三等
2020-12-05,6030,20,22,42,瑞源,三等
2020-12-06,6030,22,23,45,瑞源,三等
2020-12-07,6030,47,30,77,瑞源,三等
2020-12-08,6030,36,38,74,瑞源,三等
2020-12-09,6030,36,31,67,瑞源,三等
2020-12-10,6030,35,33,68,瑞源,三等
2020-12-11,6030,41,44,85,瑞源,三等
2020-12-12,6030,16,16,32,瑞源,三等
2020-12-13,6030,30,32,62,瑞源,三等
2020-12-14,6030,43,50,93,瑞源,三等
2020-12-15,6030,50,56,106,瑞源,三等
2020-12-16,6030,42,44,86,瑞源,三等
2020-12-17,6030,45,47,92,瑞源,三等
2020-12-18,6030,51,60,111,瑞源,三等
2020-12-19,6030,29,24,53,瑞源,三等
2020-12-20,6030,33,14,47,瑞源,三等
2020-12-21,6030,43,44,87,瑞源,三等
2020-12-22,6030,46,38,84,瑞源,三等
2020-12-23,6030,35,34,69,瑞源,三等
2020-12-24,6030,47,35,82,瑞源,三等
2020-12-25,6030,44,45,89,瑞源,三等
2020-12-26,6030,20,23,43,瑞源,三等
2020-12-27,6030,29,21,50,瑞源,三等
2020-12-28,6030,47,38,85,瑞源,三等
2020-12-29,6030,56,46,102,瑞源,三等
2020-12-30,6030,39,43,82,瑞源,三等
2020-12-31,6030,59,60,119,瑞源,三等
2020-01-01,6040,6,10,16,瑞和,招呼
2020-01-02,6040,8,11,19,瑞和,招呼
2020-01-03,6040,8,4,12,瑞和,招呼
2020-01-04,6040,6,8,14,瑞和,招呼
2020-01-05,6040,6,4,10,瑞和,招呼
2020-01-06,6040,8,9,17,瑞和,招呼
2020-01-07,6040,8,5,13,瑞和,招呼
2020-01-08,6040,9,9,18,瑞和,招呼
2020-01-09,6040,10,9,19,瑞和,招呼
2020-01-10,6040,6,2,8,瑞和,招呼
2020-01-11,6040,5,4,9,瑞和,招呼
2020-01-12,6040,4,2,6,瑞和,招呼
2020-01-13,6040,6,7,13,瑞和,招呼
2020-01-14,6040,10,5,15,瑞和,招呼
2020-01-15,6040,10,10,20,瑞和,招呼
2020-01-16,6040,9,9,18,瑞和,招呼
2020-01-17,6040,7,4,11,瑞和,招呼
2020-01-18,6040,6,1,7,瑞和,招呼
2020-01-19,6040,2,3,5,瑞和,招呼
2020-01-20,6040,7,3,10,瑞和,招呼
2020-01-21,6040,9,7,16,瑞和,招呼
2020-01-22,6040,12,17,29,瑞和,招呼
2020-01-23,6040,4,8,12,瑞和,招呼
2020-01-24,6040,1,3,4,瑞和,招呼
2020-01-25,6040,12,11,23,瑞和,招呼
2020-01-26,6040,12,2,14,瑞和,招呼
2020-01-27,6040,15,11,26,瑞和,招呼
2020-01-28,6040,1,2,3,瑞和,招呼
2020-01-29,6040,7,4,11,瑞和,招呼
2020-01-30,6040,5,5,10,瑞和,招呼
2020-01-31,6040,12,5,17,瑞和,招呼
2020-02-01,6040,7,6,13,瑞和,招呼
2020-02-02,6040,5,2,7,瑞和,招呼
2020-02-03,6040,5,2,7,瑞和,招呼
2020-02-04,6040,4,7,11,瑞和,招呼
2020-02-05,6040,4,2,6,瑞和,招呼
2020-02-06,6040,9,4,13,瑞和,招呼
2020-02-07,6040,7,6,13,瑞和,招呼
2020-02-08,6040,3,4,7,瑞和,招呼
2020-02-09,6040,3,1,4,瑞和,招呼
2020-02-10,6040,4,2,6,瑞和,招呼
2020-02-11,6040,5,3,8,瑞和,招呼
2020-02-12,6040,1,2,3,瑞和,招呼
2020-02-13,6040,3,3,6,瑞和,招呼
2020-02-14,6040,3,2,5,瑞和,招呼
2020-02-15,6040,7,9,16,瑞和,招呼
2020-02-16,6040,2,3,5,瑞和,招呼
2020-02-17,6040,5,5,10,瑞和,招呼
2020-02-18,6040,3,1,4,瑞和,招呼
2020-02-19,6040,0,5,5,瑞和,招呼
2020-02-20,6040,2,3,5,瑞和,招呼
2020-02-21,6040,0,6,6,瑞和,招呼
2020-02-22,6040,11,11,22,瑞和,招呼
2020-02-23,6040,3,2,5,瑞和,招呼
2020-02-24,6040,8,7,15,瑞和,招呼
2020-02-25,6040,12,4,16,瑞和,招呼
2020-02-26,6040,11,12,23,瑞和,招呼
2020-02-27,6040,10,6,16,瑞和,招呼
2020-02-28,6040,17,3,20,瑞和,招呼
2020-02-29,6040,2,2,4,瑞和,招呼
2020-03-01,6040,2,3,5,瑞和,招呼
2020-03-02,6040,5,4,9,瑞和,招呼
2020-03-03,6040,7,13,20,瑞和,招呼
2020-03-04,6040,13,7,20,瑞和,招呼
2020-03-05,6040,7,11,18,瑞和,招呼
2020-03-06,6040,12,7,19,瑞和,招呼
2020-03-07,6040,5,1,6,瑞和,招呼
2020-03-08,6040,5,9,14,瑞和,招呼
2020-03-09,6040,10,4,14,瑞和,招呼
2020-03-10,6040,8,5,13,瑞和,招呼
2020-03-11,6040,7,8,15,瑞和,招呼
2020-03-12,6040,8,11,19,瑞和,招呼
2020-03-13,6040,7,9,16,瑞和,招呼
2020-03-14,6040,1,2,3,瑞和,招呼
2020-03-15,6040,8,3,11,瑞和,招呼
2020-03-16,6040,7,4,11,瑞和,招呼
2020-03-17,6040,8,5,13,瑞和,招呼
2020-03-18,6040,9,6,15,瑞和,招呼
2020-03-19,6040,4,7,11,瑞和,招呼
2020-03-20,6040,12,7,19,瑞和,招呼
2020-03-21,6040,3,3,6,瑞和,招呼
2020-03-22,6040,3,3,6,瑞和,招呼
2020-03-23,6040,8,7,15,瑞和,招呼
2020-03-24,6040,9,5,14,瑞和,招呼
2020-03-25,6040,11,6,17,瑞和,招呼
2020-03-26,6040,8,6,14,瑞和,招呼
2020-03-27,6040,5,5,10,瑞和,招呼
2020-03-28,6040,3,4,7,瑞和,招呼
2020-03-29,6040,11,5,16,瑞和,招呼
2020-03-30,6040,7,9,16,瑞和,招呼
2020-03-31,6040,6,5,11,瑞和,招呼
2020-04-01,6040,6,9,15,瑞和,招呼
2020-04-02,6040,1,6,7,瑞和,招呼
2020-04-03,6040,7,1,8,瑞和,招呼
2020-04-04,6040,2,2,4,瑞和,招呼
2020-04-05,6040,5,7,12,瑞和,招呼
2020-04-06,6040,10,5,15,瑞和,招呼
2020-04-07,6040,11,10,21,瑞和,招呼
2020-04-08,6040,5,7,12,瑞和,招呼
2020-04-09,6040,7,5,12,瑞和,招呼
2020-04-10,6040,5,14,19,瑞和,招呼
2020-04-11,6040,1,1,2,瑞和,招呼
2020-04-12,6040,6,4,10,瑞和,招呼
2020-04-13,6040,7,6,13,瑞和,招呼
2020-04-14,6040,6,9,15,瑞和,招呼
2020-04-15,6040,16,3,19,瑞和,招呼
2020-04-16,6040,5,11,16,瑞和,招呼
2020-04-17,6040,5,7,12,瑞和,招呼
2020-04-18,6040,6,3,9,瑞和,招呼
2020-04-19,6040,6,3,9,瑞和,招呼
2020-04-20,6040,9,9,18,瑞和,招呼
2020-04-21,6040,7,4,11,瑞和,招呼
2020-04-22,6040,8,6,14,瑞和,招呼
2020-04-23,6040,5,6,11,瑞和,招呼
2020-04-24,6040,6,10,16,瑞和,招呼
2020-04-25,6040,6,4,10,瑞和,招呼
2020-04-26,6040,3,2,5,瑞和,招呼
2020-04-27,6040,16,9,25,瑞和,招呼
2020-04-28,6040,9,4,13,瑞和,招呼
2020-04-29,6040,5,8,13,瑞和,招呼
2020-04-30,6040,8,4,12,瑞和,招呼
2020-05-01,6040,13,7,20,瑞和,招呼
2020-05-02,6040,2,4,6,瑞和,招呼
2020-05-03,6040,4,8,12,瑞和,招呼
2020-05-04,6040,9,6,15,瑞和,招呼
2020-05-05,6040,8,6,14,瑞和,招呼
2020-05-06,6040,10,11,21,瑞和,招呼
2020-05-07,6040,8,6,14,瑞和,招呼
2020-05-08,6040,8,8,16,瑞和,招呼
2020-05-09,6040,4,2,6,瑞和,招呼
2020-05-10,6040,3,3,6,瑞和,招呼
2020-05-11,6040,10,4,14,瑞和,招呼
2020-05-12,6040,8,6,14,瑞和,招呼
2020-05-13,6040,11,9,20,瑞和,招呼
2020-05-14,6040,7,4,11,瑞和,招呼
2020-05-15,6040,12,14,26,瑞和,招呼
2020-05-16,6040,6,4,10,瑞和,招呼
2020-05-17,6040,9,6,15,瑞和,招呼
2020-05-18,6040,10,4,14,瑞和,招呼
2020-05-19,6040,7,6,13,瑞和,招呼
2020-05-20,6040,10,8,18,瑞和,招呼
2020-05-21,6040,7,3,10,瑞和,招呼
2020-05-22,6040,9,9,18,瑞和,招呼
2020-05-23,6040,2,6,8,瑞和,招呼
2020-05-24,6040,2,3,5,瑞和,招呼
2020-05-25,6040,12,5,17,瑞和,招呼
2020-05-26,6040,13,8,21,瑞和,招呼
2020-05-27,6040,7,4,11,瑞和,招呼
2020-05-28,6040,8,6,14,瑞和,招呼
2020-05-29,6040,8,9,17,瑞和,招呼
2020-05-30,6040,4,6,10,瑞和,招呼
2020-05-31,6040,7,8,15,瑞和,招呼
2020-06-01,6040,7,6,13,瑞和,招呼
2020-06-02,6040,14,11,25,瑞和,招呼
2020-06-03,6040,8,9,17,瑞和,招呼
2020-06-04,6040,11,8,19,瑞和,招呼
2020-06-05,6040,10,8,18,瑞和,招呼
2020-06-06,6040,7,4,11,瑞和,招呼
2020-06-07,6040,7,6,13,瑞和,招呼
2020-06-08,6040,11,8,19,瑞和,招呼
2020-06-09,6040,7,6,13,瑞和,招呼
2020-06-10,6040,10,7,17,瑞和,招呼
2020-06-11,6040,7,9,16,瑞和,招呼
2020-06-12,6040,8,7,15,瑞和,招呼
2020-06-13,6040,4,4,8,瑞和,招呼
2020-06-14,6040,6,3,9,瑞和,招呼
2020-06-15,6040,9,7,16,瑞和,招呼
2020-06-16,6040,8,4,12,瑞和,招呼
2020-06-17,6040,8,7,15,瑞和,招呼
2020-06-18,6040,7,9,16,瑞和,招呼
2020-06-19,6040,5,7,12,瑞和,招呼
2020-06-20,6040,3,6,9,瑞和,招呼
2020-06-21,6040,9,8,17,瑞和,招呼
2020-06-22,6040,6,8,14,瑞和,招呼
2020-06-23,6040,7,4,11,瑞和,招呼
2020-06-24,6040,10,7,17,瑞和,招呼
2020-06-25,6040,8,4,12,瑞和,招呼
2020-06-26,6040,5,3,8,瑞和,招呼
2020-06-27,6040,1,5,6,瑞和,招呼
2020-06-28,6040,7,1,8,瑞和,招呼
2020-06-29,6040,7,5,12,瑞和,招呼
2020-06-30,6040,5,3,8,瑞和,招呼
2020-07-01,6040,6,5,11,瑞和,招呼
2020-07-02,6040,6,4,10,瑞和,招呼
2020-07-03,6040,9,5,14,瑞和,招呼
2020-07-04,6040,3,5,8,瑞和,招呼
2020-07-05,6040,3,1,4,瑞和,招呼
2020-07-06,6040,4,5,9,瑞和,招呼
2020-07-07,6040,5,10,15,瑞和,招呼
2020-07-08,6040,7,5,12,瑞和,招呼
2020-07-09,6040,8,8,16,瑞和,招呼
2020-07-10,6040,7,4,11,瑞和,招呼
2020-07-11,6040,4,8,12,瑞和,招呼
2020-07-12,6040,3,2,5,瑞和,招呼
2020-07-13,6040,7,10,17,瑞和,招呼
2020-07-14,6040,4,6,10,瑞和,招呼
2020-07-15,6040,7,6,13,瑞和,招呼
2020-07-16,6040,9,4,13,瑞和,招呼
2020-07-17,6040,2,4,6,瑞和,招呼
2020-07-18,6040,5,4,9,瑞和,招呼
2020-07-19,6040,18,2,20,瑞和,招呼
2020-07-20,6040,11,5,16,瑞和,招呼
2020-07-21,6040,1,3,4,瑞和,招呼
2020-07-22,6040,4,5,9,瑞和,招呼
2020-07-23,6040,5,7,12,瑞和,招呼
2020-07-24,6040,4,8,12,瑞和,招呼
2020-07-25,6040,10,3,13,瑞和,招呼
2020-07-26,6040,4,4,8,瑞和,招呼
2020-07-27,6040,5,9,14,瑞和,招呼
2020-07-28,6040,2,2,4,瑞和,招呼
2020-07-29,6040,8,4,12,瑞和,招呼
2020-07-30,6040,3,3,6,瑞和,招呼
2020-07-31,6040,4,6,10,瑞和,招呼
2020-08-01,6040,4,4,8,瑞和,招呼
2020-08-02,6040,2,3,5,瑞和,招呼
2020-08-03,6040,6,5,11,瑞和,招呼
2020-08-04,6040,6,5,11,瑞和,招呼
2020-08-05,6040,7,3,10,瑞和,招呼
2020-08-06,6040,6,7,13,瑞和,招呼
2020-08-07,6040,3,10,13,瑞和,招呼
2020-08-08,6040,8,7,15,瑞和,招呼
2020-08-09,6040,5,3,8,瑞和,招呼
2020-08-10,6040,13,3,16,瑞和,招呼
2020-08-11,6040,4,2,6,瑞和,招呼
2020-08-12,6040,2,2,4,瑞和,招呼
2020-08-13,6040,5,3,8,瑞和,招呼
2020-08-14,6040,7,5,12,瑞和,招呼
2020-08-15,6040,3,2,5,瑞和,招呼
2020-08-16,6040,2,3,5,瑞和,招呼
2020-08-17,6040,3,0,3,瑞和,招呼
2020-08-18,6040,4,3,7,瑞和,招呼
2020-08-19,6040,5,3,8,瑞和,招呼
2020-08-20,6040,3,4,7,瑞和,招呼
2020-08-21,6040,8,2,10,瑞和,招呼
2020-08-22,6040,0,0,0,瑞和,招呼
2020-08-23,6040,5,1,6,瑞和,招呼
2020-08-24,6040,5,7,12,瑞和,招呼
2020-08-25,6040,3,0,3,瑞和,招呼
2020-08-26,6040,5,4,9,瑞和,招呼
2020-08-27,6040,5,5,10,瑞和,招呼
2020-08-28,6040,5,9,14,瑞和,招呼
2020-08-29,6040,3,0,3,瑞和,招呼
2020-08-30,6040,6,9,15,瑞和,招呼
2020-08-31,6040,8,2,10,瑞和,招呼
2020-09-01,6040,7,9,16,瑞和,招呼
2020-09-02,6040,4,6,10,瑞和,招呼
2020-09-03,6040,15,14,29,瑞和,招呼
2020-09-04,6040,11,11,22,瑞和,招呼
2020-09-05,6040,8,10,18,瑞和,招呼
2020-09-06,6040,7,3,10,瑞和,招呼
2020-09-07,6040,16,17,33,瑞和,招呼
2020-09-08,6040,10,3,13,瑞和,招呼
2020-09-09,6040,7,3,10,瑞和,招呼
2020-09-10,6040,11,4,15,瑞和,招呼
2020-09-11,6040,12,8,20,瑞和,招呼
2020-09-12,6040,11,2,13,瑞和,招呼
2020-09-13,6040,3,6,9,瑞和,招呼
2020-09-14,6040,13,6,19,瑞和,招呼
2020-09-15,6040,6,6,12,瑞和,招呼
2020-09-16,6040,7,6,13,瑞和,招呼
2020-09-17,6040,23,3,26,瑞和,招呼
2020-09-18,6040,10,5,15,瑞和,招呼
2020-09-19,6040,6,6,12,瑞和,招呼
2020-09-20,6040,11,9,20,瑞和,招呼
2020-09-21,6040,12,6,18,瑞和,招呼
2020-09-22,6040,7,12,19,瑞和,招呼
2020-09-23,6040,4,7,11,瑞和,招呼
2020-09-24,6040,7,3,10,瑞和,招呼
2020-09-25,6040,8,7,15,瑞和,招呼
2020-09-26,6040,8,5,13,瑞和,招呼
2020-09-27,6040,5,1,6,瑞和,招呼
2020-09-28,6040,11,7,18,瑞和,招呼
2020-09-29,6040,6,6,12,瑞和,招呼
2020-09-30,6040,10,12,22,瑞和,招呼
2020-10-01,6040,3,13,16,瑞和,招呼
2020-10-02,6040,3,5,8,瑞和,招呼
2020-10-03,6040,7,11,18,瑞和,招呼
2020-10-04,6040,8,9,17,瑞和,招呼
2020-10-05,6040,11,9,20,瑞和,招呼
2020-10-06,6040,9,9,18,瑞和,招呼
2020-10-07,6040,6,10,16,瑞和,招呼
2020-10-08,6040,8,7,15,瑞和,招呼
2020-10-09,6040,0,5,5,瑞和,招呼
2020-10-10,6040,6,4,10,瑞和,招呼
2020-10-11,6040,5,2,7,瑞和,招呼
2020-10-12,6040,4,11,15,瑞和,招呼
2020-10-13,6040,12,15,27,瑞和,招呼
2020-10-14,6040,5,11,16,瑞和,招呼
2020-10-15,6040,13,9,22,瑞和,招呼
2020-10-16,6040,7,7,14,瑞和,招呼
2020-10-17,6040,5,4,9,瑞和,招呼
2020-10-18,6040,9,6,15,瑞和,招呼
2020-10-19,6040,6,12,18,瑞和,招呼
2020-10-20,6040,10,10,20,瑞和,招呼
2020-10-21,6040,6,4,10,瑞和,招呼
2020-10-22,6040,7,9,16,瑞和,招呼
2020-10-23,6040,29,28,57,瑞和,招呼
2020-10-24,6040,5,5,10,瑞和,招呼
2020-10-25,6040,8,6,14,瑞和,招呼
2020-10-26,6040,4,7,11,瑞和,招呼
2020-10-27,6040,6,11,17,瑞和,招呼
2020-10-28,6040,8,5,13,瑞和,招呼
2020-10-29,6040,6,7,13,瑞和,招呼
2020-10-30,6040,5,9,14,瑞和,招呼
2020-10-31,6040,8,5,13,瑞和,招呼
2020-11-01,6040,5,4,9,瑞和,招呼
2020-11-02,6040,8,7,15,瑞和,招呼
2020-11-03,6040,6,8,14,瑞和,招呼
2020-11-04,6040,8,8,16,瑞和,招呼
2020-11-05,6040,10,10,20,瑞和,招呼
2020-11-06,6040,8,9,17,瑞和,招呼
2020-11-07,6040,7,8,15,瑞和,招呼
2020-11-08,6040,5,6,11,瑞和,招呼
2020-11-09,6040,9,10,19,瑞和,招呼
2020-11-10,6040,9,9,18,瑞和,招呼
2020-11-11,6040,9,5,14,瑞和,招呼
2020-11-12,6040,8,8,16,瑞和,招呼
2020-11-13,6040,9,6,15,瑞和,招呼
2020-11-14,6040,10,8,18,瑞和,招呼
2020-11-15,6040,9,10,19,瑞和,招呼
2020-11-16,6040,11,9,20,瑞和,招呼
2020-11-17,6040,6,11,17,瑞和,招呼
2020-11-18,6040,7,10,17,瑞和,招呼
2020-11-19,6040,9,5,14,瑞和,招呼
2020-11-20,6040,13,5,18,瑞和,招呼
2020-11-21,6040,7,11,18,瑞和,招呼
2020-11-22,6040,10,7,17,瑞和,招呼
2020-11-23,6040,10,8,18,瑞和,招呼
2020-11-24,6040,12,4,16,瑞和,招呼
2020-11-25,6040,8,6,14,瑞和,招呼
2020-11-26,6040,8,10,18,瑞和,招呼
2020-11-27,6040,7,11,18,瑞和,招呼
2020-11-28,6040,3,4,7,瑞和,招呼
2020-11-29,6040,7,5,12,瑞和,招呼
2020-11-30,6040,18,4,22,瑞和,招呼
2020-12-01,6040,11,5,16,瑞和,招呼
2020-12-02,6040,10,6,16,瑞和,招呼
2020-12-03,6040,9,6,15,瑞和,招呼
2020-12-04,6040,7,9,16,瑞和,招呼
2020-12-05,6040,4,6,10,瑞和,招呼
2020-12-06,6040,9,5,14,瑞和,招呼
2020-12-07,6040,12,14,26,瑞和,招呼
2020-12-08,6040,17,11,28,瑞和,招呼
2020-12-09,6040,13,11,24,瑞和,招呼
2020-12-10,6040,10,13,23,瑞和,招呼
2020-12-11,6040,13,18,31,瑞和,招呼
2020-12-12,6040,5,5,10,瑞和,招呼
2020-12-13,6040,8,6,14,瑞和,招呼
2020-12-14,6040,13,9,22,瑞和,招呼
2020-12-15,6040,12,10,22,瑞和,招呼
2020-12-16,6040,8,7,15,瑞和,招呼
2020-12-17,6040,10,9,19,瑞和,招呼
2020-12-18,6040,9,6,15,瑞和,招呼
2020-12-19,6040,5,6,11,瑞和,招呼
2020-12-20,6040,2,5,7,瑞和,招呼
2020-12-21,6040,10,10,20,瑞和,招呼
2020-12-22,6040,6,5,11,瑞和,招呼
2020-12-23,6040,11,7,18,瑞和,招呼
2020-12-24,6040,9,9,18,瑞和,招呼
2020-12-25,6040,12,11,23,瑞和,招呼
2020-12-26,6040,1,5,6,瑞和,招呼
2020-12-27,6040,8,9,17,瑞和,招呼
2020-12-28,6040,11,8,19,瑞和,招呼
2020-12-29,6040,10,7,17,瑞和,招呼
2020-12-30,6040,8,13,21,瑞和,招呼
2020-12-31,6040,16,9,25,瑞和,招呼
2020-01-01,6050,496,456,952,關山,三等
2020-01-02,6050,495,471,966,關山,三等
2020-01-03,6050,564,657,1221,關山,三等
2020-01-04,6050,400,542,942,關山,三等
2020-01-05,6050,651,441,1092,關山,三等
2020-01-06,6050,569,515,1084,關山,三等
2020-01-07,6050,514,433,947,關山,三等
2020-01-08,6050,488,535,1023,關山,三等
2020-01-09,6050,577,590,1167,關山,三等
2020-01-10,6050,675,963,1638,關山,三等
2020-01-11,6050,622,687,1309,關山,三等
2020-01-12,6050,808,486,1294,關山,三等
2020-01-13,6050,635,528,1163,關山,三等
2020-01-14,6050,557,531,1088,關山,三等
2020-01-15,6050,625,538,1163,關山,三等
2020-01-16,6050,586,741,1327,關山,三等
2020-01-17,6050,590,634,1224,關山,三等
2020-01-18,6050,986,542,1528,關山,三等
2020-01-19,6050,510,544,1054,關山,三等
2020-01-20,6050,659,701,1360,關山,三等
2020-01-21,6050,516,729,1245,關山,三等
2020-01-22,6050,608,1000,1608,關山,三等
2020-01-23,6050,454,1134,1588,關山,三等
2020-01-24,6050,369,1052,1421,關山,三等
2020-01-25,6050,672,992,1664,關山,三等
2020-01-26,6050,1030,954,1984,關山,三等
2020-01-27,6050,1232,899,2131,關山,三等
2020-01-28,6050,1304,525,1829,關山,三等
2020-01-29,6050,1105,471,1576,關山,三等
2020-01-30,6050,885,458,1343,關山,三等
2020-01-31,6050,758,461,1219,關山,三等
2020-02-01,6050,636,414,1050,關山,三等
2020-02-02,6050,597,392,989,關山,三等
2020-02-03,6050,561,472,1033,關山,三等
2020-02-04,6050,576,565,1141,關山,三等
2020-02-05,6050,481,480,961,關山,三等
2020-02-06,6050,574,527,1101,關山,三等
2020-02-07,6050,527,688,1215,關山,三等
2020-02-08,6050,417,401,818,關山,三等
2020-02-09,6050,550,414,964,關山,三等
2020-02-10,6050,481,477,958,關山,三等
2020-02-11,6050,406,424,830,關山,三等
2020-02-12,6050,382,376,758,關山,三等
2020-02-13,6050,411,389,800,關山,三等
2020-02-14,6050,469,576,1045,關山,三等
2020-02-15,6050,427,382,809,關山,三等
2020-02-16,6050,524,374,898,關山,三等
2020-02-17,6050,371,383,754,關山,三等
2020-02-18,6050,476,459,935,關山,三等
2020-02-19,6050,418,394,812,關山,三等
2020-02-20,6050,522,496,1018,關山,三等
2020-02-21,6050,521,614,1135,關山,三等
2020-02-22,6050,709,711,1420,關山,三等
2020-02-23,6050,596,463,1059,關山,三等
2020-02-24,6050,542,428,970,關山,三等
2020-02-25,6050,511,459,970,關山,三等
2020-02-26,6050,434,463,897,關山,三等
2020-02-27,6050,641,936,1577,關山,三等
2020-02-28,6050,433,702,1135,關山,三等
2020-02-29,6050,558,405,963,關山,三等
2020-03-01,6050,987,433,1420,關山,三等
2020-03-02,6050,586,463,1049,關山,三等
2020-03-03,6050,474,426,900,關山,三等
2020-03-04,6050,517,452,969,關山,三等
2020-03-05,6050,449,473,922,關山,三等
2020-03-06,6050,587,1597,2184,關山,三等
2020-03-07,6050,620,428,1048,關山,三等
2020-03-08,6050,1364,407,1771,關山,三等
2020-03-09,6050,493,427,920,關山,三等
2020-03-10,6050,432,410,842,關山,三等
2020-03-11,6050,413,403,816,關山,三等
2020-03-12,6050,456,414,870,關山,三等
2020-03-13,6050,570,726,1296,關山,三等
2020-03-14,6050,328,450,778,關山,三等
2020-03-15,6050,753,525,1278,關山,三等
2020-03-16,6050,484,427,911,關山,三等
2020-03-17,6050,434,452,886,關山,三等
2020-03-18,6050,394,433,827,關山,三等
2020-03-19,6050,409,437,846,關山,三等
2020-03-20,6050,541,747,1288,關山,三等
2020-03-21,6050,420,427,847,關山,三等
2020-03-22,6050,613,362,975,關山,三等
2020-03-23,6050,535,428,963,關山,三等
2020-03-24,6050,397,391,788,關山,三等
2020-03-25,6050,440,398,838,關山,三等
2020-03-26,6050,451,461,912,關山,三等
2020-03-27,6050,573,742,1315,關山,三等
2020-03-28,6050,347,432,779,關山,三等
2020-03-29,6050,599,388,987,關山,三等
2020-03-30,6050,562,422,984,關山,三等
2020-03-31,6050,392,482,874,關山,三等
2020-04-01,6050,571,945,1516,關山,三等
2020-04-02,6050,387,888,1275,關山,三等
2020-04-03,6050,384,654,1038,關山,三等
2020-04-04,6050,741,315,1056,關山,三等
2020-04-05,6050,1106,383,1489,關山,三等
2020-04-06,6050,667,409,1076,關山,三等
2020-04-07,6050,385,334,719,關山,三等
2020-04-08,6050,408,374,782,關山,三等
2020-04-09,6050,390,401,791,關山,三等
2020-04-10,6050,499,624,1123,關山,三等
2020-04-11,6050,281,276,557,關山,三等
2020-04-12,6050,431,271,702,關山,三等
2020-04-13,6050,424,358,782,關山,三等
2020-04-14,6050,392,366,758,關山,三等
2020-04-15,6050,404,484,888,關山,三等
2020-04-16,6050,400,437,837,關山,三等
2020-04-17,6050,604,607,1211,關山,三等
2020-04-18,6050,248,320,568,關山,三等
2020-04-19,6050,460,267,727,關山,三等
2020-04-20,6050,432,428,860,關山,三等
2020-04-21,6050,405,378,783,關山,三等
2020-04-22,6050,413,422,835,關山,三等
2020-04-23,6050,408,402,810,關山,三等
2020-04-24,6050,490,570,1060,關山,三等
2020-04-25,6050,273,286,559,關山,三等
2020-04-26,6050,444,316,760,關山,三等
2020-04-27,6050,424,368,792,關山,三等
2020-04-28,6050,456,422,878,關山,三等
2020-04-29,6050,349,391,740,關山,三等
2020-04-30,6050,450,502,952,關山,三等
2020-05-01,6050,475,639,1114,關山,三等
2020-05-02,6050,336,330,666,關山,三等
2020-05-03,6050,692,342,1034,關山,三等
2020-05-04,6050,508,433,941,關山,三等
2020-05-05,6050,476,417,893,關山,三等
2020-05-06,6050,397,404,801,關山,三等
2020-05-07,6050,451,445,896,關山,三等
2020-05-08,6050,519,699,1218,關山,三等
2020-05-09,6050,338,389,727,關山,三等
2020-05-10,6050,621,354,975,關山,三等
2020-05-11,6050,490,413,903,關山,三等
2020-05-12,6050,406,417,823,關山,三等
2020-05-13,6050,409,427,836,關山,三等
2020-05-14,6050,423,446,869,關山,三等
2020-05-15,6050,549,664,1213,關山,三等
2020-05-16,6050,378,460,838,關山,三等
2020-05-17,6050,639,408,1047,關山,三等
2020-05-18,6050,479,422,901,關山,三等
2020-05-19,6050,433,387,820,關山,三等
2020-05-20,6050,406,405,811,關山,三等
2020-05-21,6050,401,411,812,關山,三等
2020-05-22,6050,550,577,1127,關山,三等
2020-05-23,6050,287,321,608,關山,三等
2020-05-24,6050,492,391,883,關山,三等
2020-05-25,6050,483,453,936,關山,三等
2020-05-26,6050,420,418,838,關山,三等
2020-05-27,6050,364,381,745,關山,三等
2020-05-28,6050,463,458,921,關山,三等
2020-05-29,6050,539,710,1249,關山,三等
2020-05-30,6050,314,348,662,關山,三等
2020-05-31,6050,632,393,1025,關山,三等
2020-06-01,6050,469,400,869,關山,三等
2020-06-02,6050,463,396,859,關山,三等
2020-06-03,6050,478,426,904,關山,三等
2020-06-04,6050,445,461,906,關山,三等
2020-06-05,6050,576,651,1227,關山,三等
2020-06-06,6050,412,399,811,關山,三等
2020-06-07,6050,504,382,886,關山,三等
2020-06-08,6050,554,464,1018,關山,三等
2020-06-09,6050,470,434,904,關山,三等
2020-06-10,6050,448,450,898,關山,三等
2020-06-11,6050,451,494,945,關山,三等
2020-06-12,6050,593,653,1246,關山,三等
2020-06-13,6050,493,493,986,關山,三等
2020-06-14,6050,495,451,946,關山,三等
2020-06-15,6050,457,481,938,關山,三等
2020-06-16,6050,554,495,1049,關山,三等
2020-06-17,6050,503,508,1011,關山,三等
2020-06-18,6050,486,455,941,關山,三等
2020-06-19,6050,493,533,1026,關山,三等
2020-06-20,6050,519,568,1087,關山,三等
2020-06-21,6050,534,533,1067,關山,三等
2020-06-22,6050,666,510,1176,關山,三等
2020-06-23,6050,529,483,1012,關山,三等
2020-06-24,6050,667,938,1605,關山,三等
2020-06-25,6050,454,892,1346,關山,三等
2020-06-26,6050,528,611,1139,關山,三等
2020-06-27,6050,726,430,1156,關山,三等
2020-06-28,6050,1029,527,1556,關山,三等
2020-06-29,6050,681,531,1212,關山,三等
2020-06-30,6050,504,459,963,關山,三等
2020-07-01,6050,542,544,1086,關山,三等
2020-07-02,6050,449,504,953,關山,三等
2020-07-03,6050,549,641,1190,關山,三等
2020-07-04,6050,427,371,798,關山,三等
2020-07-05,6050,534,382,916,關山,三等
2020-07-06,6050,503,446,949,關山,三等
2020-07-07,6050,528,494,1022,關山,三等
2020-07-08,6050,455,422,877,關山,三等
2020-07-09,6050,502,511,1013,關山,三等
2020-07-10,6050,628,648,1276,關山,三等
2020-07-11,6050,502,506,1008,關山,三等
2020-07-12,6050,580,542,1122,關山,三等
2020-07-13,6050,524,536,1060,關山,三等
2020-07-14,6050,571,534,1105,關山,三等
2020-07-15,6050,498,529,1027,關山,三等
2020-07-16,6050,519,572,1091,關山,三等
2020-07-17,6050,576,761,1337,關山,三等
2020-07-18,6050,574,609,1183,關山,三等
2020-07-19,6050,783,639,1422,關山,三等
2020-07-20,6050,672,582,1254,關山,三等
2020-07-21,6050,548,536,1084,關山,三等
2020-07-22,6050,530,568,1098,關山,三等
2020-07-23,6050,526,563,1089,關山,三等
2020-07-24,6050,636,761,1397,關山,三等
2020-07-25,6050,550,589,1139,關山,三等
2020-07-26,6050,692,588,1280,關山,三等
2020-07-27,6050,623,498,1121,關山,三等
2020-07-28,6050,579,464,1043,關山,三等
2020-07-29,6050,492,475,967,關山,三等
2020-07-30,6050,482,570,1052,關山,三等
2020-07-31,6050,610,687,1297,關山,三等
2020-08-01,6050,578,632,1210,關山,三等
2020-08-02,6050,704,534,1238,關山,三等
2020-08-03,6050,588,485,1073,關山,三等
2020-08-04,6050,563,474,1037,關山,三等
2020-08-05,6050,514,499,1013,關山,三等
2020-08-06,6050,519,536,1055,關山,三等
2020-08-07,6050,545,676,1221,關山,三等
2020-08-08,6050,476,548,1024,關山,三等
2020-08-09,6050,697,468,1165,關山,三等
2020-08-10,6050,570,559,1129,關山,三等
2020-08-11,6050,532,531,1063,關山,三等
2020-08-12,6050,542,639,1181,關山,三等
2020-08-13,6050,559,537,1096,關山,三等
2020-08-14,6050,620,750,1370,關山,三等
2020-08-15,6050,570,575,1145,關山,三等
2020-08-16,6050,817,662,1479,關山,三等
2020-08-17,6050,682,671,1353,關山,三等
2020-08-18,6050,541,613,1154,關山,三等
2020-08-19,6050,584,519,1103,關山,三等
2020-08-20,6050,521,636,1157,關山,三等
2020-08-21,6050,607,815,1422,關山,三等
2020-08-22,6050,586,623,1209,關山,三等
2020-08-23,6050,913,638,1551,關山,三等
2020-08-24,6050,721,616,1337,關山,三等
2020-08-25,6050,562,585,1147,關山,三等
2020-08-26,6050,502,642,1144,關山,三等
2020-08-27,6050,586,597,1183,關山,三等
2020-08-28,6050,678,625,1303,關山,三等
2020-08-29,6050,463,445,908,關山,三等
2020-08-30,6050,696,524,1220,關山,三等
2020-08-31,6050,595,527,1122,關山,三等
2020-09-01,6050,548,473,1021,關山,三等
2020-09-02,6050,489,598,1087,關山,三等
2020-09-03,6050,520,499,1019,關山,三等
2020-09-04,6050,635,730,1365,關山,三等
2020-09-05,6050,466,464,930,關山,三等
2020-09-06,6050,703,434,1137,關山,三等
2020-09-07,6050,591,592,1183,關山,三等
2020-09-08,6050,586,552,1138,關山,三等
2020-09-09,6050,523,489,1012,關山,三等
2020-09-10,6050,466,578,1044,關山,三等
2020-09-11,6050,673,731,1404,關山,三等
2020-09-12,6050,580,536,1116,關山,三等
2020-09-13,6050,656,564,1220,關山,三等
2020-09-14,6050,576,495,1071,關山,三等
2020-09-15,6050,509,491,1000,關山,三等
2020-09-16,6050,489,477,966,關山,三等
2020-09-17,6050,481,544,1025,關山,三等
2020-09-18,6050,729,842,1571,關山,三等
2020-09-19,6050,533,510,1043,關山,三等
2020-09-20,6050,698,533,1231,關山,三等
2020-09-21,6050,596,548,1144,關山,三等
2020-09-22,6050,514,495,1009,關山,三等
2020-09-23,6050,591,492,1083,關山,三等
2020-09-24,6050,579,520,1099,關山,三等
2020-09-25,6050,537,598,1135,關山,三等
2020-09-26,6050,502,551,1053,關山,三等
2020-09-27,6050,530,434,964,關山,三等
2020-09-28,6050,520,533,1053,關山,三等
2020-09-29,6050,502,577,1079,關山,三等
2020-09-30,6050,655,950,1605,關山,三等
2020-10-01,6050,500,997,1497,關山,三等
2020-10-02,6050,588,667,1255,關山,三等
2020-10-03,6050,715,445,1160,關山,三等
2020-10-04,6050,1181,626,1807,關山,三等
2020-10-05,6050,727,529,1256,關山,三等
2020-10-06,6050,559,473,1032,關山,三等
2020-10-07,6050,504,484,988,關山,三等
2020-10-08,6050,648,876,1524,關山,三等
2020-10-09,6050,617,772,1389,關山,三等
2020-10-10,6050,550,468,1018,關山,三等
2020-10-11,6050,971,544,1515,關山,三等
2020-10-12,6050,635,480,1115,關山,三等
2020-10-13,6050,555,530,1085,關山,三等
2020-10-14,6050,508,559,1067,關山,三等
2020-10-15,6050,761,516,1277,關山,三等
2020-10-16,6050,691,885,1576,關山,三等
2020-10-17,6050,621,565,1186,關山,三等
2020-10-18,6050,737,565,1302,關山,三等
2020-10-19,6050,571,493,1064,關山,三等
2020-10-20,6050,530,488,1018,關山,三等
2020-10-21,6050,495,520,1015,關山,三等
2020-10-22,6050,458,526,984,關山,三等
2020-10-23,6050,689,849,1538,關山,三等
2020-10-24,6050,514,638,1152,關山,三等
2020-10-25,6050,1086,620,1706,關山,三等
2020-10-26,6050,641,526,1167,關山,三等
2020-10-27,6050,546,532,1078,關山,三等
2020-10-28,6050,528,504,1032,關山,三等
2020-10-29,6050,575,552,1127,關山,三等
2020-10-30,6050,677,805,1482,關山,三等
2020-10-31,6050,657,628,1285,關山,三等
2020-11-01,6050,995,545,1540,關山,三等
2020-11-02,6050,617,496,1113,關山,三等
2020-11-03,6050,505,452,957,關山,三等
2020-11-04,6050,471,464,935,關山,三等
2020-11-05,6050,525,549,1074,關山,三等
2020-11-06,6050,803,865,1668,關山,三等
2020-11-07,6050,484,550,1034,關山,三等
2020-11-08,6050,939,743,1682,關山,三等
2020-11-09,6050,608,575,1183,關山,三等
2020-11-10,6050,484,480,964,關山,三等
2020-11-11,6050,513,471,984,關山,三等
2020-11-12,6050,525,589,1114,關山,三等
2020-11-13,6050,627,695,1322,關山,三等
2020-11-14,6050,506,518,1024,關山,三等
2020-11-15,6050,730,561,1291,關山,三等
2020-11-16,6050,605,547,1152,關山,三等
2020-11-17,6050,546,494,1040,關山,三等
2020-11-18,6050,571,506,1077,關山,三等
2020-11-19,6050,521,673,1194,關山,三等
2020-11-20,6050,718,852,1570,關山,三等
2020-11-21,6050,548,547,1095,關山,三等
2020-11-22,6050,792,506,1298,關山,三等
2020-11-23,6050,584,548,1132,關山,三等
2020-11-24,6050,501,439,940,關山,三等
2020-11-25,6050,497,451,948,關山,三等
2020-11-26,6050,594,695,1289,關山,三等
2020-11-27,6050,709,908,1617,關山,三等
2020-11-28,6050,504,764,1268,關山,三等
2020-11-29,6050,1057,761,1818,關山,三等
2020-11-30,6050,649,610,1259,關山,三等
2020-12-01,6050,510,496,1006,關山,三等
2020-12-02,6050,461,486,947,關山,三等
2020-12-03,6050,491,539,1030,關山,三等
2020-12-04,6050,629,834,1463,關山,三等
2020-12-05,6050,449,568,1017,關山,三等
2020-12-06,6050,876,603,1479,關山,三等
2020-12-07,6050,593,537,1130,關山,三等
2020-12-08,6050,501,416,917,關山,三等
2020-12-09,6050,457,453,910,關山,三等
2020-12-10,6050,444,464,908,關山,三等
2020-12-11,6050,586,793,1379,關山,三等
2020-12-12,6050,456,488,944,關山,三等
2020-12-13,6050,860,584,1444,關山,三等
2020-12-14,6050,606,533,1139,關山,三等
2020-12-15,6050,486,437,923,關山,三等
2020-12-16,6050,520,499,1019,關山,三等
2020-12-17,6050,506,544,1050,關山,三等
2020-12-18,6050,657,719,1376,關山,三等
2020-12-19,6050,494,577,1071,關山,三等
2020-12-20,6050,686,524,1210,關山,三等
2020-12-21,6050,547,536,1083,關山,三等
2020-12-22,6050,532,453,985,關山,三等
2020-12-23,6050,477,553,1030,關山,三等
2020-12-24,6050,581,577,1158,關山,三等
2020-12-25,6050,652,757,1409,關山,三等
2020-12-26,6050,558,605,1163,關山,三等
2020-12-27,6050,770,501,1271,關山,三等
2020-12-28,6050,679,559,1238,關山,三等
2020-12-29,6050,533,547,1080,關山,三等
2020-12-30,6050,562,650,1212,關山,三等
2020-12-31,6050,755,883,1638,關山,三等
2020-01-01,6060,3,1,4,海端,乙簡
2020-01-02,6060,4,11,15,海端,乙簡
2020-01-03,6060,7,8,15,海端,乙簡
2020-01-04,6060,9,15,24,海端,乙簡
2020-01-05,6060,1,2,3,海端,乙簡
2020-01-06,6060,6,12,18,海端,乙簡
2020-01-07,6060,5,17,22,海端,乙簡
2020-01-08,6060,4,10,14,海端,乙簡
2020-01-09,6060,6,11,17,海端,乙簡
2020-01-10,6060,7,10,17,海端,乙簡
2020-01-11,6060,1,9,10,海端,乙簡
2020-01-12,6060,0,5,5,海端,乙簡
2020-01-13,6060,7,11,18,海端,乙簡
2020-01-14,6060,12,12,24,海端,乙簡
2020-01-15,6060,8,11,19,海端,乙簡
2020-01-16,6060,8,18,26,海端,乙簡
2020-01-17,6060,3,7,10,海端,乙簡
2020-01-18,6060,1,6,7,海端,乙簡
2020-01-19,6060,1,2,3,海端,乙簡
2020-01-20,6060,6,8,14,海端,乙簡
2020-01-21,6060,5,7,12,海端,乙簡
2020-01-22,6060,3,9,12,海端,乙簡
2020-01-23,6060,1,4,5,海端,乙簡
2020-01-24,6060,3,4,7,海端,乙簡
2020-01-25,6060,3,7,10,海端,乙簡
2020-01-26,6060,1,4,5,海端,乙簡
2020-01-27,6060,6,3,9,海端,乙簡
2020-01-28,6060,2,7,9,海端,乙簡
2020-01-29,6060,7,3,10,海端,乙簡
2020-01-30,6060,9,13,22,海端,乙簡
2020-01-31,6060,10,17,27,海端,乙簡
2020-02-01,6060,2,2,4,海端,乙簡
2020-02-02,6060,3,0,3,海端,乙簡
2020-02-03,6060,5,12,17,海端,乙簡
2020-02-04,6060,6,6,12,海端,乙簡
2020-02-05,6060,3,16,19,海端,乙簡
2020-02-06,6060,7,10,17,海端,乙簡
2020-02-07,6060,8,10,18,海端,乙簡
2020-02-08,6060,0,3,3,海端,乙簡
2020-02-09,6060,5,1,6,海端,乙簡
2020-02-10,6060,4,5,9,海端,乙簡
2020-02-11,6060,4,10,14,海端,乙簡
2020-02-12,6060,3,6,9,海端,乙簡
2020-02-13,6060,4,10,14,海端,乙簡
2020-02-14,6060,4,9,13,海端,乙簡
2020-02-15,6060,4,7,11,海端,乙簡
2020-02-16,6060,1,2,3,海端,乙簡
2020-02-17,6060,4,6,10,海端,乙簡
2020-02-18,6060,5,6,11,海端,乙簡
2020-02-19,6060,6,7,13,海端,乙簡
2020-02-20,6060,9,8,17,海端,乙簡
2020-02-21,6060,3,8,11,海端,乙簡
2020-02-22,6060,12,9,21,海端,乙簡
2020-02-23,6060,6,7,13,海端,乙簡
2020-02-24,6060,4,7,11,海端,乙簡
2020-02-25,6060,11,10,21,海端,乙簡
2020-02-26,6060,6,12,18,海端,乙簡
2020-02-27,6060,4,11,15,海端,乙簡
2020-02-28,6060,3,13,16,海端,乙簡
2020-02-29,6060,0,2,2,海端,乙簡
2020-03-01,6060,3,1,4,海端,乙簡
2020-03-02,6060,6,8,14,海端,乙簡
2020-03-03,6060,5,9,14,海端,乙簡
2020-03-04,6060,5,8,13,海端,乙簡
2020-03-05,6060,10,12,22,海端,乙簡
2020-03-06,6060,4,13,17,海端,乙簡
2020-03-07,6060,1,4,5,海端,乙簡
2020-03-08,6060,1,2,3,海端,乙簡
2020-03-09,6060,7,8,15,海端,乙簡
2020-03-10,6060,2,9,11,海端,乙簡
2020-03-11,6060,8,9,17,海端,乙簡
2020-03-12,6060,7,13,20,海端,乙簡
2020-03-13,6060,7,12,19,海端,乙簡
2020-03-14,6060,7,8,15,海端,乙簡
2020-03-15,6060,5,7,12,海端,乙簡
2020-03-16,6060,7,7,14,海端,乙簡
2020-03-17,6060,10,8,18,海端,乙簡
2020-03-18,6060,8,7,15,海端,乙簡
2020-03-19,6060,5,10,15,海端,乙簡
2020-03-20,6060,6,9,15,海端,乙簡
2020-03-21,6060,0,3,3,海端,乙簡
2020-03-22,6060,0,4,4,海端,乙簡
2020-03-23,6060,11,10,21,海端,乙簡
2020-03-24,6060,8,11,19,海端,乙簡
2020-03-25,6060,9,11,20,海端,乙簡
2020-03-26,6060,10,9,19,海端,乙簡
2020-03-27,6060,10,10,20,海端,乙簡
2020-03-28,6060,4,3,7,海端,乙簡
2020-03-29,6060,2,1,3,海端,乙簡
2020-03-30,6060,6,11,17,海端,乙簡
2020-03-31,6060,7,9,16,海端,乙簡
2020-04-01,6060,8,12,20,海端,乙簡
2020-04-02,6060,4,2,6,海端,乙簡
2020-04-03,6060,5,4,9,海端,乙簡
2020-04-04,6060,0,5,5,海端,乙簡
2020-04-05,6060,4,1,5,海端,乙簡
2020-04-06,6060,8,8,16,海端,乙簡
2020-04-07,6060,5,10,15,海端,乙簡
2020-04-08,6060,9,7,16,海端,乙簡
2020-04-09,6060,8,12,20,海端,乙簡
2020-04-10,6060,6,9,15,海端,乙簡
2020-04-11,6060,1,3,4,海端,乙簡
2020-04-12,6060,4,2,6,海端,乙簡
2020-04-13,6060,8,6,14,海端,乙簡
2020-04-14,6060,10,8,18,海端,乙簡
2020-04-15,6060,7,11,18,海端,乙簡
2020-04-16,6060,9,8,17,海端,乙簡
2020-04-17,6060,4,11,15,海端,乙簡
2020-04-18,6060,1,4,5,海端,乙簡
2020-04-19,6060,2,2,4,海端,乙簡
2020-04-20,6060,6,12,18,海端,乙簡
2020-04-21,6060,3,6,9,海端,乙簡
2020-04-22,6060,7,8,15,海端,乙簡
2020-04-23,6060,7,12,19,海端,乙簡
2020-04-24,6060,3,9,12,海端,乙簡
2020-04-25,6060,1,2,3,海端,乙簡
2020-04-26,6060,0,1,1,海端,乙簡
2020-04-27,6060,9,7,16,海端,乙簡
2020-04-28,6060,8,12,20,海端,乙簡
2020-04-29,6060,6,9,15,海端,乙簡
2020-04-30,6060,3,19,22,海端,乙簡
2020-05-01,6060,5,10,15,海端,乙簡
2020-05-02,6060,0,4,4,海端,乙簡
2020-05-03,6060,1,1,2,海端,乙簡
2020-05-04,6060,7,8,15,海端,乙簡
2020-05-05,6060,4,6,10,海端,乙簡
2020-05-06,6060,7,7,14,海端,乙簡
2020-05-07,6060,3,7,10,海端,乙簡
2020-05-08,6060,3,5,8,海端,乙簡
2020-05-09,6060,2,3,5,海端,乙簡
2020-05-10,6060,7,1,8,海端,乙簡
2020-05-11,6060,5,6,11,海端,乙簡
2020-05-12,6060,7,5,12,海端,乙簡
2020-05-13,6060,3,8,11,海端,乙簡
2020-05-14,6060,5,6,11,海端,乙簡
2020-05-15,6060,6,8,14,海端,乙簡
2020-05-16,6060,1,2,3,海端,乙簡
2020-05-17,6060,1,2,3,海端,乙簡
2020-05-18,6060,10,6,16,海端,乙簡
2020-05-19,6060,9,6,15,海端,乙簡
2020-05-20,6060,6,5,11,海端,乙簡
2020-05-21,6060,7,9,16,海端,乙簡
2020-05-22,6060,6,7,13,海端,乙簡
2020-05-23,6060,5,3,8,海端,乙簡
2020-05-24,6060,0,2,2,海端,乙簡
2020-05-25,6060,6,6,12,海端,乙簡
2020-05-26,6060,3,6,9,海端,乙簡
2020-05-27,6060,7,9,16,海端,乙簡
2020-05-28,6060,5,8,13,海端,乙簡
2020-05-29,6060,5,9,14,海端,乙簡
2020-05-30,6060,3,3,6,海端,乙簡
2020-05-31,6060,1,2,3,海端,乙簡
2020-06-01,6060,6,8,14,海端,乙簡
2020-06-02,6060,8,10,18,海端,乙簡
2020-06-03,6060,8,13,21,海端,乙簡
2020-06-04,6060,14,8,22,海端,乙簡
2020-06-05,6060,5,11,16,海端,乙簡
2020-06-06,6060,6,6,12,海端,乙簡
2020-06-07,6060,2,2,4,海端,乙簡
2020-06-08,6060,5,10,15,海端,乙簡
2020-06-09,6060,7,8,15,海端,乙簡
2020-06-10,6060,8,8,16,海端,乙簡
2020-06-11,6060,4,11,15,海端,乙簡
2020-06-12,6060,5,10,15,海端,乙簡
2020-06-13,6060,1,0,1,海端,乙簡
2020-06-14,6060,0,4,4,海端,乙簡
2020-06-15,6060,6,12,18,海端,乙簡
2020-06-16,6060,7,9,16,海端,乙簡
2020-06-17,6060,12,9,21,海端,乙簡
2020-06-18,6060,7,9,16,海端,乙簡
2020-06-19,6060,6,10,16,海端,乙簡
2020-06-20,6060,4,6,10,海端,乙簡
2020-06-21,6060,0,1,1,海端,乙簡
2020-06-22,6060,7,6,13,海端,乙簡
2020-06-23,6060,6,8,14,海端,乙簡
2020-06-24,6060,6,6,12,海端,乙簡
2020-06-25,6060,0,2,2,海端,乙簡
2020-06-26,6060,11,14,25,海端,乙簡
2020-06-27,6060,3,1,4,海端,乙簡
2020-06-28,6060,2,4,6,海端,乙簡
2020-06-29,6060,7,7,14,海端,乙簡
2020-06-30,6060,3,6,9,海端,乙簡
2020-07-01,6060,6,8,14,海端,乙簡
2020-07-02,6060,6,5,11,海端,乙簡
2020-07-03,6060,7,9,16,海端,乙簡
2020-07-04,6060,2,3,5,海端,乙簡
2020-07-05,6060,2,4,6,海端,乙簡
2020-07-06,6060,8,7,15,海端,乙簡
2020-07-07,6060,4,9,13,海端,乙簡
2020-07-08,6060,7,8,15,海端,乙簡
2020-07-09,6060,7,10,17,海端,乙簡
2020-07-10,6060,5,11,16,海端,乙簡
2020-07-11,6060,2,4,6,海端,乙簡
2020-07-12,6060,5,1,6,海端,乙簡
2020-07-13,6060,9,7,16,海端,乙簡
2020-07-14,6060,4,9,13,海端,乙簡
2020-07-15,6060,2,12,14,海端,乙簡
2020-07-16,6060,0,7,7,海端,乙簡
2020-07-17,6060,1,8,9,海端,乙簡
2020-07-18,6060,2,1,3,海端,乙簡
2020-07-19,6060,6,3,9,海端,乙簡
2020-07-20,6060,3,9,12,海端,乙簡
2020-07-21,6060,3,6,9,海端,乙簡
2020-07-22,6060,6,3,9,海端,乙簡
2020-07-23,6060,5,7,12,海端,乙簡
2020-07-24,6060,3,14,17,海端,乙簡
2020-07-25,6060,6,16,22,海端,乙簡
2020-07-26,6060,3,3,6,海端,乙簡
2020-07-27,6060,5,4,9,海端,乙簡
2020-07-28,6060,5,5,10,海端,乙簡
2020-07-29,6060,4,6,10,海端,乙簡
2020-07-30,6060,8,10,18,海端,乙簡
2020-07-31,6060,3,5,8,海端,乙簡
2020-08-01,6060,6,3,9,海端,乙簡
2020-08-02,6060,1,2,3,海端,乙簡
2020-08-03,6060,6,6,12,海端,乙簡
2020-08-04,6060,8,4,12,海端,乙簡
2020-08-05,6060,3,7,10,海端,乙簡
2020-08-06,6060,5,9,14,海端,乙簡
2020-08-07,6060,5,2,7,海端,乙簡
2020-08-08,6060,4,4,8,海端,乙簡
2020-08-09,6060,4,1,5,海端,乙簡
2020-08-10,6060,10,7,17,海端,乙簡
2020-08-11,6060,3,3,6,海端,乙簡
2020-08-12,6060,4,3,7,海端,乙簡
2020-08-13,6060,5,4,9,海端,乙簡
2020-08-14,6060,7,5,12,海端,乙簡
2020-08-15,6060,3,3,6,海端,乙簡
2020-08-16,6060,1,1,2,海端,乙簡
2020-08-17,6060,5,3,8,海端,乙簡
2020-08-18,6060,4,6,10,海端,乙簡
2020-08-19,6060,1,5,6,海端,乙簡
2020-08-20,6060,7,5,12,海端,乙簡
2020-08-21,6060,3,6,9,海端,乙簡
2020-08-22,6060,2,5,7,海端,乙簡
2020-08-23,6060,4,1,5,海端,乙簡
2020-08-24,6060,2,5,7,海端,乙簡
2020-08-25,6060,3,14,17,海端,乙簡
2020-08-26,6060,6,5,11,海端,乙簡
2020-08-27,6060,11,7,18,海端,乙簡
2020-08-28,6060,4,3,7,海端,乙簡
2020-08-29,6060,5,4,9,海端,乙簡
2020-08-30,6060,2,5,7,海端,乙簡
2020-08-31,6060,14,7,21,海端,乙簡
2020-09-01,6060,8,5,13,海端,乙簡
2020-09-02,6060,6,11,17,海端,乙簡
2020-09-03,6060,12,8,20,海端,乙簡
2020-09-04,6060,12,2,14,海端,乙簡
2020-09-05,6060,2,5,7,海端,乙簡
2020-09-06,6060,6,5,11,海端,乙簡
2020-09-07,6060,12,12,24,海端,乙簡
2020-09-08,6060,13,11,24,海端,乙簡
2020-09-09,6060,13,10,23,海端,乙簡
2020-09-10,6060,12,21,33,海端,乙簡
2020-09-11,6060,12,13,25,海端,乙簡
2020-09-12,6060,2,1,3,海端,乙簡
2020-09-13,6060,2,1,3,海端,乙簡
2020-09-14,6060,9,11,20,海端,乙簡
2020-09-15,6060,8,8,16,海端,乙簡
2020-09-16,6060,5,6,11,海端,乙簡
2020-09-17,6060,12,9,21,海端,乙簡
2020-09-18,6060,9,9,18,海端,乙簡
2020-09-19,6060,4,6,10,海端,乙簡
2020-09-20,6060,9,5,14,海端,乙簡
2020-09-21,6060,11,7,18,海端,乙簡
2020-09-22,6060,6,6,12,海端,乙簡
2020-09-23,6060,14,10,24,海端,乙簡
2020-09-24,6060,5,11,16,海端,乙簡
2020-09-25,6060,5,9,14,海端,乙簡
2020-09-26,6060,16,15,31,海端,乙簡
2020-09-27,6060,1,1,2,海端,乙簡
2020-09-28,6060,10,6,16,海端,乙簡
2020-09-29,6060,9,8,17,海端,乙簡
2020-09-30,6060,13,12,25,海端,乙簡
2020-10-01,6060,2,8,10,海端,乙簡
2020-10-02,6060,9,11,20,海端,乙簡
2020-10-03,6060,3,4,7,海端,乙簡
2020-10-04,6060,6,4,10,海端,乙簡
2020-10-05,6060,7,11,18,海端,乙簡
2020-10-06,6060,8,5,13,海端,乙簡
2020-10-07,6060,7,12,19,海端,乙簡
2020-10-08,6060,6,13,19,海端,乙簡
2020-10-09,6060,1,7,8,海端,乙簡
2020-10-10,6060,3,3,6,海端,乙簡
2020-10-11,6060,3,2,5,海端,乙簡
2020-10-12,6060,4,6,10,海端,乙簡
2020-10-13,6060,8,12,20,海端,乙簡
2020-10-14,6060,11,9,20,海端,乙簡
2020-10-15,6060,8,10,18,海端,乙簡
2020-10-16,6060,7,7,14,海端,乙簡
2020-10-17,6060,3,4,7,海端,乙簡
2020-10-18,6060,2,2,4,海端,乙簡
2020-10-19,6060,12,11,23,海端,乙簡
2020-10-20,6060,4,8,12,海端,乙簡
2020-10-21,6060,8,10,18,海端,乙簡
2020-10-22,6060,4,11,15,海端,乙簡
2020-10-23,6060,3,14,17,海端,乙簡
2020-10-24,6060,3,5,8,海端,乙簡
2020-10-25,6060,3,12,15,海端,乙簡
2020-10-26,6060,10,7,17,海端,乙簡
2020-10-27,6060,9,7,16,海端,乙簡
2020-10-28,6060,7,14,21,海端,乙簡
2020-10-29,6060,9,7,16,海端,乙簡
2020-10-30,6060,7,11,18,海端,乙簡
2020-10-31,6060,7,2,9,海端,乙簡
2020-11-01,6060,2,7,9,海端,乙簡
2020-11-02,6060,9,10,19,海端,乙簡
2020-11-03,6060,5,8,13,海端,乙簡
2020-11-04,6060,5,10,15,海端,乙簡
2020-11-05,6060,9,7,16,海端,乙簡
2020-11-06,6060,11,61,72,海端,乙簡
2020-11-07,6060,3,7,10,海端,乙簡
2020-11-08,6060,3,4,7,海端,乙簡
2020-11-09,6060,7,11,18,海端,乙簡
2020-11-10,6060,34,52,86,海端,乙簡
2020-11-11,6060,4,8,12,海端,乙簡
2020-11-12,6060,11,12,23,海端,乙簡
2020-11-13,6060,8,9,17,海端,乙簡
2020-11-14,6060,1,1,2,海端,乙簡
2020-11-15,6060,4,13,17,海端,乙簡
2020-11-16,6060,5,10,15,海端,乙簡
2020-11-17,6060,10,18,28,海端,乙簡
2020-11-18,6060,8,9,17,海端,乙簡
2020-11-19,6060,6,15,21,海端,乙簡
2020-11-20,6060,14,10,24,海端,乙簡
2020-11-21,6060,1,5,6,海端,乙簡
2020-11-22,6060,20,18,38,海端,乙簡
2020-11-23,6060,10,16,26,海端,乙簡
2020-11-24,6060,11,11,22,海端,乙簡
2020-11-25,6060,14,12,26,海端,乙簡
2020-11-26,6060,7,10,17,海端,乙簡
2020-11-27,6060,8,10,18,海端,乙簡
2020-11-28,6060,4,4,8,海端,乙簡
2020-11-29,6060,3,6,9,海端,乙簡
2020-11-30,6060,4,6,10,海端,乙簡
2020-12-01,6060,7,9,16,海端,乙簡
2020-12-02,6060,8,8,16,海端,乙簡
2020-12-03,6060,8,11,19,海端,乙簡
2020-12-04,6060,7,13,20,海端,乙簡
2020-12-05,6060,3,7,10,海端,乙簡
2020-12-06,6060,13,10,23,海端,乙簡
2020-12-07,6060,8,11,19,海端,乙簡
2020-12-08,6060,10,8,18,海端,乙簡
2020-12-09,6060,11,13,24,海端,乙簡
2020-12-10,6060,12,10,22,海端,乙簡
2020-12-11,6060,10,13,23,海端,乙簡
2020-12-12,6060,5,7,12,海端,乙簡
2020-12-13,6060,5,3,8,海端,乙簡
2020-12-14,6060,8,7,15,海端,乙簡
2020-12-15,6060,8,6,14,海端,乙簡
2020-12-16,6060,9,9,18,海端,乙簡
2020-12-17,6060,10,9,19,海端,乙簡
2020-12-18,6060,10,12,22,海端,乙簡
2020-12-19,6060,2,8,10,海端,乙簡
2020-12-20,6060,0,5,5,海端,乙簡
2020-12-21,6060,9,10,19,海端,乙簡
2020-12-22,6060,6,7,13,海端,乙簡
2020-12-23,6060,7,8,15,海端,乙簡
2020-12-24,6060,7,2,9,海端,乙簡
2020-12-25,6060,11,9,20,海端,乙簡
2020-12-26,6060,2,7,9,海端,乙簡
2020-12-27,6060,10,10,20,海端,乙簡
2020-12-28,6060,7,8,15,海端,乙簡
2020-12-29,6060,5,10,15,海端,乙簡
2020-12-30,6060,8,13,21,海端,乙簡
2020-12-31,6060,10,10,20,海端,乙簡
2020-01-01,6070,582,469,1051,池上,三等
2020-01-02,6070,449,401,850,池上,三等
2020-01-03,6070,500,522,1022,池上,三等
2020-01-04,6070,495,535,1030,池上,三等
2020-01-05,6070,565,454,1019,池上,三等
2020-01-06,6070,382,372,754,池上,三等
2020-01-07,6070,406,376,782,池上,三等
2020-01-08,6070,348,371,719,池上,三等
2020-01-09,6070,392,366,758,池上,三等
2020-01-10,6070,417,689,1106,池上,三等
2020-01-11,6070,516,628,1144,池上,三等
2020-01-12,6070,674,447,1121,池上,三等
2020-01-13,6070,453,490,943,池上,三等
2020-01-14,6070,390,426,816,池上,三等
2020-01-15,6070,484,497,981,池上,三等
2020-01-16,6070,509,1074,1583,池上,三等
2020-01-17,6070,750,811,1561,池上,三等
2020-01-18,6070,536,657,1193,池上,三等
2020-01-19,6070,597,515,1112,池上,三等
2020-01-20,6070,576,599,1175,池上,三等
2020-01-21,6070,579,701,1280,池上,三等
2020-01-22,6070,587,886,1473,池上,三等
2020-01-23,6070,492,1187,1679,池上,三等
2020-01-24,6070,314,1349,1663,池上,三等
2020-01-25,6070,749,1488,2237,池上,三等
2020-01-26,6070,1019,1380,2399,池上,三等
2020-01-27,6070,1339,1305,2644,池上,三等
2020-01-28,6070,1289,762,2051,池上,三等
2020-01-29,6070,1468,633,2101,池上,三等
2020-01-30,6070,991,580,1571,池上,三等
2020-01-31,6070,865,661,1526,池上,三等
2020-02-01,6070,734,554,1288,池上,三等
2020-02-02,6070,871,495,1366,池上,三等
2020-02-03,6070,476,462,938,池上,三等
2020-02-04,6070,498,491,989,池上,三等
2020-02-05,6070,435,416,851,池上,三等
2020-02-06,6070,545,421,966,池上,三等
2020-02-07,6070,469,579,1048,池上,三等
2020-02-08,6070,426,678,1104,池上,三等
2020-02-09,6070,723,421,1144,池上,三等
2020-02-10,6070,481,426,907,池上,三等
2020-02-11,6070,422,400,822,池上,三等
2020-02-12,6070,382,414,796,池上,三等
2020-02-13,6070,384,417,801,池上,三等
2020-02-14,6070,470,495,965,池上,三等
2020-02-15,6070,460,425,885,池上,三等
2020-02-16,6070,454,389,843,池上,三等
2020-02-17,6070,377,404,781,池上,三等
2020-02-18,6070,386,392,778,池上,三等
2020-02-19,6070,382,433,815,池上,三等
2020-02-20,6070,474,344,818,池上,三等
2020-02-21,6070,441,612,1053,池上,三等
2020-02-22,6070,519,537,1056,池上,三等
2020-02-23,6070,609,391,1000,池上,三等
2020-02-24,6070,393,287,680,池上,三等
2020-02-25,6070,323,346,669,池上,三等
2020-02-26,6070,330,375,705,池上,三等
2020-02-27,6070,361,738,1099,池上,三等
2020-02-28,6070,538,1035,1573,池上,三等
2020-02-29,6070,623,511,1134,池上,三等
2020-03-01,6070,1215,440,1655,池上,三等
2020-03-02,6070,370,311,681,池上,三等
2020-03-03,6070,287,289,576,池上,三等
2020-03-04,6070,296,374,670,池上,三等
2020-03-05,6070,302,289,591,池上,三等
2020-03-06,6070,306,717,1023,池上,三等
2020-03-07,6070,328,461,789,池上,三等
2020-03-08,6070,744,365,1109,池上,三等
2020-03-09,6070,373,361,734,池上,三等
2020-03-10,6070,294,317,611,池上,三等
2020-03-11,6070,321,317,638,池上,三等
2020-03-12,6070,339,335,674,池上,三等
2020-03-13,6070,330,545,875,池上,三等
2020-03-14,6070,414,414,828,池上,三等
2020-03-15,6070,646,409,1055,池上,三等
2020-03-16,6070,445,340,785,池上,三等
2020-03-17,6070,307,275,582,池上,三等
2020-03-18,6070,270,319,589,池上,三等
2020-03-19,6070,329,313,642,池上,三等
2020-03-20,6070,306,560,866,池上,三等
2020-03-21,6070,368,466,834,池上,三等
2020-03-22,6070,733,338,1071,池上,三等
2020-03-23,6070,315,354,669,池上,三等
2020-03-24,6070,296,282,578,池上,三等
2020-03-25,6070,263,319,582,池上,三等
2020-03-26,6070,339,380,719,池上,三等
2020-03-27,6070,336,573,909,池上,三等
2020-03-28,6070,397,468,865,池上,三等
2020-03-29,6070,591,398,989,池上,三等
2020-03-30,6070,397,324,721,池上,三等
2020-03-31,6070,300,383,683,池上,三等
2020-04-01,6070,328,731,1059,池上,三等
2020-04-02,6070,358,989,1347,池上,三等
2020-04-03,6070,506,853,1359,池上,三等
2020-04-04,6070,953,390,1343,池上,三等
2020-04-05,6070,1067,277,1344,池上,三等
2020-04-06,6070,425,275,700,池上,三等
2020-04-07,6070,263,223,486,池上,三等
2020-04-08,6070,247,222,469,池上,三等
2020-04-09,6070,201,194,395,池上,三等
2020-04-10,6070,246,464,710,池上,三等
2020-04-11,6070,256,361,617,池上,三等
2020-04-12,6070,428,304,732,池上,三等
2020-04-13,6070,259,272,531,池上,三等
2020-04-14,6070,221,290,511,池上,三等
2020-04-15,6070,264,367,631,池上,三等
2020-04-16,6070,243,235,478,池上,三等
2020-04-17,6070,299,478,777,池上,三等
2020-04-18,6070,280,414,694,池上,三等
2020-04-19,6070,446,305,751,池上,三等
2020-04-20,6070,315,278,593,池上,三等
2020-04-21,6070,205,218,423,池上,三等
2020-04-22,6070,206,214,420,池上,三等
2020-04-23,6070,286,269,555,池上,三等
2020-04-24,6070,281,416,697,池上,三等
2020-04-25,6070,234,281,515,池上,三等
2020-04-26,6070,416,230,646,池上,三等
2020-04-27,6070,292,264,556,池上,三等
2020-04-28,6070,205,257,462,池上,三等
2020-04-29,6070,233,292,525,池上,三等
2020-04-30,6070,263,395,658,池上,三等
2020-05-01,6070,317,704,1021,池上,三等
2020-05-02,6070,368,360,728,池上,三等
2020-05-03,6070,635,287,922,池上,三等
2020-05-04,6070,318,276,594,池上,三等
2020-05-05,6070,250,259,509,池上,三等
2020-05-06,6070,276,255,531,池上,三等
2020-05-07,6070,264,300,564,池上,三等
2020-05-08,6070,323,519,842,池上,三等
2020-05-09,6070,290,369,659,池上,三等
2020-05-10,6070,541,290,831,池上,三等
2020-05-11,6070,356,328,684,池上,三等
2020-05-12,6070,261,246,507,池上,三等
2020-05-13,6070,270,312,582,池上,三等
2020-05-14,6070,318,332,650,池上,三等
2020-05-15,6070,371,492,863,池上,三等
2020-05-16,6070,378,493,871,池上,三等
2020-05-17,6070,564,333,897,池上,三等
2020-05-18,6070,370,311,681,池上,三等
2020-05-19,6070,276,275,551,池上,三等
2020-05-20,6070,276,284,560,池上,三等
2020-05-21,6070,259,344,603,池上,三等
2020-05-22,6070,293,457,750,池上,三等
2020-05-23,6070,290,383,673,池上,三等
2020-05-24,6070,509,393,902,池上,三等
2020-05-25,6070,340,282,622,池上,三等
2020-05-26,6070,417,329,746,池上,三等
2020-05-27,6070,263,292,555,池上,三等
2020-05-28,6070,294,358,652,池上,三等
2020-05-29,6070,367,584,951,池上,三等
2020-05-30,6070,444,557,1001,池上,三等
2020-05-31,6070,748,516,1264,池上,三等
2020-06-01,6070,389,402,791,池上,三等
2020-06-02,6070,371,383,754,池上,三等
2020-06-03,6070,384,429,813,池上,三等
2020-06-04,6070,352,343,695,池上,三等
2020-06-05,6070,480,716,1196,池上,三等
2020-06-06,6070,494,612,1106,池上,三等
2020-06-07,6070,798,522,1320,池上,三等
2020-06-08,6070,454,431,885,池上,三等
2020-06-09,6070,379,394,773,池上,三等
2020-06-10,6070,373,504,877,池上,三等
2020-06-11,6070,413,504,917,池上,三等
2020-06-12,6070,558,751,1309,池上,三等
2020-06-13,6070,536,622,1158,池上,三等
2020-06-14,6070,737,443,1180,池上,三等
2020-06-15,6070,628,449,1077,池上,三等
2020-06-16,6070,429,392,821,池上,三等
2020-06-17,6070,377,408,785,池上,三等
2020-06-18,6070,374,450,824,池上,三等
2020-06-19,6070,504,599,1103,池上,三等
2020-06-20,6070,602,937,1539,池上,三等
2020-06-21,6070,2355,1959,4314,池上,三等
2020-06-22,6070,875,583,1458,池上,三等
2020-06-23,6070,490,534,1024,池上,三等
2020-06-24,6070,523,926,1449,池上,三等
2020-06-25,6070,542,1111,1653,池上,三等
2020-06-26,6070,757,877,1634,池上,三等
2020-06-27,6070,1314,1008,2322,池上,三等
2020-06-28,6070,1456,557,2013,池上,三等
2020-06-29,6070,634,499,1133,池上,三等
2020-06-30,6070,507,456,963,池上,三等
2020-07-01,6070,437,420,857,池上,三等
2020-07-02,6070,415,455,870,池上,三等
2020-07-03,6070,768,873,1641,池上,三等
2020-07-04,6070,726,766,1492,池上,三等
2020-07-05,6070,844,773,1617,池上,三等
2020-07-06,6070,462,443,905,池上,三等
2020-07-07,6070,386,468,854,池上,三等
2020-07-08,6070,522,604,1126,池上,三等
2020-07-09,6070,513,511,1024,池上,三等
2020-07-10,6070,665,853,1518,池上,三等
2020-07-11,6070,637,560,1197,池上,三等
2020-07-12,6070,1186,659,1845,池上,三等
2020-07-13,6070,568,577,1145,池上,三等
2020-07-14,6070,486,527,1013,池上,三等
2020-07-15,6070,537,644,1181,池上,三等
2020-07-16,6070,550,708,1258,池上,三等
2020-07-17,6070,717,1053,1770,池上,三等
2020-07-18,6070,740,903,1643,池上,三等
2020-07-19,6070,730,648,1378,池上,三等
2020-07-20,6070,637,625,1262,池上,三等
2020-07-21,6070,639,587,1226,池上,三等
2020-07-22,6070,605,710,1315,池上,三等
2020-07-23,6070,593,682,1275,池上,三等
2020-07-24,6070,601,883,1484,池上,三等
2020-07-25,6070,746,825,1571,池上,三等
2020-07-26,6070,910,704,1614,池上,三等
2020-07-27,6070,662,614,1276,池上,三等
2020-07-28,6070,679,646,1325,池上,三等
2020-07-29,6070,570,627,1197,池上,三等
2020-07-30,6070,562,694,1256,池上,三等
2020-07-31,6070,661,949,1610,池上,三等
2020-08-01,6070,725,1139,1864,池上,三等
2020-08-02,6070,951,679,1630,池上,三等
2020-08-03,6070,639,668,1307,池上,三等
2020-08-04,6070,549,501,1050,池上,三等
2020-08-05,6070,527,535,1062,池上,三等
2020-08-06,6070,456,644,1100,池上,三等
2020-08-07,6070,706,804,1510,池上,三等
2020-08-08,6070,553,893,1446,池上,三等
2020-08-09,6070,920,582,1502,池上,三等
2020-08-10,6070,578,621,1199,池上,三等
2020-08-11,6070,837,580,1417,池上,三等
2020-08-12,6070,663,752,1415,池上,三等
2020-08-13,6070,641,664,1305,池上,三等
2020-08-14,6070,798,922,1720,池上,三等
2020-08-15,6070,588,804,1392,池上,三等
2020-08-16,6070,937,805,1742,池上,三等
2020-08-17,6070,766,701,1467,池上,三等
2020-08-18,6070,610,599,1209,池上,三等
2020-08-19,6070,603,733,1336,池上,三等
2020-08-20,6070,608,924,1532,池上,三等
2020-08-21,6070,787,905,1692,池上,三等
2020-08-22,6070,732,969,1701,池上,三等
2020-08-23,6070,1069,758,1827,池上,三等
2020-08-24,6070,812,655,1467,池上,三等
2020-08-25,6070,719,717,1436,池上,三等
2020-08-26,6070,637,611,1248,池上,三等
2020-08-27,6070,523,591,1114,池上,三等
2020-08-28,6070,660,772,1432,池上,三等
2020-08-29,6070,651,931,1582,池上,三等
2020-08-30,6070,808,592,1400,池上,三等
2020-08-31,6070,599,467,1066,池上,三等
2020-09-01,6070,459,462,921,池上,三等
2020-09-02,6070,410,504,914,池上,三等
2020-09-03,6070,569,656,1225,池上,三等
2020-09-04,6070,567,752,1319,池上,三等
2020-09-05,6070,542,699,1241,池上,三等
2020-09-06,6070,976,583,1559,池上,三等
2020-09-07,6070,536,712,1248,池上,三等
2020-09-08,6070,641,472,1113,池上,三等
2020-09-09,6070,512,509,1021,池上,三等
2020-09-10,6070,581,553,1134,池上,三等
2020-09-11,6070,547,754,1301,池上,三等
2020-09-12,6070,484,823,1307,池上,三等
2020-09-13,6070,920,548,1468,池上,三等
2020-09-14,6070,528,445,973,池上,三等
2020-09-15,6070,460,414,874,池上,三等
2020-09-16,6070,480,485,965,池上,三等
2020-09-17,6070,483,552,1035,池上,三等
2020-09-18,6070,565,927,1492,池上,三等
2020-09-19,6070,533,888,1421,池上,三等
2020-09-20,6070,808,575,1383,池上,三等
2020-09-21,6070,571,481,1052,池上,三等
2020-09-22,6070,511,531,1042,池上,三等
2020-09-23,6070,428,608,1036,池上,三等
2020-09-24,6070,537,567,1104,池上,三等
2020-09-25,6070,493,742,1235,池上,三等
2020-09-26,6070,614,734,1348,池上,三等
2020-09-27,6070,866,620,1486,池上,三等
2020-09-28,6070,600,545,1145,池上,三等
2020-09-29,6070,533,514,1047,池上,三等
2020-09-30,6070,506,1073,1579,池上,三等
2020-10-01,6070,545,1181,1726,池上,三等
2020-10-02,6070,762,1075,1837,池上,三等
2020-10-03,6070,1098,684,1782,池上,三等
2020-10-04,6070,1570,527,2097,池上,三等
2020-10-05,6070,707,531,1238,池上,三等
2020-10-06,6070,581,480,1061,池上,三等
2020-10-07,6070,553,508,1061,池上,三等
2020-10-08,6070,533,950,1483,池上,三等
2020-10-09,6070,586,1243,1829,池上,三等
2020-10-10,6070,683,606,1289,池上,三等
2020-10-11,6070,1381,631,2012,池上,三等
2020-10-12,6070,613,511,1124,池上,三等
2020-10-13,6070,510,498,1008,池上,三等
2020-10-14,6070,586,534,1120,池上,三等
2020-10-15,6070,598,935,1533,池上,三等
2020-10-16,6070,865,1008,1873,池上,三等
2020-10-17,6070,718,1025,1743,池上,三等
2020-10-18,6070,1110,823,1933,池上,三等
2020-10-19,6070,703,614,1317,池上,三等
2020-10-20,6070,625,575,1200,池上,三等
2020-10-21,6070,524,919,1443,池上,三等
2020-10-22,6070,601,840,1441,池上,三等
2020-10-23,6070,943,1466,2409,池上,三等
2020-10-24,6070,1088,1688,2776,池上,三等
2020-10-25,6070,1727,1066,2793,池上,三等
2020-10-26,6070,1017,702,1719,池上,三等
2020-10-27,6070,811,783,1594,池上,三等
2020-10-28,6070,636,744,1380,池上,三等
2020-10-29,6070,634,677,1311,池上,三等
2020-10-30,6070,721,1173,1894,池上,三等
2020-10-31,6070,912,1320,2232,池上,三等
2020-11-01,6070,1564,1025,2589,池上,三等
2020-11-02,6070,1203,637,1840,池上,三等
2020-11-03,6070,695,608,1303,池上,三等
2020-11-04,6070,577,527,1104,池上,三等
2020-11-05,6070,552,617,1169,池上,三等
2020-11-06,6070,655,1014,1669,池上,三等
2020-11-07,6070,659,752,1411,池上,三等
2020-11-08,6070,1054,764,1818,池上,三等
2020-11-09,6070,903,620,1523,池上,三等
2020-11-10,6070,602,558,1160,池上,三等
2020-11-11,6070,536,563,1099,池上,三等
2020-11-12,6070,712,630,1342,池上,三等
2020-11-13,6070,675,798,1473,池上,三等
2020-11-14,6070,673,786,1459,池上,三等
2020-11-15,6070,888,802,1690,池上,三等
2020-11-16,6070,691,528,1219,池上,三等
2020-11-17,6070,663,608,1271,池上,三等
2020-11-18,6070,515,584,1099,池上,三等
2020-11-19,6070,596,572,1168,池上,三等
2020-11-20,6070,566,1107,1673,池上,三等
2020-11-21,6070,656,774,1430,池上,三等
2020-11-22,6070,915,613,1528,池上,三等
2020-11-23,6070,628,552,1180,池上,三等
2020-11-24,6070,462,472,934,池上,三等
2020-11-25,6070,455,454,909,池上,三等
2020-11-26,6070,604,697,1301,池上,三等
2020-11-27,6070,748,741,1489,池上,三等
2020-11-28,6070,780,912,1692,池上,三等
2020-11-29,6070,1007,661,1668,池上,三等
2020-11-30,6070,597,548,1145,池上,三等
2020-12-01,6070,378,402,780,池上,三等
2020-12-02,6070,370,423,793,池上,三等
2020-12-03,6070,483,623,1106,池上,三等
2020-12-04,6070,654,747,1401,池上,三等
2020-12-05,6070,633,831,1464,池上,三等
2020-12-06,6070,843,609,1452,池上,三等
2020-12-07,6070,567,479,1046,池上,三等
2020-12-08,6070,498,474,972,池上,三等
2020-12-09,6070,351,443,794,池上,三等
2020-12-10,6070,403,456,859,池上,三等
2020-12-11,6070,511,904,1415,池上,三等
2020-12-12,6070,570,1038,1608,池上,三等
2020-12-13,6070,790,607,1397,池上,三等
2020-12-14,6070,555,499,1054,池上,三等
2020-12-15,6070,409,481,890,池上,三等
2020-12-16,6070,398,369,767,池上,三等
2020-12-17,6070,454,504,958,池上,三等
2020-12-18,6070,818,782,1600,池上,三等
2020-12-19,6070,786,1297,2083,池上,三等
2020-12-20,6070,850,547,1397,池上,三等
2020-12-21,6070,563,483,1046,池上,三等
2020-12-22,6070,467,407,874,池上,三等
2020-12-23,6070,453,476,929,池上,三等
2020-12-24,6070,530,542,1072,池上,三等
2020-12-25,6070,503,804,1307,池上,三等
2020-12-26,6070,637,971,1608,池上,三等
2020-12-27,6070,894,640,1534,池上,三等
2020-12-28,6070,494,486,980,池上,三等
2020-12-29,6070,537,484,1021,池上,三等
2020-12-30,6070,533,692,1225,池上,三等
2020-12-31,6070,565,832,1397,池上,三等
2020-01-01,6080,221,128,349,富里,三等
2020-01-02,6080,90,108,198,富里,三等
2020-01-03,6080,166,175,341,富里,三等
2020-01-04,6080,118,164,282,富里,三等
2020-01-05,6080,215,140,355,富里,三等
2020-01-06,6080,129,185,314,富里,三等
2020-01-07,6080,131,178,309,富里,三等
2020-01-08,6080,164,110,274,富里,三等
2020-01-09,6080,125,141,266,富里,三等
2020-01-10,6080,159,302,461,富里,三等
2020-01-11,6080,236,259,495,富里,三等
2020-01-12,6080,273,128,401,富里,三等
2020-01-13,6080,154,165,319,富里,三等
2020-01-14,6080,149,152,301,富里,三等
2020-01-15,6080,131,109,240,富里,三等
2020-01-16,6080,138,185,323,富里,三等
2020-01-17,6080,160,186,346,富里,三等
2020-01-18,6080,161,135,296,富里,三等
2020-01-19,6080,157,174,331,富里,三等
2020-01-20,6080,170,193,363,富里,三等
2020-01-21,6080,151,255,406,富里,三等
2020-01-22,6080,157,330,487,富里,三等
2020-01-23,6080,150,328,478,富里,三等
2020-01-24,6080,126,335,461,富里,三等
2020-01-25,6080,234,340,574,富里,三等
2020-01-26,6080,416,264,680,富里,三等
2020-01-27,6080,552,298,850,富里,三等
2020-01-28,6080,515,192,707,富里,三等
2020-01-29,6080,443,169,612,富里,三等
2020-01-30,6080,327,175,502,富里,三等
2020-01-31,6080,270,152,422,富里,三等
2020-02-01,6080,172,220,392,富里,三等
2020-02-02,6080,229,184,413,富里,三等
2020-02-03,6080,205,141,346,富里,三等
2020-02-04,6080,151,142,293,富里,三等
2020-02-05,6080,141,140,281,富里,三等
2020-02-06,6080,122,128,250,富里,三等
2020-02-07,6080,185,151,336,富里,三等
2020-02-08,6080,111,116,227,富里,三等
2020-02-09,6080,171,131,302,富里,三等
2020-02-10,6080,148,125,273,富里,三等
2020-02-11,6080,121,123,244,富里,三等
2020-02-12,6080,145,108,253,富里,三等
2020-02-13,6080,105,117,222,富里,三等
2020-02-14,6080,128,133,261,富里,三等
2020-02-15,6080,181,140,321,富里,三等
2020-02-16,6080,124,104,228,富里,三等
2020-02-17,6080,145,139,284,富里,三等
2020-02-18,6080,142,163,305,富里,三等
2020-02-19,6080,131,95,226,富里,三等
2020-02-20,6080,128,131,259,富里,三等
2020-02-21,6080,132,152,284,富里,三等
2020-02-22,6080,119,104,223,富里,三等
2020-02-23,6080,170,113,283,富里,三等
2020-02-24,6080,159,142,301,富里,三等
2020-02-25,6080,127,138,265,富里,三等
2020-02-26,6080,114,123,237,富里,三等
2020-02-27,6080,156,321,477,富里,三等
2020-02-28,6080,100,179,279,富里,三等
2020-02-29,6080,159,154,313,富里,三等
2020-03-01,6080,397,129,526,富里,三等
2020-03-02,6080,143,123,266,富里,三等
2020-03-03,6080,96,113,209,富里,三等
2020-03-04,6080,94,125,219,富里,三等
2020-03-05,6080,114,93,207,富里,三等
2020-03-06,6080,136,187,323,富里,三等
2020-03-07,6080,119,170,289,富里,三等
2020-03-08,6080,208,91,299,富里,三等
2020-03-09,6080,115,115,230,富里,三等
2020-03-10,6080,102,113,215,富里,三等
2020-03-11,6080,119,100,219,富里,三等
2020-03-12,6080,129,149,278,富里,三等
2020-03-13,6080,137,199,336,富里,三等
2020-03-14,6080,97,120,217,富里,三等
2020-03-15,6080,258,117,375,富里,三等
2020-03-16,6080,134,153,287,富里,三等
2020-03-17,6080,110,99,209,富里,三等
2020-03-18,6080,96,101,197,富里,三等
2020-03-19,6080,90,119,209,富里,三等
2020-03-20,6080,122,224,346,富里,三等
2020-03-21,6080,132,170,302,富里,三等
2020-03-22,6080,248,95,343,富里,三等
2020-03-23,6080,92,133,225,富里,三等
2020-03-24,6080,84,103,187,富里,三等
2020-03-25,6080,106,120,226,富里,三等
2020-03-26,6080,144,175,319,富里,三等
2020-03-27,6080,124,240,364,富里,三等
2020-03-28,6080,108,161,269,富里,三等
2020-03-29,6080,229,110,339,富里,三等
2020-03-30,6080,118,141,259,富里,三等
2020-03-31,6080,105,139,244,富里,三等
2020-04-01,6080,159,290,449,富里,三等
2020-04-02,6080,115,321,436,富里,三等
2020-04-03,6080,129,234,363,富里,三等
2020-04-04,6080,286,115,401,富里,三等
2020-04-05,6080,367,105,472,富里,三等
2020-04-06,6080,201,124,325,富里,三等
2020-04-07,6080,107,93,200,富里,三等
2020-04-08,6080,102,110,212,富里,三等
2020-04-09,6080,116,110,226,富里,三等
2020-04-10,6080,114,162,276,富里,三等
2020-04-11,6080,100,102,202,富里,三等
2020-04-12,6080,139,115,254,富里,三等
2020-04-13,6080,106,126,232,富里,三等
2020-04-14,6080,108,99,207,富里,三等
2020-04-15,6080,89,106,195,富里,三等
2020-04-16,6080,80,101,181,富里,三等
2020-04-17,6080,93,170,263,富里,三等
2020-04-18,6080,102,105,207,富里,三等
2020-04-19,6080,198,83,281,富里,三等
2020-04-20,6080,116,128,244,富里,三等
2020-04-21,6080,92,104,196,富里,三等
2020-04-22,6080,100,95,195,富里,三等
2020-04-23,6080,85,94,179,富里,三等
2020-04-24,6080,114,176,290,富里,三等
2020-04-25,6080,79,125,204,富里,三等
2020-04-26,6080,146,74,220,富里,三等
2020-04-27,6080,98,99,197,富里,三等
2020-04-28,6080,127,113,240,富里,三等
2020-04-29,6080,115,143,258,富里,三等
2020-04-30,6080,124,140,264,富里,三等
2020-05-01,6080,142,207,349,富里,三等
2020-05-02,6080,111,136,247,富里,三等
2020-05-03,6080,198,95,293,富里,三等
2020-05-04,6080,113,118,231,富里,三等
2020-05-05,6080,90,114,204,富里,三等
2020-05-06,6080,103,123,226,富里,三等
2020-05-07,6080,127,107,234,富里,三等
2020-05-08,6080,145,228,373,富里,三等
2020-05-09,6080,142,188,330,富里,三等
2020-05-10,6080,266,116,382,富里,三等
2020-05-11,6080,159,135,294,富里,三等
2020-05-12,6080,106,126,232,富里,三等
2020-05-13,6080,109,101,210,富里,三等
2020-05-14,6080,85,111,196,富里,三等
2020-05-15,6080,142,190,332,富里,三等
2020-05-16,6080,103,118,221,富里,三等
2020-05-17,6080,212,101,313,富里,三等
2020-05-18,6080,120,127,247,富里,三等
2020-05-19,6080,107,120,227,富里,三等
2020-05-20,6080,94,119,213,富里,三等
2020-05-21,6080,115,103,218,富里,三等
2020-05-22,6080,126,187,313,富里,三等
2020-05-23,6080,73,125,198,富里,三等
2020-05-24,6080,225,111,336,富里,三等
2020-05-25,6080,103,139,242,富里,三等
2020-05-26,6080,112,120,232,富里,三等
2020-05-27,6080,102,113,215,富里,三等
2020-05-28,6080,121,124,245,富里,三等
2020-05-29,6080,138,182,320,富里,三等
2020-05-30,6080,123,111,234,富里,三等
2020-05-31,6080,195,118,313,富里,三等
2020-06-01,6080,101,123,224,富里,三等
2020-06-02,6080,111,123,234,富里,三等
2020-06-03,6080,127,105,232,富里,三等
2020-06-04,6080,136,124,260,富里,三等
2020-06-05,6080,135,185,320,富里,三等
2020-06-06,6080,117,165,282,富里,三等
2020-06-07,6080,237,95,332,富里,三等
2020-06-08,6080,143,143,286,富里,三等
2020-06-09,6080,103,140,243,富里,三等
2020-06-10,6080,104,111,215,富里,三等
2020-06-11,6080,126,143,269,富里,三等
2020-06-12,6080,199,251,450,富里,三等
2020-06-13,6080,168,117,285,富里,三等
2020-06-14,6080,195,140,335,富里,三等
2020-06-15,6080,130,126,256,富里,三等
2020-06-16,6080,175,180,355,富里,三等
2020-06-17,6080,120,121,241,富里,三等
2020-06-18,6080,110,112,222,富里,三等
2020-06-19,6080,123,158,281,富里,三等
2020-06-20,6080,120,172,292,富里,三等
2020-06-21,6080,549,518,1067,富里,三等
2020-06-22,6080,164,172,336,富里,三等
2020-06-23,6080,142,155,297,富里,三等
2020-06-24,6080,165,289,454,富里,三等
2020-06-25,6080,157,275,432,富里,三等
2020-06-26,6080,165,201,366,富里,三等
2020-06-27,6080,221,152,373,富里,三等
2020-06-28,6080,410,139,549,富里,三等
2020-06-29,6080,177,136,313,富里,三等
2020-06-30,6080,133,130,263,富里,三等
2020-07-01,6080,116,106,222,富里,三等
2020-07-02,6080,98,102,200,富里,三等
2020-07-03,6080,163,144,307,富里,三等
2020-07-04,6080,124,180,304,富里,三等
2020-07-05,6080,187,147,334,富里,三等
2020-07-06,6080,122,110,232,富里,三等
2020-07-07,6080,128,118,246,富里,三等
2020-07-08,6080,148,150,298,富里,三等
2020-07-09,6080,159,143,302,富里,三等
2020-07-10,6080,169,167,336,富里,三等
2020-07-11,6080,105,114,219,富里,三等
2020-07-12,6080,140,90,230,富里,三等
2020-07-13,6080,120,132,252,富里,三等
2020-07-14,6080,136,137,273,富里,三等
2020-07-15,6080,129,126,255,富里,三等
2020-07-16,6080,138,123,261,富里,三等
2020-07-17,6080,167,211,378,富里,三等
2020-07-18,6080,159,165,324,富里,三等
2020-07-19,6080,180,125,305,富里,三等
2020-07-20,6080,153,141,294,富里,三等
2020-07-21,6080,125,135,260,富里,三等
2020-07-22,6080,154,157,311,富里,三等
2020-07-23,6080,138,129,267,富里,三等
2020-07-24,6080,137,138,275,富里,三等
2020-07-25,6080,152,245,397,富里,三等
2020-07-26,6080,226,118,344,富里,三等
2020-07-27,6080,196,142,338,富里,三等
2020-07-28,6080,137,168,305,富里,三等
2020-07-29,6080,155,154,309,富里,三等
2020-07-30,6080,155,174,329,富里,三等
2020-07-31,6080,175,217,392,富里,三等
2020-08-01,6080,217,172,389,富里,三等
2020-08-02,6080,263,143,406,富里,三等
2020-08-03,6080,156,258,414,富里,三等
2020-08-04,6080,159,209,368,富里,三等
2020-08-05,6080,148,126,274,富里,三等
2020-08-06,6080,157,176,333,富里,三等
2020-08-07,6080,263,224,487,富里,三等
2020-08-08,6080,186,198,384,富里,三等
2020-08-09,6080,294,204,498,富里,三等
2020-08-10,6080,213,159,372,富里,三等
2020-08-11,6080,143,168,311,富里,三等
2020-08-12,6080,175,201,376,富里,三等
2020-08-13,6080,153,138,291,富里,三等
2020-08-14,6080,184,171,355,富里,三等
2020-08-15,6080,184,216,400,富里,三等
2020-08-16,6080,213,230,443,富里,三等
2020-08-17,6080,277,212,489,富里,三等
2020-08-18,6080,175,187,362,富里,三等
2020-08-19,6080,212,206,418,富里,三等
2020-08-20,6080,188,185,373,富里,三等
2020-08-21,6080,227,229,456,富里,三等
2020-08-22,6080,197,177,374,富里,三等
2020-08-23,6080,195,187,382,富里,三等
2020-08-24,6080,217,179,396,富里,三等
2020-08-25,6080,225,237,462,富里,三等
2020-08-26,6080,262,183,445,富里,三等
2020-08-27,6080,165,182,347,富里,三等
2020-08-28,6080,244,419,663,富里,三等
2020-08-29,6080,192,170,362,富里,三等
2020-08-30,6080,237,148,385,富里,三等
2020-08-31,6080,150,199,349,富里,三等
2020-09-01,6080,141,194,335,富里,三等
2020-09-02,6080,134,177,311,富里,三等
2020-09-03,6080,209,191,400,富里,三等
2020-09-04,6080,245,279,524,富里,三等
2020-09-05,6080,161,209,370,富里,三等
2020-09-06,6080,319,207,526,富里,三等
2020-09-07,6080,198,242,440,富里,三等
2020-09-08,6080,176,203,379,富里,三等
2020-09-09,6080,185,155,340,富里,三等
2020-09-10,6080,145,165,310,富里,三等
2020-09-11,6080,277,282,559,富里,三等
2020-09-12,6080,192,257,449,富里,三等
2020-09-13,6080,327,177,504,富里,三等
2020-09-14,6080,168,283,451,富里,三等
2020-09-15,6080,156,198,354,富里,三等
2020-09-16,6080,150,172,322,富里,三等
2020-09-17,6080,165,122,287,富里,三等
2020-09-18,6080,256,298,554,富里,三等
2020-09-19,6080,203,289,492,富里,三等
2020-09-20,6080,409,163,572,富里,三等
2020-09-21,6080,158,130,288,富里,三等
2020-09-22,6080,156,193,349,富里,三等
2020-09-23,6080,160,168,328,富里,三等
2020-09-24,6080,265,163,428,富里,三等
2020-09-25,6080,142,177,319,富里,三等
2020-09-26,6080,208,337,545,富里,三等
2020-09-27,6080,217,207,424,富里,三等
2020-09-28,6080,153,153,306,富里,三等
2020-09-29,6080,167,184,351,富里,三等
2020-09-30,6080,213,430,643,富里,三等
2020-10-01,6080,182,334,516,富里,三等
2020-10-02,6080,214,238,452,富里,三等
2020-10-03,6080,286,166,452,富里,三等
2020-10-04,6080,468,151,619,富里,三等
2020-10-05,6080,228,138,366,富里,三等
2020-10-06,6080,143,160,303,富里,三等
2020-10-07,6080,150,166,316,富里,三等
2020-10-08,6080,159,261,420,富里,三等
2020-10-09,6080,153,223,376,富里,三等
2020-10-10,6080,125,120,245,富里,三等
2020-10-11,6080,273,138,411,富里,三等
2020-10-12,6080,141,170,311,富里,三等
2020-10-13,6080,123,121,244,富里,三等
2020-10-14,6080,107,100,207,富里,三等
2020-10-15,6080,136,151,287,富里,三等
2020-10-16,6080,214,238,452,富里,三等
2020-10-17,6080,170,168,338,富里,三等
2020-10-18,6080,234,143,377,富里,三等
2020-10-19,6080,167,166,333,富里,三等
2020-10-20,6080,113,133,246,富里,三等
2020-10-21,6080,135,124,259,富里,三等
2020-10-22,6080,142,150,292,富里,三等
2020-10-23,6080,177,213,390,富里,三等
2020-10-24,6080,130,151,281,富里,三等
2020-10-25,6080,237,152,389,富里,三等
2020-10-26,6080,116,134,250,富里,三等
2020-10-27,6080,114,121,235,富里,三等
2020-10-28,6080,109,160,269,富里,三等
2020-10-29,6080,112,177,289,富里,三等
2020-10-30,6080,242,315,557,富里,三等
2020-10-31,6080,588,764,1352,富里,三等
2020-11-01,6080,937,578,1515,富里,三等
2020-11-02,6080,208,166,374,富里,三等
2020-11-03,6080,145,149,294,富里,三等
2020-11-04,6080,153,135,288,富里,三等
2020-11-05,6080,161,150,311,富里,三等
2020-11-06,6080,184,218,402,富里,三等
2020-11-07,6080,142,185,327,富里,三等
2020-11-08,6080,238,167,405,富里,三等
2020-11-09,6080,139,130,269,富里,三等
2020-11-10,6080,111,103,214,富里,三等
2020-11-11,6080,123,129,252,富里,三等
2020-11-12,6080,139,130,269,富里,三等
2020-11-13,6080,172,208,380,富里,三等
2020-11-14,6080,126,141,267,富里,三等
2020-11-15,6080,190,126,316,富里,三等
2020-11-16,6080,132,164,296,富里,三等
2020-11-17,6080,133,115,248,富里,三等
2020-11-18,6080,117,118,235,富里,三等
2020-11-19,6080,160,146,306,富里,三等
2020-11-20,6080,195,212,407,富里,三等
2020-11-21,6080,92,127,219,富里,三等
2020-11-22,6080,268,153,421,富里,三等
2020-11-23,6080,123,137,260,富里,三等
2020-11-24,6080,107,134,241,富里,三等
2020-11-25,6080,142,123,265,富里,三等
2020-11-26,6080,125,133,258,富里,三等
2020-11-27,6080,197,224,421,富里,三等
2020-11-28,6080,127,145,272,富里,三等
2020-11-29,6080,245,122,367,富里,三等
2020-11-30,6080,137,164,301,富里,三等
2020-12-01,6080,117,141,258,富里,三等
2020-12-02,6080,139,125,264,富里,三等
2020-12-03,6080,129,144,273,富里,三等
2020-12-04,6080,170,191,361,富里,三等
2020-12-05,6080,192,219,411,富里,三等
2020-12-06,6080,283,146,429,富里,三等
2020-12-07,6080,130,184,314,富里,三等
2020-12-08,6080,111,130,241,富里,三等
2020-12-09,6080,102,104,206,富里,三等
2020-12-10,6080,128,118,246,富里,三等
2020-12-11,6080,200,241,441,富里,三等
2020-12-12,6080,148,166,314,富里,三等
2020-12-13,6080,247,186,433,富里,三等
2020-12-14,6080,143,145,288,富里,三等
2020-12-15,6080,194,138,332,富里,三等
2020-12-16,6080,130,141,271,富里,三等
2020-12-17,6080,142,154,296,富里,三等
2020-12-18,6080,224,252,476,富里,三等
2020-12-19,6080,138,192,330,富里,三等
2020-12-20,6080,204,199,403,富里,三等
2020-12-21,6080,148,178,326,富里,三等
2020-12-22,6080,164,115,279,富里,三等
2020-12-23,6080,166,132,298,富里,三等
2020-12-24,6080,144,157,301,富里,三等
2020-12-25,6080,167,213,380,富里,三等
2020-12-26,6080,137,190,327,富里,三等
2020-12-27,6080,292,148,440,富里,三等
2020-12-28,6080,152,135,287,富里,三等
2020-12-29,6080,128,138,266,富里,三等
2020-12-30,6080,148,142,290,富里,三等
2020-12-31,6080,191,228,419,富里,三等
2020-01-01,6090,2,1,3,東竹,乙簡
2020-01-02,6090,18,11,29,東竹,乙簡
2020-01-03,6090,14,17,31,東竹,乙簡
2020-01-04,6090,9,9,18,東竹,乙簡
2020-01-05,6090,10,5,15,東竹,乙簡
2020-01-06,6090,13,8,21,東竹,乙簡
2020-01-07,6090,11,14,25,東竹,乙簡
2020-01-08,6090,13,20,33,東竹,乙簡
2020-01-09,6090,11,13,24,東竹,乙簡
2020-01-10,6090,10,19,29,東竹,乙簡
2020-01-11,6090,14,8,22,東竹,乙簡
2020-01-12,6090,7,1,8,東竹,乙簡
2020-01-13,6090,16,17,33,東竹,乙簡
2020-01-14,6090,17,13,30,東竹,乙簡
2020-01-15,6090,17,16,33,東竹,乙簡
2020-01-16,6090,13,14,27,東竹,乙簡
2020-01-17,6090,9,8,17,東竹,乙簡
2020-01-18,6090,11,5,16,東竹,乙簡
2020-01-19,6090,7,9,16,東竹,乙簡
2020-01-20,6090,25,15,40,東竹,乙簡
2020-01-21,6090,11,11,22,東竹,乙簡
2020-01-22,6090,9,7,16,東竹,乙簡
2020-01-23,6090,6,13,19,東竹,乙簡
2020-01-24,6090,5,8,13,東竹,乙簡
2020-01-25,6090,5,16,21,東竹,乙簡
2020-01-26,6090,13,3,16,東竹,乙簡
2020-01-27,6090,14,8,22,東竹,乙簡
2020-01-28,6090,19,13,32,東竹,乙簡
2020-01-29,6090,5,5,10,東竹,乙簡
2020-01-30,6090,9,4,13,東竹,乙簡
2020-01-31,6090,0,3,3,東竹,乙簡
2020-02-01,6090,7,8,15,東竹,乙簡
2020-02-02,6090,4,11,15,東竹,乙簡
2020-02-03,6090,7,5,12,東竹,乙簡
2020-02-04,6090,5,7,12,東竹,乙簡
2020-02-05,6090,12,13,25,東竹,乙簡
2020-02-06,6090,7,4,11,東竹,乙簡
2020-02-07,6090,10,9,19,東竹,乙簡
2020-02-08,6090,5,8,13,東竹,乙簡
2020-02-09,6090,6,4,10,東竹,乙簡
2020-02-10,6090,3,4,7,東竹,乙簡
2020-02-11,6090,7,5,12,東竹,乙簡
2020-02-12,6090,10,8,18,東竹,乙簡
2020-02-13,6090,11,11,22,東竹,乙簡
2020-02-14,6090,10,7,17,東竹,乙簡
2020-02-15,6090,6,7,13,東竹,乙簡
2020-02-16,6090,13,12,25,東竹,乙簡
2020-02-17,6090,4,10,14,東竹,乙簡
2020-02-18,6090,4,10,14,東竹,乙簡
2020-02-19,6090,9,9,18,東竹,乙簡
2020-02-20,6090,5,5,10,東竹,乙簡
2020-02-21,6090,14,10,24,東竹,乙簡
2020-02-22,6090,10,11,21,東竹,乙簡
2020-02-23,6090,3,2,5,東竹,乙簡
2020-02-24,6090,10,7,17,東竹,乙簡
2020-02-25,6090,10,20,30,東竹,乙簡
2020-02-26,6090,12,15,27,東竹,乙簡
2020-02-27,6090,13,24,37,東竹,乙簡
2020-02-28,6090,12,7,19,東竹,乙簡
2020-02-29,6090,16,21,37,東竹,乙簡
2020-03-01,6090,13,8,21,東竹,乙簡
2020-03-02,6090,16,15,31,東竹,乙簡
2020-03-03,6090,14,16,30,東竹,乙簡
2020-03-04,6090,12,11,23,東竹,乙簡
2020-03-05,6090,12,13,25,東竹,乙簡
2020-03-06,6090,15,14,29,東竹,乙簡
2020-03-07,6090,13,14,27,東竹,乙簡
2020-03-08,6090,15,10,25,東竹,乙簡
2020-03-09,6090,14,11,25,東竹,乙簡
2020-03-10,6090,12,8,20,東竹,乙簡
2020-03-11,6090,9,13,22,東竹,乙簡
2020-03-12,6090,8,13,21,東竹,乙簡
2020-03-13,6090,12,20,32,東竹,乙簡
2020-03-14,6090,7,2,9,東竹,乙簡
2020-03-15,6090,18,4,22,東竹,乙簡
2020-03-16,6090,12,15,27,東竹,乙簡
2020-03-17,6090,15,13,28,東竹,乙簡
2020-03-18,6090,12,15,27,東竹,乙簡
2020-03-19,6090,9,7,16,東竹,乙簡
2020-03-20,6090,14,19,33,東竹,乙簡
2020-03-21,6090,2,5,7,東竹,乙簡
2020-03-22,6090,15,6,21,東竹,乙簡
2020-03-23,6090,11,18,29,東竹,乙簡
2020-03-24,6090,14,12,26,東竹,乙簡
2020-03-25,6090,12,20,32,東竹,乙簡
2020-03-26,6090,11,14,25,東竹,乙簡
2020-03-27,6090,15,11,26,東竹,乙簡
2020-03-28,6090,6,12,18,東竹,乙簡
2020-03-29,6090,5,5,10,東竹,乙簡
2020-03-30,6090,15,17,32,東竹,乙簡
2020-03-31,6090,14,14,28,東竹,乙簡
2020-04-01,6090,17,19,36,東竹,乙簡
2020-04-02,6090,3,9,12,東竹,乙簡
2020-04-03,6090,3,7,10,東竹,乙簡
2020-04-04,6090,0,2,2,東竹,乙簡
2020-04-05,6090,9,11,20,東竹,乙簡
2020-04-06,6090,20,15,35,東竹,乙簡
2020-04-07,6090,11,8,19,東竹,乙簡
2020-04-08,6090,12,16,28,東竹,乙簡
2020-04-09,6090,11,13,24,東竹,乙簡
2020-04-10,6090,17,19,36,東竹,乙簡
2020-04-11,6090,7,18,25,東竹,乙簡
2020-04-12,6090,5,4,9,東竹,乙簡
2020-04-13,6090,18,15,33,東竹,乙簡
2020-04-14,6090,14,14,28,東竹,乙簡
2020-04-15,6090,12,16,28,東竹,乙簡
2020-04-16,6090,11,13,24,東竹,乙簡
2020-04-17,6090,11,10,21,東竹,乙簡
2020-04-18,6090,6,14,20,東竹,乙簡
2020-04-19,6090,8,11,19,東竹,乙簡
2020-04-20,6090,12,10,22,東竹,乙簡
2020-04-21,6090,10,13,23,東竹,乙簡
2020-04-22,6090,14,18,32,東竹,乙簡
2020-04-23,6090,15,16,31,東竹,乙簡
2020-04-24,6090,13,15,28,東竹,乙簡
2020-04-25,6090,10,6,16,東竹,乙簡
2020-04-26,6090,10,3,13,東竹,乙簡
2020-04-27,6090,15,13,28,東竹,乙簡
2020-04-28,6090,15,13,28,東竹,乙簡
2020-04-29,6090,13,9,22,東竹,乙簡
2020-04-30,6090,15,20,35,東竹,乙簡
2020-05-01,6090,10,13,23,東竹,乙簡
2020-05-02,6090,11,5,16,東竹,乙簡
2020-05-03,6090,11,4,15,東竹,乙簡
2020-05-04,6090,16,13,29,東竹,乙簡
2020-05-05,6090,17,9,26,東竹,乙簡
2020-05-06,6090,16,17,33,東竹,乙簡
2020-05-07,6090,16,20,36,東竹,乙簡
2020-05-08,6090,19,25,44,東竹,乙簡
2020-05-09,6090,9,14,23,東竹,乙簡
2020-05-10,6090,8,4,12,東竹,乙簡
2020-05-11,6090,12,16,28,東竹,乙簡
2020-05-12,6090,30,25,55,東竹,乙簡
2020-05-13,6090,15,16,31,東竹,乙簡
2020-05-14,6090,18,10,28,東竹,乙簡
2020-05-15,6090,21,14,35,東竹,乙簡
2020-05-16,6090,4,4,8,東竹,乙簡
2020-05-17,6090,9,9,18,東竹,乙簡
2020-05-18,6090,17,17,34,東竹,乙簡
2020-05-19,6090,17,20,37,東竹,乙簡
2020-05-20,6090,15,20,35,東竹,乙簡
2020-05-21,6090,14,13,27,東竹,乙簡
2020-05-22,6090,13,12,25,東竹,乙簡
2020-05-23,6090,3,5,8,東竹,乙簡
2020-05-24,6090,9,11,20,東竹,乙簡
2020-05-25,6090,17,13,30,東竹,乙簡
2020-05-26,6090,10,21,31,東竹,乙簡
2020-05-27,6090,12,14,26,東竹,乙簡
2020-05-28,6090,13,12,25,東竹,乙簡
2020-05-29,6090,14,12,26,東竹,乙簡
2020-05-30,6090,5,13,18,東竹,乙簡
2020-05-31,6090,12,7,19,東竹,乙簡
2020-06-01,6090,17,20,37,東竹,乙簡
2020-06-02,6090,21,26,47,東竹,乙簡
2020-06-03,6090,16,14,30,東竹,乙簡
2020-06-04,6090,21,15,36,東竹,乙簡
2020-06-05,6090,20,18,38,東竹,乙簡
2020-06-06,6090,14,16,30,東竹,乙簡
2020-06-07,6090,13,6,19,東竹,乙簡
2020-06-08,6090,20,16,36,東竹,乙簡
2020-06-09,6090,15,11,26,東竹,乙簡
2020-06-10,6090,15,13,28,東竹,乙簡
2020-06-11,6090,18,20,38,東竹,乙簡
2020-06-12,6090,15,21,36,東竹,乙簡
2020-06-13,6090,8,10,18,東竹,乙簡
2020-06-14,6090,11,4,15,東竹,乙簡
2020-06-15,6090,13,12,25,東竹,乙簡
2020-06-16,6090,17,25,42,東竹,乙簡
2020-06-17,6090,14,14,28,東竹,乙簡
2020-06-18,6090,21,16,37,東竹,乙簡
2020-06-19,6090,17,22,39,東竹,乙簡
2020-06-20,6090,14,17,31,東竹,乙簡
2020-06-21,6090,12,9,21,東竹,乙簡
2020-06-22,6090,17,7,24,東竹,乙簡
2020-06-23,6090,13,16,29,東竹,乙簡
2020-06-24,6090,16,22,38,東竹,乙簡
2020-06-25,6090,7,7,14,東竹,乙簡
2020-06-26,6090,8,3,11,東竹,乙簡
2020-06-27,6090,7,7,14,東竹,乙簡
2020-06-28,6090,15,7,22,東竹,乙簡
2020-06-29,6090,17,14,31,東竹,乙簡
2020-06-30,6090,12,9,21,東竹,乙簡
2020-07-01,6090,9,6,15,東竹,乙簡
2020-07-02,6090,17,11,28,東竹,乙簡
2020-07-03,6090,6,7,13,東竹,乙簡
2020-07-04,6090,12,5,17,東竹,乙簡
2020-07-05,6090,5,10,15,東竹,乙簡
2020-07-06,6090,10,10,20,東竹,乙簡
2020-07-07,6090,18,17,35,東竹,乙簡
2020-07-08,6090,16,17,33,東竹,乙簡
2020-07-09,6090,10,10,20,東竹,乙簡
2020-07-10,6090,16,8,24,東竹,乙簡
2020-07-11,6090,1,2,3,東竹,乙簡
2020-07-12,6090,4,9,13,東竹,乙簡
2020-07-13,6090,10,9,19,東竹,乙簡
2020-07-14,6090,11,13,24,東竹,乙簡
2020-07-15,6090,9,9,18,東竹,乙簡
2020-07-16,6090,9,9,18,東竹,乙簡
2020-07-17,6090,21,12,33,東竹,乙簡
2020-07-18,6090,29,38,67,東竹,乙簡
2020-07-19,6090,15,12,27,東竹,乙簡
2020-07-20,6090,13,14,27,東竹,乙簡
2020-07-21,6090,7,15,22,東竹,乙簡
2020-07-22,6090,8,7,15,東竹,乙簡
2020-07-23,6090,11,7,18,東竹,乙簡
2020-07-24,6090,20,16,36,東竹,乙簡
2020-07-25,6090,19,34,53,東竹,乙簡
2020-07-26,6090,9,17,26,東竹,乙簡
2020-07-27,6090,19,11,30,東竹,乙簡
2020-07-28,6090,9,11,20,東竹,乙簡
2020-07-29,6090,10,15,25,東竹,乙簡
2020-07-30,6090,5,6,11,東竹,乙簡
2020-07-31,6090,13,15,28,東竹,乙簡
2020-08-01,6090,9,11,20,東竹,乙簡
2020-08-02,6090,7,5,12,東竹,乙簡
2020-08-03,6090,12,9,21,東竹,乙簡
2020-08-04,6090,7,10,17,東竹,乙簡
2020-08-05,6090,9,8,17,東竹,乙簡
2020-08-06,6090,9,9,18,東竹,乙簡
2020-08-07,6090,6,11,17,東竹,乙簡
2020-08-08,6090,4,9,13,東竹,乙簡
2020-08-09,6090,9,3,12,東竹,乙簡
2020-08-10,6090,3,12,15,東竹,乙簡
2020-08-11,6090,4,7,11,東竹,乙簡
2020-08-12,6090,5,5,10,東竹,乙簡
2020-08-13,6090,8,8,16,東竹,乙簡
2020-08-14,6090,4,8,12,東竹,乙簡
2020-08-15,6090,6,4,10,東竹,乙簡
2020-08-16,6090,7,3,10,東竹,乙簡
2020-08-17,6090,12,8,20,東竹,乙簡
2020-08-18,6090,7,10,17,東竹,乙簡
2020-08-19,6090,4,6,10,東竹,乙簡
2020-08-20,6090,7,8,15,東竹,乙簡
2020-08-21,6090,3,4,7,東竹,乙簡
2020-08-22,6090,3,5,8,東竹,乙簡
2020-08-23,6090,2,5,7,東竹,乙簡
2020-08-24,6090,9,6,15,東竹,乙簡
2020-08-25,6090,10,4,14,東竹,乙簡
2020-08-26,6090,4,8,12,東竹,乙簡
2020-08-27,6090,5,13,18,東竹,乙簡
2020-08-28,6090,4,11,15,東竹,乙簡
2020-08-29,6090,11,10,21,東竹,乙簡
2020-08-30,6090,5,1,6,東竹,乙簡
2020-08-31,6090,16,14,30,東竹,乙簡
2020-09-01,6090,16,14,30,東竹,乙簡
2020-09-02,6090,19,26,45,東竹,乙簡
2020-09-03,6090,19,14,33,東竹,乙簡
2020-09-04,6090,15,20,35,東竹,乙簡
2020-09-05,6090,9,10,19,東竹,乙簡
2020-09-06,6090,7,1,8,東竹,乙簡
2020-09-07,6090,16,19,35,東竹,乙簡
2020-09-08,6090,17,24,41,東竹,乙簡
2020-09-09,6090,15,16,31,東竹,乙簡
2020-09-10,6090,19,19,38,東竹,乙簡
2020-09-11,6090,17,23,40,東竹,乙簡
2020-09-12,6090,22,23,45,東竹,乙簡
2020-09-13,6090,9,6,15,東竹,乙簡
2020-09-14,6090,14,11,25,東竹,乙簡
2020-09-15,6090,12,21,33,東竹,乙簡
2020-09-16,6090,14,17,31,東竹,乙簡
2020-09-17,6090,16,18,34,東竹,乙簡
2020-09-18,6090,19,22,41,東竹,乙簡
2020-09-19,6090,6,4,10,東竹,乙簡
2020-09-20,6090,15,12,27,東竹,乙簡
2020-09-21,6090,12,18,30,東竹,乙簡
2020-09-22,6090,14,19,33,東竹,乙簡
2020-09-23,6090,16,13,29,東竹,乙簡
2020-09-24,6090,16,14,30,東竹,乙簡
2020-09-25,6090,28,21,49,東竹,乙簡
2020-09-26,6090,12,15,27,東竹,乙簡
2020-09-27,6090,6,5,11,東竹,乙簡
2020-09-28,6090,12,13,25,東竹,乙簡
2020-09-29,6090,14,21,35,東竹,乙簡
2020-09-30,6090,21,26,47,東竹,乙簡
2020-10-01,6090,7,14,21,東竹,乙簡
2020-10-02,6090,9,11,20,東竹,乙簡
2020-10-03,6090,10,10,20,東竹,乙簡
2020-10-04,6090,24,10,34,東竹,乙簡
2020-10-05,6090,16,17,33,東竹,乙簡
2020-10-06,6090,14,12,26,東竹,乙簡
2020-10-07,6090,15,14,29,東竹,乙簡
2020-10-08,6090,11,22,33,東竹,乙簡
2020-10-09,6090,3,6,9,東竹,乙簡
2020-10-10,6090,11,16,27,東竹,乙簡
2020-10-11,6090,15,5,20,東竹,乙簡
2020-10-12,6090,14,16,30,東竹,乙簡
2020-10-13,6090,18,11,29,東竹,乙簡
2020-10-14,6090,11,14,25,東竹,乙簡
2020-10-15,6090,9,11,20,東竹,乙簡
2020-10-16,6090,13,14,27,東竹,乙簡
2020-10-17,6090,8,12,20,東竹,乙簡
2020-10-18,6090,9,3,12,東竹,乙簡
2020-10-19,6090,13,8,21,東竹,乙簡
2020-10-20,6090,17,16,33,東竹,乙簡
2020-10-21,6090,10,11,21,東竹,乙簡
2020-10-22,6090,14,13,27,東竹,乙簡
2020-10-23,6090,12,15,27,東竹,乙簡
2020-10-24,6090,11,12,23,東竹,乙簡
2020-10-25,6090,9,6,15,東竹,乙簡
2020-10-26,6090,13,17,30,東竹,乙簡
2020-10-27,6090,13,16,29,東竹,乙簡
2020-10-28,6090,18,16,34,東竹,乙簡
2020-10-29,6090,16,13,29,東竹,乙簡
2020-10-30,6090,20,45,65,東竹,乙簡
2020-10-31,6090,5,15,20,東竹,乙簡
2020-11-01,6090,9,12,21,東竹,乙簡
2020-11-02,6090,14,16,30,東竹,乙簡
2020-11-03,6090,14,19,33,東竹,乙簡
2020-11-04,6090,17,17,34,東竹,乙簡
2020-11-05,6090,13,13,26,東竹,乙簡
2020-11-06,6090,9,15,24,東竹,乙簡
2020-11-07,6090,10,11,21,東竹,乙簡
2020-11-08,6090,8,6,14,東竹,乙簡
2020-11-09,6090,8,11,19,東竹,乙簡
2020-11-10,6090,17,16,33,東竹,乙簡
2020-11-11,6090,16,24,40,東竹,乙簡
2020-11-12,6090,13,27,40,東竹,乙簡
2020-11-13,6090,14,18,32,東竹,乙簡
2020-11-14,6090,8,10,18,東竹,乙簡
2020-11-15,6090,11,13,24,東竹,乙簡
2020-11-16,6090,15,14,29,東竹,乙簡
2020-11-17,6090,10,19,29,東竹,乙簡
2020-11-18,6090,17,18,35,東竹,乙簡
2020-11-19,6090,20,11,31,東竹,乙簡
2020-11-20,6090,12,20,32,東竹,乙簡
2020-11-21,6090,3,7,10,東竹,乙簡
2020-11-22,6090,13,2,15,東竹,乙簡
2020-11-23,6090,11,12,23,東竹,乙簡
2020-11-24,6090,14,18,32,東竹,乙簡
2020-11-25,6090,17,20,37,東竹,乙簡
2020-11-26,6090,11,12,23,東竹,乙簡
2020-11-27,6090,14,18,32,東竹,乙簡
2020-11-28,6090,5,15,20,東竹,乙簡
2020-11-29,6090,13,5,18,東竹,乙簡
2020-11-30,6090,15,16,31,東竹,乙簡
2020-12-01,6090,13,22,35,東竹,乙簡
2020-12-02,6090,14,19,33,東竹,乙簡
2020-12-03,6090,14,12,26,東竹,乙簡
2020-12-04,6090,10,17,27,東竹,乙簡
2020-12-05,6090,10,16,26,東竹,乙簡
2020-12-06,6090,11,8,19,東竹,乙簡
2020-12-07,6090,13,13,26,東竹,乙簡
2020-12-08,6090,13,17,30,東竹,乙簡
2020-12-09,6090,15,14,29,東竹,乙簡
2020-12-10,6090,11,20,31,東竹,乙簡
2020-12-11,6090,9,26,35,東竹,乙簡
2020-12-12,6090,7,15,22,東竹,乙簡
2020-12-13,6090,13,4,17,東竹,乙簡
2020-12-14,6090,20,15,35,東竹,乙簡
2020-12-15,6090,20,27,47,東竹,乙簡
2020-12-16,6090,13,28,41,東竹,乙簡
2020-12-17,6090,13,14,27,東竹,乙簡
2020-12-18,6090,16,20,36,東竹,乙簡
2020-12-19,6090,19,24,43,東竹,乙簡
2020-12-20,6090,18,3,21,東竹,乙簡
2020-12-21,6090,13,19,32,東竹,乙簡
2020-12-22,6090,13,16,29,東竹,乙簡
2020-12-23,6090,11,12,23,東竹,乙簡
2020-12-24,6090,14,10,24,東竹,乙簡
2020-12-25,6090,17,17,34,東竹,乙簡
2020-12-26,6090,8,6,14,東竹,乙簡
2020-12-27,6090,5,11,16,東竹,乙簡
2020-12-28,6090,11,19,30,東竹,乙簡
2020-12-29,6090,12,15,27,東竹,乙簡
2020-12-30,6090,8,13,21,東竹,乙簡
2020-12-31,6090,10,11,21,東竹,乙簡
2020-01-01,6100,14,5,19,東里,三等
2020-01-02,6100,10,10,20,東里,三等
2020-01-03,6100,14,10,24,東里,三等
2020-01-04,6100,14,12,26,東里,三等
2020-01-05,6100,6,5,11,東里,三等
2020-01-06,6100,5,6,11,東里,三等
2020-01-07,6100,16,9,25,東里,三等
2020-01-08,6100,17,11,28,東里,三等
2020-01-09,6100,15,13,28,東里,三等
2020-01-10,6100,19,12,31,東里,三等
2020-01-11,6100,11,11,22,東里,三等
2020-01-12,6100,8,7,15,東里,三等
2020-01-13,6100,16,16,32,東里,三等
2020-01-14,6100,17,9,26,東里,三等
2020-01-15,6100,19,15,34,東里,三等
2020-01-16,6100,28,5,33,東里,三等
2020-01-17,6100,20,17,37,東里,三等
2020-01-18,6100,15,13,28,東里,三等
2020-01-19,6100,8,12,20,東里,三等
2020-01-20,6100,17,7,24,東里,三等
2020-01-21,6100,6,7,13,東里,三等
2020-01-22,6100,13,12,25,東里,三等
2020-01-23,6100,7,25,32,東里,三等
2020-01-24,6100,8,20,28,東里,三等
2020-01-25,6100,24,24,48,東里,三等
2020-01-26,6100,9,14,23,東里,三等
2020-01-27,6100,17,14,31,東里,三等
2020-01-28,6100,24,9,33,東里,三等
2020-01-29,6100,15,12,27,東里,三等
2020-01-30,6100,10,8,18,東里,三等
2020-01-31,6100,19,4,23,東里,三等
2020-02-01,6100,8,8,16,東里,三等
2020-02-02,6100,10,5,15,東里,三等
2020-02-03,6100,13,9,22,東里,三等
2020-02-04,6100,13,12,25,東里,三等
2020-02-05,6100,18,8,26,東里,三等
2020-02-06,6100,12,8,20,東里,三等
2020-02-07,6100,5,6,11,東里,三等
2020-02-08,6100,16,4,20,東里,三等
2020-02-09,6100,6,2,8,東里,三等
2020-02-10,6100,6,15,21,東里,三等
2020-02-11,6100,6,6,12,東里,三等
2020-02-12,6100,8,4,12,東里,三等
2020-02-13,6100,4,13,17,東里,三等
2020-02-14,6100,5,7,12,東里,三等
2020-02-15,6100,6,6,12,東里,三等
2020-02-16,6100,10,8,18,東里,三等
2020-02-17,6100,8,6,14,東里,三等
2020-02-18,6100,6,16,22,東里,三等
2020-02-19,6100,6,7,13,東里,三等
2020-02-20,6100,10,7,17,東里,三等
2020-02-21,6100,8,9,17,東里,三等
2020-02-22,6100,8,8,16,東里,三等
2020-02-23,6100,11,5,16,東里,三等
2020-02-24,6100,10,11,21,東里,三等
2020-02-25,6100,12,15,27,東里,三等
2020-02-26,6100,25,13,38,東里,三等
2020-02-27,6100,15,11,26,東里,三等
2020-02-28,6100,11,16,27,東里,三等
2020-02-29,6100,32,6,38,東里,三等
2020-03-01,6100,14,6,20,東里,三等
2020-03-02,6100,16,17,33,東里,三等
2020-03-03,6100,14,12,26,東里,三等
2020-03-04,6100,20,6,26,東里,三等
2020-03-05,6100,12,7,19,東里,三等
2020-03-06,6100,14,8,22,東里,三等
2020-03-07,6100,12,11,23,東里,三等
2020-03-08,6100,6,3,9,東里,三等
2020-03-09,6100,15,11,26,東里,三等
2020-03-10,6100,20,11,31,東里,三等
2020-03-11,6100,21,13,34,東里,三等
2020-03-12,6100,15,11,26,東里,三等
2020-03-13,6100,24,14,38,東里,三等
2020-03-14,6100,4,6,10,東里,三等
2020-03-15,6100,4,4,8,東里,三等
2020-03-16,6100,18,12,30,東里,三等
2020-03-17,6100,13,13,26,東里,三等
2020-03-18,6100,17,16,33,東里,三等
2020-03-19,6100,19,14,33,東里,三等
2020-03-20,6100,21,11,32,東里,三等
2020-03-21,6100,4,6,10,東里,三等
2020-03-22,6100,10,6,16,東里,三等
2020-03-23,6100,21,13,34,東里,三等
2020-03-24,6100,12,12,24,東里,三等
2020-03-25,6100,12,15,27,東里,三等
2020-03-26,6100,34,11,45,東里,三等
2020-03-27,6100,20,8,28,東里,三等
2020-03-28,6100,14,8,22,東里,三等
2020-03-29,6100,10,9,19,東里,三等
2020-03-30,6100,32,15,47,東里,三等
2020-03-31,6100,21,15,36,東里,三等
2020-04-01,6100,24,18,42,東里,三等
2020-04-02,6100,17,19,36,東里,三等
2020-04-03,6100,10,10,20,東里,三等
2020-04-04,6100,10,16,26,東里,三等
2020-04-05,6100,18,13,31,東里,三等
2020-04-06,6100,17,14,31,東里,三等
2020-04-07,6100,17,16,33,東里,三等
2020-04-08,6100,16,10,26,東里,三等
2020-04-09,6100,18,10,28,東里,三等
2020-04-10,6100,9,12,21,東里,三等
2020-04-11,6100,8,6,14,東里,三等
2020-04-12,6100,10,8,18,東里,三等
2020-04-13,6100,8,9,17,東里,三等
2020-04-14,6100,12,8,20,東里,三等
2020-04-15,6100,16,14,30,東里,三等
2020-04-16,6100,15,17,32,東里,三等
2020-04-17,6100,17,12,29,東里,三等
2020-04-18,6100,16,15,31,東里,三等
2020-04-19,6100,17,13,30,東里,三等
2020-04-20,6100,23,16,39,東里,三等
2020-04-21,6100,14,12,26,東里,三等
2020-04-22,6100,13,15,28,東里,三等
2020-04-23,6100,16,16,32,東里,三等
2020-04-24,6100,14,6,20,東里,三等
2020-04-25,6100,22,22,44,東里,三等
2020-04-26,6100,10,8,18,東里,三等
2020-04-27,6100,16,11,27,東里,三等
2020-04-28,6100,17,12,29,東里,三等
2020-04-29,6100,19,22,41,東里,三等
2020-04-30,6100,12,14,26,東里,三等
2020-05-01,6100,13,15,28,東里,三等
2020-05-02,6100,18,22,40,東里,三等
2020-05-03,6100,7,11,18,東里,三等
2020-05-04,6100,14,14,28,東里,三等
2020-05-05,6100,17,16,33,東里,三等
2020-05-06,6100,12,17,29,東里,三等
2020-05-07,6100,16,13,29,東里,三等
2020-05-08,6100,12,15,27,東里,三等
2020-05-09,6100,16,13,29,東里,三等
2020-05-10,6100,1,6,7,東里,三等
2020-05-11,6100,15,13,28,東里,三等
2020-05-12,6100,20,15,35,東里,三等
2020-05-13,6100,14,16,30,東里,三等
2020-05-14,6100,11,12,23,東里,三等
2020-05-15,6100,12,8,20,東里,三等
2020-05-16,6100,6,7,13,東里,三等
2020-05-17,6100,6,4,10,東里,三等
2020-05-18,6100,20,22,42,東里,三等
2020-05-19,6100,10,8,18,東里,三等
2020-05-20,6100,14,7,21,東里,三等
2020-05-21,6100,14,10,24,東里,三等
2020-05-22,6100,10,7,17,東里,三等
2020-05-23,6100,13,6,19,東里,三等
2020-05-24,6100,8,4,12,東里,三等
2020-05-25,6100,16,18,34,東里,三等
2020-05-26,6100,16,13,29,東里,三等
2020-05-27,6100,16,15,31,東里,三等
2020-05-28,6100,18,17,35,東里,三等
2020-05-29,6100,13,8,21,東里,三等
2020-05-30,6100,23,14,37,東里,三等
2020-05-31,6100,9,7,16,東里,三等
2020-06-01,6100,13,9,22,東里,三等
2020-06-02,6100,17,18,35,東里,三等
2020-06-03,6100,18,20,38,東里,三等
2020-06-04,6100,11,12,23,東里,三等
2020-06-05,6100,14,12,26,東里,三等
2020-06-06,6100,16,7,23,東里,三等
2020-06-07,6100,8,7,15,東里,三等
2020-06-08,6100,14,11,25,東里,三等
2020-06-09,6100,11,9,20,東里,三等
2020-06-10,6100,20,14,34,東里,三等
2020-06-11,6100,20,14,34,東里,三等
2020-06-12,6100,24,19,43,東里,三等
2020-06-13,6100,12,12,24,東里,三等
2020-06-14,6100,17,10,27,東里,三等
2020-06-15,6100,21,7,28,東里,三等
2020-06-16,6100,20,17,37,東里,三等
2020-06-17,6100,18,6,24,東里,三等
2020-06-18,6100,18,19,37,東里,三等
2020-06-19,6100,21,10,31,東里,三等
2020-06-20,6100,16,13,29,東里,三等
2020-06-21,6100,18,17,35,東里,三等
2020-06-22,6100,12,19,31,東里,三等
2020-06-23,6100,20,10,30,東里,三等
2020-06-24,6100,18,13,31,東里,三等
2020-06-25,6100,7,18,25,東里,三等
2020-06-26,6100,14,11,25,東里,三等
2020-06-27,6100,18,9,27,東里,三等
2020-06-28,6100,12,4,16,東里,三等
2020-06-29,6100,13,14,27,東里,三等
2020-06-30,6100,21,14,35,東里,三等
2020-07-01,6100,22,23,45,東里,三等
2020-07-02,6100,18,12,30,東里,三等
2020-07-03,6100,25,13,38,東里,三等
2020-07-04,6100,6,10,16,東里,三等
2020-07-05,6100,5,13,18,東里,三等
2020-07-06,6100,25,17,42,東里,三等
2020-07-07,6100,19,20,39,東里,三等
2020-07-08,6100,51,17,68,東里,三等
2020-07-09,6100,13,16,29,東里,三等
2020-07-10,6100,17,13,30,東里,三等
2020-07-11,6100,11,5,16,東里,三等
2020-07-12,6100,4,6,10,東里,三等
2020-07-13,6100,12,11,23,東里,三等
2020-07-14,6100,25,12,37,東里,三等
2020-07-15,6100,12,8,20,東里,三等
2020-07-16,6100,17,15,32,東里,三等
2020-07-17,6100,36,15,51,東里,三等
2020-07-18,6100,13,15,28,東里,三等
2020-07-19,6100,9,16,25,東里,三等
2020-07-20,6100,18,18,36,東里,三等
2020-07-21,6100,12,11,23,東里,三等
2020-07-22,6100,7,8,15,東里,三等
2020-07-23,6100,14,16,30,東里,三等
2020-07-24,6100,10,6,16,東里,三等
2020-07-25,6100,45,10,55,東里,三等
2020-07-26,6100,9,10,19,東里,三等
2020-07-27,6100,28,10,38,東里,三等
2020-07-28,6100,12,7,19,東里,三等
2020-07-29,6100,18,14,32,東里,三等
2020-07-30,6100,12,6,18,東里,三等
2020-07-31,6100,18,9,27,東里,三等
2020-08-01,6100,18,22,40,東里,三等
2020-08-02,6100,22,4,26,東里,三等
2020-08-03,6100,21,18,39,東里,三等
2020-08-04,6100,11,10,21,東里,三等
2020-08-05,6100,11,12,23,東里,三等
2020-08-06,6100,8,14,22,東里,三等
2020-08-07,6100,18,15,33,東里,三等
2020-08-08,6100,6,6,12,東里,三等
2020-08-09,6100,8,14,22,東里,三等
2020-08-10,6100,23,19,42,東里,三等
2020-08-11,6100,10,9,19,東里,三等
2020-08-12,6100,12,13,25,東里,三等
2020-08-13,6100,10,9,19,東里,三等
2020-08-14,6100,11,15,26,東里,三等
2020-08-15,6100,11,16,27,東里,三等
2020-08-16,6100,58,13,71,東里,三等
2020-08-17,6100,19,13,32,東里,三等
2020-08-18,6100,19,10,29,東里,三等
2020-08-19,6100,12,9,21,東里,三等
2020-08-20,6100,7,8,15,東里,三等
2020-08-21,6100,199,13,212,東里,三等
2020-08-22,6100,6,9,15,東里,三等
2020-08-23,6100,12,9,21,東里,三等
2020-08-24,6100,15,26,41,東里,三等
2020-08-25,6100,23,14,37,東里,三等
2020-08-26,6100,12,12,24,東里,三等
2020-08-27,6100,19,10,29,東里,三等
2020-08-28,6100,15,11,26,東里,三等
2020-08-29,6100,31,7,38,東里,三等
2020-08-30,6100,9,5,14,東里,三等
2020-08-31,6100,15,17,32,東里,三等
2020-09-01,6100,20,18,38,東里,三等
2020-09-02,6100,17,21,38,東里,三等
2020-09-03,6100,18,20,38,東里,三等
2020-09-04,6100,16,19,35,東里,三等
2020-09-05,6100,10,13,23,東里,三等
2020-09-06,6100,18,14,32,東里,三等
2020-09-07,6100,14,11,25,東里,三等
2020-09-08,6100,13,19,32,東里,三等
2020-09-09,6100,19,17,36,東里,三等
2020-09-10,6100,11,14,25,東里,三等
2020-09-11,6100,14,17,31,東里,三等
2020-09-12,6100,17,16,33,東里,三等
2020-09-13,6100,11,9,20,東里,三等
2020-09-14,6100,20,17,37,東里,三等
2020-09-15,6100,18,21,39,東里,三等
2020-09-16,6100,9,10,19,東里,三等
2020-09-17,6100,10,11,21,東里,三等
2020-09-18,6100,37,13,50,東里,三等
2020-09-19,6100,5,25,30,東里,三等
2020-09-20,6100,12,11,23,東里,三等
2020-09-21,6100,12,13,25,東里,三等
2020-09-22,6100,19,13,32,東里,三等
2020-09-23,6100,17,22,39,東里,三等
2020-09-24,6100,10,13,23,東里,三等
2020-09-25,6100,21,16,37,東里,三等
2020-09-26,6100,9,13,22,東里,三等
2020-09-27,6100,28,32,60,東里,三等
2020-09-28,6100,14,20,34,東里,三等
2020-09-29,6100,23,15,38,東里,三等
2020-09-30,6100,15,25,40,東里,三等
2020-10-01,6100,10,22,32,東里,三等
2020-10-02,6100,16,23,39,東里,三等
2020-10-03,6100,26,5,31,東里,三等
2020-10-04,6100,8,6,14,東里,三等
2020-10-05,6100,27,17,44,東里,三等
2020-10-06,6100,31,12,43,東里,三等
2020-10-07,6100,15,15,30,東里,三等
2020-10-08,6100,13,19,32,東里,三等
2020-10-09,6100,8,13,21,東里,三等
2020-10-10,6100,7,4,11,東里,三等
2020-10-11,6100,15,9,24,東里,三等
2020-10-12,6100,12,12,24,東里,三等
2020-10-13,6100,10,8,18,東里,三等
2020-10-14,6100,10,8,18,東里,三等
2020-10-15,6100,13,14,27,東里,三等
2020-10-16,6100,14,12,26,東里,三等
2020-10-17,6100,25,19,44,東里,三等
2020-10-18,6100,12,9,21,東里,三等
2020-10-19,6100,13,9,22,東里,三等
2020-10-20,6100,16,14,30,東里,三等
2020-10-21,6100,6,11,17,東里,三等
2020-10-22,6100,11,14,25,東里,三等
2020-10-23,6100,13,17,30,東里,三等
2020-10-24,6100,10,13,23,東里,三等
2020-10-25,6100,30,10,40,東里,三等
2020-10-26,6100,17,13,30,東里,三等
2020-10-27,6100,25,14,39,東里,三等
2020-10-28,6100,9,10,19,東里,三等
2020-10-29,6100,12,16,28,東里,三等
2020-10-30,6100,11,19,30,東里,三等
2020-10-31,6100,51,61,112,東里,三等
2020-11-01,6100,18,13,31,東里,三等
2020-11-02,6100,18,18,36,東里,三等
2020-11-03,6100,17,15,32,東里,三等
2020-11-04,6100,11,9,20,東里,三等
2020-11-05,6100,12,10,22,東里,三等
2020-11-06,6100,11,13,24,東里,三等
2020-11-07,6100,14,11,25,東里,三等
2020-11-08,6100,14,13,27,東里,三等
2020-11-09,6100,10,11,21,東里,三等
2020-11-10,6100,16,10,26,東里,三等
2020-11-11,6100,9,18,27,東里,三等
2020-11-12,6100,14,14,28,東里,三等
2020-11-13,6100,10,15,25,東里,三等
2020-11-14,6100,13,16,29,東里,三等
2020-11-15,6100,14,17,31,東里,三等
2020-11-16,6100,19,22,41,東里,三等
2020-11-17,6100,22,11,33,東里,三等
2020-11-18,6100,14,20,34,東里,三等
2020-11-19,6100,15,13,28,東里,三等
2020-11-20,6100,16,13,29,東里,三等
2020-11-21,6100,8,9,17,東里,三等
2020-11-22,6100,5,10,15,東里,三等
2020-11-23,6100,24,15,39,東里,三等
2020-11-24,6100,11,9,20,東里,三等
2020-11-25,6100,11,11,22,東里,三等
2020-11-26,6100,11,13,24,東里,三等
2020-11-27,6100,13,17,30,東里,三等
2020-11-28,6100,12,16,28,東里,三等
2020-11-29,6100,6,11,17,東里,三等
2020-11-30,6100,18,11,29,東里,三等
2020-12-01,6100,14,14,28,東里,三等
2020-12-02,6100,16,16,32,東里,三等
2020-12-03,6100,16,6,22,東里,三等
2020-12-04,6100,27,12,39,東里,三等
2020-12-05,6100,33,6,39,東里,三等
2020-12-06,6100,15,9,24,東里,三等
2020-12-07,6100,10,13,23,東里,三等
2020-12-08,6100,10,12,22,東里,三等
2020-12-09,6100,13,13,26,東里,三等
2020-12-10,6100,10,10,20,東里,三等
2020-12-11,6100,13,23,36,東里,三等
2020-12-12,6100,6,4,10,東里,三等
2020-12-13,6100,8,6,14,東里,三等
2020-12-14,6100,15,10,25,東里,三等
2020-12-15,6100,14,13,27,東里,三等
2020-12-16,6100,19,24,43,東里,三等
2020-12-17,6100,11,19,30,東里,三等
2020-12-18,6100,15,8,23,東里,三等
2020-12-19,6100,15,16,31,東里,三等
2020-12-20,6100,8,3,11,東里,三等
2020-12-21,6100,11,10,21,東里,三等
2020-12-22,6100,11,12,23,東里,三等
2020-12-23,6100,9,15,24,東里,三等
2020-12-24,6100,12,12,24,東里,三等
2020-12-25,6100,14,12,26,東里,三等
2020-12-26,6100,11,42,53,東里,三等
2020-12-27,6100,6,6,12,東里,三等
2020-12-28,6100,14,13,27,東里,三等
2020-12-29,6100,13,13,26,東里,三等
2020-12-30,6100,20,12,32,東里,三等
2020-12-31,6100,19,21,40,東里,三等
2020-01-01,6110,996,1141,2137,玉里,一等
2020-01-02,6110,1041,965,2006,玉里,一等
2020-01-03,6110,1356,1298,2654,玉里,一等
2020-01-04,6110,999,1187,2186,玉里,一等
2020-01-05,6110,1472,1272,2744,玉里,一等
2020-01-06,6110,1050,1048,2098,玉里,一等
2020-01-07,6110,1099,1000,2099,玉里,一等
2020-01-08,6110,1052,1012,2064,玉里,一等
2020-01-09,6110,1032,1157,2189,玉里,一等
2020-01-10,6110,1516,2194,3710,玉里,一等
2020-01-11,6110,1789,1839,3628,玉里,一等
2020-01-12,6110,1990,1356,3346,玉里,一等
2020-01-13,6110,1239,1331,2570,玉里,一等
2020-01-14,6110,1106,1024,2130,玉里,一等
2020-01-15,6110,1042,1090,2132,玉里,一等
2020-01-16,6110,1123,1227,2350,玉里,一等
2020-01-17,6110,1469,1531,3000,玉里,一等
2020-01-18,6110,1324,1628,2952,玉里,一等
2020-01-19,6110,1450,1420,2870,玉里,一等
2020-01-20,6110,1307,1518,2825,玉里,一等
2020-01-21,6110,1416,1766,3182,玉里,一等
2020-01-22,6110,1477,2241,3718,玉里,一等
2020-01-23,6110,1085,2719,3804,玉里,一等
2020-01-24,6110,893,2730,3623,玉里,一等
2020-01-25,6110,1765,2338,4103,玉里,一等
2020-01-26,6110,2665,2397,5062,玉里,一等
2020-01-27,6110,2940,2022,4962,玉里,一等
2020-01-28,6110,3214,1424,4638,玉里,一等
2020-01-29,6110,2776,1383,4159,玉里,一等
2020-01-30,6110,1921,1238,3159,玉里,一等
2020-01-31,6110,1727,1257,2984,玉里,一等
2020-02-01,6110,1339,1028,2367,玉里,一等
2020-02-02,6110,1386,1158,2544,玉里,一等
2020-02-03,6110,1289,1240,2529,玉里,一等
2020-02-04,6110,1123,1030,2153,玉里,一等
2020-02-05,6110,1231,981,2212,玉里,一等
2020-02-06,6110,1202,1108,2310,玉里,一等
2020-02-07,6110,1486,1349,2835,玉里,一等
2020-02-08,6110,1087,1054,2141,玉里,一等
2020-02-09,6110,1299,1113,2412,玉里,一等
2020-02-10,6110,1137,1101,2238,玉里,一等
2020-02-11,6110,980,968,1948,玉里,一等
2020-02-12,6110,1054,1001,2055,玉里,一等
2020-02-13,6110,1071,984,2055,玉里,一等
2020-02-14,6110,1236,1174,2410,玉里,一等
2020-02-15,6110,1061,1077,2138,玉里,一等
2020-02-16,6110,1083,989,2072,玉里,一等
2020-02-17,6110,1027,1055,2082,玉里,一等
2020-02-18,6110,1000,1025,2025,玉里,一等
2020-02-19,6110,1073,960,2033,玉里,一等
2020-02-20,6110,1000,917,1917,玉里,一等
2020-02-21,6110,1324,1507,2831,玉里,一等
2020-02-22,6110,1020,1057,2077,玉里,一等
2020-02-23,6110,1253,1066,2319,玉里,一等
2020-02-24,6110,1120,911,2031,玉里,一等
2020-02-25,6110,1028,884,1912,玉里,一等
2020-02-26,6110,907,936,1843,玉里,一等
2020-02-27,6110,1404,1665,3069,玉里,一等
2020-02-28,6110,1037,1574,2611,玉里,一等
2020-02-29,6110,1153,929,2082,玉里,一等
2020-03-01,6110,2322,1247,3569,玉里,一等
2020-03-02,6110,1084,867,1951,玉里,一等
2020-03-03,6110,838,840,1678,玉里,一等
2020-03-04,6110,839,808,1647,玉里,一等
2020-03-05,6110,868,832,1700,玉里,一等
2020-03-06,6110,1104,1454,2558,玉里,一等
2020-03-07,6110,917,1153,2070,玉里,一等
2020-03-08,6110,1578,1000,2578,玉里,一等
2020-03-09,6110,968,938,1906,玉里,一等
2020-03-10,6110,841,1089,1930,玉里,一等
2020-03-11,6110,819,841,1660,玉里,一等
2020-03-12,6110,859,818,1677,玉里,一等
2020-03-13,6110,1421,1537,2958,玉里,一等
2020-03-14,6110,932,1145,2077,玉里,一等
2020-03-15,6110,1540,1010,2550,玉里,一等
2020-03-16,6110,907,874,1781,玉里,一等
2020-03-17,6110,1076,841,1917,玉里,一等
2020-03-18,6110,874,981,1855,玉里,一等
2020-03-19,6110,761,890,1651,玉里,一等
2020-03-20,6110,1207,1583,2790,玉里,一等
2020-03-21,6110,1095,1023,2118,玉里,一等
2020-03-22,6110,1596,1067,2663,玉里,一等
2020-03-23,6110,912,875,1787,玉里,一等
2020-03-24,6110,806,781,1587,玉里,一等
2020-03-25,6110,1022,794,1816,玉里,一等
2020-03-26,6110,897,896,1793,玉里,一等
2020-03-27,6110,1056,1650,2706,玉里,一等
2020-03-28,6110,816,997,1813,玉里,一等
2020-03-29,6110,1370,914,2284,玉里,一等
2020-03-30,6110,917,870,1787,玉里,一等
2020-03-31,6110,756,929,1685,玉里,一等
2020-04-01,6110,1218,2054,3272,玉里,一等
2020-04-02,6110,846,2442,3288,玉里,一等
2020-04-03,6110,1003,1766,2769,玉里,一等
2020-04-04,6110,1795,852,2647,玉里,一等
2020-04-05,6110,2812,924,3736,玉里,一等
2020-04-06,6110,1512,795,2307,玉里,一等
2020-04-07,6110,859,668,1527,玉里,一等
2020-04-08,6110,762,714,1476,玉里,一等
2020-04-09,6110,773,698,1471,玉里,一等
2020-04-10,6110,976,1181,2157,玉里,一等
2020-04-11,6110,618,817,1435,玉里,一等
2020-04-12,6110,1222,801,2023,玉里,一等
2020-04-13,6110,871,730,1601,玉里,一等
2020-04-14,6110,667,727,1394,玉里,一等
2020-04-15,6110,734,662,1396,玉里,一等
2020-04-16,6110,729,685,1414,玉里,一等
2020-04-17,6110,993,1240,2233,玉里,一等
2020-04-18,6110,703,821,1524,玉里,一等
2020-04-19,6110,1211,827,2038,玉里,一等
2020-04-20,6110,914,814,1728,玉里,一等
2020-04-21,6110,754,730,1484,玉里,一等
2020-04-22,6110,768,711,1479,玉里,一等
2020-04-23,6110,710,746,1456,玉里,一等
2020-04-24,6110,932,1183,2115,玉里,一等
2020-04-25,6110,747,778,1525,玉里,一等
2020-04-26,6110,1073,737,1810,玉里,一等
2020-04-27,6110,744,753,1497,玉里,一等
2020-04-28,6110,679,708,1387,玉里,一等
2020-04-29,6110,781,732,1513,玉里,一等
2020-04-30,6110,886,974,1860,玉里,一等
2020-05-01,6110,957,1645,2602,玉里,一等
2020-05-02,6110,788,810,1598,玉里,一等
2020-05-03,6110,1710,915,2625,玉里,一等
2020-05-04,6110,888,793,1681,玉里,一等
2020-05-05,6110,896,712,1608,玉里,一等
2020-05-06,6110,731,762,1493,玉里,一等
2020-05-07,6110,806,861,1667,玉里,一等
2020-05-08,6110,1218,1672,2890,玉里,一等
2020-05-09,6110,819,1158,1977,玉里,一等
2020-05-10,6110,1758,1026,2784,玉里,一等
2020-05-11,6110,1032,911,1943,玉里,一等
2020-05-12,6110,827,841,1668,玉里,一等
2020-05-13,6110,847,815,1662,玉里,一等
2020-05-14,6110,770,825,1595,玉里,一等
2020-05-15,6110,1282,1436,2718,玉里,一等
2020-05-16,6110,829,959,1788,玉里,一等
2020-05-17,6110,1281,920,2201,玉里,一等
2020-05-18,6110,987,875,1862,玉里,一等
2020-05-19,6110,753,765,1518,玉里,一等
2020-05-20,6110,766,669,1435,玉里,一等
2020-05-21,6110,804,883,1687,玉里,一等
2020-05-22,6110,1068,1330,2398,玉里,一等
2020-05-23,6110,795,906,1701,玉里,一等
2020-05-24,6110,1347,987,2334,玉里,一等
2020-05-25,6110,972,899,1871,玉里,一等
2020-05-26,6110,905,838,1743,玉里,一等
2020-05-27,6110,846,826,1672,玉里,一等
2020-05-28,6110,843,870,1713,玉里,一等
2020-05-29,6110,1161,1325,2486,玉里,一等
2020-05-30,6110,964,1132,2096,玉里,一等
2020-05-31,6110,1464,1059,2523,玉里,一等
2020-06-01,6110,946,923,1869,玉里,一等
2020-06-02,6110,819,843,1662,玉里,一等
2020-06-03,6110,823,771,1594,玉里,一等
2020-06-04,6110,841,919,1760,玉里,一等
2020-06-05,6110,1243,1473,2716,玉里,一等
2020-06-06,6110,968,1090,2058,玉里,一等
2020-06-07,6110,1475,1128,2603,玉里,一等
2020-06-08,6110,1050,998,2048,玉里,一等
2020-06-09,6110,974,925,1899,玉里,一等
2020-06-10,6110,930,983,1913,玉里,一等
2020-06-11,6110,1001,955,1956,玉里,一等
2020-06-12,6110,1471,1458,2929,玉里,一等
2020-06-13,6110,1039,1108,2147,玉里,一等
2020-06-14,6110,1465,1238,2703,玉里,一等
2020-06-15,6110,1021,1114,2135,玉里,一等
2020-06-16,6110,922,924,1846,玉里,一等
2020-06-17,6110,947,972,1919,玉里,一等
2020-06-18,6110,1065,974,2039,玉里,一等
2020-06-19,6110,1165,1334,2499,玉里,一等
2020-06-20,6110,1191,1326,2517,玉里,一等
2020-06-21,6110,1705,1446,3151,玉里,一等
2020-06-22,6110,1226,1115,2341,玉里,一等
2020-06-23,6110,1036,1146,2182,玉里,一等
2020-06-24,6110,1532,2025,3557,玉里,一等
2020-06-25,6110,1052,2175,3227,玉里,一等
2020-06-26,6110,1306,1513,2819,玉里,一等
2020-06-27,6110,1739,1103,2842,玉里,一等
2020-06-28,6110,2560,1510,4070,玉里,一等
2020-06-29,6110,1518,1144,2662,玉里,一等
2020-06-30,6110,1079,1036,2115,玉里,一等
2020-07-01,6110,941,860,1801,玉里,一等
2020-07-02,6110,972,1039,2011,玉里,一等
2020-07-03,6110,1311,1324,2635,玉里,一等
2020-07-04,6110,979,1106,2085,玉里,一等
2020-07-05,6110,1254,1084,2338,玉里,一等
2020-07-06,6110,1072,1133,2205,玉里,一等
2020-07-07,6110,1033,1046,2079,玉里,一等
2020-07-08,6110,1013,1065,2078,玉里,一等
2020-07-09,6110,1107,957,2064,玉里,一等
2020-07-10,6110,1459,1364,2823,玉里,一等
2020-07-11,6110,1036,1241,2277,玉里,一等
2020-07-12,6110,1424,1284,2708,玉里,一等
2020-07-13,6110,1131,2026,3157,玉里,一等
2020-07-14,6110,1133,1211,2344,玉里,一等
2020-07-15,6110,1120,1216,2336,玉里,一等
2020-07-16,6110,1169,1245,2414,玉里,一等
2020-07-17,6110,1489,1749,3238,玉里,一等
2020-07-18,6110,1734,1714,3448,玉里,一等
2020-07-19,6110,1608,1289,2897,玉里,一等
2020-07-20,6110,1371,1297,2668,玉里,一等
2020-07-21,6110,1158,1117,2275,玉里,一等
2020-07-22,6110,1129,1102,2231,玉里,一等
2020-07-23,6110,1119,1324,2443,玉里,一等
2020-07-24,6110,1562,1690,3252,玉里,一等
2020-07-25,6110,1681,1517,3198,玉里,一等
2020-07-26,6110,1656,1284,2940,玉里,一等
2020-07-27,6110,1375,1312,2687,玉里,一等
2020-07-28,6110,1185,1235,2420,玉里,一等
2020-07-29,6110,1165,1124,2289,玉里,一等
2020-07-30,6110,1285,1206,2491,玉里,一等
2020-07-31,6110,1548,1570,3118,玉里,一等
2020-08-01,6110,1777,1934,3711,玉里,一等
2020-08-02,6110,1636,1403,3039,玉里,一等
2020-08-03,6110,1311,1285,2596,玉里,一等
2020-08-04,6110,1130,1149,2279,玉里,一等
2020-08-05,6110,1102,1174,2276,玉里,一等
2020-08-06,6110,1165,1258,2423,玉里,一等
2020-08-07,6110,1704,1738,3442,玉里,一等
2020-08-08,6110,1191,1586,2777,玉里,一等
2020-08-09,6110,1792,1336,3128,玉里,一等
2020-08-10,6110,1456,1342,2798,玉里,一等
2020-08-11,6110,1113,1202,2315,玉里,一等
2020-08-12,6110,1260,1309,2569,玉里,一等
2020-08-13,6110,1278,1500,2778,玉里,一等
2020-08-14,6110,1769,1777,3546,玉里,一等
2020-08-15,6110,1423,1648,3071,玉里,一等
2020-08-16,6110,1827,1655,3482,玉里,一等
2020-08-17,6110,1661,1490,3151,玉里,一等
2020-08-18,6110,1551,1310,2861,玉里,一等
2020-08-19,6110,1246,1233,2479,玉里,一等
2020-08-20,6110,1282,1325,2607,玉里,一等
2020-08-21,6110,1699,1840,3539,玉里,一等
2020-08-22,6110,1332,1963,3295,玉里,一等
2020-08-23,6110,1958,1637,3595,玉里,一等
2020-08-24,6110,1770,1480,3250,玉里,一等
2020-08-25,6110,1527,1308,2835,玉里,一等
2020-08-26,6110,1342,1319,2661,玉里,一等
2020-08-27,6110,1391,1550,2941,玉里,一等
2020-08-28,6110,1659,1847,3506,玉里,一等
2020-08-29,6110,1401,1515,2916,玉里,一等
2020-08-30,6110,1833,1427,3260,玉里,一等
2020-08-31,6110,1385,1329,2714,玉里,一等
2020-09-01,6110,1159,1219,2378,玉里,一等
2020-09-02,6110,1164,1169,2333,玉里,一等
2020-09-03,6110,1223,1271,2494,玉里,一等
2020-09-04,6110,1657,1967,3624,玉里,一等
2020-09-05,6110,1441,1667,3108,玉里,一等
2020-09-06,6110,2036,1513,3549,玉里,一等
2020-09-07,6110,1410,1272,2682,玉里,一等
2020-09-08,6110,1201,1157,2358,玉里,一等
2020-09-09,6110,1212,1127,2339,玉里,一等
2020-09-10,6110,1240,1126,2366,玉里,一等
2020-09-11,6110,1519,1732,3251,玉里,一等
2020-09-12,6110,1411,1715,3126,玉里,一等
2020-09-13,6110,2136,1536,3672,玉里,一等
2020-09-14,6110,1374,1176,2550,玉里,一等
2020-09-15,6110,1112,1102,2214,玉里,一等
2020-09-16,6110,1194,1187,2381,玉里,一等
2020-09-17,6110,1176,1126,2302,玉里,一等
2020-09-18,6110,1723,2077,3800,玉里,一等
2020-09-19,6110,1460,1502,2962,玉里,一等
2020-09-20,6110,1842,1655,3497,玉里,一等
2020-09-21,6110,1327,1260,2587,玉里,一等
2020-09-22,6110,1095,1084,2179,玉里,一等
2020-09-23,6110,1257,1098,2355,玉里,一等
2020-09-24,6110,1257,1232,2489,玉里,一等
2020-09-25,6110,1279,1601,2880,玉里,一等
2020-09-26,6110,1338,1440,2778,玉里,一等
2020-09-27,6110,1632,1271,2903,玉里,一等
2020-09-28,6110,1248,1175,2423,玉里,一等
2020-09-29,6110,1200,1237,2437,玉里,一等
2020-09-30,6110,1788,2521,4309,玉里,一等
2020-10-01,6110,1297,2471,3768,玉里,一等
2020-10-02,6110,1621,1760,3381,玉里,一等
2020-10-03,6110,2046,1247,3293,玉里,一等
2020-10-04,6110,3086,1620,4706,玉里,一等
2020-10-05,6110,1701,1361,3062,玉里,一等
2020-10-06,6110,1083,1040,2123,玉里,一等
2020-10-07,6110,1157,1249,2406,玉里,一等
2020-10-08,6110,1716,1891,3607,玉里,一等
2020-10-09,6110,1383,1841,3224,玉里,一等
2020-10-10,6110,1357,1243,2600,玉里,一等
2020-10-11,6110,2313,1553,3866,玉里,一等
2020-10-12,6110,1351,1150,2501,玉里,一等
2020-10-13,6110,1137,1031,2168,玉里,一等
2020-10-14,6110,1015,974,1989,玉里,一等
2020-10-15,6110,1098,1123,2221,玉里,一等
2020-10-16,6110,1747,1662,3409,玉里,一等
2020-10-17,6110,1412,1630,3042,玉里,一等
2020-10-18,6110,1865,1548,3413,玉里,一等
2020-10-19,6110,1308,1174,2482,玉里,一等
2020-10-20,6110,1185,1006,2191,玉里,一等
2020-10-21,6110,1074,972,2046,玉里,一等
2020-10-22,6110,1054,1037,2091,玉里,一等
2020-10-23,6110,1644,1835,3479,玉里,一等
2020-10-24,6110,1350,1620,2970,玉里,一等
2020-10-25,6110,1971,1493,3464,玉里,一等
2020-10-26,6110,1299,1227,2526,玉里,一等
2020-10-27,6110,1086,1043,2129,玉里,一等
2020-10-28,6110,1149,1037,2186,玉里,一等
2020-10-29,6110,1160,1322,2482,玉里,一等
2020-10-30,6110,1626,1758,3384,玉里,一等
2020-10-31,6110,1561,1974,3535,玉里,一等
2020-11-01,6110,2112,1571,3683,玉里,一等
2020-11-02,6110,1273,1164,2437,玉里,一等
2020-11-03,6110,1001,1093,2094,玉里,一等
2020-11-04,6110,1021,1046,2067,玉里,一等
2020-11-05,6110,1219,1190,2409,玉里,一等
2020-11-06,6110,1512,1631,3143,玉里,一等
2020-11-07,6110,1338,1471,2809,玉里,一等
2020-11-08,6110,1642,1348,2990,玉里,一等
2020-11-09,6110,1281,1095,2376,玉里,一等
2020-11-10,6110,1047,988,2035,玉里,一等
2020-11-11,6110,1055,1026,2081,玉里,一等
2020-11-12,6110,1079,1118,2197,玉里,一等
2020-11-13,6110,1631,1609,3240,玉里,一等
2020-11-14,6110,1591,1324,2915,玉里,一等
2020-11-15,6110,1746,1495,3241,玉里,一等
2020-11-16,6110,1269,1210,2479,玉里,一等
2020-11-17,6110,1355,1351,2706,玉里,一等
2020-11-18,6110,1065,1153,2218,玉里,一等
2020-11-19,6110,1201,1274,2475,玉里,一等
2020-11-20,6110,1792,1851,3643,玉里,一等
2020-11-21,6110,1314,1384,2698,玉里,一等
2020-11-22,6110,1859,1374,3233,玉里,一等
2020-11-23,6110,1297,1238,2535,玉里,一等
2020-11-24,6110,1042,1055,2097,玉里,一等
2020-11-25,6110,1104,1018,2122,玉里,一等
2020-11-26,6110,1194,1106,2300,玉里,一等
2020-11-27,6110,1562,1735,3297,玉里,一等
2020-11-28,6110,1188,1329,2517,玉里,一等
2020-11-29,6110,1772,1421,3193,玉里,一等
2020-11-30,6110,1235,1165,2400,玉里,一等
2020-12-01,6110,1007,970,1977,玉里,一等
2020-12-02,6110,1064,930,1994,玉里,一等
2020-12-03,6110,1081,1040,2121,玉里,一等
2020-12-04,6110,1630,1697,3327,玉里,一等
2020-12-05,6110,1211,1463,2674,玉里,一等
2020-12-06,6110,1954,1624,3578,玉里,一等
2020-12-07,6110,1215,1153,2368,玉里,一等
2020-12-08,6110,1115,1084,2199,玉里,一等
2020-12-09,6110,1074,972,2046,玉里,一等
2020-12-10,6110,1088,1138,2226,玉里,一等
2020-12-11,6110,1465,1979,3444,玉里,一等
2020-12-12,6110,1298,1527,2825,玉里,一等
2020-12-13,6110,1949,1481,3430,玉里,一等
2020-12-14,6110,1226,1245,2471,玉里,一等
2020-12-15,6110,1068,1020,2088,玉里,一等
2020-12-16,6110,1028,1013,2041,玉里,一等
2020-12-17,6110,1118,1095,2213,玉里,一等
2020-12-18,6110,1684,1708,3392,玉里,一等
2020-12-19,6110,1317,1401,2718,玉里,一等
2020-12-20,6110,1610,1337,2947,玉里,一等
2020-12-21,6110,1088,1172,2260,玉里,一等
2020-12-22,6110,1084,1049,2133,玉里,一等
2020-12-23,6110,1098,1066,2164,玉里,一等
2020-12-24,6110,1096,1151,2247,玉里,一等
2020-12-25,6110,1480,1588,3068,玉里,一等
2020-12-26,6110,1135,1338,2473,玉里,一等
2020-12-27,6110,1740,1470,3210,玉里,一等
2020-12-28,6110,1276,1229,2505,玉里,一等
2020-12-29,6110,1045,1059,2104,玉里,一等
2020-12-30,6110,1066,1223,2289,玉里,一等
2020-12-31,6110,1720,1999,3719,玉里,一等
2020-01-01,6120,7,9,16,三民,乙簡
2020-01-02,6120,6,8,14,三民,乙簡
2020-01-03,6120,18,13,31,三民,乙簡
2020-01-04,6120,9,16,25,三民,乙簡
2020-01-05,6120,9,15,24,三民,乙簡
2020-01-06,6120,12,12,24,三民,乙簡
2020-01-07,6120,5,2,7,三民,乙簡
2020-01-08,6120,10,8,18,三民,乙簡
2020-01-09,6120,4,7,11,三民,乙簡
2020-01-10,6120,17,12,29,三民,乙簡
2020-01-11,6120,7,20,27,三民,乙簡
2020-01-12,6120,7,13,20,三民,乙簡
2020-01-13,6120,10,15,25,三民,乙簡
2020-01-14,6120,7,9,16,三民,乙簡
2020-01-15,6120,8,10,18,三民,乙簡
2020-01-16,6120,9,15,24,三民,乙簡
2020-01-17,6120,7,11,18,三民,乙簡
2020-01-18,6120,10,13,23,三民,乙簡
2020-01-19,6120,11,18,29,三民,乙簡
2020-01-20,6120,8,14,22,三民,乙簡
2020-01-21,6120,11,6,17,三民,乙簡
2020-01-22,6120,10,18,28,三民,乙簡
2020-01-23,6120,7,21,28,三民,乙簡
2020-01-24,6120,2,12,14,三民,乙簡
2020-01-25,6120,3,15,18,三民,乙簡
2020-01-26,6120,5,7,12,三民,乙簡
2020-01-27,6120,14,15,29,三民,乙簡
2020-01-28,6120,11,6,17,三民,乙簡
2020-01-29,6120,14,10,24,三民,乙簡
2020-01-30,6120,1,3,4,三民,乙簡
2020-01-31,6120,11,7,18,三民,乙簡
2020-02-01,6120,6,8,14,三民,乙簡
2020-02-02,6120,6,3,9,三民,乙簡
2020-02-03,6120,6,8,14,三民,乙簡
2020-02-04,6120,5,8,13,三民,乙簡
2020-02-05,6120,2,5,7,三民,乙簡
2020-02-06,6120,13,15,28,三民,乙簡
2020-02-07,6120,9,10,19,三民,乙簡
2020-02-08,6120,3,12,15,三民,乙簡
2020-02-09,6120,11,4,15,三民,乙簡
2020-02-10,6120,5,5,10,三民,乙簡
2020-02-11,6120,7,7,14,三民,乙簡
2020-02-12,6120,4,20,24,三民,乙簡
2020-02-13,6120,6,8,14,三民,乙簡
2020-02-14,6120,9,5,14,三民,乙簡
2020-02-15,6120,3,10,13,三民,乙簡
2020-02-16,6120,3,7,10,三民,乙簡
2020-02-17,6120,11,16,27,三民,乙簡
2020-02-18,6120,5,11,16,三民,乙簡
2020-02-19,6120,7,9,16,三民,乙簡
2020-02-20,6120,5,13,18,三民,乙簡
2020-02-21,6120,4,10,14,三民,乙簡
2020-02-22,6120,1,0,1,三民,乙簡
2020-02-23,6120,4,8,12,三民,乙簡
2020-02-24,6120,11,6,17,三民,乙簡
2020-02-25,6120,14,12,26,三民,乙簡
2020-02-26,6120,8,14,22,三民,乙簡
2020-02-27,6120,10,19,29,三民,乙簡
2020-02-28,6120,7,26,33,三民,乙簡
2020-02-29,6120,3,13,16,三民,乙簡
2020-03-01,6120,8,7,15,三民,乙簡
2020-03-02,6120,4,9,13,三民,乙簡
2020-03-03,6120,8,10,18,三民,乙簡
2020-03-04,6120,4,7,11,三民,乙簡
2020-03-05,6120,4,5,9,三民,乙簡
2020-03-06,6120,4,14,18,三民,乙簡
2020-03-07,6120,12,18,30,三民,乙簡
2020-03-08,6120,11,8,19,三民,乙簡
2020-03-09,6120,7,14,21,三民,乙簡
2020-03-10,6120,8,6,14,三民,乙簡
2020-03-11,6120,12,6,18,三民,乙簡
2020-03-12,6120,14,8,22,三民,乙簡
2020-03-13,6120,12,28,40,三民,乙簡
2020-03-14,6120,6,19,25,三民,乙簡
2020-03-15,6120,13,9,22,三民,乙簡
2020-03-16,6120,13,13,26,三民,乙簡
2020-03-17,6120,6,7,13,三民,乙簡
2020-03-18,6120,7,4,11,三民,乙簡
2020-03-19,6120,6,7,13,三民,乙簡
2020-03-20,6120,12,12,24,三民,乙簡
2020-03-21,6120,4,19,23,三民,乙簡
2020-03-22,6120,17,14,31,三民,乙簡
2020-03-23,6120,9,13,22,三民,乙簡
2020-03-24,6120,8,9,17,三民,乙簡
2020-03-25,6120,7,4,11,三民,乙簡
2020-03-26,6120,9,7,16,三民,乙簡
2020-03-27,6120,6,15,21,三民,乙簡
2020-03-28,6120,13,18,31,三民,乙簡
2020-03-29,6120,14,10,24,三民,乙簡
2020-03-30,6120,8,9,17,三民,乙簡
2020-03-31,6120,5,6,11,三民,乙簡
2020-04-01,6120,5,18,23,三民,乙簡
2020-04-02,6120,1,24,25,三民,乙簡
2020-04-03,6120,9,14,23,三民,乙簡
2020-04-04,6120,6,7,13,三民,乙簡
2020-04-05,6120,16,15,31,三民,乙簡
2020-04-06,6120,2,15,17,三民,乙簡
2020-04-07,6120,8,4,12,三民,乙簡
2020-04-08,6120,4,6,10,三民,乙簡
2020-04-09,6120,8,13,21,三民,乙簡
2020-04-10,6120,17,17,34,三民,乙簡
2020-04-11,6120,12,4,16,三民,乙簡
2020-04-12,6120,15,13,28,三民,乙簡
2020-04-13,6120,4,12,16,三民,乙簡
2020-04-14,6120,10,7,17,三民,乙簡
2020-04-15,6120,11,3,14,三民,乙簡
2020-04-16,6120,8,7,15,三民,乙簡
2020-04-17,6120,14,11,25,三民,乙簡
2020-04-18,6120,6,19,25,三民,乙簡
2020-04-19,6120,14,12,26,三民,乙簡
2020-04-20,6120,9,13,22,三民,乙簡
2020-04-21,6120,11,7,18,三民,乙簡
2020-04-22,6120,8,4,12,三民,乙簡
2020-04-23,6120,5,6,11,三民,乙簡
2020-04-24,6120,11,16,27,三民,乙簡
2020-04-25,6120,12,24,36,三民,乙簡
2020-04-26,6120,8,8,16,三民,乙簡
2020-04-27,6120,0,8,8,三民,乙簡
2020-04-28,6120,6,2,8,三民,乙簡
2020-04-29,6120,6,5,11,三民,乙簡
2020-04-30,6120,8,11,19,三民,乙簡
2020-05-01,6120,8,15,23,三民,乙簡
2020-05-02,6120,5,11,16,三民,乙簡
2020-05-03,6120,11,13,24,三民,乙簡
2020-05-04,6120,0,8,8,三民,乙簡
2020-05-05,6120,8,8,16,三民,乙簡
2020-05-06,6120,2,1,3,三民,乙簡
2020-05-07,6120,5,8,13,三民,乙簡
2020-05-08,6120,9,19,28,三民,乙簡
2020-05-09,6120,5,13,18,三民,乙簡
2020-05-10,6120,9,7,16,三民,乙簡
2020-05-11,6120,3,11,14,三民,乙簡
2020-05-12,6120,6,10,16,三民,乙簡
2020-05-13,6120,11,6,17,三民,乙簡
2020-05-14,6120,1,15,16,三民,乙簡
2020-05-15,6120,14,8,22,三民,乙簡
2020-05-16,6120,3,19,22,三民,乙簡
2020-05-17,6120,15,22,37,三民,乙簡
2020-05-18,6120,7,11,18,三民,乙簡
2020-05-19,6120,6,10,16,三民,乙簡
2020-05-20,6120,3,7,10,三民,乙簡
2020-05-21,6120,5,5,10,三民,乙簡
2020-05-22,6120,11,17,28,三民,乙簡
2020-05-23,6120,3,14,17,三民,乙簡
2020-05-24,6120,10,14,24,三民,乙簡
2020-05-25,6120,5,11,16,三民,乙簡
2020-05-26,6120,7,12,19,三民,乙簡
2020-05-27,6120,4,5,9,三民,乙簡
2020-05-28,6120,4,11,15,三民,乙簡
2020-05-29,6120,6,17,23,三民,乙簡
2020-05-30,6120,5,20,25,三民,乙簡
2020-05-31,6120,9,8,17,三民,乙簡
2020-06-01,6120,4,20,24,三民,乙簡
2020-06-02,6120,3,8,11,三民,乙簡
2020-06-03,6120,7,10,17,三民,乙簡
2020-06-04,6120,6,5,11,三民,乙簡
2020-06-05,6120,16,7,23,三民,乙簡
2020-06-06,6120,6,15,21,三民,乙簡
2020-06-07,6120,5,9,14,三民,乙簡
2020-06-08,6120,8,20,28,三民,乙簡
2020-06-09,6120,4,12,16,三民,乙簡
2020-06-10,6120,9,7,16,三民,乙簡
2020-06-11,6120,5,4,9,三民,乙簡
2020-06-12,6120,20,11,31,三民,乙簡
2020-06-13,6120,5,13,18,三民,乙簡
2020-06-14,6120,9,8,17,三民,乙簡
2020-06-15,6120,8,11,19,三民,乙簡
2020-06-16,6120,12,5,17,三民,乙簡
2020-06-17,6120,4,8,12,三民,乙簡
2020-06-18,6120,5,7,12,三民,乙簡
2020-06-19,6120,6,10,16,三民,乙簡
2020-06-20,6120,17,8,25,三民,乙簡
2020-06-21,6120,5,17,22,三民,乙簡
2020-06-22,6120,17,23,40,三民,乙簡
2020-06-23,6120,8,10,18,三民,乙簡
2020-06-24,6120,12,24,36,三民,乙簡
2020-06-25,6120,2,26,28,三民,乙簡
2020-06-26,6120,8,11,19,三民,乙簡
2020-06-27,6120,9,17,26,三民,乙簡
2020-06-28,6120,19,10,29,三民,乙簡
2020-06-29,6120,9,16,25,三民,乙簡
2020-06-30,6120,6,3,9,三民,乙簡
2020-07-01,6120,6,5,11,三民,乙簡
2020-07-02,6120,10,4,14,三民,乙簡
2020-07-03,6120,5,17,22,三民,乙簡
2020-07-04,6120,5,13,18,三民,乙簡
2020-07-05,6120,14,7,21,三民,乙簡
2020-07-06,6120,11,10,21,三民,乙簡
2020-07-07,6120,6,11,17,三民,乙簡
2020-07-08,6120,3,6,9,三民,乙簡
2020-07-09,6120,3,8,11,三民,乙簡
2020-07-10,6120,8,19,27,三民,乙簡
2020-07-11,6120,8,13,21,三民,乙簡
2020-07-12,6120,8,13,21,三民,乙簡
2020-07-13,6120,5,10,15,三民,乙簡
2020-07-14,6120,7,6,13,三民,乙簡
2020-07-15,6120,5,8,13,三民,乙簡
2020-07-16,6120,4,8,12,三民,乙簡
2020-07-17,6120,5,4,9,三民,乙簡
2020-07-18,6120,5,9,14,三民,乙簡
2020-07-19,6120,8,11,19,三民,乙簡
2020-07-20,6120,6,6,12,三民,乙簡
2020-07-21,6120,6,5,11,三民,乙簡
2020-07-22,6120,2,4,6,三民,乙簡
2020-07-23,6120,4,9,13,三民,乙簡
2020-07-24,6120,5,20,25,三民,乙簡
2020-07-25,6120,9,17,26,三民,乙簡
2020-07-26,6120,6,13,19,三民,乙簡
2020-07-27,6120,3,27,30,三民,乙簡
2020-07-28,6120,1,9,10,三民,乙簡
2020-07-29,6120,22,12,34,三民,乙簡
2020-07-30,6120,6,7,13,三民,乙簡
2020-07-31,6120,6,10,16,三民,乙簡
2020-08-01,6120,8,12,20,三民,乙簡
2020-08-02,6120,30,16,46,三民,乙簡
2020-08-03,6120,3,6,9,三民,乙簡
2020-08-04,6120,7,8,15,三民,乙簡
2020-08-05,6120,14,9,23,三民,乙簡
2020-08-06,6120,5,10,15,三民,乙簡
2020-08-07,6120,7,19,26,三民,乙簡
2020-08-08,6120,2,7,9,三民,乙簡
2020-08-09,6120,10,12,22,三民,乙簡
2020-08-10,6120,10,9,19,三民,乙簡
2020-08-11,6120,7,5,12,三民,乙簡
2020-08-12,6120,4,8,12,三民,乙簡
2020-08-13,6120,6,7,13,三民,乙簡
2020-08-14,6120,7,8,15,三民,乙簡
2020-08-15,6120,9,10,19,三民,乙簡
2020-08-16,6120,5,14,19,三民,乙簡
2020-08-17,6120,2,9,11,三民,乙簡
2020-08-18,6120,5,4,9,三民,乙簡
2020-08-19,6120,4,9,13,三民,乙簡
2020-08-20,6120,3,10,13,三民,乙簡
2020-08-21,6120,7,21,28,三民,乙簡
2020-08-22,6120,7,12,19,三民,乙簡
2020-08-23,6120,8,5,13,三民,乙簡
2020-08-24,6120,2,12,14,三民,乙簡
2020-08-25,6120,6,12,18,三民,乙簡
2020-08-26,6120,5,11,16,三民,乙簡
2020-08-27,6120,4,10,14,三民,乙簡
2020-08-28,6120,8,16,24,三民,乙簡
2020-08-29,6120,5,5,10,三民,乙簡
2020-08-30,6120,10,13,23,三民,乙簡
2020-08-31,6120,6,11,17,三民,乙簡
2020-09-01,6120,4,9,13,三民,乙簡
2020-09-02,6120,4,10,14,三民,乙簡
2020-09-03,6120,9,12,21,三民,乙簡
2020-09-04,6120,7,14,21,三民,乙簡
2020-09-05,6120,2,31,33,三民,乙簡
2020-09-06,6120,18,17,35,三民,乙簡
2020-09-07,6120,4,11,15,三民,乙簡
2020-09-08,6120,8,8,16,三民,乙簡
2020-09-09,6120,4,9,13,三民,乙簡
2020-09-10,6120,6,3,9,三民,乙簡
2020-09-11,6120,5,9,14,三民,乙簡
2020-09-12,6120,8,15,23,三民,乙簡
2020-09-13,6120,4,18,22,三民,乙簡
2020-09-14,6120,6,14,20,三民,乙簡
2020-09-15,6120,5,4,9,三民,乙簡
2020-09-16,6120,9,6,15,三民,乙簡
2020-09-17,6120,7,7,14,三民,乙簡
2020-09-18,6120,10,15,25,三民,乙簡
2020-09-19,6120,4,15,19,三民,乙簡
2020-09-20,6120,9,5,14,三民,乙簡
2020-09-21,6120,8,11,19,三民,乙簡
2020-09-22,6120,11,8,19,三民,乙簡
2020-09-23,6120,7,11,18,三民,乙簡
2020-09-24,6120,8,4,12,三民,乙簡
2020-09-25,6120,7,10,17,三民,乙簡
2020-09-26,6120,7,14,21,三民,乙簡
2020-09-27,6120,8,19,27,三民,乙簡
2020-09-28,6120,3,10,13,三民,乙簡
2020-09-29,6120,7,13,20,三民,乙簡
2020-09-30,6120,10,31,41,三民,乙簡
2020-10-01,6120,4,16,20,三民,乙簡
2020-10-02,6120,7,14,21,三民,乙簡
2020-10-03,6120,5,9,14,三民,乙簡
2020-10-04,6120,13,14,27,三民,乙簡
2020-10-05,6120,8,4,12,三民,乙簡
2020-10-06,6120,6,11,17,三民,乙簡
2020-10-07,6120,4,4,8,三民,乙簡
2020-10-08,6120,3,18,21,三民,乙簡
2020-10-09,6120,4,11,15,三民,乙簡
2020-10-10,6120,5,16,21,三民,乙簡
2020-10-11,6120,9,5,14,三民,乙簡
2020-10-12,6120,6,7,13,三民,乙簡
2020-10-13,6120,3,6,9,三民,乙簡
2020-10-14,6120,3,3,6,三民,乙簡
2020-10-15,6120,6,6,12,三民,乙簡
2020-10-16,6120,8,33,41,三民,乙簡
2020-10-17,6120,10,15,25,三民,乙簡
2020-10-18,6120,25,15,40,三民,乙簡
2020-10-19,6120,3,8,11,三民,乙簡
2020-10-20,6120,2,19,21,三民,乙簡
2020-10-21,6120,2,7,9,三民,乙簡
2020-10-22,6120,2,5,7,三民,乙簡
2020-10-23,6120,6,25,31,三民,乙簡
2020-10-24,6120,5,9,14,三民,乙簡
2020-10-25,6120,9,9,18,三民,乙簡
2020-10-26,6120,3,9,12,三民,乙簡
2020-10-27,6120,3,9,12,三民,乙簡
2020-10-28,6120,6,8,14,三民,乙簡
2020-10-29,6120,5,8,13,三民,乙簡
2020-10-30,6120,6,39,45,三民,乙簡
2020-10-31,6120,9,11,20,三民,乙簡
2020-11-01,6120,24,16,40,三民,乙簡
2020-11-02,6120,3,8,11,三民,乙簡
2020-11-03,6120,7,9,16,三民,乙簡
2020-11-04,6120,4,11,15,三民,乙簡
2020-11-05,6120,4,7,11,三民,乙簡
2020-11-06,6120,9,25,34,三民,乙簡
2020-11-07,6120,8,7,15,三民,乙簡
2020-11-08,6120,14,16,30,三民,乙簡
2020-11-09,6120,12,14,26,三民,乙簡
2020-11-10,6120,8,6,14,三民,乙簡
2020-11-11,6120,6,6,12,三民,乙簡
2020-11-12,6120,3,8,11,三民,乙簡
2020-11-13,6120,3,16,19,三民,乙簡
2020-11-14,6120,4,5,9,三民,乙簡
2020-11-15,6120,14,5,19,三民,乙簡
2020-11-16,6120,11,20,31,三民,乙簡
2020-11-17,6120,3,6,9,三民,乙簡
2020-11-18,6120,6,8,14,三民,乙簡
2020-11-19,6120,8,6,14,三民,乙簡
2020-11-20,6120,6,16,22,三民,乙簡
2020-11-21,6120,5,12,17,三民,乙簡
2020-11-22,6120,8,28,36,三民,乙簡
2020-11-23,6120,9,14,23,三民,乙簡
2020-11-24,6120,6,7,13,三民,乙簡
2020-11-25,6120,2,10,12,三民,乙簡
2020-11-26,6120,9,14,23,三民,乙簡
2020-11-27,6120,8,33,41,三民,乙簡
2020-11-28,6120,17,14,31,三民,乙簡
2020-11-29,6120,26,12,38,三民,乙簡
2020-11-30,6120,7,8,15,三民,乙簡
2020-12-01,6120,5,7,12,三民,乙簡
2020-12-02,6120,6,4,10,三民,乙簡
2020-12-03,6120,7,10,17,三民,乙簡
2020-12-04,6120,2,18,20,三民,乙簡
2020-12-05,6120,2,15,17,三民,乙簡
2020-12-06,6120,5,14,19,三民,乙簡
2020-12-07,6120,4,7,11,三民,乙簡
2020-12-08,6120,5,5,10,三民,乙簡
2020-12-09,6120,6,8,14,三民,乙簡
2020-12-10,6120,2,6,8,三民,乙簡
2020-12-11,6120,6,38,44,三民,乙簡
2020-12-12,6120,10,11,21,三民,乙簡
2020-12-13,6120,25,11,36,三民,乙簡
2020-12-14,6120,3,11,14,三民,乙簡
2020-12-15,6120,7,8,15,三民,乙簡
2020-12-16,6120,6,9,15,三民,乙簡
2020-12-17,6120,4,11,15,三民,乙簡
2020-12-18,6120,8,29,37,三民,乙簡
2020-12-19,6120,8,13,21,三民,乙簡
2020-12-20,6120,8,4,12,三民,乙簡
2020-12-21,6120,5,15,20,三民,乙簡
2020-12-22,6120,10,7,17,三民,乙簡
2020-12-23,6120,6,7,13,三民,乙簡
2020-12-24,6120,3,9,12,三民,乙簡
2020-12-25,6120,11,49,60,三民,乙簡
2020-12-26,6120,6,7,13,三民,乙簡
2020-12-27,6120,47,16,63,三民,乙簡
2020-12-28,6120,2,10,12,三民,乙簡
2020-12-29,6120,6,10,16,三民,乙簡
2020-12-30,6120,9,13,22,三民,乙簡
2020-12-31,6120,6,15,21,三民,乙簡
2020-01-01,6130,624,510,1134,瑞穗,三等
2020-01-02,6130,558,503,1061,瑞穗,三等
2020-01-03,6130,596,787,1383,瑞穗,三等
2020-01-04,6130,428,658,1086,瑞穗,三等
2020-01-05,6130,857,492,1349,瑞穗,三等
2020-01-06,6130,572,553,1125,瑞穗,三等
2020-01-07,6130,501,552,1053,瑞穗,三等
2020-01-08,6130,614,557,1171,瑞穗,三等
2020-01-09,6130,449,580,1029,瑞穗,三等
2020-01-10,6130,750,926,1676,瑞穗,三等
2020-01-11,6130,762,893,1655,瑞穗,三等
2020-01-12,6130,908,550,1458,瑞穗,三等
2020-01-13,6130,620,658,1278,瑞穗,三等
2020-01-14,6130,519,583,1102,瑞穗,三等
2020-01-15,6130,480,567,1047,瑞穗,三等
2020-01-16,6130,548,681,1229,瑞穗,三等
2020-01-17,6130,865,763,1628,瑞穗,三等
2020-01-18,6130,623,701,1324,瑞穗,三等
2020-01-19,6130,720,596,1316,瑞穗,三等
2020-01-20,6130,629,841,1470,瑞穗,三等
2020-01-21,6130,554,771,1325,瑞穗,三等
2020-01-22,6130,637,1013,1650,瑞穗,三等
2020-01-23,6130,501,1222,1723,瑞穗,三等
2020-01-24,6130,469,1417,1886,瑞穗,三等
2020-01-25,6130,763,1182,1945,瑞穗,三等
2020-01-26,6130,1288,1169,2457,瑞穗,三等
2020-01-27,6130,1389,843,2232,瑞穗,三等
2020-01-28,6130,1493,633,2126,瑞穗,三等
2020-01-29,6130,1140,538,1678,瑞穗,三等
2020-01-30,6130,925,723,1648,瑞穗,三等
2020-01-31,6130,948,723,1671,瑞穗,三等
2020-02-01,6130,771,597,1368,瑞穗,三等
2020-02-02,6130,742,523,1265,瑞穗,三等
2020-02-03,6130,657,626,1283,瑞穗,三等
2020-02-04,6130,705,628,1333,瑞穗,三等
2020-02-05,6130,527,514,1041,瑞穗,三等
2020-02-06,6130,745,647,1392,瑞穗,三等
2020-02-07,6130,682,593,1275,瑞穗,三等
2020-02-08,6130,437,497,934,瑞穗,三等
2020-02-09,6130,676,552,1228,瑞穗,三等
2020-02-10,6130,590,548,1138,瑞穗,三等
2020-02-11,6130,485,530,1015,瑞穗,三等
2020-02-12,6130,609,518,1127,瑞穗,三等
2020-02-13,6130,531,435,966,瑞穗,三等
2020-02-14,6130,555,522,1077,瑞穗,三等
2020-02-15,6130,584,596,1180,瑞穗,三等
2020-02-16,6130,652,474,1126,瑞穗,三等
2020-02-17,6130,533,495,1028,瑞穗,三等
2020-02-18,6130,500,534,1034,瑞穗,三等
2020-02-19,6130,452,490,942,瑞穗,三等
2020-02-20,6130,489,481,970,瑞穗,三等
2020-02-21,6130,535,941,1476,瑞穗,三等
2020-02-22,6130,472,589,1061,瑞穗,三等
2020-02-23,6130,1094,479,1573,瑞穗,三等
2020-02-24,6130,610,453,1063,瑞穗,三等
2020-02-25,6130,434,508,942,瑞穗,三等
2020-02-26,6130,466,496,962,瑞穗,三等
2020-02-27,6130,543,822,1365,瑞穗,三等
2020-02-28,6130,426,808,1234,瑞穗,三等
2020-02-29,6130,561,465,1026,瑞穗,三等
2020-03-01,6130,1070,437,1507,瑞穗,三等
2020-03-02,6130,511,421,932,瑞穗,三等
2020-03-03,6130,429,413,842,瑞穗,三等
2020-03-04,6130,377,374,751,瑞穗,三等
2020-03-05,6130,410,437,847,瑞穗,三等
2020-03-06,6130,472,735,1207,瑞穗,三等
2020-03-07,6130,338,588,926,瑞穗,三等
2020-03-08,6130,799,398,1197,瑞穗,三等
2020-03-09,6130,546,471,1017,瑞穗,三等
2020-03-10,6130,424,381,805,瑞穗,三等
2020-03-11,6130,400,407,807,瑞穗,三等
2020-03-12,6130,432,456,888,瑞穗,三等
2020-03-13,6130,492,844,1336,瑞穗,三等
2020-03-14,6130,446,593,1039,瑞穗,三等
2020-03-15,6130,751,401,1152,瑞穗,三等
2020-03-16,6130,470,495,965,瑞穗,三等
2020-03-17,6130,398,414,812,瑞穗,三等
2020-03-18,6130,408,420,828,瑞穗,三等
2020-03-19,6130,416,390,806,瑞穗,三等
2020-03-20,6130,478,785,1263,瑞穗,三等
2020-03-21,6130,453,621,1074,瑞穗,三等
2020-03-22,6130,864,421,1285,瑞穗,三等
2020-03-23,6130,455,444,899,瑞穗,三等
2020-03-24,6130,412,412,824,瑞穗,三等
2020-03-25,6130,325,373,698,瑞穗,三等
2020-03-26,6130,414,429,843,瑞穗,三等
2020-03-27,6130,401,688,1089,瑞穗,三等
2020-03-28,6130,400,534,934,瑞穗,三等
2020-03-29,6130,822,433,1255,瑞穗,三等
2020-03-30,6130,484,442,926,瑞穗,三等
2020-03-31,6130,413,485,898,瑞穗,三等
2020-04-01,6130,494,900,1394,瑞穗,三等
2020-04-02,6130,392,1135,1527,瑞穗,三等
2020-04-03,6130,519,942,1461,瑞穗,三等
2020-04-04,6130,977,491,1468,瑞穗,三等
2020-04-05,6130,1253,337,1590,瑞穗,三等
2020-04-06,6130,736,417,1153,瑞穗,三等
2020-04-07,6130,402,368,770,瑞穗,三等
2020-04-08,6130,333,352,685,瑞穗,三等
2020-04-09,6130,424,462,886,瑞穗,三等
2020-04-10,6130,439,566,1005,瑞穗,三等
2020-04-11,6130,372,508,880,瑞穗,三等
2020-04-12,6130,572,318,890,瑞穗,三等
2020-04-13,6130,403,413,816,瑞穗,三等
2020-04-14,6130,393,373,766,瑞穗,三等
2020-04-15,6130,326,359,685,瑞穗,三等
2020-04-16,6130,352,386,738,瑞穗,三等
2020-04-17,6130,431,621,1052,瑞穗,三等
2020-04-18,6130,358,488,846,瑞穗,三等
2020-04-19,6130,609,340,949,瑞穗,三等
2020-04-20,6130,498,457,955,瑞穗,三等
2020-04-21,6130,383,337,720,瑞穗,三等
2020-04-22,6130,353,360,713,瑞穗,三等
2020-04-23,6130,348,396,744,瑞穗,三等
2020-04-24,6130,397,598,995,瑞穗,三等
2020-04-25,6130,313,474,787,瑞穗,三等
2020-04-26,6130,639,336,975,瑞穗,三等
2020-04-27,6130,369,382,751,瑞穗,三等
2020-04-28,6130,345,336,681,瑞穗,三等
2020-04-29,6130,341,388,729,瑞穗,三等
2020-04-30,6130,450,482,932,瑞穗,三等
2020-05-01,6130,447,942,1389,瑞穗,三等
2020-05-02,6130,386,390,776,瑞穗,三等
2020-05-03,6130,875,385,1260,瑞穗,三等
2020-05-04,6130,435,379,814,瑞穗,三等
2020-05-05,6130,351,382,733,瑞穗,三等
2020-05-06,6130,454,393,847,瑞穗,三等
2020-05-07,6130,357,424,781,瑞穗,三等
2020-05-08,6130,493,776,1269,瑞穗,三等
2020-05-09,6130,390,650,1040,瑞穗,三等
2020-05-10,6130,962,485,1447,瑞穗,三等
2020-05-11,6130,541,504,1045,瑞穗,三等
2020-05-12,6130,406,433,839,瑞穗,三等
2020-05-13,6130,422,405,827,瑞穗,三等
2020-05-14,6130,453,432,885,瑞穗,三等
2020-05-15,6130,556,664,1220,瑞穗,三等
2020-05-16,6130,345,502,847,瑞穗,三等
2020-05-17,6130,683,438,1121,瑞穗,三等
2020-05-18,6130,501,485,986,瑞穗,三等
2020-05-19,6130,378,381,759,瑞穗,三等
2020-05-20,6130,435,365,800,瑞穗,三等
2020-05-21,6130,403,466,869,瑞穗,三等
2020-05-22,6130,505,688,1193,瑞穗,三等
2020-05-23,6130,372,528,900,瑞穗,三等
2020-05-24,6130,816,482,1298,瑞穗,三等
2020-05-25,6130,507,488,995,瑞穗,三等
2020-05-26,6130,492,420,912,瑞穗,三等
2020-05-27,6130,459,413,872,瑞穗,三等
2020-05-28,6130,396,418,814,瑞穗,三等
2020-05-29,6130,479,817,1296,瑞穗,三等
2020-05-30,6130,480,698,1178,瑞穗,三等
2020-05-31,6130,915,520,1435,瑞穗,三等
2020-06-01,6130,524,461,985,瑞穗,三等
2020-06-02,6130,458,424,882,瑞穗,三等
2020-06-03,6130,439,416,855,瑞穗,三等
2020-06-04,6130,485,501,986,瑞穗,三等
2020-06-05,6130,542,793,1335,瑞穗,三等
2020-06-06,6130,513,606,1119,瑞穗,三等
2020-06-07,6130,859,497,1356,瑞穗,三等
2020-06-08,6130,513,527,1040,瑞穗,三等
2020-06-09,6130,455,435,890,瑞穗,三等
2020-06-10,6130,457,483,940,瑞穗,三等
2020-06-11,6130,490,545,1035,瑞穗,三等
2020-06-12,6130,620,753,1373,瑞穗,三等
2020-06-13,6130,528,673,1201,瑞穗,三等
2020-06-14,6130,818,515,1333,瑞穗,三等
2020-06-15,6130,533,504,1037,瑞穗,三等
2020-06-16,6130,526,530,1056,瑞穗,三等
2020-06-17,6130,527,529,1056,瑞穗,三等
2020-06-18,6130,458,502,960,瑞穗,三等
2020-06-19,6130,535,758,1293,瑞穗,三等
2020-06-20,6130,628,690,1318,瑞穗,三等
2020-06-21,6130,723,512,1235,瑞穗,三等
2020-06-22,6130,772,677,1449,瑞穗,三等
2020-06-23,6130,454,535,989,瑞穗,三等
2020-06-24,6130,692,915,1607,瑞穗,三等
2020-06-25,6130,532,947,1479,瑞穗,三等
2020-06-26,6130,621,779,1400,瑞穗,三等
2020-06-27,6130,810,573,1383,瑞穗,三等
2020-06-28,6130,1138,597,1735,瑞穗,三等
2020-06-29,6130,761,597,1358,瑞穗,三等
2020-06-30,6130,591,480,1071,瑞穗,三等
2020-07-01,6130,521,569,1090,瑞穗,三等
2020-07-02,6130,479,520,999,瑞穗,三等
2020-07-03,6130,649,833,1482,瑞穗,三等
2020-07-04,6130,570,593,1163,瑞穗,三等
2020-07-05,6130,745,567,1312,瑞穗,三等
2020-07-06,6130,527,566,1093,瑞穗,三等
2020-07-07,6130,561,603,1164,瑞穗,三等
2020-07-08,6130,532,545,1077,瑞穗,三等
2020-07-09,6130,591,546,1137,瑞穗,三等
2020-07-10,6130,692,836,1528,瑞穗,三等
2020-07-11,6130,624,626,1250,瑞穗,三等
2020-07-12,6130,791,564,1355,瑞穗,三等
2020-07-13,6130,652,703,1355,瑞穗,三等
2020-07-14,6130,648,681,1329,瑞穗,三等
2020-07-15,6130,570,623,1193,瑞穗,三等
2020-07-16,6130,606,622,1228,瑞穗,三等
2020-07-17,6130,589,843,1432,瑞穗,三等
2020-07-18,6130,724,835,1559,瑞穗,三等
2020-07-19,6130,923,638,1561,瑞穗,三等
2020-07-20,6130,662,621,1283,瑞穗,三等
2020-07-21,6130,621,602,1223,瑞穗,三等
2020-07-22,6130,701,712,1413,瑞穗,三等
2020-07-23,6130,645,621,1266,瑞穗,三等
2020-07-24,6130,686,806,1492,瑞穗,三等
2020-07-25,6130,591,695,1286,瑞穗,三等
2020-07-26,6130,766,567,1333,瑞穗,三等
2020-07-27,6130,653,519,1172,瑞穗,三等
2020-07-28,6130,613,555,1168,瑞穗,三等
2020-07-29,6130,565,645,1210,瑞穗,三等
2020-07-30,6130,600,572,1172,瑞穗,三等
2020-07-31,6130,757,798,1555,瑞穗,三等
2020-08-01,6130,671,847,1518,瑞穗,三等
2020-08-02,6130,716,669,1385,瑞穗,三等
2020-08-03,6130,745,676,1421,瑞穗,三等
2020-08-04,6130,647,624,1271,瑞穗,三等
2020-08-05,6130,528,612,1140,瑞穗,三等
2020-08-06,6130,579,652,1231,瑞穗,三等
2020-08-07,6130,714,853,1567,瑞穗,三等
2020-08-08,6130,631,878,1509,瑞穗,三等
2020-08-09,6130,994,623,1617,瑞穗,三等
2020-08-10,6130,776,743,1519,瑞穗,三等
2020-08-11,6130,561,564,1125,瑞穗,三等
2020-08-12,6130,656,616,1272,瑞穗,三等
2020-08-13,6130,536,734,1270,瑞穗,三等
2020-08-14,6130,779,1137,1916,瑞穗,三等
2020-08-15,6130,615,958,1573,瑞穗,三等
2020-08-16,6130,1198,648,1846,瑞穗,三等
2020-08-17,6130,841,676,1517,瑞穗,三等
2020-08-18,6130,690,632,1322,瑞穗,三等
2020-08-19,6130,576,566,1142,瑞穗,三等
2020-08-20,6130,628,757,1385,瑞穗,三等
2020-08-21,6130,686,1033,1719,瑞穗,三等
2020-08-22,6130,740,968,1708,瑞穗,三等
2020-08-23,6130,1047,581,1628,瑞穗,三等
2020-08-24,6130,926,647,1573,瑞穗,三等
2020-08-25,6130,677,528,1205,瑞穗,三等
2020-08-26,6130,624,593,1217,瑞穗,三等
2020-08-27,6130,683,683,1366,瑞穗,三等
2020-08-28,6130,719,720,1439,瑞穗,三等
2020-08-29,6130,536,762,1298,瑞穗,三等
2020-08-30,6130,970,660,1630,瑞穗,三等
2020-08-31,6130,602,575,1177,瑞穗,三等
2020-09-01,6130,611,707,1318,瑞穗,三等
2020-09-02,6130,576,523,1099,瑞穗,三等
2020-09-03,6130,642,625,1267,瑞穗,三等
2020-09-04,6130,704,1039,1743,瑞穗,三等
2020-09-05,6130,607,1060,1667,瑞穗,三等
2020-09-06,6130,963,574,1537,瑞穗,三等
2020-09-07,6130,679,688,1367,瑞穗,三等
2020-09-08,6130,610,592,1202,瑞穗,三等
2020-09-09,6130,615,589,1204,瑞穗,三等
2020-09-10,6130,576,588,1164,瑞穗,三等
2020-09-11,6130,710,964,1674,瑞穗,三等
2020-09-12,6130,616,862,1478,瑞穗,三等
2020-09-13,6130,1033,591,1624,瑞穗,三等
2020-09-14,6130,627,548,1175,瑞穗,三等
2020-09-15,6130,555,530,1085,瑞穗,三等
2020-09-16,6130,532,467,999,瑞穗,三等
2020-09-17,6130,549,627,1176,瑞穗,三等
2020-09-18,6130,651,820,1471,瑞穗,三等
2020-09-19,6130,565,723,1288,瑞穗,三等
2020-09-20,6130,829,658,1487,瑞穗,三等
2020-09-21,6130,586,601,1187,瑞穗,三等
2020-09-22,6130,533,535,1068,瑞穗,三等
2020-09-23,6130,701,554,1255,瑞穗,三等
2020-09-24,6130,466,480,946,瑞穗,三等
2020-09-25,6130,461,630,1091,瑞穗,三等
2020-09-26,6130,568,600,1168,瑞穗,三等
2020-09-27,6130,578,420,998,瑞穗,三等
2020-09-28,6130,512,600,1112,瑞穗,三等
2020-09-29,6130,510,581,1091,瑞穗,三等
2020-09-30,6130,717,1124,1841,瑞穗,三等
2020-10-01,6130,559,1223,1782,瑞穗,三等
2020-10-02,6130,734,862,1596,瑞穗,三等
2020-10-03,6130,991,606,1597,瑞穗,三等
2020-10-04,6130,1246,593,1839,瑞穗,三等
2020-10-05,6130,779,570,1349,瑞穗,三等
2020-10-06,6130,521,537,1058,瑞穗,三等
2020-10-07,6130,618,578,1196,瑞穗,三等
2020-10-08,6130,646,908,1554,瑞穗,三等
2020-10-09,6130,621,979,1600,瑞穗,三等
2020-10-10,6130,584,642,1226,瑞穗,三等
2020-10-11,6130,1134,589,1723,瑞穗,三等
2020-10-12,6130,759,731,1490,瑞穗,三等
2020-10-13,6130,517,558,1075,瑞穗,三等
2020-10-14,6130,479,472,951,瑞穗,三等
2020-10-15,6130,546,674,1220,瑞穗,三等
2020-10-16,6130,560,882,1442,瑞穗,三等
2020-10-17,6130,475,721,1196,瑞穗,三等
2020-10-18,6130,808,548,1356,瑞穗,三等
2020-10-19,6130,618,595,1213,瑞穗,三等
2020-10-20,6130,562,552,1114,瑞穗,三等
2020-10-21,6130,562,579,1141,瑞穗,三等
2020-10-22,6130,543,536,1079,瑞穗,三等
2020-10-23,6130,722,883,1605,瑞穗,三等
2020-10-24,6130,595,742,1337,瑞穗,三等
2020-10-25,6130,876,561,1437,瑞穗,三等
2020-10-26,6130,623,608,1231,瑞穗,三等
2020-10-27,6130,524,524,1048,瑞穗,三等
2020-10-28,6130,464,511,975,瑞穗,三等
2020-10-29,6130,435,580,1015,瑞穗,三等
2020-10-30,6130,636,1096,1732,瑞穗,三等
2020-10-31,6130,538,685,1223,瑞穗,三等
2020-11-01,6130,1099,509,1608,瑞穗,三等
2020-11-02,6130,606,612,1218,瑞穗,三等
2020-11-03,6130,500,802,1302,瑞穗,三等
2020-11-04,6130,630,534,1164,瑞穗,三等
2020-11-05,6130,733,497,1230,瑞穗,三等
2020-11-06,6130,707,788,1495,瑞穗,三等
2020-11-07,6130,577,975,1552,瑞穗,三等
2020-11-08,6130,828,605,1433,瑞穗,三等
2020-11-09,6130,532,556,1088,瑞穗,三等
2020-11-10,6130,587,484,1071,瑞穗,三等
2020-11-11,6130,448,519,967,瑞穗,三等
2020-11-12,6130,519,635,1154,瑞穗,三等
2020-11-13,6130,635,885,1520,瑞穗,三等
2020-11-14,6130,732,709,1441,瑞穗,三等
2020-11-15,6130,874,553,1427,瑞穗,三等
2020-11-16,6130,601,642,1243,瑞穗,三等
2020-11-17,6130,507,501,1008,瑞穗,三等
2020-11-18,6130,476,512,988,瑞穗,三等
2020-11-19,6130,465,607,1072,瑞穗,三等
2020-11-20,6130,692,1080,1772,瑞穗,三等
2020-11-21,6130,712,935,1647,瑞穗,三等
2020-11-22,6130,1028,719,1747,瑞穗,三等
2020-11-23,6130,662,580,1242,瑞穗,三等
2020-11-24,6130,525,497,1022,瑞穗,三等
2020-11-25,6130,576,471,1047,瑞穗,三等
2020-11-26,6130,431,659,1090,瑞穗,三等
2020-11-27,6130,597,861,1458,瑞穗,三等
2020-11-28,6130,575,931,1506,瑞穗,三等
2020-11-29,6130,1032,555,1587,瑞穗,三等
2020-11-30,6130,649,519,1168,瑞穗,三等
2020-12-01,6130,536,514,1050,瑞穗,三等
2020-12-02,6130,437,431,868,瑞穗,三等
2020-12-03,6130,439,526,965,瑞穗,三等
2020-12-04,6130,652,789,1441,瑞穗,三等
2020-12-05,6130,592,678,1270,瑞穗,三等
2020-12-06,6130,940,677,1617,瑞穗,三等
2020-12-07,6130,573,549,1122,瑞穗,三等
2020-12-08,6130,671,563,1234,瑞穗,三等
2020-12-09,6130,501,492,993,瑞穗,三等
2020-12-10,6130,527,455,982,瑞穗,三等
2020-12-11,6130,645,881,1526,瑞穗,三等
2020-12-12,6130,657,729,1386,瑞穗,三等
2020-12-13,6130,911,758,1669,瑞穗,三等
2020-12-14,6130,595,587,1182,瑞穗,三等
2020-12-15,6130,553,474,1027,瑞穗,三等
2020-12-16,6130,477,510,987,瑞穗,三等
2020-12-17,6130,503,531,1034,瑞穗,三等
2020-12-18,6130,647,921,1568,瑞穗,三等
2020-12-19,6130,547,741,1288,瑞穗,三等
2020-12-20,6130,871,608,1479,瑞穗,三等
2020-12-21,6130,623,831,1454,瑞穗,三等
2020-12-22,6130,631,535,1166,瑞穗,三等
2020-12-23,6130,861,579,1440,瑞穗,三等
2020-12-24,6130,496,551,1047,瑞穗,三等
2020-12-25,6130,643,811,1454,瑞穗,三等
2020-12-26,6130,541,710,1251,瑞穗,三等
2020-12-27,6130,1043,734,1777,瑞穗,三等
2020-12-28,6130,658,838,1496,瑞穗,三等
2020-12-29,6130,582,611,1193,瑞穗,三等
2020-12-30,6130,599,593,1192,瑞穗,三等
2020-12-31,6130,741,899,1640,瑞穗,三等
2020-01-01,6140,40,34,74,富源,三等
2020-01-02,6140,34,27,61,富源,三等
2020-01-03,6140,40,39,79,富源,三等
2020-01-04,6140,39,53,92,富源,三等
2020-01-05,6140,41,32,73,富源,三等
2020-01-06,6140,33,33,66,富源,三等
2020-01-07,6140,42,33,75,富源,三等
2020-01-08,6140,32,37,69,富源,三等
2020-01-09,6140,30,31,61,富源,三等
2020-01-10,6140,48,48,96,富源,三等
2020-01-11,6140,29,43,72,富源,三等
2020-01-12,6140,66,32,98,富源,三等
2020-01-13,6140,35,39,74,富源,三等
2020-01-14,6140,37,27,64,富源,三等
2020-01-15,6140,38,27,65,富源,三等
2020-01-16,6140,30,30,60,富源,三等
2020-01-17,6140,61,33,94,富源,三等
2020-01-18,6140,31,30,61,富源,三等
2020-01-19,6140,34,32,66,富源,三等
2020-01-20,6140,45,43,88,富源,三等
2020-01-21,6140,28,56,84,富源,三等
2020-01-22,6140,45,57,102,富源,三等
2020-01-23,6140,57,61,118,富源,三等
2020-01-24,6140,22,87,109,富源,三等
2020-01-25,6140,67,65,132,富源,三等
2020-01-26,6140,84,74,158,富源,三等
2020-01-27,6140,87,39,126,富源,三等
2020-01-28,6140,65,37,102,富源,三等
2020-01-29,6140,75,26,101,富源,三等
2020-01-30,6140,59,31,90,富源,三等
2020-01-31,6140,64,41,105,富源,三等
2020-02-01,6140,29,36,65,富源,三等
2020-02-02,6140,27,33,60,富源,三等
2020-02-03,6140,43,77,120,富源,三等
2020-02-04,6140,66,62,128,富源,三等
2020-02-05,6140,40,40,80,富源,三等
2020-02-06,6140,57,45,102,富源,三等
2020-02-07,6140,71,72,143,富源,三等
2020-02-08,6140,38,46,84,富源,三等
2020-02-09,6140,42,38,80,富源,三等
2020-02-10,6140,42,39,81,富源,三等
2020-02-11,6140,53,44,97,富源,三等
2020-02-12,6140,41,38,79,富源,三等
2020-02-13,6140,44,35,79,富源,三等
2020-02-14,6140,45,34,79,富源,三等
2020-02-15,6140,38,42,80,富源,三等
2020-02-16,6140,32,29,61,富源,三等
2020-02-17,6140,31,29,60,富源,三等
2020-02-18,6140,42,37,79,富源,三等
2020-02-19,6140,40,38,78,富源,三等
2020-02-20,6140,34,33,67,富源,三等
2020-02-21,6140,72,49,121,富源,三等
2020-02-22,6140,29,29,58,富源,三等
2020-02-23,6140,40,26,66,富源,三等
2020-02-24,6140,57,47,104,富源,三等
2020-02-25,6140,28,32,60,富源,三等
2020-02-26,6140,28,24,52,富源,三等
2020-02-27,6140,37,50,87,富源,三等
2020-02-28,6140,27,41,68,富源,三等
2020-02-29,6140,52,50,102,富源,三等
2020-03-01,6140,66,25,91,富源,三等
2020-03-02,6140,37,35,72,富源,三等
2020-03-03,6140,34,35,69,富源,三等
2020-03-04,6140,31,26,57,富源,三等
2020-03-05,6140,39,37,76,富源,三等
2020-03-06,6140,46,55,101,富源,三等
2020-03-07,6140,28,47,75,富源,三等
2020-03-08,6140,48,32,80,富源,三等
2020-03-09,6140,44,44,88,富源,三等
2020-03-10,6140,37,32,69,富源,三等
2020-03-11,6140,36,37,73,富源,三等
2020-03-12,6140,34,38,72,富源,三等
2020-03-13,6140,43,62,105,富源,三等
2020-03-14,6140,26,33,59,富源,三等
2020-03-15,6140,55,33,88,富源,三等
2020-03-16,6140,43,43,86,富源,三等
2020-03-17,6140,28,31,59,富源,三等
2020-03-18,6140,41,33,74,富源,三等
2020-03-19,6140,33,34,67,富源,三等
2020-03-20,6140,36,53,89,富源,三等
2020-03-21,6140,29,39,68,富源,三等
2020-03-22,6140,52,26,78,富源,三等
2020-03-23,6140,36,37,73,富源,三等
2020-03-24,6140,39,32,71,富源,三等
2020-03-25,6140,32,28,60,富源,三等
2020-03-26,6140,33,31,64,富源,三等
2020-03-27,6140,41,38,79,富源,三等
2020-03-28,6140,37,50,87,富源,三等
2020-03-29,6140,51,31,82,富源,三等
2020-03-30,6140,37,41,78,富源,三等
2020-03-31,6140,28,36,64,富源,三等
2020-04-01,6140,39,43,82,富源,三等
2020-04-02,6140,26,78,104,富源,三等
2020-04-03,6140,51,65,116,富源,三等
2020-04-04,6140,57,33,90,富源,三等
2020-04-05,6140,77,27,104,富源,三等
2020-04-06,6140,45,28,73,富源,三等
2020-04-07,6140,31,24,55,富源,三等
2020-04-08,6140,28,25,53,富源,三等
2020-04-09,6140,35,19,54,富源,三等
2020-04-10,6140,41,53,94,富源,三等
2020-04-11,6140,29,46,75,富源,三等
2020-04-12,6140,33,23,56,富源,三等
2020-04-13,6140,24,34,58,富源,三等
2020-04-14,6140,38,37,75,富源,三等
2020-04-15,6140,36,22,58,富源,三等
2020-04-16,6140,32,27,59,富源,三等
2020-04-17,6140,40,50,90,富源,三等
2020-04-18,6140,43,48,91,富源,三等
2020-04-19,6140,40,23,63,富源,三等
2020-04-20,6140,34,61,95,富源,三等
2020-04-21,6140,23,24,47,富源,三等
2020-04-22,6140,23,22,45,富源,三等
2020-04-23,6140,39,27,66,富源,三等
2020-04-24,6140,45,31,76,富源,三等
2020-04-25,6140,26,39,65,富源,三等
2020-04-26,6140,38,23,61,富源,三等
2020-04-27,6140,37,37,74,富源,三等
2020-04-28,6140,29,14,43,富源,三等
2020-04-29,6140,29,28,57,富源,三等
2020-04-30,6140,31,31,62,富源,三等
2020-05-01,6140,50,48,98,富源,三等
2020-05-02,6140,35,50,85,富源,三等
2020-05-03,6140,52,24,76,富源,三等
2020-05-04,6140,30,36,66,富源,三等
2020-05-05,6140,36,31,67,富源,三等
2020-05-06,6140,24,19,43,富源,三等
2020-05-07,6140,33,29,62,富源,三等
2020-05-08,6140,31,44,75,富源,三等
2020-05-09,6140,45,65,110,富源,三等
2020-05-10,6140,53,33,86,富源,三等
2020-05-11,6140,36,44,80,富源,三等
2020-05-12,6140,49,41,90,富源,三等
2020-05-13,6140,20,19,39,富源,三等
2020-05-14,6140,28,24,52,富源,三等
2020-05-15,6140,53,44,97,富源,三等
2020-05-16,6140,32,41,73,富源,三等
2020-05-17,6140,57,30,87,富源,三等
2020-05-18,6140,46,31,77,富源,三等
2020-05-19,6140,33,24,57,富源,三等
2020-05-20,6140,29,29,58,富源,三等
2020-05-21,6140,36,36,72,富源,三等
2020-05-22,6140,43,37,80,富源,三等
2020-05-23,6140,47,35,82,富源,三等
2020-05-24,6140,47,24,71,富源,三等
2020-05-25,6140,34,43,77,富源,三等
2020-05-26,6140,31,30,61,富源,三等
2020-05-27,6140,27,28,55,富源,三等
2020-05-28,6140,25,36,61,富源,三等
2020-05-29,6140,44,32,76,富源,三等
2020-05-30,6140,41,51,92,富源,三等
2020-05-31,6140,53,28,81,富源,三等
2020-06-01,6140,38,34,72,富源,三等
2020-06-02,6140,28,25,53,富源,三等
2020-06-03,6140,32,39,71,富源,三等
2020-06-04,6140,32,30,62,富源,三等
2020-06-05,6140,36,42,78,富源,三等
2020-06-06,6140,46,50,96,富源,三等
2020-06-07,6140,43,26,69,富源,三等
2020-06-08,6140,41,40,81,富源,三等
2020-06-09,6140,38,29,67,富源,三等
2020-06-10,6140,39,23,62,富源,三等
2020-06-11,6140,27,40,67,富源,三等
2020-06-12,6140,43,53,96,富源,三等
2020-06-13,6140,30,41,71,富源,三等
2020-06-14,6140,45,29,74,富源,三等
2020-06-15,6140,41,41,82,富源,三等
2020-06-16,6140,47,37,84,富源,三等
2020-06-17,6140,36,30,66,富源,三等
2020-06-18,6140,29,26,55,富源,三等
2020-06-19,6140,24,31,55,富源,三等
2020-06-20,6140,40,43,83,富源,三等
2020-06-21,6140,33,34,67,富源,三等
2020-06-22,6140,36,27,63,富源,三等
2020-06-23,6140,34,48,82,富源,三等
2020-06-24,6140,49,46,95,富源,三等
2020-06-25,6140,17,45,62,富源,三等
2020-06-26,6140,43,35,78,富源,三等
2020-06-27,6140,51,36,87,富源,三等
2020-06-28,6140,63,30,93,富源,三等
2020-06-29,6140,55,39,94,富源,三等
2020-06-30,6140,38,21,59,富源,三等
2020-07-01,6140,28,33,61,富源,三等
2020-07-02,6140,31,44,75,富源,三等
2020-07-03,6140,43,35,78,富源,三等
2020-07-04,6140,35,46,81,富源,三等
2020-07-05,6140,71,27,98,富源,三等
2020-07-06,6140,38,43,81,富源,三等
2020-07-07,6140,40,27,67,富源,三等
2020-07-08,6140,50,34,84,富源,三等
2020-07-09,6140,43,33,76,富源,三等
2020-07-10,6140,38,50,88,富源,三等
2020-07-11,6140,34,59,93,富源,三等
2020-07-12,6140,46,22,68,富源,三等
2020-07-13,6140,37,34,71,富源,三等
2020-07-14,6140,46,50,96,富源,三等
2020-07-15,6140,25,20,45,富源,三等
2020-07-16,6140,40,50,90,富源,三等
2020-07-17,6140,27,41,68,富源,三等
2020-07-18,6140,41,59,100,富源,三等
2020-07-19,6140,48,48,96,富源,三等
2020-07-20,6140,43,34,77,富源,三等
2020-07-21,6140,38,40,78,富源,三等
2020-07-22,6140,46,42,88,富源,三等
2020-07-23,6140,50,31,81,富源,三等
2020-07-24,6140,43,41,84,富源,三等
2020-07-25,6140,38,54,92,富源,三等
2020-07-26,6140,35,44,79,富源,三等
2020-07-27,6140,53,34,87,富源,三等
2020-07-28,6140,49,41,90,富源,三等
2020-07-29,6140,40,29,69,富源,三等
2020-07-30,6140,38,28,66,富源,三等
2020-07-31,6140,42,41,83,富源,三等
2020-08-01,6140,42,75,117,富源,三等
2020-08-02,6140,61,46,107,富源,三等
2020-08-03,6140,60,36,96,富源,三等
2020-08-04,6140,38,39,77,富源,三等
2020-08-05,6140,43,51,94,富源,三等
2020-08-06,6140,36,41,77,富源,三等
2020-08-07,6140,56,59,115,富源,三等
2020-08-08,6140,48,49,97,富源,三等
2020-08-09,6140,61,37,98,富源,三等
2020-08-10,6140,59,42,101,富源,三等
2020-08-11,6140,28,32,60,富源,三等
2020-08-12,6140,32,29,61,富源,三等
2020-08-13,6140,41,58,99,富源,三等
2020-08-14,6140,49,76,125,富源,三等
2020-08-15,6140,70,81,151,富源,三等
2020-08-16,6140,70,37,107,富源,三等
2020-08-17,6140,88,37,125,富源,三等
2020-08-18,6140,41,37,78,富源,三等
2020-08-19,6140,49,53,102,富源,三等
2020-08-20,6140,69,40,109,富源,三等
2020-08-21,6140,47,39,86,富源,三等
2020-08-22,6140,34,30,64,富源,三等
2020-08-23,6140,45,25,70,富源,三等
2020-08-24,6140,46,39,85,富源,三等
2020-08-25,6140,31,33,64,富源,三等
2020-08-26,6140,44,45,89,富源,三等
2020-08-27,6140,28,48,76,富源,三等
2020-08-28,6140,54,40,94,富源,三等
2020-08-29,6140,28,50,78,富源,三等
2020-08-30,6140,34,26,60,富源,三等
2020-08-31,6140,32,44,76,富源,三等
2020-09-01,6140,42,39,81,富源,三等
2020-09-02,6140,43,39,82,富源,三等
2020-09-03,6140,32,34,66,富源,三等
2020-09-04,6140,43,51,94,富源,三等
2020-09-05,6140,25,54,79,富源,三等
2020-09-06,6140,58,36,94,富源,三等
2020-09-07,6140,48,35,83,富源,三等
2020-09-08,6140,26,32,58,富源,三等
2020-09-09,6140,31,42,73,富源,三等
2020-09-10,6140,42,34,76,富源,三等
2020-09-11,6140,35,40,75,富源,三等
2020-09-12,6140,42,46,88,富源,三等
2020-09-13,6140,57,28,85,富源,三等
2020-09-14,6140,41,43,84,富源,三等
2020-09-15,6140,29,24,53,富源,三等
2020-09-16,6140,30,29,59,富源,三等
2020-09-17,6140,26,30,56,富源,三等
2020-09-18,6140,33,43,76,富源,三等
2020-09-19,6140,21,57,78,富源,三等
2020-09-20,6140,51,39,90,富源,三等
2020-09-21,6140,61,34,95,富源,三等
2020-09-22,6140,44,36,80,富源,三等
2020-09-23,6140,35,30,65,富源,三等
2020-09-24,6140,30,29,59,富源,三等
2020-09-25,6140,22,25,47,富源,三等
2020-09-26,6140,33,51,84,富源,三等
2020-09-27,6140,50,37,87,富源,三等
2020-09-28,6140,51,37,88,富源,三等
2020-09-29,6140,29,35,64,富源,三等
2020-09-30,6140,64,87,151,富源,三等
2020-10-01,6140,44,52,96,富源,三等
2020-10-02,6140,46,47,93,富源,三等
2020-10-03,6140,64,46,110,富源,三等
2020-10-04,6140,93,24,117,富源,三等
2020-10-05,6140,58,48,106,富源,三等
2020-10-06,6140,31,33,64,富源,三等
2020-10-07,6140,33,41,74,富源,三等
2020-10-08,6140,43,72,115,富源,三等
2020-10-09,6140,40,52,92,富源,三等
2020-10-10,6140,39,52,91,富源,三等
2020-10-11,6140,75,32,107,富源,三等
2020-10-12,6140,48,37,85,富源,三等
2020-10-13,6140,34,33,67,富源,三等
2020-10-14,6140,30,33,63,富源,三等
2020-10-15,6140,36,52,88,富源,三等
2020-10-16,6140,41,67,108,富源,三等
2020-10-17,6140,31,26,57,富源,三等
2020-10-18,6140,65,55,120,富源,三等
2020-10-19,6140,57,36,93,富源,三等
2020-10-20,6140,60,28,88,富源,三等
2020-10-21,6140,24,86,110,富源,三等
2020-10-22,6140,42,35,77,富源,三等
2020-10-23,6140,35,69,104,富源,三等
2020-10-24,6140,20,36,56,富源,三等
2020-10-25,6140,68,24,92,富源,三等
2020-10-26,6140,47,32,79,富源,三等
2020-10-27,6140,41,29,70,富源,三等
2020-10-28,6140,43,29,72,富源,三等
2020-10-29,6140,42,35,77,富源,三等
2020-10-30,6140,35,65,100,富源,三等
2020-10-31,6140,46,62,108,富源,三等
2020-11-01,6140,51,25,76,富源,三等
2020-11-02,6140,50,40,90,富源,三等
2020-11-03,6140,32,28,60,富源,三等
2020-11-04,6140,29,30,59,富源,三等
2020-11-05,6140,41,31,72,富源,三等
2020-11-06,6140,49,54,103,富源,三等
2020-11-07,6140,28,38,66,富源,三等
2020-11-08,6140,55,39,94,富源,三等
2020-11-09,6140,39,37,76,富源,三等
2020-11-10,6140,35,25,60,富源,三等
2020-11-11,6140,30,23,53,富源,三等
2020-11-12,6140,32,33,65,富源,三等
2020-11-13,6140,31,53,84,富源,三等
2020-11-14,6140,36,46,82,富源,三等
2020-11-15,6140,43,45,88,富源,三等
2020-11-16,6140,47,58,105,富源,三等
2020-11-17,6140,30,32,62,富源,三等
2020-11-18,6140,33,35,68,富源,三等
2020-11-19,6140,40,36,76,富源,三等
2020-11-20,6140,44,50,94,富源,三等
2020-11-21,6140,32,47,79,富源,三等
2020-11-22,6140,61,35,96,富源,三等
2020-11-23,6140,44,28,72,富源,三等
2020-11-24,6140,38,34,72,富源,三等
2020-11-25,6140,29,32,61,富源,三等
2020-11-26,6140,37,47,84,富源,三等
2020-11-27,6140,44,67,111,富源,三等
2020-11-28,6140,42,35,77,富源,三等
2020-11-29,6140,53,23,76,富源,三等
2020-11-30,6140,43,28,71,富源,三等
2020-12-01,6140,34,36,70,富源,三等
2020-12-02,6140,39,37,76,富源,三等
2020-12-03,6140,36,23,59,富源,三等
2020-12-04,6140,36,52,88,富源,三等
2020-12-05,6140,42,55,97,富源,三等
2020-12-06,6140,51,36,87,富源,三等
2020-12-07,6140,44,48,92,富源,三等
2020-12-08,6140,46,33,79,富源,三等
2020-12-09,6140,31,27,58,富源,三等
2020-12-10,6140,29,26,55,富源,三等
2020-12-11,6140,34,50,84,富源,三等
2020-12-12,6140,21,19,40,富源,三等
2020-12-13,6140,45,24,69,富源,三等
2020-12-14,6140,53,56,109,富源,三等
2020-12-15,6140,57,54,111,富源,三等
2020-12-16,6140,47,33,80,富源,三等
2020-12-17,6140,48,51,99,富源,三等
2020-12-18,6140,50,64,114,富源,三等
2020-12-19,6140,30,42,72,富源,三等
2020-12-20,6140,56,24,80,富源,三等
2020-12-21,6140,38,41,79,富源,三等
2020-12-22,6140,31,34,65,富源,三等
2020-12-23,6140,35,27,62,富源,三等
2020-12-24,6140,32,29,61,富源,三等
2020-12-25,6140,32,51,83,富源,三等
2020-12-26,6140,38,39,77,富源,三等
2020-12-27,6140,53,19,72,富源,三等
2020-12-28,6140,50,40,90,富源,三等
2020-12-29,6140,30,33,63,富源,三等
2020-12-30,6140,39,21,60,富源,三等
2020-12-31,6140,48,61,109,富源,三等
2020-01-01,6150,3,3,6,大富,招呼
2020-01-02,6150,9,8,17,大富,招呼
2020-01-03,6150,7,7,14,大富,招呼
2020-01-04,6150,3,7,10,大富,招呼
2020-01-05,6150,6,2,8,大富,招呼
2020-01-06,6150,10,3,13,大富,招呼
2020-01-07,6150,2,0,2,大富,招呼
2020-01-08,6150,5,1,6,大富,招呼
2020-01-09,6150,9,3,12,大富,招呼
2020-01-10,6150,7,7,14,大富,招呼
2020-01-11,6150,12,5,17,大富,招呼
2020-01-12,6150,4,2,6,大富,招呼
2020-01-13,6150,5,3,8,大富,招呼
2020-01-14,6150,8,5,13,大富,招呼
2020-01-15,6150,5,23,28,大富,招呼
2020-01-16,6150,5,6,11,大富,招呼
2020-01-17,6150,0,11,11,大富,招呼
2020-01-18,6150,4,6,10,大富,招呼
2020-01-19,6150,5,6,11,大富,招呼
2020-01-20,6150,3,4,7,大富,招呼
2020-01-21,6150,4,3,7,大富,招呼
2020-01-22,6150,4,9,13,大富,招呼
2020-01-23,6150,3,10,13,大富,招呼
2020-01-24,6150,2,4,6,大富,招呼
2020-01-25,6150,7,19,26,大富,招呼
2020-01-26,6150,5,5,10,大富,招呼
2020-01-27,6150,14,12,26,大富,招呼
2020-01-28,6150,19,2,21,大富,招呼
2020-01-29,6150,13,8,21,大富,招呼
2020-01-30,6150,6,10,16,大富,招呼
2020-01-31,6150,1,2,3,大富,招呼
2020-02-01,6150,10,4,14,大富,招呼
2020-02-02,6150,2,1,3,大富,招呼
2020-02-03,6150,5,1,6,大富,招呼
2020-02-04,6150,6,3,9,大富,招呼
2020-02-05,6150,4,4,8,大富,招呼
2020-02-06,6150,4,10,14,大富,招呼
2020-02-07,6150,2,6,8,大富,招呼
2020-02-08,6150,6,4,10,大富,招呼
2020-02-09,6150,4,6,10,大富,招呼
2020-02-10,6150,2,5,7,大富,招呼
2020-02-11,6150,5,5,10,大富,招呼
2020-02-12,6150,2,10,12,大富,招呼
2020-02-13,6150,2,3,5,大富,招呼
2020-02-14,6150,5,8,13,大富,招呼
2020-02-15,6150,11,4,15,大富,招呼
2020-02-16,6150,5,7,12,大富,招呼
2020-02-17,6150,8,5,13,大富,招呼
2020-02-18,6150,5,3,8,大富,招呼
2020-02-19,6150,4,2,6,大富,招呼
2020-02-20,6150,6,2,8,大富,招呼
2020-02-21,6150,3,6,9,大富,招呼
2020-02-22,6150,4,4,8,大富,招呼
2020-02-23,6150,6,5,11,大富,招呼
2020-02-24,6150,11,9,20,大富,招呼
2020-02-25,6150,4,7,11,大富,招呼
2020-02-26,6150,2,4,6,大富,招呼
2020-02-27,6150,7,12,19,大富,招呼
2020-02-28,6150,0,3,3,大富,招呼
2020-02-29,6150,11,9,20,大富,招呼
2020-03-01,6150,12,6,18,大富,招呼
2020-03-02,6150,9,5,14,大富,招呼
2020-03-03,6150,4,3,7,大富,招呼
2020-03-04,6150,6,2,8,大富,招呼
2020-03-05,6150,8,7,15,大富,招呼
2020-03-06,6150,4,6,10,大富,招呼
2020-03-07,6150,11,2,13,大富,招呼
2020-03-08,6150,4,4,8,大富,招呼
2020-03-09,6150,4,3,7,大富,招呼
2020-03-10,6150,4,5,9,大富,招呼
2020-03-11,6150,0,3,3,大富,招呼
2020-03-12,6150,8,6,14,大富,招呼
2020-03-13,6150,5,8,13,大富,招呼
2020-03-14,6150,4,2,6,大富,招呼
2020-03-15,6150,4,16,20,大富,招呼
2020-03-16,6150,5,6,11,大富,招呼
2020-03-17,6150,6,1,7,大富,招呼
2020-03-18,6150,2,2,4,大富,招呼
2020-03-19,6150,5,3,8,大富,招呼
2020-03-20,6150,3,8,11,大富,招呼
2020-03-21,6150,6,8,14,大富,招呼
2020-03-22,6150,7,5,12,大富,招呼
2020-03-23,6150,4,6,10,大富,招呼
2020-03-24,6150,4,5,9,大富,招呼
2020-03-25,6150,0,5,5,大富,招呼
2020-03-26,6150,6,5,11,大富,招呼
2020-03-27,6150,5,7,12,大富,招呼
2020-03-28,6150,1,4,5,大富,招呼
2020-03-29,6150,2,4,6,大富,招呼
2020-03-30,6150,7,5,12,大富,招呼
2020-03-31,6150,3,3,6,大富,招呼
2020-04-01,6150,5,11,16,大富,招呼
2020-04-02,6150,8,11,19,大富,招呼
2020-04-03,6150,4,22,26,大富,招呼
2020-04-04,6150,5,2,7,大富,招呼
2020-04-05,6150,8,1,9,大富,招呼
2020-04-06,6150,5,5,10,大富,招呼
2020-04-07,6150,4,1,5,大富,招呼
2020-04-08,6150,4,3,7,大富,招呼
2020-04-09,6150,2,1,3,大富,招呼
2020-04-10,6150,4,3,7,大富,招呼
2020-04-11,6150,4,4,8,大富,招呼
2020-04-12,6150,5,1,6,大富,招呼
2020-04-13,6150,5,4,9,大富,招呼
2020-04-14,6150,7,2,9,大富,招呼
2020-04-15,6150,2,1,3,大富,招呼
2020-04-16,6150,2,3,5,大富,招呼
2020-04-17,6150,3,10,13,大富,招呼
2020-04-18,6150,3,3,6,大富,招呼
2020-04-19,6150,10,5,15,大富,招呼
2020-04-20,6150,3,9,12,大富,招呼
2020-04-21,6150,0,2,2,大富,招呼
2020-04-22,6150,4,1,5,大富,招呼
2020-04-23,6150,5,3,8,大富,招呼
2020-04-24,6150,4,6,10,大富,招呼
2020-04-25,6150,3,6,9,大富,招呼
2020-04-26,6150,3,2,5,大富,招呼
2020-04-27,6150,3,1,4,大富,招呼
2020-04-28,6150,7,2,9,大富,招呼
2020-04-29,6150,2,3,5,大富,招呼
2020-04-30,6150,4,2,6,大富,招呼
2020-05-01,6150,2,9,11,大富,招呼
2020-05-02,6150,8,5,13,大富,招呼
2020-05-03,6150,2,1,3,大富,招呼
2020-05-04,6150,4,3,7,大富,招呼
2020-05-05,6150,7,3,10,大富,招呼
2020-05-06,6150,6,7,13,大富,招呼
2020-05-07,6150,2,3,5,大富,招呼
2020-05-08,6150,8,6,14,大富,招呼
2020-05-09,6150,9,10,19,大富,招呼
2020-05-10,6150,12,5,17,大富,招呼
2020-05-11,6150,5,7,12,大富,招呼
2020-05-12,6150,5,10,15,大富,招呼
2020-05-13,6150,7,4,11,大富,招呼
2020-05-14,6150,1,1,2,大富,招呼
2020-05-15,6150,3,12,15,大富,招呼
2020-05-16,6150,10,3,13,大富,招呼
2020-05-17,6150,7,5,12,大富,招呼
2020-05-18,6150,13,2,15,大富,招呼
2020-05-19,6150,3,1,4,大富,招呼
2020-05-20,6150,6,5,11,大富,招呼
2020-05-21,6150,4,3,7,大富,招呼
2020-05-22,6150,7,7,14,大富,招呼
2020-05-23,6150,5,6,11,大富,招呼
2020-05-24,6150,6,5,11,大富,招呼
2020-05-25,6150,9,5,14,大富,招呼
2020-05-26,6150,4,4,8,大富,招呼
2020-05-27,6150,5,5,10,大富,招呼
2020-05-28,6150,8,1,9,大富,招呼
2020-05-29,6150,2,10,12,大富,招呼
2020-05-30,6150,7,6,13,大富,招呼
2020-05-31,6150,3,2,5,大富,招呼
2020-06-01,6150,9,5,14,大富,招呼
2020-06-02,6150,5,3,8,大富,招呼
2020-06-03,6150,9,10,19,大富,招呼
2020-06-04,6150,6,4,10,大富,招呼
2020-06-05,6150,7,12,19,大富,招呼
2020-06-06,6150,0,4,4,大富,招呼
2020-06-07,6150,2,1,3,大富,招呼
2020-06-08,6150,4,4,8,大富,招呼
2020-06-09,6150,4,4,8,大富,招呼
2020-06-10,6150,6,3,9,大富,招呼
2020-06-11,6150,3,2,5,大富,招呼
2020-06-12,6150,4,4,8,大富,招呼
2020-06-13,6150,5,9,14,大富,招呼
2020-06-14,6150,3,0,3,大富,招呼
2020-06-15,6150,5,11,16,大富,招呼
2020-06-16,6150,2,3,5,大富,招呼
2020-06-17,6150,7,6,13,大富,招呼
2020-06-18,6150,3,5,8,大富,招呼
2020-06-19,6150,3,2,5,大富,招呼
2020-06-20,6150,6,8,14,大富,招呼
2020-06-21,6150,2,6,8,大富,招呼
2020-06-22,6150,6,7,13,大富,招呼
2020-06-23,6150,5,6,11,大富,招呼
2020-06-24,6150,7,9,16,大富,招呼
2020-06-25,6150,1,5,6,大富,招呼
2020-06-26,6150,5,4,9,大富,招呼
2020-06-27,6150,5,10,15,大富,招呼
2020-06-28,6150,11,4,15,大富,招呼
2020-06-29,6150,5,5,10,大富,招呼
2020-06-30,6150,6,5,11,大富,招呼
2020-07-01,6150,5,7,12,大富,招呼
2020-07-02,6150,4,33,37,大富,招呼
2020-07-03,6150,5,3,8,大富,招呼
2020-07-04,6150,9,8,17,大富,招呼
2020-07-05,6150,4,11,15,大富,招呼
2020-07-06,6150,5,1,6,大富,招呼
2020-07-07,6150,6,3,9,大富,招呼
2020-07-08,6150,8,8,16,大富,招呼
2020-07-09,6150,5,1,6,大富,招呼
2020-07-10,6150,1,5,6,大富,招呼
2020-07-11,6150,5,5,10,大富,招呼
2020-07-12,6150,4,3,7,大富,招呼
2020-07-13,6150,13,5,18,大富,招呼
2020-07-14,6150,4,5,9,大富,招呼
2020-07-15,6150,9,7,16,大富,招呼
2020-07-16,6150,10,11,21,大富,招呼
2020-07-17,6150,7,4,11,大富,招呼
2020-07-18,6150,5,14,19,大富,招呼
2020-07-19,6150,4,2,6,大富,招呼
2020-07-20,6150,2,5,7,大富,招呼
2020-07-21,6150,4,4,8,大富,招呼
2020-07-22,6150,7,9,16,大富,招呼
2020-07-23,6150,10,6,16,大富,招呼
2020-07-24,6150,4,13,17,大富,招呼
2020-07-25,6150,17,7,24,大富,招呼
2020-07-26,6150,6,7,13,大富,招呼
2020-07-27,6150,12,2,14,大富,招呼
2020-07-28,6150,1,7,8,大富,招呼
2020-07-29,6150,7,5,12,大富,招呼
2020-07-30,6150,5,5,10,大富,招呼
2020-07-31,6150,8,10,18,大富,招呼
2020-08-01,6150,12,6,18,大富,招呼
2020-08-02,6150,2,4,6,大富,招呼
2020-08-03,6150,5,4,9,大富,招呼
2020-08-04,6150,5,2,7,大富,招呼
2020-08-05,6150,8,3,11,大富,招呼
2020-08-06,6150,8,3,11,大富,招呼
2020-08-07,6150,6,24,30,大富,招呼
2020-08-08,6150,5,6,11,大富,招呼
2020-08-09,6150,8,7,15,大富,招呼
2020-08-10,6150,10,6,16,大富,招呼
2020-08-11,6150,8,11,19,大富,招呼
2020-08-12,6150,7,10,17,大富,招呼
2020-08-13,6150,10,6,16,大富,招呼
2020-08-14,6150,4,6,10,大富,招呼
2020-08-15,6150,4,9,13,大富,招呼
2020-08-16,6150,5,2,7,大富,招呼
2020-08-17,6150,8,7,15,大富,招呼
2020-08-18,6150,3,3,6,大富,招呼
2020-08-19,6150,9,6,15,大富,招呼
2020-08-20,6150,4,2,6,大富,招呼
2020-08-21,6150,4,10,14,大富,招呼
2020-08-22,6150,5,10,15,大富,招呼
2020-08-23,6150,1,3,4,大富,招呼
2020-08-24,6150,7,2,9,大富,招呼
2020-08-25,6150,7,6,13,大富,招呼
2020-08-26,6150,2,4,6,大富,招呼
2020-08-27,6150,3,7,10,大富,招呼
2020-08-28,6150,1,2,3,大富,招呼
2020-08-29,6150,4,5,9,大富,招呼
2020-08-30,6150,5,4,9,大富,招呼
2020-08-31,6150,4,3,7,大富,招呼
2020-09-01,6150,4,8,12,大富,招呼
2020-09-02,6150,12,10,22,大富,招呼
2020-09-03,6150,10,13,23,大富,招呼
2020-09-04,6150,5,7,12,大富,招呼
2020-09-05,6150,4,7,11,大富,招呼
2020-09-06,6150,13,2,15,大富,招呼
2020-09-07,6150,7,3,10,大富,招呼
2020-09-08,6150,5,1,6,大富,招呼
2020-09-09,6150,8,6,14,大富,招呼
2020-09-10,6150,3,1,4,大富,招呼
2020-09-11,6150,3,11,14,大富,招呼
2020-09-12,6150,3,16,19,大富,招呼
2020-09-13,6150,8,6,14,大富,招呼
2020-09-14,6150,5,0,5,大富,招呼
2020-09-15,6150,7,5,12,大富,招呼
2020-09-16,6150,17,1,18,大富,招呼
2020-09-17,6150,6,6,12,大富,招呼
2020-09-18,6150,2,7,9,大富,招呼
2020-09-19,6150,6,7,13,大富,招呼
2020-09-20,6150,4,10,14,大富,招呼
2020-09-21,6150,2,2,4,大富,招呼
2020-09-22,6150,2,7,9,大富,招呼
2020-09-23,6150,2,2,4,大富,招呼
2020-09-24,6150,4,5,9,大富,招呼
2020-09-25,6150,10,7,17,大富,招呼
2020-09-26,6150,5,8,13,大富,招呼
2020-09-27,6150,4,3,7,大富,招呼
2020-09-28,6150,2,6,8,大富,招呼
2020-09-29,6150,4,7,11,大富,招呼
2020-09-30,6150,5,18,23,大富,招呼
2020-10-01,6150,2,7,9,大富,招呼
2020-10-02,6150,5,11,16,大富,招呼
2020-10-03,6150,6,1,7,大富,招呼
2020-10-04,6150,9,1,10,大富,招呼
2020-10-05,6150,15,4,19,大富,招呼
2020-10-06,6150,3,6,9,大富,招呼
2020-10-07,6150,6,6,12,大富,招呼
2020-10-08,6150,4,6,10,大富,招呼
2020-10-09,6150,3,8,11,大富,招呼
2020-10-10,6150,10,23,33,大富,招呼
2020-10-11,6150,11,1,12,大富,招呼
2020-10-12,6150,8,12,20,大富,招呼
2020-10-13,6150,5,4,9,大富,招呼
2020-10-14,6150,6,11,17,大富,招呼
2020-10-15,6150,4,7,11,大富,招呼
2020-10-16,6150,2,3,5,大富,招呼
2020-10-17,6150,8,4,12,大富,招呼
2020-10-18,6150,8,8,16,大富,招呼
2020-10-19,6150,6,10,16,大富,招呼
2020-10-20,6150,6,10,16,大富,招呼
2020-10-21,6150,8,4,12,大富,招呼
2020-10-22,6150,1,3,4,大富,招呼
2020-10-23,6150,0,7,7,大富,招呼
2020-10-24,6150,8,6,14,大富,招呼
2020-10-25,6150,7,2,9,大富,招呼
2020-10-26,6150,2,6,8,大富,招呼
2020-10-27,6150,4,6,10,大富,招呼
2020-10-28,6150,7,6,13,大富,招呼
2020-10-29,6150,3,4,7,大富,招呼
2020-10-30,6150,2,6,8,大富,招呼
2020-10-31,6150,4,4,8,大富,招呼
2020-11-01,6150,9,3,12,大富,招呼
2020-11-02,6150,5,7,12,大富,招呼
2020-11-03,6150,0,2,2,大富,招呼
2020-11-04,6150,7,6,13,大富,招呼
2020-11-05,6150,2,6,8,大富,招呼
2020-11-06,6150,3,9,12,大富,招呼
2020-11-07,6150,8,3,11,大富,招呼
2020-11-08,6150,4,2,6,大富,招呼
2020-11-09,6150,4,5,9,大富,招呼
2020-11-10,6150,7,2,9,大富,招呼
2020-11-11,6150,9,3,12,大富,招呼
2020-11-12,6150,5,9,14,大富,招呼
2020-11-13,6150,8,12,20,大富,招呼
2020-11-14,6150,7,232,239,大富,招呼
2020-11-15,6150,12,2,14,大富,招呼
2020-11-16,6150,10,9,19,大富,招呼
2020-11-17,6150,8,8,16,大富,招呼
2020-11-18,6150,9,7,16,大富,招呼
2020-11-19,6150,8,7,15,大富,招呼
2020-11-20,6150,3,8,11,大富,招呼
2020-11-21,6150,1,1,2,大富,招呼
2020-11-22,6150,3,3,6,大富,招呼
2020-11-23,6150,0,1,1,大富,招呼
2020-11-24,6150,5,1,6,大富,招呼
2020-11-25,6150,4,4,8,大富,招呼
2020-11-26,6150,2,7,9,大富,招呼
2020-11-27,6150,2,5,7,大富,招呼
2020-11-28,6150,5,9,14,大富,招呼
2020-11-29,6150,2,1,3,大富,招呼
2020-11-30,6150,2,2,4,大富,招呼
2020-12-01,6150,4,7,11,大富,招呼
2020-12-02,6150,6,6,12,大富,招呼
2020-12-03,6150,5,3,8,大富,招呼
2020-12-04,6150,6,6,12,大富,招呼
2020-12-05,6150,3,9,12,大富,招呼
2020-12-06,6150,4,3,7,大富,招呼
2020-12-07,6150,11,2,13,大富,招呼
2020-12-08,6150,3,8,11,大富,招呼
2020-12-09,6150,5,4,9,大富,招呼
2020-12-10,6150,3,6,9,大富,招呼
2020-12-11,6150,3,7,10,大富,招呼
2020-12-12,6150,6,7,13,大富,招呼
2020-12-13,6150,3,6,9,大富,招呼
2020-12-14,6150,2,3,5,大富,招呼
2020-12-15,6150,7,7,14,大富,招呼
2020-12-16,6150,6,6,12,大富,招呼
2020-12-17,6150,11,5,16,大富,招呼
2020-12-18,6150,2,4,6,大富,招呼
2020-12-19,6150,5,6,11,大富,招呼
2020-12-20,6150,8,4,12,大富,招呼
2020-12-21,6150,3,6,9,大富,招呼
2020-12-22,6150,1,3,4,大富,招呼
2020-12-23,6150,6,3,9,大富,招呼
2020-12-24,6150,2,4,6,大富,招呼
2020-12-25,6150,2,5,7,大富,招呼
2020-12-26,6150,10,7,17,大富,招呼
2020-12-27,6150,7,7,14,大富,招呼
2020-12-28,6150,1,3,4,大富,招呼
2020-12-29,6150,7,26,33,大富,招呼
2020-12-30,6150,4,5,9,大富,招呼
2020-12-31,6150,3,10,13,大富,招呼
2020-01-01,6160,428,438,866,光復,三等
2020-01-02,6160,481,448,929,光復,三等
2020-01-03,6160,529,516,1045,光復,三等
2020-01-04,6160,452,444,896,光復,三等
2020-01-05,6160,616,387,1003,光復,三等
2020-01-06,6160,438,403,841,光復,三等
2020-01-07,6160,402,336,738,光復,三等
2020-01-08,6160,381,356,737,光復,三等
2020-01-09,6160,411,376,787,光復,三等
2020-01-10,6160,534,709,1243,光復,三等
2020-01-11,6160,536,657,1193,光復,三等
2020-01-12,6160,673,363,1036,光復,三等
2020-01-13,6160,493,455,948,光復,三等
2020-01-14,6160,371,345,716,光復,三等
2020-01-15,6160,458,383,841,光復,三等
2020-01-16,6160,434,387,821,光復,三等
2020-01-17,6160,514,552,1066,光復,三等
2020-01-18,6160,413,504,917,光復,三等
2020-01-19,6160,443,423,866,光復,三等
2020-01-20,6160,457,509,966,光復,三等
2020-01-21,6160,441,535,976,光復,三等
2020-01-22,6160,469,745,1214,光復,三等
2020-01-23,6160,428,850,1278,光復,三等
2020-01-24,6160,403,893,1296,光復,三等
2020-01-25,6160,731,879,1610,光復,三等
2020-01-26,6160,879,763,1642,光復,三等
2020-01-27,6160,1017,887,1904,光復,三等
2020-01-28,6160,989,482,1471,光復,三等
2020-01-29,6160,864,438,1302,光復,三等
2020-01-30,6160,629,476,1105,光復,三等
2020-01-31,6160,577,486,1063,光復,三等
2020-02-01,6160,430,305,735,光復,三等
2020-02-02,6160,497,328,825,光復,三等
2020-02-03,6160,422,415,837,光復,三等
2020-02-04,6160,408,401,809,光復,三等
2020-02-05,6160,447,349,796,光復,三等
2020-02-06,6160,390,410,800,光復,三等
2020-02-07,6160,404,421,825,光復,三等
2020-02-08,6160,390,395,785,光復,三等
2020-02-09,6160,462,321,783,光復,三等
2020-02-10,6160,424,475,899,光復,三等
2020-02-11,6160,373,435,808,光復,三等
2020-02-12,6160,397,341,738,光復,三等
2020-02-13,6160,377,334,711,光復,三等
2020-02-14,6160,388,442,830,光復,三等
2020-02-15,6160,362,366,728,光復,三等
2020-02-16,6160,376,284,660,光復,三等
2020-02-17,6160,382,413,795,光復,三等
2020-02-18,6160,371,360,731,光復,三等
2020-02-19,6160,377,380,757,光復,三等
2020-02-20,6160,489,441,930,光復,三等
2020-02-21,6160,434,499,933,光復,三等
2020-02-22,6160,397,375,772,光復,三等
2020-02-23,6160,425,329,754,光復,三等
2020-02-24,6160,477,365,842,光復,三等
2020-02-25,6160,394,340,734,光復,三等
2020-02-26,6160,346,340,686,光復,三等
2020-02-27,6160,479,625,1104,光復,三等
2020-02-28,6160,392,599,991,光復,三等
2020-02-29,6160,465,392,857,光復,三等
2020-03-01,6160,702,390,1092,光復,三等
2020-03-02,6160,442,368,810,光復,三等
2020-03-03,6160,368,325,693,光復,三等
2020-03-04,6160,307,347,654,光復,三等
2020-03-05,6160,389,318,707,光復,三等
2020-03-06,6160,491,526,1017,光復,三等
2020-03-07,6160,376,452,828,光復,三等
2020-03-08,6160,497,289,786,光復,三等
2020-03-09,6160,388,359,747,光復,三等
2020-03-10,6160,362,296,658,光復,三等
2020-03-11,6160,339,314,653,光復,三等
2020-03-12,6160,381,329,710,光復,三等
2020-03-13,6160,474,611,1085,光復,三等
2020-03-14,6160,386,394,780,光復,三等
2020-03-15,6160,554,382,936,光復,三等
2020-03-16,6160,408,537,945,光復,三等
2020-03-17,6160,343,356,699,光復,三等
2020-03-18,6160,388,322,710,光復,三等
2020-03-19,6160,371,403,774,光復,三等
2020-03-20,6160,444,587,1031,光復,三等
2020-03-21,6160,417,542,959,光復,三等
2020-03-22,6160,527,300,827,光復,三等
2020-03-23,6160,372,320,692,光復,三等
2020-03-24,6160,315,336,651,光復,三等
2020-03-25,6160,369,297,666,光復,三等
2020-03-26,6160,356,328,684,光復,三等
2020-03-27,6160,431,554,985,光復,三等
2020-03-28,6160,361,512,873,光復,三等
2020-03-29,6160,486,340,826,光復,三等
2020-03-30,6160,412,330,742,光復,三等
2020-03-31,6160,392,405,797,光復,三等
2020-04-01,6160,485,632,1117,光復,三等
2020-04-02,6160,304,923,1227,光復,三等
2020-04-03,6160,501,695,1196,光復,三等
2020-04-04,6160,681,405,1086,光復,三等
2020-04-05,6160,882,282,1164,光復,三等
2020-04-06,6160,556,451,1007,光復,三等
2020-04-07,6160,371,282,653,光復,三等
2020-04-08,6160,307,264,571,光復,三等
2020-04-09,6160,336,320,656,光復,三等
2020-04-10,6160,368,487,855,光復,三等
2020-04-11,6160,238,285,523,光復,三等
2020-04-12,6160,357,256,613,光復,三等
2020-04-13,6160,344,282,626,光復,三等
2020-04-14,6160,317,290,607,光復,三等
2020-04-15,6160,326,274,600,光復,三等
2020-04-16,6160,276,313,589,光復,三等
2020-04-17,6160,405,470,875,光復,三等
2020-04-18,6160,278,378,656,光復,三等
2020-04-19,6160,473,273,746,光復,三等
2020-04-20,6160,334,293,627,光復,三等
2020-04-21,6160,315,294,609,光復,三等
2020-04-22,6160,306,285,591,光復,三等
2020-04-23,6160,315,351,666,光復,三等
2020-04-24,6160,343,412,755,光復,三等
2020-04-25,6160,292,290,582,光復,三等
2020-04-26,6160,326,266,592,光復,三等
2020-04-27,6160,337,298,635,光復,三等
2020-04-28,6160,287,264,551,光復,三等
2020-04-29,6160,295,308,603,光復,三等
2020-04-30,6160,349,379,728,光復,三等
2020-05-01,6160,337,523,860,光復,三等
2020-05-02,6160,323,376,699,光復,三等
2020-05-03,6160,494,309,803,光復,三等
2020-05-04,6160,399,303,702,光復,三等
2020-05-05,6160,335,298,633,光復,三等
2020-05-06,6160,344,326,670,光復,三等
2020-05-07,6160,313,317,630,光復,三等
2020-05-08,6160,427,579,1006,光復,三等
2020-05-09,6160,369,501,870,光復,三等
2020-05-10,6160,572,388,960,光復,三等
2020-05-11,6160,451,413,864,光復,三等
2020-05-12,6160,363,321,684,光復,三等
2020-05-13,6160,365,309,674,光復,三等
2020-05-14,6160,338,332,670,光復,三等
2020-05-15,6160,403,484,887,光復,三等
2020-05-16,6160,298,348,646,光復,三等
2020-05-17,6160,429,293,722,光復,三等
2020-05-18,6160,403,395,798,光復,三等
2020-05-19,6160,326,313,639,光復,三等
2020-05-20,6160,328,299,627,光復,三等
2020-05-21,6160,332,322,654,光復,三等
2020-05-22,6160,418,503,921,光復,三等
2020-05-23,6160,304,381,685,光復,三等
2020-05-24,6160,481,299,780,光復,三等
2020-05-25,6160,417,370,787,光復,三等
2020-05-26,6160,317,316,633,光復,三等
2020-05-27,6160,329,311,640,光復,三等
2020-05-28,6160,341,342,683,光復,三等
2020-05-29,6160,386,494,880,光復,三等
2020-05-30,6160,361,446,807,光復,三等
2020-05-31,6160,512,311,823,光復,三等
2020-06-01,6160,372,329,701,光復,三等
2020-06-02,6160,351,327,678,光復,三等
2020-06-03,6160,355,332,687,光復,三等
2020-06-04,6160,325,330,655,光復,三等
2020-06-05,6160,485,490,975,光復,三等
2020-06-06,6160,520,419,939,光復,三等
2020-06-07,6160,459,379,838,光復,三等
2020-06-08,6160,389,442,831,光復,三等
2020-06-09,6160,313,317,630,光復,三等
2020-06-10,6160,327,330,657,光復,三等
2020-06-11,6160,364,394,758,光復,三等
2020-06-12,6160,498,506,1004,光復,三等
2020-06-13,6160,406,399,805,光復,三等
2020-06-14,6160,502,394,896,光復,三等
2020-06-15,6160,421,436,857,光復,三等
2020-06-16,6160,341,366,707,光復,三等
2020-06-17,6160,365,356,721,光復,三等
2020-06-18,6160,400,348,748,光復,三等
2020-06-19,6160,331,398,729,光復,三等
2020-06-20,6160,430,405,835,光復,三等
2020-06-21,6160,432,363,795,光復,三等
2020-06-22,6160,463,433,896,光復,三等
2020-06-23,6160,352,389,741,光復,三等
2020-06-24,6160,512,623,1135,光復,三等
2020-06-25,6160,378,709,1087,光復,三等
2020-06-26,6160,428,529,957,光復,三等
2020-06-27,6160,628,388,1016,光復,三等
2020-06-28,6160,743,391,1134,光復,三等
2020-06-29,6160,527,416,943,光復,三等
2020-06-30,6160,396,364,760,光復,三等
2020-07-01,6160,351,336,687,光復,三等
2020-07-02,6160,370,384,754,光復,三等
2020-07-03,6160,429,520,949,光復,三等
2020-07-04,6160,333,360,693,光復,三等
2020-07-05,6160,438,367,805,光復,三等
2020-07-06,6160,406,404,810,光復,三等
2020-07-07,6160,355,348,703,光復,三等
2020-07-08,6160,384,370,754,光復,三等
2020-07-09,6160,379,374,753,光復,三等
2020-07-10,6160,477,501,978,光復,三等
2020-07-11,6160,473,423,896,光復,三等
2020-07-12,6160,463,334,797,光復,三等
2020-07-13,6160,420,587,1007,光復,三等
2020-07-14,6160,445,404,849,光復,三等
2020-07-15,6160,438,411,849,光復,三等
2020-07-16,6160,375,342,717,光復,三等
2020-07-17,6160,463,482,945,光復,三等
2020-07-18,6160,368,485,853,光復,三等
2020-07-19,6160,469,454,923,光復,三等
2020-07-20,6160,420,429,849,光復,三等
2020-07-21,6160,391,373,764,光復,三等
2020-07-22,6160,398,394,792,光復,三等
2020-07-23,6160,391,432,823,光復,三等
2020-07-24,6160,467,496,963,光復,三等
2020-07-25,6160,401,380,781,光復,三等
2020-07-26,6160,507,338,845,光復,三等
2020-07-27,6160,441,425,866,光復,三等
2020-07-28,6160,385,378,763,光復,三等
2020-07-29,6160,382,450,832,光復,三等
2020-07-30,6160,425,434,859,光復,三等
2020-07-31,6160,464,497,961,光復,三等
2020-08-01,6160,411,447,858,光復,三等
2020-08-02,6160,491,367,858,光復,三等
2020-08-03,6160,435,397,832,光復,三等
2020-08-04,6160,333,351,684,光復,三等
2020-08-05,6160,321,391,712,光復,三等
2020-08-06,6160,426,442,868,光復,三等
2020-08-07,6160,409,585,994,光復,三等
2020-08-08,6160,482,468,950,光復,三等
2020-08-09,6160,625,399,1024,光復,三等
2020-08-10,6160,758,608,1366,光復,三等
2020-08-11,6160,417,434,851,光復,三等
2020-08-12,6160,484,503,987,光復,三等
2020-08-13,6160,491,610,1101,光復,三等
2020-08-14,6160,461,748,1209,光復,三等
2020-08-15,6160,476,639,1115,光復,三等
2020-08-16,6160,643,430,1073,光復,三等
2020-08-17,6160,668,441,1109,光復,三等
2020-08-18,6160,511,442,953,光復,三等
2020-08-19,6160,404,544,948,光復,三等
2020-08-20,6160,464,729,1193,光復,三等
2020-08-21,6160,546,740,1286,光復,三等
2020-08-22,6160,612,548,1160,光復,三等
2020-08-23,6160,767,363,1130,光復,三等
2020-08-24,6160,706,470,1176,光復,三等
2020-08-25,6160,564,355,919,光復,三等
2020-08-26,6160,452,405,857,光復,三等
2020-08-27,6160,405,422,827,光復,三等
2020-08-28,6160,451,524,975,光復,三等
2020-08-29,6160,414,414,828,光復,三等
2020-08-30,6160,445,409,854,光復,三等
2020-08-31,6160,674,392,1066,光復,三等
2020-09-01,6160,389,493,882,光復,三等
2020-09-02,6160,427,379,806,光復,三等
2020-09-03,6160,402,382,784,光復,三等
2020-09-04,6160,494,480,974,光復,三等
2020-09-05,6160,523,514,1037,光復,三等
2020-09-06,6160,525,409,934,光復,三等
2020-09-07,6160,448,573,1021,光復,三等
2020-09-08,6160,380,351,731,光復,三等
2020-09-09,6160,420,385,805,光復,三等
2020-09-10,6160,371,455,826,光復,三等
2020-09-11,6160,716,625,1341,光復,三等
2020-09-12,6160,571,467,1038,光復,三等
2020-09-13,6160,589,377,966,光復,三等
2020-09-14,6160,380,451,831,光復,三等
2020-09-15,6160,353,338,691,光復,三等
2020-09-16,6160,351,327,678,光復,三等
2020-09-17,6160,338,306,644,光復,三等
2020-09-18,6160,473,510,983,光復,三等
2020-09-19,6160,400,435,835,光復,三等
2020-09-20,6160,495,404,899,光復,三等
2020-09-21,6160,417,403,820,光復,三等
2020-09-22,6160,405,359,764,光復,三等
2020-09-23,6160,401,341,742,光復,三等
2020-09-24,6160,406,473,879,光復,三等
2020-09-25,6160,438,420,858,光復,三等
2020-09-26,6160,457,440,897,光復,三等
2020-09-27,6160,496,323,819,光復,三等
2020-09-28,6160,412,415,827,光復,三等
2020-09-29,6160,345,465,810,光復,三等
2020-09-30,6160,636,821,1457,光復,三等
2020-10-01,6160,352,806,1158,光復,三等
2020-10-02,6160,708,541,1249,光復,三等
2020-10-03,6160,744,403,1147,光復,三等
2020-10-04,6160,863,415,1278,光復,三等
2020-10-05,6160,550,506,1056,光復,三等
2020-10-06,6160,404,334,738,光復,三等
2020-10-07,6160,380,400,780,光復,三等
2020-10-08,6160,479,616,1095,光復,三等
2020-10-09,6160,421,578,999,光復,三等
2020-10-10,6160,465,465,930,光復,三等
2020-10-11,6160,702,409,1111,光復,三等
2020-10-12,6160,454,374,828,光復,三等
2020-10-13,6160,396,337,733,光復,三等
2020-10-14,6160,365,357,722,光復,三等
2020-10-15,6160,381,346,727,光復,三等
2020-10-16,6160,512,535,1047,光復,三等
2020-10-17,6160,379,471,850,光復,三等
2020-10-18,6160,571,407,978,光復,三等
2020-10-19,6160,453,399,852,光復,三等
2020-10-20,6160,427,361,788,光復,三等
2020-10-21,6160,357,375,732,光復,三等
2020-10-22,6160,427,413,840,光復,三等
2020-10-23,6160,545,489,1034,光復,三等
2020-10-24,6160,328,386,714,光復,三等
2020-10-25,6160,467,379,846,光復,三等
2020-10-26,6160,480,423,903,光復,三等
2020-10-27,6160,490,421,911,光復,三等
2020-10-28,6160,412,340,752,光復,三等
2020-10-29,6160,399,572,971,光復,三等
2020-10-30,6160,477,522,999,光復,三等
2020-10-31,6160,422,436,858,光復,三等
2020-11-01,6160,501,360,861,光復,三等
2020-11-02,6160,461,456,917,光復,三等
2020-11-03,6160,403,324,727,光復,三等
2020-11-04,6160,350,371,721,光復,三等
2020-11-05,6160,374,378,752,光復,三等
2020-11-06,6160,519,562,1081,光復,三等
2020-11-07,6160,421,439,860,光復,三等
2020-11-08,6160,544,378,922,光復,三等
2020-11-09,6160,484,584,1068,光復,三等
2020-11-10,6160,355,379,734,光復,三等
2020-11-11,6160,378,340,718,光復,三等
2020-11-12,6160,367,353,720,光復,三等
2020-11-13,6160,478,598,1076,光復,三等
2020-11-14,6160,393,472,865,光復,三等
2020-11-15,6160,631,403,1034,光復,三等
2020-11-16,6160,490,422,912,光復,三等
2020-11-17,6160,409,364,773,光復,三等
2020-11-18,6160,451,390,841,光復,三等
2020-11-19,6160,456,457,913,光復,三等
2020-11-20,6160,514,578,1092,光復,三等
2020-11-21,6160,358,449,807,光復,三等
2020-11-22,6160,515,343,858,光復,三等
2020-11-23,6160,423,362,785,光復,三等
2020-11-24,6160,370,357,727,光復,三等
2020-11-25,6160,368,353,721,光復,三等
2020-11-26,6160,402,456,858,光復,三等
2020-11-27,6160,531,622,1153,光復,三等
2020-11-28,6160,424,465,889,光復,三等
2020-11-29,6160,493,411,904,光復,三等
2020-11-30,6160,436,395,831,光復,三等
2020-12-01,6160,374,324,698,光復,三等
2020-12-02,6160,334,390,724,光復,三等
2020-12-03,6160,404,371,775,光復,三等
2020-12-04,6160,581,521,1102,光復,三等
2020-12-05,6160,376,402,778,光復,三等
2020-12-06,6160,421,294,715,光復,三等
2020-12-07,6160,400,401,801,光復,三等
2020-12-08,6160,427,428,855,光復,三等
2020-12-09,6160,372,317,689,光復,三等
2020-12-10,6160,428,351,779,光復,三等
2020-12-11,6160,522,639,1161,光復,三等
2020-12-12,6160,568,415,983,光復,三等
2020-12-13,6160,503,416,919,光復,三等
2020-12-14,6160,398,600,998,光復,三等
2020-12-15,6160,402,382,784,光復,三等
2020-12-16,6160,413,393,806,光復,三等
2020-12-17,6160,439,490,929,光復,三等
2020-12-18,6160,529,596,1125,光復,三等
2020-12-19,6160,394,384,778,光復,三等
2020-12-20,6160,502,364,866,光復,三等
2020-12-21,6160,452,384,836,光復,三等
2020-12-22,6160,395,348,743,光復,三等
2020-12-23,6160,385,462,847,光復,三等
2020-12-24,6160,409,383,792,光復,三等
2020-12-25,6160,631,537,1168,光復,三等
2020-12-26,6160,356,413,769,光復,三等
2020-12-27,6160,471,356,827,光復,三等
2020-12-28,6160,497,386,883,光復,三等
2020-12-29,6160,474,391,865,光復,三等
2020-12-30,6160,335,381,716,光復,三等
2020-12-31,6160,524,642,1166,光復,三等
2020-01-01,6170,52,64,116,萬榮,三等
2020-01-02,6170,33,51,84,萬榮,三等
2020-01-03,6170,52,58,110,萬榮,三等
2020-01-04,6170,39,60,99,萬榮,三等
2020-01-05,6170,32,25,57,萬榮,三等
2020-01-06,6170,64,53,117,萬榮,三等
2020-01-07,6170,33,49,82,萬榮,三等
2020-01-08,6170,40,60,100,萬榮,三等
2020-01-09,6170,57,61,118,萬榮,三等
2020-01-10,6170,57,79,136,萬榮,三等
2020-01-11,6170,37,69,106,萬榮,三等
2020-01-12,6170,51,32,83,萬榮,三等
2020-01-13,6170,50,39,89,萬榮,三等
2020-01-14,6170,52,73,125,萬榮,三等
2020-01-15,6170,32,57,89,萬榮,三等
2020-01-16,6170,53,60,113,萬榮,三等
2020-01-17,6170,40,45,85,萬榮,三等
2020-01-18,6170,27,41,68,萬榮,三等
2020-01-19,6170,40,19,59,萬榮,三等
2020-01-20,6170,33,47,80,萬榮,三等
2020-01-21,6170,44,43,87,萬榮,三等
2020-01-22,6170,38,58,96,萬榮,三等
2020-01-23,6170,31,39,70,萬榮,三等
2020-01-24,6170,25,50,75,萬榮,三等
2020-01-25,6170,39,71,110,萬榮,三等
2020-01-26,6170,27,54,81,萬榮,三等
2020-01-27,6170,58,20,78,萬榮,三等
2020-01-28,6170,65,36,101,萬榮,三等
2020-01-29,6170,44,31,75,萬榮,三等
2020-01-30,6170,51,53,104,萬榮,三等
2020-01-31,6170,48,42,90,萬榮,三等
2020-02-01,6170,14,34,48,萬榮,三等
2020-02-02,6170,23,32,55,萬榮,三等
2020-02-03,6170,46,43,89,萬榮,三等
2020-02-04,6170,41,47,88,萬榮,三等
2020-02-05,6170,27,36,63,萬榮,三等
2020-02-06,6170,52,33,85,萬榮,三等
2020-02-07,6170,38,37,75,萬榮,三等
2020-02-08,6170,33,44,77,萬榮,三等
2020-02-09,6170,24,22,46,萬榮,三等
2020-02-10,6170,47,38,85,萬榮,三等
2020-02-11,6170,41,43,84,萬榮,三等
2020-02-12,6170,40,47,87,萬榮,三等
2020-02-13,6170,34,55,89,萬榮,三等
2020-02-14,6170,42,32,74,萬榮,三等
2020-02-15,6170,24,48,72,萬榮,三等
2020-02-16,6170,36,17,53,萬榮,三等
2020-02-17,6170,46,40,86,萬榮,三等
2020-02-18,6170,39,54,93,萬榮,三等
2020-02-19,6170,29,43,72,萬榮,三等
2020-02-20,6170,21,30,51,萬榮,三等
2020-02-21,6170,23,45,68,萬榮,三等
2020-02-22,6170,31,39,70,萬榮,三等
2020-02-23,6170,18,17,35,萬榮,三等
2020-02-24,6170,62,49,111,萬榮,三等
2020-02-25,6170,56,58,114,萬榮,三等
2020-02-26,6170,44,52,96,萬榮,三等
2020-02-27,6170,58,73,131,萬榮,三等
2020-02-28,6170,31,52,83,萬榮,三等
2020-02-29,6170,40,53,93,萬榮,三等
2020-03-01,6170,50,24,74,萬榮,三等
2020-03-02,6170,53,51,104,萬榮,三等
2020-03-03,6170,47,52,99,萬榮,三等
2020-03-04,6170,28,49,77,萬榮,三等
2020-03-05,6170,40,49,89,萬榮,三等
2020-03-06,6170,37,61,98,萬榮,三等
2020-03-07,6170,38,39,77,萬榮,三等
2020-03-08,6170,33,36,69,萬榮,三等
2020-03-09,6170,53,43,96,萬榮,三等
2020-03-10,6170,56,57,113,萬榮,三等
2020-03-11,6170,45,46,91,萬榮,三等
2020-03-12,6170,46,49,95,萬榮,三等
2020-03-13,6170,52,76,128,萬榮,三等
2020-03-14,6170,28,54,82,萬榮,三等
2020-03-15,6170,43,20,63,萬榮,三等
2020-03-16,6170,48,56,104,萬榮,三等
2020-03-17,6170,38,50,88,萬榮,三等
2020-03-18,6170,37,54,91,萬榮,三等
2020-03-19,6170,45,57,102,萬榮,三等
2020-03-20,6170,42,79,121,萬榮,三等
2020-03-21,6170,26,42,68,萬榮,三等
2020-03-22,6170,36,19,55,萬榮,三等
2020-03-23,6170,54,57,111,萬榮,三等
2020-03-24,6170,55,50,105,萬榮,三等
2020-03-25,6170,41,47,88,萬榮,三等
2020-03-26,6170,48,55,103,萬榮,三等
2020-03-27,6170,58,66,124,萬榮,三等
2020-03-28,6170,27,58,85,萬榮,三等
2020-03-29,6170,46,27,73,萬榮,三等
2020-03-30,6170,49,39,88,萬榮,三等
2020-03-31,6170,38,54,92,萬榮,三等
2020-04-01,6170,54,50,104,萬榮,三等
2020-04-02,6170,32,41,73,萬榮,三等
2020-04-03,6170,41,36,77,萬榮,三等
2020-04-04,6170,30,30,60,萬榮,三等
2020-04-05,6170,60,17,77,萬榮,三等
2020-04-06,6170,49,38,87,萬榮,三等
2020-04-07,6170,40,53,93,萬榮,三等
2020-04-08,6170,38,49,87,萬榮,三等
2020-04-09,6170,39,58,97,萬榮,三等
2020-04-10,6170,52,47,99,萬榮,三等
2020-04-11,6170,24,33,57,萬榮,三等
2020-04-12,6170,34,24,58,萬榮,三等
2020-04-13,6170,43,56,99,萬榮,三等
2020-04-14,6170,33,55,88,萬榮,三等
2020-04-15,6170,42,52,94,萬榮,三等
2020-04-16,6170,53,63,116,萬榮,三等
2020-04-17,6170,61,56,117,萬榮,三等
2020-04-18,6170,22,48,70,萬榮,三等
2020-04-19,6170,15,27,42,萬榮,三等
2020-04-20,6170,49,51,100,萬榮,三等
2020-04-21,6170,36,53,89,萬榮,三等
2020-04-22,6170,39,44,83,萬榮,三等
2020-04-23,6170,47,37,84,萬榮,三等
2020-04-24,6170,37,52,89,萬榮,三等
2020-04-25,6170,9,32,41,萬榮,三等
2020-04-26,6170,34,24,58,萬榮,三等
2020-04-27,6170,57,48,105,萬榮,三等
2020-04-28,6170,51,44,95,萬榮,三等
2020-04-29,6170,59,46,105,萬榮,三等
2020-04-30,6170,63,55,118,萬榮,三等
2020-05-01,6170,36,74,110,萬榮,三等
2020-05-02,6170,35,36,71,萬榮,三等
2020-05-03,6170,49,32,81,萬榮,三等
2020-05-04,6170,62,46,108,萬榮,三等
2020-05-05,6170,59,48,107,萬榮,三等
2020-05-06,6170,62,44,106,萬榮,三等
2020-05-07,6170,36,48,84,萬榮,三等
2020-05-08,6170,49,55,104,萬榮,三等
2020-05-09,6170,32,41,73,萬榮,三等
2020-05-10,6170,42,41,83,萬榮,三等
2020-05-11,6170,57,47,104,萬榮,三等
2020-05-12,6170,60,50,110,萬榮,三等
2020-05-13,6170,59,46,105,萬榮,三等
2020-05-14,6170,64,38,102,萬榮,三等
2020-05-15,6170,46,64,110,萬榮,三等
2020-05-16,6170,28,42,70,萬榮,三等
2020-05-17,6170,43,18,61,萬榮,三等
2020-05-18,6170,65,38,103,萬榮,三等
2020-05-19,6170,54,45,99,萬榮,三等
2020-05-20,6170,69,51,120,萬榮,三等
2020-05-21,6170,56,53,109,萬榮,三等
2020-05-22,6170,39,53,92,萬榮,三等
2020-05-23,6170,18,52,70,萬榮,三等
2020-05-24,6170,37,30,67,萬榮,三等
2020-05-25,6170,75,47,122,萬榮,三等
2020-05-26,6170,59,53,112,萬榮,三等
2020-05-27,6170,60,53,113,萬榮,三等
2020-05-28,6170,68,46,114,萬榮,三等
2020-05-29,6170,38,60,98,萬榮,三等
2020-05-30,6170,37,45,82,萬榮,三等
2020-05-31,6170,37,39,76,萬榮,三等
2020-06-01,6170,64,44,108,萬榮,三等
2020-06-02,6170,47,38,85,萬榮,三等
2020-06-03,6170,81,54,135,萬榮,三等
2020-06-04,6170,56,61,117,萬榮,三等
2020-06-05,6170,57,53,110,萬榮,三等
2020-06-06,6170,23,50,73,萬榮,三等
2020-06-07,6170,34,24,58,萬榮,三等
2020-06-08,6170,75,49,124,萬榮,三等
2020-06-09,6170,55,59,114,萬榮,三等
2020-06-10,6170,67,42,109,萬榮,三等
2020-06-11,6170,64,42,106,萬榮,三等
2020-06-12,6170,55,62,117,萬榮,三等
2020-06-13,6170,17,44,61,萬榮,三等
2020-06-14,6170,47,34,81,萬榮,三等
2020-06-15,6170,61,38,99,萬榮,三等
2020-06-16,6170,57,46,103,萬榮,三等
2020-06-17,6170,62,50,112,萬榮,三等
2020-06-18,6170,57,50,107,萬榮,三等
2020-06-19,6170,63,51,114,萬榮,三等
2020-06-20,6170,48,54,102,萬榮,三等
2020-06-21,6170,49,43,92,萬榮,三等
2020-06-22,6170,68,55,123,萬榮,三等
2020-06-23,6170,54,43,97,萬榮,三等
2020-06-24,6170,56,59,115,萬榮,三等
2020-06-25,6170,39,57,96,萬榮,三等
2020-06-26,6170,36,30,66,萬榮,三等
2020-06-27,6170,31,32,63,萬榮,三等
2020-06-28,6170,47,29,76,萬榮,三等
2020-06-29,6170,62,57,119,萬榮,三等
2020-06-30,6170,61,50,111,萬榮,三等
2020-07-01,6170,42,42,84,萬榮,三等
2020-07-02,6170,88,49,137,萬榮,三等
2020-07-03,6170,61,55,116,萬榮,三等
2020-07-04,6170,39,48,87,萬榮,三等
2020-07-05,6170,58,26,84,萬榮,三等
2020-07-06,6170,64,52,116,萬榮,三等
2020-07-07,6170,57,52,109,萬榮,三等
2020-07-08,6170,58,41,99,萬榮,三等
2020-07-09,6170,54,39,93,萬榮,三等
2020-07-10,6170,56,54,110,萬榮,三等
2020-07-11,6170,27,46,73,萬榮,三等
2020-07-12,6170,37,30,67,萬榮,三等
2020-07-13,6170,47,48,95,萬榮,三等
2020-07-14,6170,50,58,108,萬榮,三等
2020-07-15,6170,27,38,65,萬榮,三等
2020-07-16,6170,43,32,75,萬榮,三等
2020-07-17,6170,46,45,91,萬榮,三等
2020-07-18,6170,39,38,77,萬榮,三等
2020-07-19,6170,24,24,48,萬榮,三等
2020-07-20,6170,58,42,100,萬榮,三等
2020-07-21,6170,41,25,66,萬榮,三等
2020-07-22,6170,70,63,133,萬榮,三等
2020-07-23,6170,43,45,88,萬榮,三等
2020-07-24,6170,42,37,79,萬榮,三等
2020-07-25,6170,28,34,62,萬榮,三等
2020-07-26,6170,46,28,74,萬榮,三等
2020-07-27,6170,49,41,90,萬榮,三等
2020-07-28,6170,41,35,76,萬榮,三等
2020-07-29,6170,50,47,97,萬榮,三等
2020-07-30,6170,50,35,85,萬榮,三等
2020-07-31,6170,45,41,86,萬榮,三等
2020-08-01,6170,40,39,79,萬榮,三等
2020-08-02,6170,29,23,52,萬榮,三等
2020-08-03,6170,41,31,72,萬榮,三等
2020-08-04,6170,52,41,93,萬榮,三等
2020-08-05,6170,53,44,97,萬榮,三等
2020-08-06,6170,53,61,114,萬榮,三等
2020-08-07,6170,69,46,115,萬榮,三等
2020-08-08,6170,26,35,61,萬榮,三等
2020-08-09,6170,38,30,68,萬榮,三等
2020-08-10,6170,51,39,90,萬榮,三等
2020-08-11,6170,41,37,78,萬榮,三等
2020-08-12,6170,31,48,79,萬榮,三等
2020-08-13,6170,54,36,90,萬榮,三等
2020-08-14,6170,50,41,91,萬榮,三等
2020-08-15,6170,28,45,73,萬榮,三等
2020-08-16,6170,32,30,62,萬榮,三等
2020-08-17,6170,53,32,85,萬榮,三等
2020-08-18,6170,47,47,94,萬榮,三等
2020-08-19,6170,40,44,84,萬榮,三等
2020-08-20,6170,33,34,67,萬榮,三等
2020-08-21,6170,51,46,97,萬榮,三等
2020-08-22,6170,121,138,259,萬榮,三等
2020-08-23,6170,37,27,64,萬榮,三等
2020-08-24,6170,56,55,111,萬榮,三等
2020-08-25,6170,39,33,72,萬榮,三等
2020-08-26,6170,56,48,104,萬榮,三等
2020-08-27,6170,36,34,70,萬榮,三等
2020-08-28,6170,47,48,95,萬榮,三等
2020-08-29,6170,26,27,53,萬榮,三等
2020-08-30,6170,26,23,49,萬榮,三等
2020-08-31,6170,74,40,114,萬榮,三等
2020-09-01,6170,66,48,114,萬榮,三等
2020-09-02,6170,59,47,106,萬榮,三等
2020-09-03,6170,77,57,134,萬榮,三等
2020-09-04,6170,65,58,123,萬榮,三等
2020-09-05,6170,24,41,65,萬榮,三等
2020-09-06,6170,55,32,87,萬榮,三等
2020-09-07,6170,72,69,141,萬榮,三等
2020-09-08,6170,57,39,96,萬榮,三等
2020-09-09,6170,59,42,101,萬榮,三等
2020-09-10,6170,67,47,114,萬榮,三等
2020-09-11,6170,66,60,126,萬榮,三等
2020-09-12,6170,54,52,106,萬榮,三等
2020-09-13,6170,52,27,79,萬榮,三等
2020-09-14,6170,67,49,116,萬榮,三等
2020-09-15,6170,70,51,121,萬榮,三等
2020-09-16,6170,65,54,119,萬榮,三等
2020-09-17,6170,72,45,117,萬榮,三等
2020-09-18,6170,67,62,129,萬榮,三等
2020-09-19,6170,47,65,112,萬榮,三等
2020-09-20,6170,59,28,87,萬榮,三等
2020-09-21,6170,55,57,112,萬榮,三等
2020-09-22,6170,62,56,118,萬榮,三等
2020-09-23,6170,53,32,85,萬榮,三等
2020-09-24,6170,70,54,124,萬榮,三等
2020-09-25,6170,67,49,116,萬榮,三等
2020-09-26,6170,60,64,124,萬榮,三等
2020-09-27,6170,38,14,52,萬榮,三等
2020-09-28,6170,63,61,124,萬榮,三等
2020-09-29,6170,68,49,117,萬榮,三等
2020-09-30,6170,77,85,162,萬榮,三等
2020-10-01,6170,26,52,78,萬榮,三等
2020-10-02,6170,42,44,86,萬榮,三等
2020-10-03,6170,53,38,91,萬榮,三等
2020-10-04,6170,56,25,81,萬榮,三等
2020-10-05,6170,58,54,112,萬榮,三等
2020-10-06,6170,57,52,109,萬榮,三等
2020-10-07,6170,62,64,126,萬榮,三等
2020-10-08,6170,55,76,131,萬榮,三等
2020-10-09,6170,60,36,96,萬榮,三等
2020-10-10,6170,45,31,76,萬榮,三等
2020-10-11,6170,72,17,89,萬榮,三等
2020-10-12,6170,67,48,115,萬榮,三等
2020-10-13,6170,63,41,104,萬榮,三等
2020-10-14,6170,42,47,89,萬榮,三等
2020-10-15,6170,61,46,107,萬榮,三等
2020-10-16,6170,43,52,95,萬榮,三等
2020-10-17,6170,25,43,68,萬榮,三等
2020-10-18,6170,40,15,55,萬榮,三等
2020-10-19,6170,54,53,107,萬榮,三等
2020-10-20,6170,59,49,108,萬榮,三等
2020-10-21,6170,52,43,95,萬榮,三等
2020-10-22,6170,47,50,97,萬榮,三等
2020-10-23,6170,48,56,104,萬榮,三等
2020-10-24,6170,31,31,62,萬榮,三等
2020-10-25,6170,43,24,67,萬榮,三等
2020-10-26,6170,63,48,111,萬榮,三等
2020-10-27,6170,51,55,106,萬榮,三等
2020-10-28,6170,68,61,129,萬榮,三等
2020-10-29,6170,43,37,80,萬榮,三等
2020-10-30,6170,49,65,114,萬榮,三等
2020-10-31,6170,29,35,64,萬榮,三等
2020-11-01,6170,36,28,64,萬榮,三等
2020-11-02,6170,55,57,112,萬榮,三等
2020-11-03,6170,57,52,109,萬榮,三等
2020-11-04,6170,49,37,86,萬榮,三等
2020-11-05,6170,49,40,89,萬榮,三等
2020-11-06,6170,41,57,98,萬榮,三等
2020-11-07,6170,24,34,58,萬榮,三等
2020-11-08,6170,45,31,76,萬榮,三等
2020-11-09,6170,48,46,94,萬榮,三等
2020-11-10,6170,62,48,110,萬榮,三等
2020-11-11,6170,49,41,90,萬榮,三等
2020-11-12,6170,56,46,102,萬榮,三等
2020-11-13,6170,56,59,115,萬榮,三等
2020-11-14,6170,24,50,74,萬榮,三等
2020-11-15,6170,52,32,84,萬榮,三等
2020-11-16,6170,67,50,117,萬榮,三等
2020-11-17,6170,60,47,107,萬榮,三等
2020-11-18,6170,54,50,104,萬榮,三等
2020-11-19,6170,60,40,100,萬榮,三等
2020-11-20,6170,43,56,99,萬榮,三等
2020-11-21,6170,89,64,153,萬榮,三等
2020-11-22,6170,40,45,85,萬榮,三等
2020-11-23,6170,59,43,102,萬榮,三等
2020-11-24,6170,100,46,146,萬榮,三等
2020-11-25,6170,58,45,103,萬榮,三等
2020-11-26,6170,66,46,112,萬榮,三等
2020-11-27,6170,49,52,101,萬榮,三等
2020-11-28,6170,42,245,287,萬榮,三等
2020-11-29,6170,38,18,56,萬榮,三等
2020-11-30,6170,72,41,113,萬榮,三等
2020-12-01,6170,58,39,97,萬榮,三等
2020-12-02,6170,51,41,92,萬榮,三等
2020-12-03,6170,64,49,113,萬榮,三等
2020-12-04,6170,30,54,84,萬榮,三等
2020-12-05,6170,28,28,56,萬榮,三等
2020-12-06,6170,40,19,59,萬榮,三等
2020-12-07,6170,65,39,104,萬榮,三等
2020-12-08,6170,49,41,90,萬榮,三等
2020-12-09,6170,48,36,84,萬榮,三等
2020-12-10,6170,50,57,107,萬榮,三等
2020-12-11,6170,55,60,115,萬榮,三等
2020-12-12,6170,33,58,91,萬榮,三等
2020-12-13,6170,46,23,69,萬榮,三等
2020-12-14,6170,72,53,125,萬榮,三等
2020-12-15,6170,49,37,86,萬榮,三等
2020-12-16,6170,51,47,98,萬榮,三等
2020-12-17,6170,59,51,110,萬榮,三等
2020-12-18,6170,65,69,134,萬榮,三等
2020-12-19,6170,54,57,111,萬榮,三等
2020-12-20,6170,44,20,64,萬榮,三等
2020-12-21,6170,55,50,105,萬榮,三等
2020-12-22,6170,32,37,69,萬榮,三等
2020-12-23,6170,41,37,78,萬榮,三等
2020-12-24,6170,49,52,101,萬榮,三等
2020-12-25,6170,57,282,339,萬榮,三等
2020-12-26,6170,24,41,65,萬榮,三等
2020-12-27,6170,55,46,101,萬榮,三等
2020-12-28,6170,51,33,84,萬榮,三等
2020-12-29,6170,67,45,112,萬榮,三等
2020-12-30,6170,51,52,103,萬榮,三等
2020-12-31,6170,55,102,157,萬榮,三等
2020-01-01,6180,338,289,627,鳳林,三等
2020-01-02,6180,314,339,653,鳳林,三等
2020-01-03,6180,352,354,706,鳳林,三等
2020-01-04,6180,282,364,646,鳳林,三等
2020-01-05,6180,367,278,645,鳳林,三等
2020-01-06,6180,329,347,676,鳳林,三等
2020-01-07,6180,302,316,618,鳳林,三等
2020-01-08,6180,309,301,610,鳳林,三等
2020-01-09,6180,292,344,636,鳳林,三等
2020-01-10,6180,396,551,947,鳳林,三等
2020-01-11,6180,508,523,1031,鳳林,三等
2020-01-12,6180,513,296,809,鳳林,三等
2020-01-13,6180,362,436,798,鳳林,三等
2020-01-14,6180,338,402,740,鳳林,三等
2020-01-15,6180,304,293,597,鳳林,三等
2020-01-16,6180,321,371,692,鳳林,三等
2020-01-17,6180,347,405,752,鳳林,三等
2020-01-18,6180,302,350,652,鳳林,三等
2020-01-19,6180,402,313,715,鳳林,三等
2020-01-20,6180,375,384,759,鳳林,三等
2020-01-21,6180,374,483,857,鳳林,三等
2020-01-22,6180,392,591,983,鳳林,三等
2020-01-23,6180,302,659,961,鳳林,三等
2020-01-24,6180,288,669,957,鳳林,三等
2020-01-25,6180,376,596,972,鳳林,三等
2020-01-26,6180,750,761,1511,鳳林,三等
2020-01-27,6180,804,534,1338,鳳林,三等
2020-01-28,6180,824,416,1240,鳳林,三等
2020-01-29,6180,706,380,1086,鳳林,三等
2020-01-30,6180,570,329,899,鳳林,三等
2020-01-31,6180,448,421,869,鳳林,三等
2020-02-01,6180,404,353,757,鳳林,三等
2020-02-02,6180,403,268,671,鳳林,三等
2020-02-03,6180,447,342,789,鳳林,三等
2020-02-04,6180,321,294,615,鳳林,三等
2020-02-05,6180,288,303,591,鳳林,三等
2020-02-06,6180,381,281,662,鳳林,三等
2020-02-07,6180,367,370,737,鳳林,三等
2020-02-08,6180,266,335,601,鳳林,三等
2020-02-09,6180,416,300,716,鳳林,三等
2020-02-10,6180,376,296,672,鳳林,三等
2020-02-11,6180,300,304,604,鳳林,三等
2020-02-12,6180,276,263,539,鳳林,三等
2020-02-13,6180,305,283,588,鳳林,三等
2020-02-14,6180,304,316,620,鳳林,三等
2020-02-15,6180,323,325,648,鳳林,三等
2020-02-16,6180,372,278,650,鳳林,三等
2020-02-17,6180,280,262,542,鳳林,三等
2020-02-18,6180,294,301,595,鳳林,三等
2020-02-19,6180,277,264,541,鳳林,三等
2020-02-20,6180,296,281,577,鳳林,三等
2020-02-21,6180,310,337,647,鳳林,三等
2020-02-22,6180,251,307,558,鳳林,三等
2020-02-23,6180,360,271,631,鳳林,三等
2020-02-24,6180,361,298,659,鳳林,三等
2020-02-25,6180,282,287,569,鳳林,三等
2020-02-26,6180,293,307,600,鳳林,三等
2020-02-27,6180,385,486,871,鳳林,三等
2020-02-28,6180,281,505,786,鳳林,三等
2020-02-29,6180,327,286,613,鳳林,三等
2020-03-01,6180,604,239,843,鳳林,三等
2020-03-02,6180,320,297,617,鳳林,三等
2020-03-03,6180,260,263,523,鳳林,三等
2020-03-04,6180,269,275,544,鳳林,三等
2020-03-05,6180,262,294,556,鳳林,三等
2020-03-06,6180,312,391,703,鳳林,三等
2020-03-07,6180,257,400,657,鳳林,三等
2020-03-08,6180,387,231,618,鳳林,三等
2020-03-09,6180,287,279,566,鳳林,三等
2020-03-10,6180,263,273,536,鳳林,三等
2020-03-11,6180,292,293,585,鳳林,三等
2020-03-12,6180,281,297,578,鳳林,三等
2020-03-13,6180,323,392,715,鳳林,三等
2020-03-14,6180,213,309,522,鳳林,三等
2020-03-15,6180,389,230,619,鳳林,三等
2020-03-16,6180,311,307,618,鳳林,三等
2020-03-17,6180,281,297,578,鳳林,三等
2020-03-18,6180,269,304,573,鳳林,三等
2020-03-19,6180,272,274,546,鳳林,三等
2020-03-20,6180,314,444,758,鳳林,三等
2020-03-21,6180,293,335,628,鳳林,三等
2020-03-22,6180,415,217,632,鳳林,三等
2020-03-23,6180,300,344,644,鳳林,三等
2020-03-24,6180,314,324,638,鳳林,三等
2020-03-25,6180,335,339,674,鳳林,三等
2020-03-26,6180,350,300,650,鳳林,三等
2020-03-27,6180,366,416,782,鳳林,三等
2020-03-28,6180,197,320,517,鳳林,三等
2020-03-29,6180,359,191,550,鳳林,三等
2020-03-30,6180,335,282,617,鳳林,三等
2020-03-31,6180,241,281,522,鳳林,三等
2020-04-01,6180,349,487,836,鳳林,三等
2020-04-02,6180,273,602,875,鳳林,三等
2020-04-03,6180,313,432,745,鳳林,三等
2020-04-04,6180,399,233,632,鳳林,三等
2020-04-05,6180,634,252,886,鳳林,三等
2020-04-06,6180,358,271,629,鳳林,三等
2020-04-07,6180,262,242,504,鳳林,三等
2020-04-08,6180,259,221,480,鳳林,三等
2020-04-09,6180,265,253,518,鳳林,三等
2020-04-10,6180,302,375,677,鳳林,三等
2020-04-11,6180,192,223,415,鳳林,三等
2020-04-12,6180,258,143,401,鳳林,三等
2020-04-13,6180,262,259,521,鳳林,三等
2020-04-14,6180,238,248,486,鳳林,三等
2020-04-15,6180,264,263,527,鳳林,三等
2020-04-16,6180,223,255,478,鳳林,三等
2020-04-17,6180,309,383,692,鳳林,三等
2020-04-18,6180,170,233,403,鳳林,三等
2020-04-19,6180,283,195,478,鳳林,三等
2020-04-20,6180,284,269,553,鳳林,三等
2020-04-21,6180,247,264,511,鳳林,三等
2020-04-22,6180,258,293,551,鳳林,三等
2020-04-23,6180,227,236,463,鳳林,三等
2020-04-24,6180,286,306,592,鳳林,三等
2020-04-25,6180,211,261,472,鳳林,三等
2020-04-26,6180,277,168,445,鳳林,三等
2020-04-27,6180,287,266,553,鳳林,三等
2020-04-28,6180,222,243,465,鳳林,三等
2020-04-29,6180,267,283,550,鳳林,三等
2020-04-30,6180,296,365,661,鳳林,三等
2020-05-01,6180,354,446,800,鳳林,三等
2020-05-02,6180,225,250,475,鳳林,三等
2020-05-03,6180,473,206,679,鳳林,三等
2020-05-04,6180,285,279,564,鳳林,三等
2020-05-05,6180,251,275,526,鳳林,三等
2020-05-06,6180,229,256,485,鳳林,三等
2020-05-07,6180,267,274,541,鳳林,三等
2020-05-08,6180,304,402,706,鳳林,三等
2020-05-09,6180,235,366,601,鳳林,三等
2020-05-10,6180,442,224,666,鳳林,三等
2020-05-11,6180,327,313,640,鳳林,三等
2020-05-12,6180,241,266,507,鳳林,三等
2020-05-13,6180,258,283,541,鳳林,三等
2020-05-14,6180,282,302,584,鳳林,三等
2020-05-15,6180,351,424,775,鳳林,三等
2020-05-16,6180,246,320,566,鳳林,三等
2020-05-17,6180,410,231,641,鳳林,三等
2020-05-18,6180,314,265,579,鳳林,三等
2020-05-19,6180,266,278,544,鳳林,三等
2020-05-20,6180,275,292,567,鳳林,三等
2020-05-21,6180,248,277,525,鳳林,三等
2020-05-22,6180,340,394,734,鳳林,三等
2020-05-23,6180,241,271,512,鳳林,三等
2020-05-24,6180,403,280,683,鳳林,三等
2020-05-25,6180,292,296,588,鳳林,三等
2020-05-26,6180,263,267,530,鳳林,三等
2020-05-27,6180,309,313,622,鳳林,三等
2020-05-28,6180,243,295,538,鳳林,三等
2020-05-29,6180,334,397,731,鳳林,三等
2020-05-30,6180,253,320,573,鳳林,三等
2020-05-31,6180,392,238,630,鳳林,三等
2020-06-01,6180,333,317,650,鳳林,三等
2020-06-02,6180,258,282,540,鳳林,三等
2020-06-03,6180,270,280,550,鳳林,三等
2020-06-04,6180,267,292,559,鳳林,三等
2020-06-05,6180,305,388,693,鳳林,三等
2020-06-06,6180,229,319,548,鳳林,三等
2020-06-07,6180,367,280,647,鳳林,三等
2020-06-08,6180,335,296,631,鳳林,三等
2020-06-09,6180,299,296,595,鳳林,三等
2020-06-10,6180,267,274,541,鳳林,三等
2020-06-11,6180,307,313,620,鳳林,三等
2020-06-12,6180,404,425,829,鳳林,三等
2020-06-13,6180,288,283,571,鳳林,三等
2020-06-14,6180,385,285,670,鳳林,三等
2020-06-15,6180,324,336,660,鳳林,三等
2020-06-16,6180,280,292,572,鳳林,三等
2020-06-17,6180,281,298,579,鳳林,三等
2020-06-18,6180,303,348,651,鳳林,三等
2020-06-19,6180,349,348,697,鳳林,三等
2020-06-20,6180,281,336,617,鳳林,三等
2020-06-21,6180,306,300,606,鳳林,三等
2020-06-22,6180,324,330,654,鳳林,三等
2020-06-23,6180,317,320,637,鳳林,三等
2020-06-24,6180,378,483,861,鳳林,三等
2020-06-25,6180,327,631,958,鳳林,三等
2020-06-26,6180,406,399,805,鳳林,三等
2020-06-27,6180,450,289,739,鳳林,三等
2020-06-28,6180,677,289,966,鳳林,三等
2020-06-29,6180,386,325,711,鳳林,三等
2020-06-30,6180,308,298,606,鳳林,三等
2020-07-01,6180,291,287,578,鳳林,三等
2020-07-02,6180,304,321,625,鳳林,三等
2020-07-03,6180,328,379,707,鳳林,三等
2020-07-04,6180,262,257,519,鳳林,三等
2020-07-05,6180,365,265,630,鳳林,三等
2020-07-06,6180,336,359,695,鳳林,三等
2020-07-07,6180,293,322,615,鳳林,三等
2020-07-08,6180,309,331,640,鳳林,三等
2020-07-09,6180,319,327,646,鳳林,三等
2020-07-10,6180,421,386,807,鳳林,三等
2020-07-11,6180,306,355,661,鳳林,三等
2020-07-12,6180,361,260,621,鳳林,三等
2020-07-13,6180,381,322,703,鳳林,三等
2020-07-14,6180,352,369,721,鳳林,三等
2020-07-15,6180,290,315,605,鳳林,三等
2020-07-16,6180,315,307,622,鳳林,三等
2020-07-17,6180,370,356,726,鳳林,三等
2020-07-18,6180,317,351,668,鳳林,三等
2020-07-19,6180,427,320,747,鳳林,三等
2020-07-20,6180,394,378,772,鳳林,三等
2020-07-21,6180,352,309,661,鳳林,三等
2020-07-22,6180,345,313,658,鳳林,三等
2020-07-23,6180,363,379,742,鳳林,三等
2020-07-24,6180,403,389,792,鳳林,三等
2020-07-25,6180,370,404,774,鳳林,三等
2020-07-26,6180,392,295,687,鳳林,三等
2020-07-27,6180,364,393,757,鳳林,三等
2020-07-28,6180,349,341,690,鳳林,三等
2020-07-29,6180,357,367,724,鳳林,三等
2020-07-30,6180,343,304,647,鳳林,三等
2020-07-31,6180,444,420,864,鳳林,三等
2020-08-01,6180,342,460,802,鳳林,三等
2020-08-02,6180,398,297,695,鳳林,三等
2020-08-03,6180,374,304,678,鳳林,三等
2020-08-04,6180,322,307,629,鳳林,三等
2020-08-05,6180,330,322,652,鳳林,三等
2020-08-06,6180,347,373,720,鳳林,三等
2020-08-07,6180,424,504,928,鳳林,三等
2020-08-08,6180,294,426,720,鳳林,三等
2020-08-09,6180,452,324,776,鳳林,三等
2020-08-10,6180,476,351,827,鳳林,三等
2020-08-11,6180,428,327,755,鳳林,三等
2020-08-12,6180,308,353,661,鳳林,三等
2020-08-13,6180,355,325,680,鳳林,三等
2020-08-14,6180,408,458,866,鳳林,三等
2020-08-15,6180,338,347,685,鳳林,三等
2020-08-16,6180,387,331,718,鳳林,三等
2020-08-17,6180,375,386,761,鳳林,三等
2020-08-18,6180,316,367,683,鳳林,三等
2020-08-19,6180,337,320,657,鳳林,三等
2020-08-20,6180,343,334,677,鳳林,三等
2020-08-21,6180,363,412,775,鳳林,三等
2020-08-22,6180,314,406,720,鳳林,三等
2020-08-23,6180,413,297,710,鳳林,三等
2020-08-24,6180,404,381,785,鳳林,三等
2020-08-25,6180,339,310,649,鳳林,三等
2020-08-26,6180,382,361,743,鳳林,三等
2020-08-27,6180,362,342,704,鳳林,三等
2020-08-28,6180,368,449,817,鳳林,三等
2020-08-29,6180,289,335,624,鳳林,三等
2020-08-30,6180,379,303,682,鳳林,三等
2020-08-31,6180,338,348,686,鳳林,三等
2020-09-01,6180,281,296,577,鳳林,三等
2020-09-02,6180,308,344,652,鳳林,三等
2020-09-03,6180,346,331,677,鳳林,三等
2020-09-04,6180,377,449,826,鳳林,三等
2020-09-05,6180,290,325,615,鳳林,三等
2020-09-06,6180,360,277,637,鳳林,三等
2020-09-07,6180,348,341,689,鳳林,三等
2020-09-08,6180,314,308,622,鳳林,三等
2020-09-09,6180,288,301,589,鳳林,三等
2020-09-10,6180,304,336,640,鳳林,三等
2020-09-11,6180,419,418,837,鳳林,三等
2020-09-12,6180,252,312,564,鳳林,三等
2020-09-13,6180,371,268,639,鳳林,三等
2020-09-14,6180,324,356,680,鳳林,三等
2020-09-15,6180,291,317,608,鳳林,三等
2020-09-16,6180,335,305,640,鳳林,三等
2020-09-17,6180,288,360,648,鳳林,三等
2020-09-18,6180,365,476,841,鳳林,三等
2020-09-19,6180,397,399,796,鳳林,三等
2020-09-20,6180,421,296,717,鳳林,三等
2020-09-21,6180,340,331,671,鳳林,三等
2020-09-22,6180,300,288,588,鳳林,三等
2020-09-23,6180,313,336,649,鳳林,三等
2020-09-24,6180,312,329,641,鳳林,三等
2020-09-25,6180,328,387,715,鳳林,三等
2020-09-26,6180,321,393,714,鳳林,三等
2020-09-27,6180,382,347,729,鳳林,三等
2020-09-28,6180,337,366,703,鳳林,三等
2020-09-29,6180,300,367,667,鳳林,三等
2020-09-30,6180,402,580,982,鳳林,三等
2020-10-01,6180,347,626,973,鳳林,三等
2020-10-02,6180,469,432,901,鳳林,三等
2020-10-03,6180,516,349,865,鳳林,三等
2020-10-04,6180,746,323,1069,鳳林,三等
2020-10-05,6180,412,408,820,鳳林,三等
2020-10-06,6180,323,319,642,鳳林,三等
2020-10-07,6180,285,357,642,鳳林,三等
2020-10-08,6180,383,502,885,鳳林,三等
2020-10-09,6180,387,485,872,鳳林,三等
2020-10-10,6180,364,300,664,鳳林,三等
2020-10-11,6180,540,321,861,鳳林,三等
2020-10-12,6180,411,348,759,鳳林,三等
2020-10-13,6180,295,322,617,鳳林,三等
2020-10-14,6180,299,308,607,鳳林,三等
2020-10-15,6180,322,322,644,鳳林,三等
2020-10-16,6180,412,471,883,鳳林,三等
2020-10-17,6180,287,307,594,鳳林,三等
2020-10-18,6180,359,292,651,鳳林,三等
2020-10-19,6180,384,333,717,鳳林,三等
2020-10-20,6180,311,308,619,鳳林,三等
2020-10-21,6180,281,330,611,鳳林,三等
2020-10-22,6180,311,463,774,鳳林,三等
2020-10-23,6180,432,448,880,鳳林,三等
2020-10-24,6180,333,347,680,鳳林,三等
2020-10-25,6180,420,328,748,鳳林,三等
2020-10-26,6180,351,376,727,鳳林,三等
2020-10-27,6180,353,317,670,鳳林,三等
2020-10-28,6180,299,290,589,鳳林,三等
2020-10-29,6180,285,318,603,鳳林,三等
2020-10-30,6180,415,477,892,鳳林,三等
2020-10-31,6180,280,291,571,鳳林,三等
2020-11-01,6180,466,304,770,鳳林,三等
2020-11-02,6180,316,344,660,鳳林,三等
2020-11-03,6180,331,298,629,鳳林,三等
2020-11-04,6180,292,304,596,鳳林,三等
2020-11-05,6180,310,302,612,鳳林,三等
2020-11-06,6180,361,465,826,鳳林,三等
2020-11-07,6180,292,318,610,鳳林,三等
2020-11-08,6180,431,291,722,鳳林,三等
2020-11-09,6180,332,367,699,鳳林,三等
2020-11-10,6180,299,317,616,鳳林,三等
2020-11-11,6180,333,306,639,鳳林,三等
2020-11-12,6180,309,292,601,鳳林,三等
2020-11-13,6180,413,535,948,鳳林,三等
2020-11-14,6180,325,344,669,鳳林,三等
2020-11-15,6180,493,347,840,鳳林,三等
2020-11-16,6180,355,370,725,鳳林,三等
2020-11-17,6180,326,334,660,鳳林,三等
2020-11-18,6180,342,304,646,鳳林,三等
2020-11-19,6180,312,327,639,鳳林,三等
2020-11-20,6180,409,534,943,鳳林,三等
2020-11-21,6180,305,316,621,鳳林,三等
2020-11-22,6180,423,327,750,鳳林,三等
2020-11-23,6180,321,392,713,鳳林,三等
2020-11-24,6180,295,301,596,鳳林,三等
2020-11-25,6180,326,311,637,鳳林,三等
2020-11-26,6180,559,379,938,鳳林,三等
2020-11-27,6180,422,506,928,鳳林,三等
2020-11-28,6180,333,352,685,鳳林,三等
2020-11-29,6180,399,309,708,鳳林,三等
2020-11-30,6180,354,366,720,鳳林,三等
2020-12-01,6180,289,316,605,鳳林,三等
2020-12-02,6180,273,301,574,鳳林,三等
2020-12-03,6180,290,288,578,鳳林,三等
2020-12-04,6180,380,444,824,鳳林,三等
2020-12-05,6180,259,300,559,鳳林,三等
2020-12-06,6180,412,303,715,鳳林,三等
2020-12-07,6180,299,347,646,鳳林,三等
2020-12-08,6180,286,283,569,鳳林,三等
2020-12-09,6180,280,276,556,鳳林,三等
2020-12-10,6180,297,312,609,鳳林,三等
2020-12-11,6180,412,476,888,鳳林,三等
2020-12-12,6180,261,338,599,鳳林,三等
2020-12-13,6180,456,299,755,鳳林,三等
2020-12-14,6180,329,366,695,鳳林,三等
2020-12-15,6180,267,281,548,鳳林,三等
2020-12-16,6180,308,310,618,鳳林,三等
2020-12-17,6180,330,369,699,鳳林,三等
2020-12-18,6180,379,489,868,鳳林,三等
2020-12-19,6180,300,1066,1366,鳳林,三等
2020-12-20,6180,1073,306,1379,鳳林,三等
2020-12-21,6180,326,321,647,鳳林,三等
2020-12-22,6180,296,313,609,鳳林,三等
2020-12-23,6180,267,288,555,鳳林,三等
2020-12-24,6180,297,374,671,鳳林,三等
2020-12-25,6180,347,469,816,鳳林,三等
2020-12-26,6180,287,307,594,鳳林,三等
2020-12-27,6180,486,321,807,鳳林,三等
2020-12-28,6180,347,319,666,鳳林,三等
2020-12-29,6180,356,373,729,鳳林,三等
2020-12-30,6180,310,332,642,鳳林,三等
2020-12-31,6180,385,505,890,鳳林,三等
2020-01-01,6190,23,20,43,南平,三等
2020-01-02,6190,24,31,55,南平,三等
2020-01-03,6190,13,26,39,南平,三等
2020-01-04,6190,9,15,24,南平,三等
2020-01-05,6190,15,11,26,南平,三等
2020-01-06,6190,24,22,46,南平,三等
2020-01-07,6190,23,27,50,南平,三等
2020-01-08,6190,21,31,52,南平,三等
2020-01-09,6190,25,26,51,南平,三等
2020-01-10,6190,25,41,66,南平,三等
2020-01-11,6190,13,30,43,南平,三等
2020-01-12,6190,15,19,34,南平,三等
2020-01-13,6190,23,26,49,南平,三等
2020-01-14,6190,23,34,57,南平,三等
2020-01-15,6190,23,24,47,南平,三等
2020-01-16,6190,21,16,37,南平,三等
2020-01-17,6190,11,20,31,南平,三等
2020-01-18,6190,3,12,15,南平,三等
2020-01-19,6190,23,12,35,南平,三等
2020-01-20,6190,16,11,27,南平,三等
2020-01-21,6190,14,20,34,南平,三等
2020-01-22,6190,13,22,35,南平,三等
2020-01-23,6190,17,33,50,南平,三等
2020-01-24,6190,6,12,18,南平,三等
2020-01-25,6190,6,14,20,南平,三等
2020-01-26,6190,20,21,41,南平,三等
2020-01-27,6190,22,13,35,南平,三等
2020-01-28,6190,13,17,30,南平,三等
2020-01-29,6190,20,12,32,南平,三等
2020-01-30,6190,19,19,38,南平,三等
2020-01-31,6190,25,17,42,南平,三等
2020-02-01,6190,6,13,19,南平,三等
2020-02-02,6190,11,5,16,南平,三等
2020-02-03,6190,17,17,34,南平,三等
2020-02-04,6190,14,15,29,南平,三等
2020-02-05,6190,6,8,14,南平,三等
2020-02-06,6190,10,6,16,南平,三等
2020-02-07,6190,17,17,34,南平,三等
2020-02-08,6190,8,10,18,南平,三等
2020-02-09,6190,4,5,9,南平,三等
2020-02-10,6190,16,14,30,南平,三等
2020-02-11,6190,13,8,21,南平,三等
2020-02-12,6190,15,14,29,南平,三等
2020-02-13,6190,20,14,34,南平,三等
2020-02-14,6190,15,10,25,南平,三等
2020-02-15,6190,6,13,19,南平,三等
2020-02-16,6190,4,10,14,南平,三等
2020-02-17,6190,12,16,28,南平,三等
2020-02-18,6190,18,15,33,南平,三等
2020-02-19,6190,20,23,43,南平,三等
2020-02-20,6190,15,13,28,南平,三等
2020-02-21,6190,17,19,36,南平,三等
2020-02-22,6190,6,11,17,南平,三等
2020-02-23,6190,10,10,20,南平,三等
2020-02-24,6190,17,8,25,南平,三等
2020-02-25,6190,22,22,44,南平,三等
2020-02-26,6190,24,33,57,南平,三等
2020-02-27,6190,24,46,70,南平,三等
2020-02-28,6190,13,36,49,南平,三等
2020-02-29,6190,9,9,18,南平,三等
2020-03-01,6190,11,6,17,南平,三等
2020-03-02,6190,28,20,48,南平,三等
2020-03-03,6190,25,26,51,南平,三等
2020-03-04,6190,18,34,52,南平,三等
2020-03-05,6190,21,26,47,南平,三等
2020-03-06,6190,21,53,74,南平,三等
2020-03-07,6190,9,31,40,南平,三等
2020-03-08,6190,12,7,19,南平,三等
2020-03-09,6190,26,28,54,南平,三等
2020-03-10,6190,16,28,44,南平,三等
2020-03-11,6190,24,25,49,南平,三等
2020-03-12,6190,19,24,43,南平,三等
2020-03-13,6190,24,40,64,南平,三等
2020-03-14,6190,8,27,35,南平,三等
2020-03-15,6190,15,6,21,南平,三等
2020-03-16,6190,21,19,40,南平,三等
2020-03-17,6190,24,29,53,南平,三等
2020-03-18,6190,17,28,45,南平,三等
2020-03-19,6190,21,29,50,南平,三等
2020-03-20,6190,18,39,57,南平,三等
2020-03-21,6190,9,17,26,南平,三等
2020-03-22,6190,11,11,22,南平,三等
2020-03-23,6190,28,19,47,南平,三等
2020-03-24,6190,26,31,57,南平,三等
2020-03-25,6190,17,20,37,南平,三等
2020-03-26,6190,25,26,51,南平,三等
2020-03-27,6190,27,31,58,南平,三等
2020-03-28,6190,1,26,27,南平,三等
2020-03-29,6190,12,12,24,南平,三等
2020-03-30,6190,25,23,48,南平,三等
2020-03-31,6190,23,29,52,南平,三等
2020-04-01,6190,24,41,65,南平,三等
2020-04-02,6190,26,47,73,南平,三等
2020-04-03,6190,20,24,44,南平,三等
2020-04-04,6190,16,11,27,南平,三等
2020-04-05,6190,23,5,28,南平,三等
2020-04-06,6190,37,25,62,南平,三等
2020-04-07,6190,24,30,54,南平,三等
2020-04-08,6190,23,27,50,南平,三等
2020-04-09,6190,22,26,48,南平,三等
2020-04-10,6190,22,27,49,南平,三等
2020-04-11,6190,2,23,25,南平,三等
2020-04-12,6190,12,5,17,南平,三等
2020-04-13,6190,25,20,45,南平,三等
2020-04-14,6190,23,26,49,南平,三等
2020-04-15,6190,25,29,54,南平,三等
2020-04-16,6190,20,24,44,南平,三等
2020-04-17,6190,24,26,50,南平,三等
2020-04-18,6190,11,22,33,南平,三等
2020-04-19,6190,15,7,22,南平,三等
2020-04-20,6190,20,22,42,南平,三等
2020-04-21,6190,20,24,44,南平,三等
2020-04-22,6190,23,26,49,南平,三等
2020-04-23,6190,18,21,39,南平,三等
2020-04-24,6190,25,26,51,南平,三等
2020-04-25,6190,12,13,25,南平,三等
2020-04-26,6190,17,7,24,南平,三等
2020-04-27,6190,23,17,40,南平,三等
2020-04-28,6190,26,28,54,南平,三等
2020-04-29,6190,26,25,51,南平,三等
2020-04-30,6190,26,26,52,南平,三等
2020-05-01,6190,21,34,55,南平,三等
2020-05-02,6190,10,19,29,南平,三等
2020-05-03,6190,13,10,23,南平,三等
2020-05-04,6190,34,23,57,南平,三等
2020-05-05,6190,29,26,55,南平,三等
2020-05-06,6190,27,29,56,南平,三等
2020-05-07,6190,25,33,58,南平,三等
2020-05-08,6190,30,39,69,南平,三等
2020-05-09,6190,13,18,31,南平,三等
2020-05-10,6190,19,17,36,南平,三等
2020-05-11,6190,34,18,52,南平,三等
2020-05-12,6190,23,27,50,南平,三等
2020-05-13,6190,28,29,57,南平,三等
2020-05-14,6190,31,34,65,南平,三等
2020-05-15,6190,26,38,64,南平,三等
2020-05-16,6190,8,25,33,南平,三等
2020-05-17,6190,23,10,33,南平,三等
2020-05-18,6190,36,24,60,南平,三等
2020-05-19,6190,29,33,62,南平,三等
2020-05-20,6190,26,24,50,南平,三等
2020-05-21,6190,27,27,54,南平,三等
2020-05-22,6190,31,39,70,南平,三等
2020-05-23,6190,13,25,38,南平,三等
2020-05-24,6190,12,10,22,南平,三等
2020-05-25,6190,33,20,53,南平,三等
2020-05-26,6190,33,41,74,南平,三等
2020-05-27,6190,20,25,45,南平,三等
2020-05-28,6190,24,23,47,南平,三等
2020-05-29,6190,27,32,59,南平,三等
2020-05-30,6190,6,26,32,南平,三等
2020-05-31,6190,12,7,19,南平,三等
2020-06-01,6190,35,20,55,南平,三等
2020-06-02,6190,25,30,55,南平,三等
2020-06-03,6190,29,31,60,南平,三等
2020-06-04,6190,24,30,54,南平,三等
2020-06-05,6190,31,30,61,南平,三等
2020-06-06,6190,5,21,26,南平,三等
2020-06-07,6190,18,11,29,南平,三等
2020-06-08,6190,28,26,54,南平,三等
2020-06-09,6190,23,25,48,南平,三等
2020-06-10,6190,29,25,54,南平,三等
2020-06-11,6190,25,29,54,南平,三等
2020-06-12,6190,29,33,62,南平,三等
2020-06-13,6190,15,35,50,南平,三等
2020-06-14,6190,10,8,18,南平,三等
2020-06-15,6190,25,18,43,南平,三等
2020-06-16,6190,23,33,56,南平,三等
2020-06-17,6190,20,19,39,南平,三等
2020-06-18,6190,22,30,52,南平,三等
2020-06-19,6190,27,43,70,南平,三等
2020-06-20,6190,14,18,32,南平,三等
2020-06-21,6190,9,24,33,南平,三等
2020-06-22,6190,34,13,47,南平,三等
2020-06-23,6190,23,23,46,南平,三等
2020-06-24,6190,19,24,43,南平,三等
2020-06-25,6190,17,34,51,南平,三等
2020-06-26,6190,12,15,27,南平,三等
2020-06-27,6190,11,11,22,南平,三等
2020-06-28,6190,12,6,18,南平,三等
2020-06-29,6190,31,12,43,南平,三等
2020-06-30,6190,17,17,34,南平,三等
2020-07-01,6190,33,14,47,南平,三等
2020-07-02,6190,22,25,47,南平,三等
2020-07-03,6190,18,31,49,南平,三等
2020-07-04,6190,15,19,34,南平,三等
2020-07-05,6190,20,17,37,南平,三等
2020-07-06,6190,30,25,55,南平,三等
2020-07-07,6190,33,22,55,南平,三等
2020-07-08,6190,22,24,46,南平,三等
2020-07-09,6190,23,23,46,南平,三等
2020-07-10,6190,21,27,48,南平,三等
2020-07-11,6190,8,22,30,南平,三等
2020-07-12,6190,13,5,18,南平,三等
2020-07-13,6190,24,13,37,南平,三等
2020-07-14,6190,35,34,69,南平,三等
2020-07-15,6190,13,22,35,南平,三等
2020-07-16,6190,17,19,36,南平,三等
2020-07-17,6190,24,23,47,南平,三等
2020-07-18,6190,16,17,33,南平,三等
2020-07-19,6190,8,3,11,南平,三等
2020-07-20,6190,25,13,38,南平,三等
2020-07-21,6190,26,22,48,南平,三等
2020-07-22,6190,26,18,44,南平,三等
2020-07-23,6190,17,25,42,南平,三等
2020-07-24,6190,23,15,38,南平,三等
2020-07-25,6190,41,29,70,南平,三等
2020-07-26,6190,10,9,19,南平,三等
2020-07-27,6190,22,13,35,南平,三等
2020-07-28,6190,20,19,39,南平,三等
2020-07-29,6190,21,19,40,南平,三等
2020-07-30,6190,25,18,43,南平,三等
2020-07-31,6190,25,30,55,南平,三等
2020-08-01,6190,7,11,18,南平,三等
2020-08-02,6190,10,12,22,南平,三等
2020-08-03,6190,19,20,39,南平,三等
2020-08-04,6190,22,13,35,南平,三等
2020-08-05,6190,19,20,39,南平,三等
2020-08-06,6190,19,17,36,南平,三等
2020-08-07,6190,18,22,40,南平,三等
2020-08-08,6190,5,4,9,南平,三等
2020-08-09,6190,17,9,26,南平,三等
2020-08-10,6190,17,14,31,南平,三等
2020-08-11,6190,10,11,21,南平,三等
2020-08-12,6190,16,19,35,南平,三等
2020-08-13,6190,19,23,42,南平,三等
2020-08-14,6190,18,20,38,南平,三等
2020-08-15,6190,5,11,16,南平,三等
2020-08-16,6190,8,11,19,南平,三等
2020-08-17,6190,16,17,33,南平,三等
2020-08-18,6190,16,19,35,南平,三等
2020-08-19,6190,14,16,30,南平,三等
2020-08-20,6190,12,14,26,南平,三等
2020-08-21,6190,23,24,47,南平,三等
2020-08-22,6190,8,14,22,南平,三等
2020-08-23,6190,11,7,18,南平,三等
2020-08-24,6190,21,14,35,南平,三等
2020-08-25,6190,12,18,30,南平,三等
2020-08-26,6190,18,13,31,南平,三等
2020-08-27,6190,14,13,27,南平,三等
2020-08-28,6190,11,12,23,南平,三等
2020-08-29,6190,4,4,8,南平,三等
2020-08-30,6190,6,4,10,南平,三等
2020-08-31,6190,22,14,36,南平,三等
2020-09-01,6190,25,24,49,南平,三等
2020-09-02,6190,27,28,55,南平,三等
2020-09-03,6190,27,29,56,南平,三等
2020-09-04,6190,28,37,65,南平,三等
2020-09-05,6190,10,36,46,南平,三等
2020-09-06,6190,23,8,31,南平,三等
2020-09-07,6190,34,19,53,南平,三等
2020-09-08,6190,29,28,57,南平,三等
2020-09-09,6190,17,28,45,南平,三等
2020-09-10,6190,25,27,52,南平,三等
2020-09-11,6190,32,38,70,南平,三等
2020-09-12,6190,15,22,37,南平,三等
2020-09-13,6190,22,6,28,南平,三等
2020-09-14,6190,26,18,44,南平,三等
2020-09-15,6190,27,27,54,南平,三等
2020-09-16,6190,27,24,51,南平,三等
2020-09-17,6190,18,23,41,南平,三等
2020-09-18,6190,23,37,60,南平,三等
2020-09-19,6190,19,34,53,南平,三等
2020-09-20,6190,13,6,19,南平,三等
2020-09-21,6190,26,22,48,南平,三等
2020-09-22,6190,28,24,52,南平,三等
2020-09-23,6190,23,25,48,南平,三等
2020-09-24,6190,19,24,43,南平,三等
2020-09-25,6190,27,34,61,南平,三等
2020-09-26,6190,21,36,57,南平,三等
2020-09-27,6190,11,7,18,南平,三等
2020-09-28,6190,27,22,49,南平,三等
2020-09-29,6190,22,24,46,南平,三等
2020-09-30,6190,26,47,73,南平,三等
2020-10-01,6190,17,22,39,南平,三等
2020-10-02,6190,15,13,28,南平,三等
2020-10-03,6190,16,7,23,南平,三等
2020-10-04,6190,28,11,39,南平,三等
2020-10-05,6190,29,23,52,南平,三等
2020-10-06,6190,18,36,54,南平,三等
2020-10-07,6190,20,31,51,南平,三等
2020-10-08,6190,24,46,70,南平,三等
2020-10-09,6190,22,21,43,南平,三等
2020-10-10,6190,4,6,10,南平,三等
2020-10-11,6190,17,3,20,南平,三等
2020-10-12,6190,33,26,59,南平,三等
2020-10-13,6190,24,23,47,南平,三等
2020-10-14,6190,26,25,51,南平,三等
2020-10-15,6190,23,26,49,南平,三等
2020-10-16,6190,23,38,61,南平,三等
2020-10-17,6190,13,20,33,南平,三等
2020-10-18,6190,42,36,78,南平,三等
2020-10-19,6190,25,23,48,南平,三等
2020-10-20,6190,31,28,59,南平,三等
2020-10-21,6190,22,25,47,南平,三等
2020-10-22,6190,19,33,52,南平,三等
2020-10-23,6190,23,40,63,南平,三等
2020-10-24,6190,7,16,23,南平,三等
2020-10-25,6190,23,12,35,南平,三等
2020-10-26,6190,35,29,64,南平,三等
2020-10-27,6190,26,29,55,南平,三等
2020-10-28,6190,27,25,52,南平,三等
2020-10-29,6190,21,24,45,南平,三等
2020-10-30,6190,22,41,63,南平,三等
2020-10-31,6190,15,15,30,南平,三等
2020-11-01,6190,16,11,27,南平,三等
2020-11-02,6190,25,21,46,南平,三等
2020-11-03,6190,27,25,52,南平,三等
2020-11-04,6190,26,26,52,南平,三等
2020-11-05,6190,23,27,50,南平,三等
2020-11-06,6190,22,48,70,南平,三等
2020-11-07,6190,11,21,32,南平,三等
2020-11-08,6190,33,13,46,南平,三等
2020-11-09,6190,28,30,58,南平,三等
2020-11-10,6190,25,28,53,南平,三等
2020-11-11,6190,30,23,53,南平,三等
2020-11-12,6190,22,21,43,南平,三等
2020-11-13,6190,24,44,68,南平,三等
2020-11-14,6190,8,11,19,南平,三等
2020-11-15,6190,17,5,22,南平,三等
2020-11-16,6190,32,27,59,南平,三等
2020-11-17,6190,27,28,55,南平,三等
2020-11-18,6190,29,25,54,南平,三等
2020-11-19,6190,28,23,51,南平,三等
2020-11-20,6190,30,44,74,南平,三等
2020-11-21,6190,16,16,32,南平,三等
2020-11-22,6190,13,17,30,南平,三等
2020-11-23,6190,34,23,57,南平,三等
2020-11-24,6190,26,23,49,南平,三等
2020-11-25,6190,21,25,46,南平,三等
2020-11-26,6190,21,24,45,南平,三等
2020-11-27,6190,22,37,59,南平,三等
2020-11-28,6190,44,45,89,南平,三等
2020-11-29,6190,7,9,16,南平,三等
2020-11-30,6190,32,25,57,南平,三等
2020-12-01,6190,28,22,50,南平,三等
2020-12-02,6190,28,29,57,南平,三等
2020-12-03,6190,20,18,38,南平,三等
2020-12-04,6190,20,40,60,南平,三等
2020-12-05,6190,9,14,23,南平,三等
2020-12-06,6190,11,14,25,南平,三等
2020-12-07,6190,34,24,58,南平,三等
2020-12-08,6190,22,27,49,南平,三等
2020-12-09,6190,23,30,53,南平,三等
2020-12-10,6190,29,21,50,南平,三等
2020-12-11,6190,22,36,58,南平,三等
2020-12-12,6190,17,18,35,南平,三等
2020-12-13,6190,19,10,29,南平,三等
2020-12-14,6190,30,25,55,南平,三等
2020-12-15,6190,25,25,50,南平,三等
2020-12-16,6190,20,26,46,南平,三等
2020-12-17,6190,25,28,53,南平,三等
2020-12-18,6190,29,39,68,南平,三等
2020-12-19,6190,7,3,10,南平,三等
2020-12-20,6190,13,13,26,南平,三等
2020-12-21,6190,35,27,62,南平,三等
2020-12-22,6190,18,21,39,南平,三等
2020-12-23,6190,25,27,52,南平,三等
2020-12-24,6190,20,29,49,南平,三等
2020-12-25,6190,23,40,63,南平,三等
2020-12-26,6190,8,12,20,南平,三等
2020-12-27,6190,15,4,19,南平,三等
2020-12-28,6190,34,25,59,南平,三等
2020-12-29,6190,26,27,53,南平,三等
2020-12-30,6190,26,31,57,南平,三等
2020-12-31,6190,23,34,57,南平,三等
2020-01-01,6200,39,22,61,林榮新光,簡易
2020-01-02,6200,23,27,50,林榮新光,簡易
2020-01-03,6200,27,9,36,林榮新光,簡易
2020-01-04,6200,40,44,84,林榮新光,簡易
2020-01-05,6200,37,32,69,林榮新光,簡易
2020-01-06,6200,14,15,29,林榮新光,簡易
2020-01-07,6200,26,18,44,林榮新光,簡易
2020-01-08,6200,26,262,288,林榮新光,簡易
2020-01-09,6200,11,18,29,林榮新光,簡易
2020-01-10,6200,10,14,24,林榮新光,簡易
2020-01-11,6200,29,34,63,林榮新光,簡易
2020-01-12,6200,50,27,77,林榮新光,簡易
2020-01-13,6200,72,50,122,林榮新光,簡易
2020-01-14,6200,18,13,31,林榮新光,簡易
2020-01-15,6200,23,26,49,林榮新光,簡易
2020-01-16,6200,30,22,52,林榮新光,簡易
2020-01-17,6200,17,29,46,林榮新光,簡易
2020-01-18,6200,40,79,119,林榮新光,簡易
2020-01-19,6200,115,78,193,林榮新光,簡易
2020-01-20,6200,60,32,92,林榮新光,簡易
2020-01-21,6200,54,48,102,林榮新光,簡易
2020-01-22,6200,42,40,82,林榮新光,簡易
2020-01-23,6200,55,24,79,林榮新光,簡易
2020-01-24,6200,11,23,34,林榮新光,簡易
2020-01-25,6200,46,56,102,林榮新光,簡易
2020-01-26,6200,53,64,117,林榮新光,簡易
2020-01-27,6200,82,50,132,林榮新光,簡易
2020-01-28,6200,74,62,136,林榮新光,簡易
2020-01-29,6200,45,63,108,林榮新光,簡易
2020-01-30,6200,92,97,189,林榮新光,簡易
2020-01-31,6200,106,116,222,林榮新光,簡易
2020-02-01,6200,96,190,286,林榮新光,簡易
2020-02-02,6200,190,42,232,林榮新光,簡易
2020-02-03,6200,75,32,107,林榮新光,簡易
2020-02-04,6200,35,19,54,林榮新光,簡易
2020-02-05,6200,76,82,158,林榮新光,簡易
2020-02-06,6200,134,61,195,林榮新光,簡易
2020-02-07,6200,38,63,101,林榮新光,簡易
2020-02-08,6200,50,111,161,林榮新光,簡易
2020-02-09,6200,89,47,136,林榮新光,簡易
2020-02-10,6200,56,31,87,林榮新光,簡易
2020-02-11,6200,34,37,71,林榮新光,簡易
2020-02-12,6200,43,41,84,林榮新光,簡易
2020-02-13,6200,24,10,34,林榮新光,簡易
2020-02-14,6200,14,16,30,林榮新光,簡易
2020-02-15,6200,24,47,71,林榮新光,簡易
2020-02-16,6200,66,37,103,林榮新光,簡易
2020-02-17,6200,61,47,108,林榮新光,簡易
2020-02-18,6200,37,38,75,林榮新光,簡易
2020-02-19,6200,46,22,68,林榮新光,簡易
2020-02-20,6200,20,29,49,林榮新光,簡易
2020-02-21,6200,33,61,94,林榮新光,簡易
2020-02-22,6200,51,61,112,林榮新光,簡易
2020-02-23,6200,87,31,118,林榮新光,簡易
2020-02-24,6200,52,28,80,林榮新光,簡易
2020-02-25,6200,13,13,26,林榮新光,簡易
2020-02-26,6200,18,12,30,林榮新光,簡易
2020-02-27,6200,29,28,57,林榮新光,簡易
2020-02-28,6200,37,55,92,林榮新光,簡易
2020-02-29,6200,92,68,160,林榮新光,簡易
2020-03-01,6200,63,44,107,林榮新光,簡易
2020-03-02,6200,18,19,37,林榮新光,簡易
2020-03-03,6200,3,9,12,林榮新光,簡易
2020-03-04,6200,8,3,11,林榮新光,簡易
2020-03-05,6200,7,6,13,林榮新光,簡易
2020-03-06,6200,6,6,12,林榮新光,簡易
2020-03-07,6200,36,94,130,林榮新光,簡易
2020-03-08,6200,80,26,106,林榮新光,簡易
2020-03-09,6200,26,10,36,林榮新光,簡易
2020-03-10,6200,1,1,2,林榮新光,簡易
2020-03-11,6200,11,7,18,林榮新光,簡易
2020-03-12,6200,12,20,32,林榮新光,簡易
2020-03-13,6200,22,16,38,林榮新光,簡易
2020-03-14,6200,37,32,69,林榮新光,簡易
2020-03-15,6200,36,18,54,林榮新光,簡易
2020-03-16,6200,13,9,22,林榮新光,簡易
2020-03-17,6200,8,4,12,林榮新光,簡易
2020-03-18,6200,14,18,32,林榮新光,簡易
2020-03-19,6200,21,11,32,林榮新光,簡易
2020-03-20,6200,11,25,36,林榮新光,簡易
2020-03-21,6200,25,58,83,林榮新光,簡易
2020-03-22,6200,59,21,80,林榮新光,簡易
2020-03-23,6200,21,11,32,林榮新光,簡易
2020-03-24,6200,16,19,35,林榮新光,簡易
2020-03-25,6200,20,28,48,林榮新光,簡易
2020-03-26,6200,13,16,29,林榮新光,簡易
2020-03-27,6200,30,17,47,林榮新光,簡易
2020-03-28,6200,34,32,66,林榮新光,簡易
2020-03-29,6200,37,26,63,林榮新光,簡易
2020-03-30,6200,28,8,36,林榮新光,簡易
2020-03-31,6200,15,15,30,林榮新光,簡易
2020-04-01,6200,12,10,22,林榮新光,簡易
2020-04-02,6200,26,64,90,林榮新光,簡易
2020-04-03,6200,56,34,90,林榮新光,簡易
2020-04-04,6200,66,40,106,林榮新光,簡易
2020-04-05,6200,36,21,57,林榮新光,簡易
2020-04-06,6200,5,2,7,林榮新光,簡易
2020-04-07,6200,10,6,16,林榮新光,簡易
2020-04-08,6200,10,6,16,林榮新光,簡易
2020-04-09,6200,10,9,19,林榮新光,簡易
2020-04-10,6200,7,13,20,林榮新光,簡易
2020-04-11,6200,17,30,47,林榮新光,簡易
2020-04-12,6200,14,11,25,林榮新光,簡易
2020-04-13,6200,2,7,9,林榮新光,簡易
2020-04-14,6200,9,10,19,林榮新光,簡易
2020-04-15,6200,2,8,10,林榮新光,簡易
2020-04-16,6200,13,10,23,林榮新光,簡易
2020-04-17,6200,8,12,20,林榮新光,簡易
2020-04-18,6200,9,18,27,林榮新光,簡易
2020-04-19,6200,21,10,31,林榮新光,簡易
2020-04-20,6200,5,12,17,林榮新光,簡易
2020-04-21,6200,6,3,9,林榮新光,簡易
2020-04-22,6200,4,5,9,林榮新光,簡易
2020-04-23,6200,3,6,9,林榮新光,簡易
2020-04-24,6200,4,6,10,林榮新光,簡易
2020-04-25,6200,10,14,24,林榮新光,簡易
2020-04-26,6200,35,18,53,林榮新光,簡易
2020-04-27,6200,10,4,14,林榮新光,簡易
2020-04-28,6200,8,9,17,林榮新光,簡易
2020-04-29,6200,9,4,13,林榮新光,簡易
2020-04-30,6200,12,7,19,林榮新光,簡易
2020-05-01,6200,10,24,34,林榮新光,簡易
2020-05-02,6200,29,41,70,林榮新光,簡易
2020-05-03,6200,57,3,60,林榮新光,簡易
2020-05-04,6200,5,3,8,林榮新光,簡易
2020-05-05,6200,6,12,18,林榮新光,簡易
2020-05-06,6200,9,17,26,林榮新光,簡易
2020-05-07,6200,12,9,21,林榮新光,簡易
2020-05-08,6200,13,5,18,林榮新光,簡易
2020-05-09,6200,10,17,27,林榮新光,簡易
2020-05-10,6200,46,48,94,林榮新光,簡易
2020-05-11,6200,14,18,32,林榮新光,簡易
2020-05-12,6200,14,6,20,林榮新光,簡易
2020-05-13,6200,20,15,35,林榮新光,簡易
2020-05-14,6200,7,12,19,林榮新光,簡易
2020-05-15,6200,7,10,17,林榮新光,簡易
2020-05-16,6200,35,18,53,林榮新光,簡易
2020-05-17,6200,38,14,52,林榮新光,簡易
2020-05-18,6200,11,14,25,林榮新光,簡易
2020-05-19,6200,13,2,15,林榮新光,簡易
2020-05-20,6200,11,11,22,林榮新光,簡易
2020-05-21,6200,15,11,26,林榮新光,簡易
2020-05-22,6200,16,10,26,林榮新光,簡易
2020-05-23,6200,10,31,41,林榮新光,簡易
2020-05-24,6200,52,22,74,林榮新光,簡易
2020-05-25,6200,17,21,38,林榮新光,簡易
2020-05-26,6200,12,13,25,林榮新光,簡易
2020-05-27,6200,8,17,25,林榮新光,簡易
2020-05-28,6200,14,15,29,林榮新光,簡易
2020-05-29,6200,17,9,26,林榮新光,簡易
2020-05-30,6200,18,14,32,林榮新光,簡易
2020-05-31,6200,25,17,42,林榮新光,簡易
2020-06-01,6200,7,9,16,林榮新光,簡易
2020-06-02,6200,8,11,19,林榮新光,簡易
2020-06-03,6200,9,24,33,林榮新光,簡易
2020-06-04,6200,35,26,61,林榮新光,簡易
2020-06-05,6200,17,41,58,林榮新光,簡易
2020-06-06,6200,36,57,93,林榮新光,簡易
2020-06-07,6200,69,31,100,林榮新光,簡易
2020-06-08,6200,46,13,59,林榮新光,簡易
2020-06-09,6200,16,20,36,林榮新光,簡易
2020-06-10,6200,56,49,105,林榮新光,簡易
2020-06-11,6200,8,17,25,林榮新光,簡易
2020-06-12,6200,11,30,41,林榮新光,簡易
2020-06-13,6200,28,30,58,林榮新光,簡易
2020-06-14,6200,34,24,58,林榮新光,簡易
2020-06-15,6200,20,14,34,林榮新光,簡易
2020-06-16,6200,9,11,20,林榮新光,簡易
2020-06-17,6200,15,18,33,林榮新光,簡易
2020-06-18,6200,19,12,31,林榮新光,簡易
2020-06-19,6200,21,37,58,林榮新光,簡易
2020-06-20,6200,49,59,108,林榮新光,簡易
2020-06-21,6200,70,54,124,林榮新光,簡易
2020-06-22,6200,57,22,79,林榮新光,簡易
2020-06-23,6200,29,12,41,林榮新光,簡易
2020-06-24,6200,6,18,24,林榮新光,簡易
2020-06-25,6200,26,29,55,林榮新光,簡易
2020-06-26,6200,49,46,95,林榮新光,簡易
2020-06-27,6200,38,14,52,林榮新光,簡易
2020-06-28,6200,23,18,41,林榮新光,簡易
2020-06-29,6200,13,12,25,林榮新光,簡易
2020-06-30,6200,35,13,48,林榮新光,簡易
2020-07-01,6200,15,18,33,林榮新光,簡易
2020-07-02,6200,7,34,41,林榮新光,簡易
2020-07-03,6200,277,288,565,林榮新光,簡易
2020-07-04,6200,40,28,68,林榮新光,簡易
2020-07-05,6200,29,31,60,林榮新光,簡易
2020-07-06,6200,19,28,47,林榮新光,簡易
2020-07-07,6200,22,13,35,林榮新光,簡易
2020-07-08,6200,24,28,52,林榮新光,簡易
2020-07-09,6200,31,23,54,林榮新光,簡易
2020-07-10,6200,29,31,60,林榮新光,簡易
2020-07-11,6200,29,91,120,林榮新光,簡易
2020-07-12,6200,82,22,104,林榮新光,簡易
2020-07-13,6200,27,23,50,林榮新光,簡易
2020-07-14,6200,27,40,67,林榮新光,簡易
2020-07-15,6200,18,22,40,林榮新光,簡易
2020-07-16,6200,67,57,124,林榮新光,簡易
2020-07-17,6200,35,65,100,林榮新光,簡易
2020-07-18,6200,39,44,83,林榮新光,簡易
2020-07-19,6200,39,55,94,林榮新光,簡易
2020-07-20,6200,47,54,101,林榮新光,簡易
2020-07-21,6200,59,24,83,林榮新光,簡易
2020-07-22,6200,48,22,70,林榮新光,簡易
2020-07-23,6200,47,51,98,林榮新光,簡易
2020-07-24,6200,36,34,70,林榮新光,簡易
2020-07-25,6200,48,36,84,林榮新光,簡易
2020-07-26,6200,29,36,65,林榮新光,簡易
2020-07-27,6200,33,51,84,林榮新光,簡易
2020-07-28,6200,34,31,65,林榮新光,簡易
2020-07-29,6200,61,42,103,林榮新光,簡易
2020-07-30,6200,52,33,85,林榮新光,簡易
2020-07-31,6200,74,55,129,林榮新光,簡易
2020-08-01,6200,36,31,67,林榮新光,簡易
2020-08-02,6200,31,26,57,林榮新光,簡易
2020-08-03,6200,34,31,65,林榮新光,簡易
2020-08-04,6200,18,11,29,林榮新光,簡易
2020-08-05,6200,49,51,100,林榮新光,簡易
2020-08-06,6200,28,46,74,林榮新光,簡易
2020-08-07,6200,38,27,65,林榮新光,簡易
2020-08-08,6200,28,18,46,林榮新光,簡易
2020-08-09,6200,27,16,43,林榮新光,簡易
2020-08-10,6200,27,106,133,林榮新光,簡易
2020-08-11,6200,21,104,125,林榮新光,簡易
2020-08-12,6200,66,66,132,林榮新光,簡易
2020-08-13,6200,54,37,91,林榮新光,簡易
2020-08-14,6200,111,34,145,林榮新光,簡易
2020-08-15,6200,35,23,58,林榮新光,簡易
2020-08-16,6200,35,44,79,林榮新光,簡易
2020-08-17,6200,23,19,42,林榮新光,簡易
2020-08-18,6200,16,36,52,林榮新光,簡易
2020-08-19,6200,46,36,82,林榮新光,簡易
2020-08-20,6200,22,11,33,林榮新光,簡易
2020-08-21,6200,31,19,50,林榮新光,簡易
2020-08-22,6200,55,53,108,林榮新光,簡易
2020-08-23,6200,41,29,70,林榮新光,簡易
2020-08-24,6200,17,16,33,林榮新光,簡易
2020-08-25,6200,54,16,70,林榮新光,簡易
2020-08-26,6200,18,28,46,林榮新光,簡易
2020-08-27,6200,39,29,68,林榮新光,簡易
2020-08-28,6200,41,37,78,林榮新光,簡易
2020-08-29,6200,38,39,77,林榮新光,簡易
2020-08-30,6200,32,16,48,林榮新光,簡易
2020-08-31,6200,24,16,40,林榮新光,簡易
2020-09-01,6200,6,17,23,林榮新光,簡易
2020-09-02,6200,7,9,16,林榮新光,簡易
2020-09-03,6200,15,14,29,林榮新光,簡易
2020-09-04,6200,12,8,20,林榮新光,簡易
2020-09-05,6200,32,42,74,林榮新光,簡易
2020-09-06,6200,50,14,64,林榮新光,簡易
2020-09-07,6200,16,24,40,林榮新光,簡易
2020-09-08,6200,25,21,46,林榮新光,簡易
2020-09-09,6200,17,10,27,林榮新光,簡易
2020-09-10,6200,13,24,37,林榮新光,簡易
2020-09-11,6200,15,52,67,林榮新光,簡易
2020-09-12,6200,42,36,78,林榮新光,簡易
2020-09-13,6200,44,14,58,林榮新光,簡易
2020-09-14,6200,17,9,26,林榮新光,簡易
2020-09-15,6200,14,5,19,林榮新光,簡易
2020-09-16,6200,10,11,21,林榮新光,簡易
2020-09-17,6200,10,16,26,林榮新光,簡易
2020-09-18,6200,9,47,56,林榮新光,簡易
2020-09-19,6200,20,38,58,林榮新光,簡易
2020-09-20,6200,41,22,63,林榮新光,簡易
2020-09-21,6200,13,7,20,林榮新光,簡易
2020-09-22,6200,15,16,31,林榮新光,簡易
2020-09-23,6200,22,46,68,林榮新光,簡易
2020-09-24,6200,11,19,30,林榮新光,簡易
2020-09-25,6200,18,14,32,林榮新光,簡易
2020-09-26,6200,24,32,56,林榮新光,簡易
2020-09-27,6200,48,30,78,林榮新光,簡易
2020-09-28,6200,15,48,63,林榮新光,簡易
2020-09-29,6200,15,4,19,林榮新光,簡易
2020-09-30,6200,12,10,22,林榮新光,簡易
2020-10-01,6200,30,45,75,林榮新光,簡易
2020-10-02,6200,45,36,81,林榮新光,簡易
2020-10-03,6200,32,31,63,林榮新光,簡易
2020-10-04,6200,69,21,90,林榮新光,簡易
2020-10-05,6200,13,11,24,林榮新光,簡易
2020-10-06,6200,10,7,17,林榮新光,簡易
2020-10-07,6200,7,44,51,林榮新光,簡易
2020-10-08,6200,4,10,14,林榮新光,簡易
2020-10-09,6200,42,66,108,林榮新光,簡易
2020-10-10,6200,66,45,111,林榮新光,簡易
2020-10-11,6200,58,22,80,林榮新光,簡易
2020-10-12,6200,5,5,10,林榮新光,簡易
2020-10-13,6200,40,33,73,林榮新光,簡易
2020-10-14,6200,22,79,101,林榮新光,簡易
2020-10-15,6200,10,19,29,林榮新光,簡易
2020-10-16,6200,15,20,35,林榮新光,簡易
2020-10-17,6200,43,274,317,林榮新光,簡易
2020-10-18,6200,83,39,122,林榮新光,簡易
2020-10-19,6200,13,12,25,林榮新光,簡易
2020-10-20,6200,22,7,29,林榮新光,簡易
2020-10-21,6200,14,16,30,林榮新光,簡易
2020-10-22,6200,22,9,31,林榮新光,簡易
2020-10-23,6200,24,17,41,林榮新光,簡易
2020-10-24,6200,24,265,289,林榮新光,簡易
2020-10-25,6200,22,27,49,林榮新光,簡易
2020-10-26,6200,15,16,31,林榮新光,簡易
2020-10-27,6200,23,15,38,林榮新光,簡易
2020-10-28,6200,23,19,42,林榮新光,簡易
2020-10-29,6200,32,21,53,林榮新光,簡易
2020-10-30,6200,14,17,31,林榮新光,簡易
2020-10-31,6200,22,29,51,林榮新光,簡易
2020-11-01,6200,59,24,83,林榮新光,簡易
2020-11-02,6200,16,8,24,林榮新光,簡易
2020-11-03,6200,18,7,25,林榮新光,簡易
2020-11-04,6200,9,13,22,林榮新光,簡易
2020-11-05,6200,11,12,23,林榮新光,簡易
2020-11-06,6200,27,63,90,林榮新光,簡易
2020-11-07,6200,19,49,68,林榮新光,簡易
2020-11-08,6200,39,43,82,林榮新光,簡易
2020-11-09,6200,39,10,49,林榮新光,簡易
2020-11-10,6200,22,9,31,林榮新光,簡易
2020-11-11,6200,13,11,24,林榮新光,簡易
2020-11-12,6200,18,9,27,林榮新光,簡易
2020-11-13,6200,9,29,38,林榮新光,簡易
2020-11-14,6200,32,22,54,林榮新光,簡易
2020-11-15,6200,48,39,87,林榮新光,簡易
2020-11-16,6200,16,18,34,林榮新光,簡易
2020-11-17,6200,136,114,250,林榮新光,簡易
2020-11-18,6200,19,16,35,林榮新光,簡易
2020-11-19,6200,23,38,61,林榮新光,簡易
2020-11-20,6200,22,26,48,林榮新光,簡易
2020-11-21,6200,51,26,77,林榮新光,簡易
2020-11-22,6200,45,38,83,林榮新光,簡易
2020-11-23,6200,24,3,27,林榮新光,簡易
2020-11-24,6200,5,12,17,林榮新光,簡易
2020-11-25,6200,42,7,49,林榮新光,簡易
2020-11-26,6200,17,17,34,林榮新光,簡易
2020-11-27,6200,13,27,40,林榮新光,簡易
2020-11-28,6200,57,22,79,林榮新光,簡易
2020-11-29,6200,33,17,50,林榮新光,簡易
2020-11-30,6200,22,24,46,林榮新光,簡易
2020-12-01,6200,30,18,48,林榮新光,簡易
2020-12-02,6200,8,9,17,林榮新光,簡易
2020-12-03,6200,15,18,33,林榮新光,簡易
2020-12-04,6200,47,42,89,林榮新光,簡易
2020-12-05,6200,38,52,90,林榮新光,簡易
2020-12-06,6200,41,39,80,林榮新光,簡易
2020-12-07,6200,28,23,51,林榮新光,簡易
2020-12-08,6200,16,21,37,林榮新光,簡易
2020-12-09,6200,9,6,15,林榮新光,簡易
2020-12-10,6200,15,12,27,林榮新光,簡易
2020-12-11,6200,37,40,77,林榮新光,簡易
2020-12-12,6200,15,25,40,林榮新光,簡易
2020-12-13,6200,28,44,72,林榮新光,簡易
2020-12-14,6200,28,11,39,林榮新光,簡易
2020-12-15,6200,11,13,24,林榮新光,簡易
2020-12-16,6200,14,6,20,林榮新光,簡易
2020-12-17,6200,7,12,19,林榮新光,簡易
2020-12-18,6200,27,20,47,林榮新光,簡易
2020-12-19,6200,33,33,66,林榮新光,簡易
2020-12-20,6200,44,33,77,林榮新光,簡易
2020-12-21,6200,14,19,33,林榮新光,簡易
2020-12-22,6200,20,10,30,林榮新光,簡易
2020-12-23,6200,10,9,19,林榮新光,簡易
2020-12-24,6200,22,16,38,林榮新光,簡易
2020-12-25,6200,36,34,70,林榮新光,簡易
2020-12-26,6200,42,21,63,林榮新光,簡易
2020-12-27,6200,22,16,38,林榮新光,簡易
2020-12-28,6200,8,14,22,林榮新光,簡易
2020-12-29,6200,11,31,42,林榮新光,簡易
2020-12-30,6200,19,7,26,林榮新光,簡易
2020-12-31,6200,13,12,25,林榮新光,簡易
2020-01-01,6210,48,53,101,豐田,簡易
2020-01-02,6210,73,59,132,豐田,簡易
2020-01-03,6210,60,59,119,豐田,簡易
2020-01-04,6210,54,62,116,豐田,簡易
2020-01-05,6210,41,51,92,豐田,簡易
2020-01-06,6210,69,60,129,豐田,簡易
2020-01-07,6210,55,63,118,豐田,簡易
2020-01-08,6210,63,70,133,豐田,簡易
2020-01-09,6210,68,57,125,豐田,簡易
2020-01-10,6210,64,76,140,豐田,簡易
2020-01-11,6210,38,53,91,豐田,簡易
2020-01-12,6210,41,33,74,豐田,簡易
2020-01-13,6210,69,56,125,豐田,簡易
2020-01-14,6210,56,97,153,豐田,簡易
2020-01-15,6210,68,81,149,豐田,簡易
2020-01-16,6210,73,61,134,豐田,簡易
2020-01-17,6210,43,78,121,豐田,簡易
2020-01-18,6210,59,39,98,豐田,簡易
2020-01-19,6210,55,49,104,豐田,簡易
2020-01-20,6210,57,56,113,豐田,簡易
2020-01-21,6210,43,42,85,豐田,簡易
2020-01-22,6210,37,46,83,豐田,簡易
2020-01-23,6210,35,60,95,豐田,簡易
2020-01-24,6210,27,57,84,豐田,簡易
2020-01-25,6210,26,29,55,豐田,簡易
2020-01-26,6210,30,31,61,豐田,簡易
2020-01-27,6210,40,36,76,豐田,簡易
2020-01-28,6210,46,47,93,豐田,簡易
2020-01-29,6210,53,49,102,豐田,簡易
2020-01-30,6210,70,53,123,豐田,簡易
2020-01-31,6210,40,59,99,豐田,簡易
2020-02-01,6210,27,29,56,豐田,簡易
2020-02-02,6210,47,35,82,豐田,簡易
2020-02-03,6210,38,42,80,豐田,簡易
2020-02-04,6210,44,39,83,豐田,簡易
2020-02-05,6210,31,35,66,豐田,簡易
2020-02-06,6210,60,50,110,豐田,簡易
2020-02-07,6210,21,34,55,豐田,簡易
2020-02-08,6210,24,21,45,豐田,簡易
2020-02-09,6210,18,24,42,豐田,簡易
2020-02-10,6210,21,33,54,豐田,簡易
2020-02-11,6210,45,41,86,豐田,簡易
2020-02-12,6210,28,51,79,豐田,簡易
2020-02-13,6210,36,37,73,豐田,簡易
2020-02-14,6210,55,27,82,豐田,簡易
2020-02-15,6210,34,39,73,豐田,簡易
2020-02-16,6210,15,27,42,豐田,簡易
2020-02-17,6210,32,33,65,豐田,簡易
2020-02-18,6210,40,23,63,豐田,簡易
2020-02-19,6210,35,30,65,豐田,簡易
2020-02-20,6210,40,36,76,豐田,簡易
2020-02-21,6210,47,39,86,豐田,簡易
2020-02-22,6210,28,34,62,豐田,簡易
2020-02-23,6210,25,27,52,豐田,簡易
2020-02-24,6210,43,45,88,豐田,簡易
2020-02-25,6210,81,57,138,豐田,簡易
2020-02-26,6210,74,68,142,豐田,簡易
2020-02-27,6210,64,68,132,豐田,簡易
2020-02-28,6210,42,53,95,豐田,簡易
2020-02-29,6210,35,47,82,豐田,簡易
2020-03-01,6210,52,31,83,豐田,簡易
2020-03-02,6210,84,53,137,豐田,簡易
2020-03-03,6210,68,69,137,豐田,簡易
2020-03-04,6210,58,65,123,豐田,簡易
2020-03-05,6210,72,73,145,豐田,簡易
2020-03-06,6210,75,67,142,豐田,簡易
2020-03-07,6210,33,46,79,豐田,簡易
2020-03-08,6210,32,35,67,豐田,簡易
2020-03-09,6210,76,53,129,豐田,簡易
2020-03-10,6210,61,60,121,豐田,簡易
2020-03-11,6210,73,74,147,豐田,簡易
2020-03-12,6210,83,72,155,豐田,簡易
2020-03-13,6210,71,66,137,豐田,簡易
2020-03-14,6210,30,49,79,豐田,簡易
2020-03-15,6210,38,36,74,豐田,簡易
2020-03-16,6210,68,64,132,豐田,簡易
2020-03-17,6210,58,64,122,豐田,簡易
2020-03-18,6210,62,67,129,豐田,簡易
2020-03-19,6210,70,69,139,豐田,簡易
2020-03-20,6210,72,73,145,豐田,簡易
2020-03-21,6210,57,80,137,豐田,簡易
2020-03-22,6210,35,24,59,豐田,簡易
2020-03-23,6210,73,62,135,豐田,簡易
2020-03-24,6210,57,59,116,豐田,簡易
2020-03-25,6210,62,70,132,豐田,簡易
2020-03-26,6210,64,66,130,豐田,簡易
2020-03-27,6210,76,61,137,豐田,簡易
2020-03-28,6210,44,54,98,豐田,簡易
2020-03-29,6210,51,48,99,豐田,簡易
2020-03-30,6210,77,70,147,豐田,簡易
2020-03-31,6210,62,58,120,豐田,簡易
2020-04-01,6210,67,72,139,豐田,簡易
2020-04-02,6210,42,61,103,豐田,簡易
2020-04-03,6210,38,43,81,豐田,簡易
2020-04-04,6210,43,27,70,豐田,簡易
2020-04-05,6210,41,33,74,豐田,簡易
2020-04-06,6210,83,63,146,豐田,簡易
2020-04-07,6210,79,81,160,豐田,簡易
2020-04-08,6210,65,66,131,豐田,簡易
2020-04-09,6210,64,65,129,豐田,簡易
2020-04-10,6210,77,83,160,豐田,簡易
2020-04-11,6210,28,38,66,豐田,簡易
2020-04-12,6210,34,31,65,豐田,簡易
2020-04-13,6210,69,63,132,豐田,簡易
2020-04-14,6210,67,61,128,豐田,簡易
2020-04-15,6210,90,91,181,豐田,簡易
2020-04-16,6210,67,74,141,豐田,簡易
2020-04-17,6210,78,67,145,豐田,簡易
2020-04-18,6210,37,59,96,豐田,簡易
2020-04-19,6210,43,48,91,豐田,簡易
2020-04-20,6210,70,61,131,豐田,簡易
2020-04-21,6210,61,67,128,豐田,簡易
2020-04-22,6210,65,69,134,豐田,簡易
2020-04-23,6210,72,63,135,豐田,簡易
2020-04-24,6210,65,60,125,豐田,簡易
2020-04-25,6210,34,36,70,豐田,簡易
2020-04-26,6210,27,38,65,豐田,簡易
2020-04-27,6210,68,62,130,豐田,簡易
2020-04-28,6210,74,74,148,豐田,簡易
2020-04-29,6210,67,63,130,豐田,簡易
2020-04-30,6210,84,81,165,豐田,簡易
2020-05-01,6210,69,74,143,豐田,簡易
2020-05-02,6210,33,47,80,豐田,簡易
2020-05-03,6210,22,31,53,豐田,簡易
2020-05-04,6210,72,66,138,豐田,簡易
2020-05-05,6210,71,61,132,豐田,簡易
2020-05-06,6210,66,65,131,豐田,簡易
2020-05-07,6210,65,75,140,豐田,簡易
2020-05-08,6210,74,66,140,豐田,簡易
2020-05-09,6210,35,53,88,豐田,簡易
2020-05-10,6210,30,47,77,豐田,簡易
2020-05-11,6210,64,55,119,豐田,簡易
2020-05-12,6210,64,59,123,豐田,簡易
2020-05-13,6210,68,68,136,豐田,簡易
2020-05-14,6210,73,66,139,豐田,簡易
2020-05-15,6210,71,62,133,豐田,簡易
2020-05-16,6210,41,52,93,豐田,簡易
2020-05-17,6210,34,36,70,豐田,簡易
2020-05-18,6210,71,75,146,豐田,簡易
2020-05-19,6210,61,60,121,豐田,簡易
2020-05-20,6210,63,67,130,豐田,簡易
2020-05-21,6210,56,66,122,豐田,簡易
2020-05-22,6210,56,71,127,豐田,簡易
2020-05-23,6210,42,50,92,豐田,簡易
2020-05-24,6210,40,43,83,豐田,簡易
2020-05-25,6210,83,56,139,豐田,簡易
2020-05-26,6210,75,64,139,豐田,簡易
2020-05-27,6210,63,65,128,豐田,簡易
2020-05-28,6210,52,55,107,豐田,簡易
2020-05-29,6210,66,61,127,豐田,簡易
2020-05-30,6210,31,27,58,豐田,簡易
2020-05-31,6210,35,29,64,豐田,簡易
2020-06-01,6210,64,76,140,豐田,簡易
2020-06-02,6210,46,64,110,豐田,簡易
2020-06-03,6210,71,62,133,豐田,簡易
2020-06-04,6210,60,68,128,豐田,簡易
2020-06-05,6210,65,54,119,豐田,簡易
2020-06-06,6210,73,74,147,豐田,簡易
2020-06-07,6210,36,32,68,豐田,簡易
2020-06-08,6210,65,54,119,豐田,簡易
2020-06-09,6210,61,58,119,豐田,簡易
2020-06-10,6210,63,46,109,豐田,簡易
2020-06-11,6210,62,67,129,豐田,簡易
2020-06-12,6210,63,65,128,豐田,簡易
2020-06-13,6210,45,51,96,豐田,簡易
2020-06-14,6210,42,37,79,豐田,簡易
2020-06-15,6210,68,53,121,豐田,簡易
2020-06-16,6210,48,59,107,豐田,簡易
2020-06-17,6210,63,64,127,豐田,簡易
2020-06-18,6210,49,56,105,豐田,簡易
2020-06-19,6210,52,65,117,豐田,簡易
2020-06-20,6210,63,59,122,豐田,簡易
2020-06-21,6210,21,49,70,豐田,簡易
2020-06-22,6210,50,57,107,豐田,簡易
2020-06-23,6210,50,54,104,豐田,簡易
2020-06-24,6210,44,69,113,豐田,簡易
2020-06-25,6210,46,71,117,豐田,簡易
2020-06-26,6210,53,61,114,豐田,簡易
2020-06-27,6210,46,52,98,豐田,簡易
2020-06-28,6210,55,24,79,豐田,簡易
2020-06-29,6210,67,52,119,豐田,簡易
2020-06-30,6210,58,75,133,豐田,簡易
2020-07-01,6210,45,42,87,豐田,簡易
2020-07-02,6210,56,53,109,豐田,簡易
2020-07-03,6210,43,63,106,豐田,簡易
2020-07-04,6210,37,44,81,豐田,簡易
2020-07-05,6210,29,38,67,豐田,簡易
2020-07-06,6210,59,56,115,豐田,簡易
2020-07-07,6210,54,57,111,豐田,簡易
2020-07-08,6210,78,84,162,豐田,簡易
2020-07-09,6210,57,51,108,豐田,簡易
2020-07-10,6210,57,64,121,豐田,簡易
2020-07-11,6210,30,54,84,豐田,簡易
2020-07-12,6210,29,34,63,豐田,簡易
2020-07-13,6210,63,67,130,豐田,簡易
2020-07-14,6210,61,67,128,豐田,簡易
2020-07-15,6210,51,57,108,豐田,簡易
2020-07-16,6210,55,61,116,豐田,簡易
2020-07-17,6210,40,39,79,豐田,簡易
2020-07-18,6210,32,37,69,豐田,簡易
2020-07-19,6210,26,28,54,豐田,簡易
2020-07-20,6210,48,49,97,豐田,簡易
2020-07-21,6210,50,42,92,豐田,簡易
2020-07-22,6210,47,38,85,豐田,簡易
2020-07-23,6210,42,37,79,豐田,簡易
2020-07-24,6210,46,36,82,豐田,簡易
2020-07-25,6210,28,52,80,豐田,簡易
2020-07-26,6210,38,68,106,豐田,簡易
2020-07-27,6210,38,73,111,豐田,簡易
2020-07-28,6210,49,48,97,豐田,簡易
2020-07-29,6210,82,44,126,豐田,簡易
2020-07-30,6210,71,45,116,豐田,簡易
2020-07-31,6210,78,47,125,豐田,簡易
2020-08-01,6210,38,48,86,豐田,簡易
2020-08-02,6210,47,48,95,豐田,簡易
2020-08-03,6210,33,54,87,豐田,簡易
2020-08-04,6210,40,44,84,豐田,簡易
2020-08-05,6210,63,34,97,豐田,簡易
2020-08-06,6210,50,39,89,豐田,簡易
2020-08-07,6210,40,29,69,豐田,簡易
2020-08-08,6210,24,33,57,豐田,簡易
2020-08-09,6210,53,52,105,豐田,簡易
2020-08-10,6210,44,39,83,豐田,簡易
2020-08-11,6210,42,57,99,豐田,簡易
2020-08-12,6210,48,43,91,豐田,簡易
2020-08-13,6210,44,59,103,豐田,簡易
2020-08-14,6210,51,50,101,豐田,簡易
2020-08-15,6210,23,37,60,豐田,簡易
2020-08-16,6210,46,23,69,豐田,簡易
2020-08-17,6210,52,36,88,豐田,簡易
2020-08-18,6210,37,39,76,豐田,簡易
2020-08-19,6210,51,34,85,豐田,簡易
2020-08-20,6210,37,38,75,豐田,簡易
2020-08-21,6210,45,45,90,豐田,簡易
2020-08-22,6210,41,57,98,豐田,簡易
2020-08-23,6210,48,31,79,豐田,簡易
2020-08-24,6210,35,31,66,豐田,簡易
2020-08-25,6210,38,51,89,豐田,簡易
2020-08-26,6210,57,39,96,豐田,簡易
2020-08-27,6210,32,53,85,豐田,簡易
2020-08-28,6210,54,39,93,豐田,簡易
2020-08-29,6210,27,25,52,豐田,簡易
2020-08-30,6210,45,41,86,豐田,簡易
2020-08-31,6210,90,72,162,豐田,簡易
2020-09-01,6210,80,83,163,豐田,簡易
2020-09-02,6210,74,92,166,豐田,簡易
2020-09-03,6210,80,79,159,豐田,簡易
2020-09-04,6210,94,87,181,豐田,簡易
2020-09-05,6210,41,72,113,豐田,簡易
2020-09-06,6210,59,35,94,豐田,簡易
2020-09-07,6210,93,70,163,豐田,簡易
2020-09-08,6210,77,83,160,豐田,簡易
2020-09-09,6210,77,79,156,豐田,簡易
2020-09-10,6210,82,91,173,豐田,簡易
2020-09-11,6210,95,112,207,豐田,簡易
2020-09-12,6210,39,71,110,豐田,簡易
2020-09-13,6210,35,38,73,豐田,簡易
2020-09-14,6210,95,72,167,豐田,簡易
2020-09-15,6210,83,82,165,豐田,簡易
2020-09-16,6210,70,78,148,豐田,簡易
2020-09-17,6210,79,79,158,豐田,簡易
2020-09-18,6210,67,80,147,豐田,簡易
2020-09-19,6210,49,70,119,豐田,簡易
2020-09-20,6210,47,25,72,豐田,簡易
2020-09-21,6210,85,86,171,豐田,簡易
2020-09-22,6210,84,85,169,豐田,簡易
2020-09-23,6210,75,86,161,豐田,簡易
2020-09-24,6210,85,88,173,豐田,簡易
2020-09-25,6210,74,106,180,豐田,簡易
2020-09-26,6210,63,60,123,豐田,簡易
2020-09-27,6210,33,38,71,豐田,簡易
2020-09-28,6210,94,98,192,豐田,簡易
2020-09-29,6210,76,74,150,豐田,簡易
2020-09-30,6210,87,117,204,豐田,簡易
2020-10-01,6210,40,65,105,豐田,簡易
2020-10-02,6210,59,63,122,豐田,簡易
2020-10-03,6210,44,44,88,豐田,簡易
2020-10-04,6210,47,33,80,豐田,簡易
2020-10-05,6210,101,96,197,豐田,簡易
2020-10-06,6210,82,82,164,豐田,簡易
2020-10-07,6210,74,90,164,豐田,簡易
2020-10-08,6210,72,94,166,豐田,簡易
2020-10-09,6210,58,45,103,豐田,簡易
2020-10-10,6210,50,48,98,豐田,簡易
2020-10-11,6210,50,29,79,豐田,簡易
2020-10-12,6210,92,99,191,豐田,簡易
2020-10-13,6210,91,100,191,豐田,簡易
2020-10-14,6210,80,88,168,豐田,簡易
2020-10-15,6210,83,76,159,豐田,簡易
2020-10-16,6210,79,80,159,豐田,簡易
2020-10-17,6210,40,41,81,豐田,簡易
2020-10-18,6210,45,32,77,豐田,簡易
2020-10-19,6210,82,94,176,豐田,簡易
2020-10-20,6210,80,86,166,豐田,簡易
2020-10-21,6210,71,77,148,豐田,簡易
2020-10-22,6210,47,86,133,豐田,簡易
2020-10-23,6210,73,90,163,豐田,簡易
2020-10-24,6210,34,40,74,豐田,簡易
2020-10-25,6210,32,36,68,豐田,簡易
2020-10-26,6210,91,94,185,豐田,簡易
2020-10-27,6210,76,73,149,豐田,簡易
2020-10-28,6210,74,78,152,豐田,簡易
2020-10-29,6210,63,68,131,豐田,簡易
2020-10-30,6210,73,90,163,豐田,簡易
2020-10-31,6210,39,33,72,豐田,簡易
2020-11-01,6210,38,31,69,豐田,簡易
2020-11-02,6210,89,84,173,豐田,簡易
2020-11-03,6210,80,71,151,豐田,簡易
2020-11-04,6210,67,75,142,豐田,簡易
2020-11-05,6210,73,127,200,豐田,簡易
2020-11-06,6210,110,93,203,豐田,簡易
2020-11-07,6210,42,49,91,豐田,簡易
2020-11-08,6210,51,59,110,豐田,簡易
2020-11-09,6210,89,83,172,豐田,簡易
2020-11-10,6210,85,86,171,豐田,簡易
2020-11-11,6210,77,97,174,豐田,簡易
2020-11-12,6210,83,74,157,豐田,簡易
2020-11-13,6210,76,93,169,豐田,簡易
2020-11-14,6210,45,37,82,豐田,簡易
2020-11-15,6210,36,26,62,豐田,簡易
2020-11-16,6210,92,81,173,豐田,簡易
2020-11-17,6210,74,88,162,豐田,簡易
2020-11-18,6210,84,86,170,豐田,簡易
2020-11-19,6210,66,82,148,豐田,簡易
2020-11-20,6210,78,84,162,豐田,簡易
2020-11-21,6210,34,43,77,豐田,簡易
2020-11-22,6210,47,40,87,豐田,簡易
2020-11-23,6210,87,79,166,豐田,簡易
2020-11-24,6210,81,91,172,豐田,簡易
2020-11-25,6210,75,113,188,豐田,簡易
2020-11-26,6210,77,79,156,豐田,簡易
2020-11-27,6210,90,79,169,豐田,簡易
2020-11-28,6210,72,79,151,豐田,簡易
2020-11-29,6210,32,24,56,豐田,簡易
2020-11-30,6210,79,79,158,豐田,簡易
2020-12-01,6210,81,72,153,豐田,簡易
2020-12-02,6210,81,83,164,豐田,簡易
2020-12-03,6210,77,78,155,豐田,簡易
2020-12-04,6210,51,84,135,豐田,簡易
2020-12-05,6210,43,30,73,豐田,簡易
2020-12-06,6210,26,24,50,豐田,簡易
2020-12-07,6210,81,76,157,豐田,簡易
2020-12-08,6210,71,74,145,豐田,簡易
2020-12-09,6210,80,81,161,豐田,簡易
2020-12-10,6210,71,77,148,豐田,簡易
2020-12-11,6210,73,85,158,豐田,簡易
2020-12-12,6210,36,27,63,豐田,簡易
2020-12-13,6210,26,34,60,豐田,簡易
2020-12-14,6210,96,84,180,豐田,簡易
2020-12-15,6210,74,83,157,豐田,簡易
2020-12-16,6210,75,86,161,豐田,簡易
2020-12-17,6210,76,73,149,豐田,簡易
2020-12-18,6210,73,87,160,豐田,簡易
2020-12-19,6210,39,51,90,豐田,簡易
2020-12-20,6210,29,27,56,豐田,簡易
2020-12-21,6210,76,77,153,豐田,簡易
2020-12-22,6210,73,84,157,豐田,簡易
2020-12-23,6210,73,88,161,豐田,簡易
2020-12-24,6210,65,76,141,豐田,簡易
2020-12-25,6210,71,95,166,豐田,簡易
2020-12-26,6210,51,47,98,豐田,簡易
2020-12-27,6210,35,28,63,豐田,簡易
2020-12-28,6210,79,88,167,豐田,簡易
2020-12-29,6210,83,83,166,豐田,簡易
2020-12-30,6210,74,81,155,豐田,簡易
2020-12-31,6210,86,77,163,豐田,簡易
2020-01-01,6220,215,275,490,壽豐,三等
2020-01-02,6220,288,272,560,壽豐,三等
2020-01-03,6220,318,359,677,壽豐,三等
2020-01-04,6220,246,252,498,壽豐,三等
2020-01-05,6220,277,269,546,壽豐,三等
2020-01-06,6220,311,276,587,壽豐,三等
2020-01-07,6220,307,243,550,壽豐,三等
2020-01-08,6220,283,296,579,壽豐,三等
2020-01-09,6220,373,276,649,壽豐,三等
2020-01-10,6220,439,447,886,壽豐,三等
2020-01-11,6220,392,392,784,壽豐,三等
2020-01-12,6220,335,364,699,壽豐,三等
2020-01-13,6220,303,312,615,壽豐,三等
2020-01-14,6220,258,495,753,壽豐,三等
2020-01-15,6220,450,277,727,壽豐,三等
2020-01-16,6220,341,276,617,壽豐,三等
2020-01-17,6220,277,394,671,壽豐,三等
2020-01-18,6220,291,273,564,壽豐,三等
2020-01-19,6220,315,274,589,壽豐,三等
2020-01-20,6220,255,292,547,壽豐,三等
2020-01-21,6220,253,334,587,壽豐,三等
2020-01-22,6220,300,441,741,壽豐,三等
2020-01-23,6220,290,458,748,壽豐,三等
2020-01-24,6220,226,422,648,壽豐,三等
2020-01-25,6220,334,418,752,壽豐,三等
2020-01-26,6220,442,496,938,壽豐,三等
2020-01-27,6220,494,375,869,壽豐,三等
2020-01-28,6220,546,355,901,壽豐,三等
2020-01-29,6220,477,320,797,壽豐,三等
2020-01-30,6220,414,343,757,壽豐,三等
2020-01-31,6220,347,310,657,壽豐,三等
2020-02-01,6220,347,397,744,壽豐,三等
2020-02-02,6220,279,260,539,壽豐,三等
2020-02-03,6220,256,274,530,壽豐,三等
2020-02-04,6220,230,213,443,壽豐,三等
2020-02-05,6220,282,219,501,壽豐,三等
2020-02-06,6220,200,250,450,壽豐,三等
2020-02-07,6220,250,262,512,壽豐,三等
2020-02-08,6220,223,208,431,壽豐,三等
2020-02-09,6220,309,237,546,壽豐,三等
2020-02-10,6220,255,236,491,壽豐,三等
2020-02-11,6220,174,229,403,壽豐,三等
2020-02-12,6220,198,230,428,壽豐,三等
2020-02-13,6220,204,158,362,壽豐,三等
2020-02-14,6220,237,239,476,壽豐,三等
2020-02-15,6220,197,260,457,壽豐,三等
2020-02-16,6220,258,240,498,壽豐,三等
2020-02-17,6220,191,208,399,壽豐,三等
2020-02-18,6220,171,177,348,壽豐,三等
2020-02-19,6220,195,209,404,壽豐,三等
2020-02-20,6220,217,279,496,壽豐,三等
2020-02-21,6220,280,258,538,壽豐,三等
2020-02-22,6220,233,234,467,壽豐,三等
2020-02-23,6220,275,208,483,壽豐,三等
2020-02-24,6220,201,245,446,壽豐,三等
2020-02-25,6220,208,213,421,壽豐,三等
2020-02-26,6220,223,220,443,壽豐,三等
2020-02-27,6220,274,352,626,壽豐,三等
2020-02-28,6220,191,274,465,壽豐,三等
2020-02-29,6220,259,242,501,壽豐,三等
2020-03-01,6220,401,251,652,壽豐,三等
2020-03-02,6220,271,231,502,壽豐,三等
2020-03-03,6220,173,186,359,壽豐,三等
2020-03-04,6220,188,195,383,壽豐,三等
2020-03-05,6220,217,209,426,壽豐,三等
2020-03-06,6220,295,253,548,壽豐,三等
2020-03-07,6220,241,249,490,壽豐,三等
2020-03-08,6220,356,280,636,壽豐,三等
2020-03-09,6220,222,237,459,壽豐,三等
2020-03-10,6220,204,215,419,壽豐,三等
2020-03-11,6220,201,232,433,壽豐,三等
2020-03-12,6220,235,225,460,壽豐,三等
2020-03-13,6220,279,313,592,壽豐,三等
2020-03-14,6220,209,232,441,壽豐,三等
2020-03-15,6220,267,220,487,壽豐,三等
2020-03-16,6220,247,212,459,壽豐,三等
2020-03-17,6220,210,203,413,壽豐,三等
2020-03-18,6220,206,193,399,壽豐,三等
2020-03-19,6220,226,240,466,壽豐,三等
2020-03-20,6220,263,327,590,壽豐,三等
2020-03-21,6220,188,252,440,壽豐,三等
2020-03-22,6220,248,212,460,壽豐,三等
2020-03-23,6220,242,232,474,壽豐,三等
2020-03-24,6220,191,196,387,壽豐,三等
2020-03-25,6220,199,202,401,壽豐,三等
2020-03-26,6220,213,223,436,壽豐,三等
2020-03-27,6220,247,346,593,壽豐,三等
2020-03-28,6220,206,234,440,壽豐,三等
2020-03-29,6220,333,233,566,壽豐,三等
2020-03-30,6220,255,227,482,壽豐,三等
2020-03-31,6220,206,236,442,壽豐,三等
2020-04-01,6220,362,460,822,壽豐,三等
2020-04-02,6220,318,414,732,壽豐,三等
2020-04-03,6220,273,272,545,壽豐,三等
2020-04-04,6220,267,171,438,壽豐,三等
2020-04-05,6220,396,233,629,壽豐,三等
2020-04-06,6220,288,288,576,壽豐,三等
2020-04-07,6220,198,191,389,壽豐,三等
2020-04-08,6220,206,204,410,壽豐,三等
2020-04-09,6220,191,184,375,壽豐,三等
2020-04-10,6220,235,290,525,壽豐,三等
2020-04-11,6220,185,185,370,壽豐,三等
2020-04-12,6220,213,158,371,壽豐,三等
2020-04-13,6220,193,196,389,壽豐,三等
2020-04-14,6220,202,207,409,壽豐,三等
2020-04-15,6220,189,195,384,壽豐,三等
2020-04-16,6220,204,218,422,壽豐,三等
2020-04-17,6220,224,269,493,壽豐,三等
2020-04-18,6220,186,219,405,壽豐,三等
2020-04-19,6220,234,156,390,壽豐,三等
2020-04-20,6220,205,220,425,壽豐,三等
2020-04-21,6220,197,186,383,壽豐,三等
2020-04-22,6220,203,267,470,壽豐,三等
2020-04-23,6220,360,316,676,壽豐,三等
2020-04-24,6220,241,248,489,壽豐,三等
2020-04-25,6220,171,196,367,壽豐,三等
2020-04-26,6220,247,201,448,壽豐,三等
2020-04-27,6220,211,200,411,壽豐,三等
2020-04-28,6220,185,182,367,壽豐,三等
2020-04-29,6220,180,183,363,壽豐,三等
2020-04-30,6220,225,260,485,壽豐,三等
2020-05-01,6220,219,300,519,壽豐,三等
2020-05-02,6220,193,195,388,壽豐,三等
2020-05-03,6220,281,189,470,壽豐,三等
2020-05-04,6220,243,179,422,壽豐,三等
2020-05-05,6220,178,207,385,壽豐,三等
2020-05-06,6220,208,206,414,壽豐,三等
2020-05-07,6220,229,241,470,壽豐,三等
2020-05-08,6220,298,300,598,壽豐,三等
2020-05-09,6220,207,294,501,壽豐,三等
2020-05-10,6220,327,250,577,壽豐,三等
2020-05-11,6220,257,241,498,壽豐,三等
2020-05-12,6220,242,215,457,壽豐,三等
2020-05-13,6220,213,227,440,壽豐,三等
2020-05-14,6220,206,203,409,壽豐,三等
2020-05-15,6220,267,302,569,壽豐,三等
2020-05-16,6220,188,220,408,壽豐,三等
2020-05-17,6220,268,234,502,壽豐,三等
2020-05-18,6220,239,250,489,壽豐,三等
2020-05-19,6220,203,180,383,壽豐,三等
2020-05-20,6220,214,240,454,壽豐,三等
2020-05-21,6220,228,218,446,壽豐,三等
2020-05-22,6220,278,289,567,壽豐,三等
2020-05-23,6220,230,263,493,壽豐,三等
2020-05-24,6220,279,263,542,壽豐,三等
2020-05-25,6220,302,205,507,壽豐,三等
2020-05-26,6220,216,220,436,壽豐,三等
2020-05-27,6220,215,205,420,壽豐,三等
2020-05-28,6220,203,245,448,壽豐,三等
2020-05-29,6220,306,294,600,壽豐,三等
2020-05-30,6220,215,302,517,壽豐,三等
2020-05-31,6220,345,221,566,壽豐,三等
2020-06-01,6220,233,230,463,壽豐,三等
2020-06-02,6220,213,206,419,壽豐,三等
2020-06-03,6220,210,211,421,壽豐,三等
2020-06-04,6220,221,188,409,壽豐,三等
2020-06-05,6220,356,311,667,壽豐,三等
2020-06-06,6220,250,288,538,壽豐,三等
2020-06-07,6220,296,296,592,壽豐,三等
2020-06-08,6220,261,320,581,壽豐,三等
2020-06-09,6220,226,250,476,壽豐,三等
2020-06-10,6220,231,232,463,壽豐,三等
2020-06-11,6220,219,217,436,壽豐,三等
2020-06-12,6220,339,345,684,壽豐,三等
2020-06-13,6220,236,262,498,壽豐,三等
2020-06-14,6220,282,290,572,壽豐,三等
2020-06-15,6220,260,233,493,壽豐,三等
2020-06-16,6220,269,223,492,壽豐,三等
2020-06-17,6220,229,260,489,壽豐,三等
2020-06-18,6220,246,232,478,壽豐,三等
2020-06-19,6220,273,271,544,壽豐,三等
2020-06-20,6220,294,296,590,壽豐,三等
2020-06-21,6220,345,335,680,壽豐,三等
2020-06-22,6220,368,350,718,壽豐,三等
2020-06-23,6220,294,275,569,壽豐,三等
2020-06-24,6220,391,484,875,壽豐,三等
2020-06-25,6220,314,493,807,壽豐,三等
2020-06-26,6220,312,317,629,壽豐,三等
2020-06-27,6220,363,260,623,壽豐,三等
2020-06-28,6220,443,310,753,壽豐,三等
2020-06-29,6220,322,258,580,壽豐,三等
2020-06-30,6220,266,225,491,壽豐,三等
2020-07-01,6220,253,250,503,壽豐,三等
2020-07-02,6220,226,218,444,壽豐,三等
2020-07-03,6220,291,305,596,壽豐,三等
2020-07-04,6220,249,286,535,壽豐,三等
2020-07-05,6220,238,273,511,壽豐,三等
2020-07-06,6220,300,263,563,壽豐,三等
2020-07-07,6220,251,221,472,壽豐,三等
2020-07-08,6220,281,286,567,壽豐,三等
2020-07-09,6220,251,240,491,壽豐,三等
2020-07-10,6220,314,341,655,壽豐,三等
2020-07-11,6220,268,300,568,壽豐,三等
2020-07-12,6220,296,255,551,壽豐,三等
2020-07-13,6220,310,268,578,壽豐,三等
2020-07-14,6220,250,260,510,壽豐,三等
2020-07-15,6220,224,277,501,壽豐,三等
2020-07-16,6220,231,257,488,壽豐,三等
2020-07-17,6220,302,357,659,壽豐,三等
2020-07-18,6220,278,295,573,壽豐,三等
2020-07-19,6220,317,275,592,壽豐,三等
2020-07-20,6220,267,283,550,壽豐,三等
2020-07-21,6220,200,189,389,壽豐,三等
2020-07-22,6220,254,251,505,壽豐,三等
2020-07-23,6220,196,210,406,壽豐,三等
2020-07-24,6220,265,330,595,壽豐,三等
2020-07-25,6220,314,317,631,壽豐,三等
2020-07-26,6220,353,256,609,壽豐,三等
2020-07-27,6220,319,250,569,壽豐,三等
2020-07-28,6220,223,228,451,壽豐,三等
2020-07-29,6220,236,233,469,壽豐,三等
2020-07-30,6220,265,271,536,壽豐,三等
2020-07-31,6220,367,350,717,壽豐,三等
2020-08-01,6220,314,348,662,壽豐,三等
2020-08-02,6220,274,279,553,壽豐,三等
2020-08-03,6220,282,299,581,壽豐,三等
2020-08-04,6220,234,257,491,壽豐,三等
2020-08-05,6220,261,251,512,壽豐,三等
2020-08-06,6220,225,253,478,壽豐,三等
2020-08-07,6220,296,386,682,壽豐,三等
2020-08-08,6220,275,344,619,壽豐,三等
2020-08-09,6220,391,269,660,壽豐,三等
2020-08-10,6220,332,265,597,壽豐,三等
2020-08-11,6220,269,255,524,壽豐,三等
2020-08-12,6220,304,290,594,壽豐,三等
2020-08-13,6220,276,352,628,壽豐,三等
2020-08-14,6220,304,495,799,壽豐,三等
2020-08-15,6220,336,374,710,壽豐,三等
2020-08-16,6220,481,346,827,壽豐,三等
2020-08-17,6220,307,278,585,壽豐,三等
2020-08-18,6220,322,229,551,壽豐,三等
2020-08-19,6220,296,269,565,壽豐,三等
2020-08-20,6220,245,263,508,壽豐,三等
2020-08-21,6220,283,419,702,壽豐,三等
2020-08-22,6220,274,311,585,壽豐,三等
2020-08-23,6220,400,329,729,壽豐,三等
2020-08-24,6220,333,327,660,壽豐,三等
2020-08-25,6220,328,285,613,壽豐,三等
2020-08-26,6220,301,259,560,壽豐,三等
2020-08-27,6220,225,261,486,壽豐,三等
2020-08-28,6220,527,333,860,壽豐,三等
2020-08-29,6220,246,233,479,壽豐,三等
2020-08-30,6220,287,244,531,壽豐,三等
2020-08-31,6220,272,230,502,壽豐,三等
2020-09-01,6220,277,271,548,壽豐,三等
2020-09-02,6220,253,223,476,壽豐,三等
2020-09-03,6220,273,275,548,壽豐,三等
2020-09-04,6220,348,366,714,壽豐,三等
2020-09-05,6220,230,226,456,壽豐,三等
2020-09-06,6220,308,268,576,壽豐,三等
2020-09-07,6220,313,307,620,壽豐,三等
2020-09-08,6220,256,260,516,壽豐,三等
2020-09-09,6220,266,278,544,壽豐,三等
2020-09-10,6220,248,270,518,壽豐,三等
2020-09-11,6220,341,425,766,壽豐,三等
2020-09-12,6220,299,359,658,壽豐,三等
2020-09-13,6220,341,256,597,壽豐,三等
2020-09-14,6220,283,264,547,壽豐,三等
2020-09-15,6220,319,216,535,壽豐,三等
2020-09-16,6220,252,262,514,壽豐,三等
2020-09-17,6220,268,246,514,壽豐,三等
2020-09-18,6220,347,392,739,壽豐,三等
2020-09-19,6220,303,330,633,壽豐,三等
2020-09-20,6220,350,304,654,壽豐,三等
2020-09-21,6220,283,301,584,壽豐,三等
2020-09-22,6220,243,245,488,壽豐,三等
2020-09-23,6220,244,229,473,壽豐,三等
2020-09-24,6220,276,276,552,壽豐,三等
2020-09-25,6220,332,283,615,壽豐,三等
2020-09-26,6220,248,396,644,壽豐,三等
2020-09-27,6220,244,241,485,壽豐,三等
2020-09-28,6220,326,321,647,壽豐,三等
2020-09-29,6220,210,279,489,壽豐,三等
2020-09-30,6220,345,471,816,壽豐,三等
2020-10-01,6220,420,420,840,壽豐,三等
2020-10-02,6220,365,368,733,壽豐,三等
2020-10-03,6220,415,315,730,壽豐,三等
2020-10-04,6220,528,360,888,壽豐,三等
2020-10-05,6220,329,303,632,壽豐,三等
2020-10-06,6220,257,208,465,壽豐,三等
2020-10-07,6220,271,252,523,壽豐,三等
2020-10-08,6220,369,426,795,壽豐,三等
2020-10-09,6220,294,357,651,壽豐,三等
2020-10-10,6220,303,281,584,壽豐,三等
2020-10-11,6220,395,337,732,壽豐,三等
2020-10-12,6220,339,293,632,壽豐,三等
2020-10-13,6220,238,241,479,壽豐,三等
2020-10-14,6220,375,266,641,壽豐,三等
2020-10-15,6220,237,234,471,壽豐,三等
2020-10-16,6220,344,391,735,壽豐,三等
2020-10-17,6220,236,236,472,壽豐,三等
2020-10-18,6220,303,303,606,壽豐,三等
2020-10-19,6220,310,396,706,壽豐,三等
2020-10-20,6220,265,251,516,壽豐,三等
2020-10-21,6220,294,237,531,壽豐,三等
2020-10-22,6220,234,271,505,壽豐,三等
2020-10-23,6220,310,308,618,壽豐,三等
2020-10-24,6220,258,313,571,壽豐,三等
2020-10-25,6220,255,301,556,壽豐,三等
2020-10-26,6220,287,299,586,壽豐,三等
2020-10-27,6220,239,240,479,壽豐,三等
2020-10-28,6220,274,253,527,壽豐,三等
2020-10-29,6220,246,286,532,壽豐,三等
2020-10-30,6220,360,329,689,壽豐,三等
2020-10-31,6220,254,316,570,壽豐,三等
2020-11-01,6220,273,292,565,壽豐,三等
2020-11-02,6220,292,270,562,壽豐,三等
2020-11-03,6220,244,242,486,壽豐,三等
2020-11-04,6220,227,280,507,壽豐,三等
2020-11-05,6220,265,260,525,壽豐,三等
2020-11-06,6220,330,307,637,壽豐,三等
2020-11-07,6220,279,262,541,壽豐,三等
2020-11-08,6220,330,288,618,壽豐,三等
2020-11-09,6220,310,259,569,壽豐,三等
2020-11-10,6220,219,263,482,壽豐,三等
2020-11-11,6220,256,250,506,壽豐,三等
2020-11-12,6220,285,249,534,壽豐,三等
2020-11-13,6220,340,313,653,壽豐,三等
2020-11-14,6220,287,332,619,壽豐,三等
2020-11-15,6220,281,289,570,壽豐,三等
2020-11-16,6220,291,495,786,壽豐,三等
2020-11-17,6220,260,266,526,壽豐,三等
2020-11-18,6220,340,240,580,壽豐,三等
2020-11-19,6220,277,281,558,壽豐,三等
2020-11-20,6220,353,604,957,壽豐,三等
2020-11-21,6220,269,274,543,壽豐,三等
2020-11-22,6220,303,323,626,壽豐,三等
2020-11-23,6220,245,280,525,壽豐,三等
2020-11-24,6220,241,225,466,壽豐,三等
2020-11-25,6220,228,224,452,壽豐,三等
2020-11-26,6220,253,293,546,壽豐,三等
2020-11-27,6220,329,406,735,壽豐,三等
2020-11-28,6220,283,304,587,壽豐,三等
2020-11-29,6220,324,281,605,壽豐,三等
2020-11-30,6220,296,313,609,壽豐,三等
2020-12-01,6220,261,232,493,壽豐,三等
2020-12-02,6220,292,235,527,壽豐,三等
2020-12-03,6220,265,216,481,壽豐,三等
2020-12-04,6220,378,310,688,壽豐,三等
2020-12-05,6220,248,253,501,壽豐,三等
2020-12-06,6220,259,304,563,壽豐,三等
2020-12-07,6220,241,270,511,壽豐,三等
2020-12-08,6220,221,218,439,壽豐,三等
2020-12-09,6220,241,242,483,壽豐,三等
2020-12-10,6220,222,215,437,壽豐,三等
2020-12-11,6220,293,350,643,壽豐,三等
2020-12-12,6220,302,245,547,壽豐,三等
2020-12-13,6220,284,276,560,壽豐,三等
2020-12-14,6220,261,270,531,壽豐,三等
2020-12-15,6220,237,208,445,壽豐,三等
2020-12-16,6220,219,216,435,壽豐,三等
2020-12-17,6220,240,274,514,壽豐,三等
2020-12-18,6220,354,367,721,壽豐,三等
2020-12-19,6220,256,260,516,壽豐,三等
2020-12-20,6220,349,330,679,壽豐,三等
2020-12-21,6220,282,313,595,壽豐,三等
2020-12-22,6220,250,236,486,壽豐,三等
2020-12-23,6220,249,246,495,壽豐,三等
2020-12-24,6220,270,270,540,壽豐,三等
2020-12-25,6220,346,383,729,壽豐,三等
2020-12-26,6220,263,247,510,壽豐,三等
2020-12-27,6220,343,312,655,壽豐,三等
2020-12-28,6220,297,281,578,壽豐,三等
2020-12-29,6220,276,283,559,壽豐,三等
2020-12-30,6220,300,291,591,壽豐,三等
2020-12-31,6220,378,408,786,壽豐,三等
2020-01-01,6230,19,26,45,平和,招呼
2020-01-02,6230,18,21,39,平和,招呼
2020-01-03,6230,20,25,45,平和,招呼
2020-01-04,6230,10,20,30,平和,招呼
2020-01-05,6230,2,12,14,平和,招呼
2020-01-06,6230,12,17,29,平和,招呼
2020-01-07,6230,15,20,35,平和,招呼
2020-01-08,6230,20,25,45,平和,招呼
2020-01-09,6230,15,21,36,平和,招呼
2020-01-10,6230,16,25,41,平和,招呼
2020-01-11,6230,8,16,24,平和,招呼
2020-01-12,6230,3,17,20,平和,招呼
2020-01-13,6230,17,20,37,平和,招呼
2020-01-14,6230,19,25,44,平和,招呼
2020-01-15,6230,15,14,29,平和,招呼
2020-01-16,6230,18,19,37,平和,招呼
2020-01-17,6230,14,13,27,平和,招呼
2020-01-18,6230,4,8,12,平和,招呼
2020-01-19,6230,2,9,11,平和,招呼
2020-01-20,6230,9,18,27,平和,招呼
2020-01-21,6230,6,11,17,平和,招呼
2020-01-22,6230,7,13,20,平和,招呼
2020-01-23,6230,4,10,14,平和,招呼
2020-01-24,6230,7,8,15,平和,招呼
2020-01-25,6230,6,4,10,平和,招呼
2020-01-26,6230,14,20,34,平和,招呼
2020-01-27,6230,11,6,17,平和,招呼
2020-01-28,6230,2,14,16,平和,招呼
2020-01-29,6230,16,11,27,平和,招呼
2020-01-30,6230,3,11,14,平和,招呼
2020-01-31,6230,7,17,24,平和,招呼
2020-02-01,6230,4,15,19,平和,招呼
2020-02-02,6230,6,12,18,平和,招呼
2020-02-03,6230,6,16,22,平和,招呼
2020-02-04,6230,3,9,12,平和,招呼
2020-02-05,6230,2,8,10,平和,招呼
2020-02-06,6230,10,14,24,平和,招呼
2020-02-07,6230,10,11,21,平和,招呼
2020-02-08,6230,5,3,8,平和,招呼
2020-02-09,6230,4,18,22,平和,招呼
2020-02-10,6230,3,8,11,平和,招呼
2020-02-11,6230,10,9,19,平和,招呼
2020-02-12,6230,7,16,23,平和,招呼
2020-02-13,6230,10,15,25,平和,招呼
2020-02-14,6230,7,10,17,平和,招呼
2020-02-15,6230,15,9,24,平和,招呼
2020-02-16,6230,3,13,16,平和,招呼
2020-02-17,6230,4,35,39,平和,招呼
2020-02-18,6230,11,12,23,平和,招呼
2020-02-19,6230,4,10,14,平和,招呼
2020-02-20,6230,8,14,22,平和,招呼
2020-02-21,6230,12,20,32,平和,招呼
2020-02-22,6230,3,11,14,平和,招呼
2020-02-23,6230,5,11,16,平和,招呼
2020-02-24,6230,8,12,20,平和,招呼
2020-02-25,6230,19,14,33,平和,招呼
2020-02-26,6230,17,21,38,平和,招呼
2020-02-27,6230,14,19,33,平和,招呼
2020-02-28,6230,7,10,17,平和,招呼
2020-02-29,6230,2,11,13,平和,招呼
2020-03-01,6230,5,32,37,平和,招呼
2020-03-02,6230,20,19,39,平和,招呼
2020-03-03,6230,21,21,42,平和,招呼
2020-03-04,6230,12,16,28,平和,招呼
2020-03-05,6230,20,18,38,平和,招呼
2020-03-06,6230,23,20,43,平和,招呼
2020-03-07,6230,9,12,21,平和,招呼
2020-03-08,6230,7,17,24,平和,招呼
2020-03-09,6230,18,18,36,平和,招呼
2020-03-10,6230,17,21,38,平和,招呼
2020-03-11,6230,13,19,32,平和,招呼
2020-03-12,6230,16,19,35,平和,招呼
2020-03-13,6230,17,16,33,平和,招呼
2020-03-14,6230,8,12,20,平和,招呼
2020-03-15,6230,3,16,19,平和,招呼
2020-03-16,6230,21,19,40,平和,招呼
2020-03-17,6230,16,25,41,平和,招呼
2020-03-18,6230,10,19,29,平和,招呼
2020-03-19,6230,11,17,28,平和,招呼
2020-03-20,6230,9,18,27,平和,招呼
2020-03-21,6230,7,15,22,平和,招呼
2020-03-22,6230,7,7,14,平和,招呼
2020-03-23,6230,12,12,24,平和,招呼
2020-03-24,6230,17,21,38,平和,招呼
2020-03-25,6230,13,22,35,平和,招呼
2020-03-26,6230,13,22,35,平和,招呼
2020-03-27,6230,19,13,32,平和,招呼
2020-03-28,6230,7,9,16,平和,招呼
2020-03-29,6230,2,11,13,平和,招呼
2020-03-30,6230,18,20,38,平和,招呼
2020-03-31,6230,14,22,36,平和,招呼
2020-04-01,6230,17,21,38,平和,招呼
2020-04-02,6230,4,18,22,平和,招呼
2020-04-03,6230,7,8,15,平和,招呼
2020-04-04,6230,6,6,12,平和,招呼
2020-04-05,6230,12,8,20,平和,招呼
2020-04-06,6230,20,15,35,平和,招呼
2020-04-07,6230,14,25,39,平和,招呼
2020-04-08,6230,20,18,38,平和,招呼
2020-04-09,6230,15,19,34,平和,招呼
2020-04-10,6230,17,17,34,平和,招呼
2020-04-11,6230,5,12,17,平和,招呼
2020-04-12,6230,6,7,13,平和,招呼
2020-04-13,6230,17,16,33,平和,招呼
2020-04-14,6230,13,19,32,平和,招呼
2020-04-15,6230,15,21,36,平和,招呼
2020-04-16,6230,18,22,40,平和,招呼
2020-04-17,6230,24,20,44,平和,招呼
2020-04-18,6230,4,20,24,平和,招呼
2020-04-19,6230,8,16,24,平和,招呼
2020-04-20,6230,12,11,23,平和,招呼
2020-04-21,6230,18,20,38,平和,招呼
2020-04-22,6230,22,29,51,平和,招呼
2020-04-23,6230,14,16,30,平和,招呼
2020-04-24,6230,13,23,36,平和,招呼
2020-04-25,6230,3,15,18,平和,招呼
2020-04-26,6230,5,9,14,平和,招呼
2020-04-27,6230,10,12,22,平和,招呼
2020-04-28,6230,15,26,41,平和,招呼
2020-04-29,6230,13,18,31,平和,招呼
2020-04-30,6230,11,18,29,平和,招呼
2020-05-01,6230,11,19,30,平和,招呼
2020-05-02,6230,9,20,29,平和,招呼
2020-05-03,6230,7,11,18,平和,招呼
2020-05-04,6230,13,18,31,平和,招呼
2020-05-05,6230,12,22,34,平和,招呼
2020-05-06,6230,14,22,36,平和,招呼
2020-05-07,6230,15,17,32,平和,招呼
2020-05-08,6230,13,25,38,平和,招呼
2020-05-09,6230,6,11,17,平和,招呼
2020-05-10,6230,6,6,12,平和,招呼
2020-05-11,6230,11,19,30,平和,招呼
2020-05-12,6230,13,16,29,平和,招呼
2020-05-13,6230,18,21,39,平和,招呼
2020-05-14,6230,14,24,38,平和,招呼
2020-05-15,6230,11,27,38,平和,招呼
2020-05-16,6230,5,20,25,平和,招呼
2020-05-17,6230,6,12,18,平和,招呼
2020-05-18,6230,13,18,31,平和,招呼
2020-05-19,6230,19,19,38,平和,招呼
2020-05-20,6230,14,19,33,平和,招呼
2020-05-21,6230,8,14,22,平和,招呼
2020-05-22,6230,13,14,27,平和,招呼
2020-05-23,6230,4,18,22,平和,招呼
2020-05-24,6230,1,8,9,平和,招呼
2020-05-25,6230,17,18,35,平和,招呼
2020-05-26,6230,17,21,38,平和,招呼
2020-05-27,6230,16,22,38,平和,招呼
2020-05-28,6230,11,19,30,平和,招呼
2020-05-29,6230,13,21,34,平和,招呼
2020-05-30,6230,4,19,23,平和,招呼
2020-05-31,6230,7,15,22,平和,招呼
2020-06-01,6230,14,15,29,平和,招呼
2020-06-02,6230,14,16,30,平和,招呼
2020-06-03,6230,12,20,32,平和,招呼
2020-06-04,6230,13,17,30,平和,招呼
2020-06-05,6230,10,16,26,平和,招呼
2020-06-06,6230,3,11,14,平和,招呼
2020-06-07,6230,3,7,10,平和,招呼
2020-06-08,6230,10,12,22,平和,招呼
2020-06-09,6230,7,18,25,平和,招呼
2020-06-10,6230,16,17,33,平和,招呼
2020-06-11,6230,24,33,57,平和,招呼
2020-06-12,6230,15,20,35,平和,招呼
2020-06-13,6230,7,19,26,平和,招呼
2020-06-14,6230,3,10,13,平和,招呼
2020-06-15,6230,11,17,28,平和,招呼
2020-06-16,6230,11,20,31,平和,招呼
2020-06-17,6230,13,15,28,平和,招呼
2020-06-18,6230,7,18,25,平和,招呼
2020-06-19,6230,8,17,25,平和,招呼
2020-06-20,6230,9,15,24,平和,招呼
2020-06-21,6230,4,8,12,平和,招呼
2020-06-22,6230,11,40,51,平和,招呼
2020-06-23,6230,11,22,33,平和,招呼
2020-06-24,6230,13,21,34,平和,招呼
2020-06-25,6230,8,21,29,平和,招呼
2020-06-26,6230,6,26,32,平和,招呼
2020-06-27,6230,2,3,5,平和,招呼
2020-06-28,6230,5,10,15,平和,招呼
2020-06-29,6230,17,13,30,平和,招呼
2020-06-30,6230,16,16,32,平和,招呼
2020-07-01,6230,11,21,32,平和,招呼
2020-07-02,6230,10,14,24,平和,招呼
2020-07-03,6230,10,20,30,平和,招呼
2020-07-04,6230,8,13,21,平和,招呼
2020-07-05,6230,7,19,26,平和,招呼
2020-07-06,6230,22,14,36,平和,招呼
2020-07-07,6230,11,27,38,平和,招呼
2020-07-08,6230,15,19,34,平和,招呼
2020-07-09,6230,12,20,32,平和,招呼
2020-07-10,6230,13,54,67,平和,招呼
2020-07-11,6230,7,16,23,平和,招呼
2020-07-12,6230,5,4,9,平和,招呼
2020-07-13,6230,17,11,28,平和,招呼
2020-07-14,6230,15,27,42,平和,招呼
2020-07-15,6230,13,21,34,平和,招呼
2020-07-16,6230,39,47,86,平和,招呼
2020-07-17,6230,4,7,11,平和,招呼
2020-07-18,6230,7,8,15,平和,招呼
2020-07-19,6230,2,7,9,平和,招呼
2020-07-20,6230,9,14,23,平和,招呼
2020-07-21,6230,5,10,15,平和,招呼
2020-07-22,6230,9,18,27,平和,招呼
2020-07-23,6230,9,31,40,平和,招呼
2020-07-24,6230,10,10,20,平和,招呼
2020-07-25,6230,16,12,28,平和,招呼
2020-07-26,6230,8,18,26,平和,招呼
2020-07-27,6230,6,8,14,平和,招呼
2020-07-28,6230,6,23,29,平和,招呼
2020-07-29,6230,7,17,24,平和,招呼
2020-07-30,6230,14,11,25,平和,招呼
2020-07-31,6230,9,39,48,平和,招呼
2020-08-01,6230,12,8,20,平和,招呼
2020-08-02,6230,4,10,14,平和,招呼
2020-08-03,6230,22,10,32,平和,招呼
2020-08-04,6230,6,11,17,平和,招呼
2020-08-05,6230,16,14,30,平和,招呼
2020-08-06,6230,4,15,19,平和,招呼
2020-08-07,6230,11,14,25,平和,招呼
2020-08-08,6230,2,22,24,平和,招呼
2020-08-09,6230,10,11,21,平和,招呼
2020-08-10,6230,13,15,28,平和,招呼
2020-08-11,6230,13,14,27,平和,招呼
2020-08-12,6230,12,16,28,平和,招呼
2020-08-13,6230,9,37,46,平和,招呼
2020-08-14,6230,7,14,21,平和,招呼
2020-08-15,6230,3,15,18,平和,招呼
2020-08-16,6230,8,14,22,平和,招呼
2020-08-17,6230,9,12,21,平和,招呼
2020-08-18,6230,19,21,40,平和,招呼
2020-08-19,6230,12,15,27,平和,招呼
2020-08-20,6230,11,10,21,平和,招呼
2020-08-21,6230,8,11,19,平和,招呼
2020-08-22,6230,6,12,18,平和,招呼
2020-08-23,6230,12,9,21,平和,招呼
2020-08-24,6230,11,13,24,平和,招呼
2020-08-25,6230,15,24,39,平和,招呼
2020-08-26,6230,53,89,142,平和,招呼
2020-08-27,6230,11,34,45,平和,招呼
2020-08-28,6230,35,44,79,平和,招呼
2020-08-29,6230,3,6,9,平和,招呼
2020-08-30,6230,7,11,18,平和,招呼
2020-08-31,6230,14,16,30,平和,招呼
2020-09-01,6230,11,16,27,平和,招呼
2020-09-02,6230,25,19,44,平和,招呼
2020-09-03,6230,9,20,29,平和,招呼
2020-09-04,6230,15,22,37,平和,招呼
2020-09-05,6230,0,18,18,平和,招呼
2020-09-06,6230,9,6,15,平和,招呼
2020-09-07,6230,19,15,34,平和,招呼
2020-09-08,6230,20,18,38,平和,招呼
2020-09-09,6230,8,15,23,平和,招呼
2020-09-10,6230,18,14,32,平和,招呼
2020-09-11,6230,15,18,33,平和,招呼
2020-09-12,6230,7,20,27,平和,招呼
2020-09-13,6230,5,4,9,平和,招呼
2020-09-14,6230,14,12,26,平和,招呼
2020-09-15,6230,18,18,36,平和,招呼
2020-09-16,6230,15,18,33,平和,招呼
2020-09-17,6230,13,18,31,平和,招呼
2020-09-18,6230,10,19,29,平和,招呼
2020-09-19,6230,6,16,22,平和,招呼
2020-09-20,6230,4,7,11,平和,招呼
2020-09-21,6230,15,17,32,平和,招呼
2020-09-22,6230,13,10,23,平和,招呼
2020-09-23,6230,11,18,29,平和,招呼
2020-09-24,6230,14,15,29,平和,招呼
2020-09-25,6230,12,16,28,平和,招呼
2020-09-26,6230,6,10,16,平和,招呼
2020-09-27,6230,2,7,9,平和,招呼
2020-09-28,6230,18,26,44,平和,招呼
2020-09-29,6230,16,20,36,平和,招呼
2020-09-30,6230,12,17,29,平和,招呼
2020-10-01,6230,10,9,19,平和,招呼
2020-10-02,6230,7,9,16,平和,招呼
2020-10-03,6230,6,7,13,平和,招呼
2020-10-04,6230,3,9,12,平和,招呼
2020-10-05,6230,17,18,35,平和,招呼
2020-10-06,6230,13,14,27,平和,招呼
2020-10-07,6230,17,17,34,平和,招呼
2020-10-08,6230,16,20,36,平和,招呼
2020-10-09,6230,10,20,30,平和,招呼
2020-10-10,6230,6,5,11,平和,招呼
2020-10-11,6230,4,12,16,平和,招呼
2020-10-12,6230,18,20,38,平和,招呼
2020-10-13,6230,8,19,27,平和,招呼
2020-10-14,6230,9,14,23,平和,招呼
2020-10-15,6230,23,19,42,平和,招呼
2020-10-16,6230,10,14,24,平和,招呼
2020-10-17,6230,5,13,18,平和,招呼
2020-10-18,6230,3,4,7,平和,招呼
2020-10-19,6230,17,13,30,平和,招呼
2020-10-20,6230,21,22,43,平和,招呼
2020-10-21,6230,20,16,36,平和,招呼
2020-10-22,6230,10,14,24,平和,招呼
2020-10-23,6230,15,33,48,平和,招呼
2020-10-24,6230,6,7,13,平和,招呼
2020-10-25,6230,10,16,26,平和,招呼
2020-10-26,6230,11,17,28,平和,招呼
2020-10-27,6230,15,23,38,平和,招呼
2020-10-28,6230,20,16,36,平和,招呼
2020-10-29,6230,14,18,32,平和,招呼
2020-10-30,6230,18,17,35,平和,招呼
2020-10-31,6230,3,3,6,平和,招呼
2020-11-01,6230,12,5,17,平和,招呼
2020-11-02,6230,14,14,28,平和,招呼
2020-11-03,6230,13,14,27,平和,招呼
2020-11-04,6230,9,19,28,平和,招呼
2020-11-05,6230,16,16,32,平和,招呼
2020-11-06,6230,8,19,27,平和,招呼
2020-11-07,6230,4,6,10,平和,招呼
2020-11-08,6230,9,7,16,平和,招呼
2020-11-09,6230,7,19,26,平和,招呼
2020-11-10,6230,10,18,28,平和,招呼
2020-11-11,6230,17,22,39,平和,招呼
2020-11-12,6230,20,17,37,平和,招呼
2020-11-13,6230,7,19,26,平和,招呼
2020-11-14,6230,6,38,44,平和,招呼
2020-11-15,6230,15,18,33,平和,招呼
2020-11-16,6230,19,20,39,平和,招呼
2020-11-17,6230,12,15,27,平和,招呼
2020-11-18,6230,12,16,28,平和,招呼
2020-11-19,6230,16,18,34,平和,招呼
2020-11-20,6230,19,20,39,平和,招呼
2020-11-21,6230,6,9,15,平和,招呼
2020-11-22,6230,5,8,13,平和,招呼
2020-11-23,6230,14,22,36,平和,招呼
2020-11-24,6230,10,16,26,平和,招呼
2020-11-25,6230,19,19,38,平和,招呼
2020-11-26,6230,11,23,34,平和,招呼
2020-11-27,6230,22,21,43,平和,招呼
2020-11-28,6230,6,15,21,平和,招呼
2020-11-29,6230,4,8,12,平和,招呼
2020-11-30,6230,9,22,31,平和,招呼
2020-12-01,6230,15,27,42,平和,招呼
2020-12-02,6230,17,20,37,平和,招呼
2020-12-03,6230,12,16,28,平和,招呼
2020-12-04,6230,10,17,27,平和,招呼
2020-12-05,6230,2,5,7,平和,招呼
2020-12-06,6230,2,5,7,平和,招呼
2020-12-07,6230,13,17,30,平和,招呼
2020-12-08,6230,16,17,33,平和,招呼
2020-12-09,6230,8,14,22,平和,招呼
2020-12-10,6230,19,18,37,平和,招呼
2020-12-11,6230,19,21,40,平和,招呼
2020-12-12,6230,5,5,10,平和,招呼
2020-12-13,6230,6,10,16,平和,招呼
2020-12-14,6230,13,20,33,平和,招呼
2020-12-15,6230,12,13,25,平和,招呼
2020-12-16,6230,11,14,25,平和,招呼
2020-12-17,6230,14,16,30,平和,招呼
2020-12-18,6230,12,18,30,平和,招呼
2020-12-19,6230,3,17,20,平和,招呼
2020-12-20,6230,8,3,11,平和,招呼
2020-12-21,6230,14,21,35,平和,招呼
2020-12-22,6230,10,19,29,平和,招呼
2020-12-23,6230,11,9,20,平和,招呼
2020-12-24,6230,15,13,28,平和,招呼
2020-12-25,6230,12,16,28,平和,招呼
2020-12-26,6230,7,7,14,平和,招呼
2020-12-27,6230,7,7,14,平和,招呼
2020-12-28,6230,20,18,38,平和,招呼
2020-12-29,6230,16,20,36,平和,招呼
2020-12-30,6230,10,17,27,平和,招呼
2020-12-31,6230,13,18,31,平和,招呼
2020-01-01,6240,214,460,674,志學,三等
2020-01-02,6240,249,286,535,志學,三等
2020-01-03,6240,369,223,592,志學,三等
2020-01-04,6240,303,243,546,志學,三等
2020-01-05,6240,220,349,569,志學,三等
2020-01-06,6240,194,327,521,志學,三等
2020-01-07,6240,182,233,415,志學,三等
2020-01-08,6240,337,211,548,志學,三等
2020-01-09,6240,940,220,1160,志學,三等
2020-01-10,6240,1675,254,1929,志學,三等
2020-01-11,6240,851,342,1193,志學,三等
2020-01-12,6240,438,413,851,志學,三等
2020-01-13,6240,420,398,818,志學,三等
2020-01-14,6240,342,243,585,志學,三等
2020-01-15,6240,249,228,477,志學,三等
2020-01-16,6240,207,193,400,志學,三等
2020-01-17,6240,279,217,496,志學,三等
2020-01-18,6240,229,148,377,志學,三等
2020-01-19,6240,195,219,414,志學,三等
2020-01-20,6240,218,157,375,志學,三等
2020-01-21,6240,303,168,471,志學,三等
2020-01-22,6240,381,154,535,志學,三等
2020-01-23,6240,383,173,556,志學,三等
2020-01-24,6240,169,174,343,志學,三等
2020-01-25,6240,128,187,315,志學,三等
2020-01-26,6240,141,175,316,志學,三等
2020-01-27,6240,172,164,336,志學,三等
2020-01-28,6240,179,152,331,志學,三等
2020-01-29,6240,167,188,355,志學,三等
2020-01-30,6240,135,193,328,志學,三等
2020-01-31,6240,150,202,352,志學,三等
2020-02-01,6240,161,215,376,志學,三等
2020-02-02,6240,194,230,424,志學,三等
2020-02-03,6240,201,228,429,志學,三等
2020-02-04,6240,153,161,314,志學,三等
2020-02-05,6240,161,134,295,志學,三等
2020-02-06,6240,154,145,299,志學,三等
2020-02-07,6240,224,217,441,志學,三等
2020-02-08,6240,161,150,311,志學,三等
2020-02-09,6240,175,226,401,志學,三等
2020-02-10,6240,153,203,356,志學,三等
2020-02-11,6240,189,169,358,志學,三等
2020-02-12,6240,192,227,419,志學,三等
2020-02-13,6240,183,338,521,志學,三等
2020-02-14,6240,184,266,450,志學,三等
2020-02-15,6240,191,349,540,志學,三等
2020-02-16,6240,155,423,578,志學,三等
2020-02-17,6240,206,220,426,志學,三等
2020-02-18,6240,190,174,364,志學,三等
2020-02-19,6240,161,156,317,志學,三等
2020-02-20,6240,155,162,317,志學,三等
2020-02-21,6240,217,228,445,志學,三等
2020-02-22,6240,162,164,326,志學,三等
2020-02-23,6240,201,222,423,志學,三等
2020-02-24,6240,146,235,381,志學,三等
2020-02-25,6240,190,213,403,志學,三等
2020-02-26,6240,242,343,585,志學,三等
2020-02-27,6240,320,748,1068,志學,三等
2020-02-28,6240,264,484,748,志學,三等
2020-02-29,6240,210,885,1095,志學,三等
2020-03-01,6240,307,1296,1603,志學,三等
2020-03-02,6240,242,443,685,志學,三等
2020-03-03,6240,186,211,397,志學,三等
2020-03-04,6240,232,214,446,志學,三等
2020-03-05,6240,296,224,520,志學,三等
2020-03-06,6240,545,229,774,志學,三等
2020-03-07,6240,332,307,639,志學,三等
2020-03-08,6240,350,536,886,志學,三等
2020-03-09,6240,221,338,559,志學,三等
2020-03-10,6240,187,192,379,志學,三等
2020-03-11,6240,242,201,443,志學,三等
2020-03-12,6240,322,191,513,志學,三等
2020-03-13,6240,651,272,923,志學,三等
2020-03-14,6240,319,214,533,志學,三等
2020-03-15,6240,309,627,936,志學,三等
2020-03-16,6240,235,404,639,志學,三等
2020-03-17,6240,193,219,412,志學,三等
2020-03-18,6240,203,195,398,志學,三等
2020-03-19,6240,311,192,503,志學,三等
2020-03-20,6240,603,285,888,志學,三等
2020-03-21,6240,352,271,623,志學,三等
2020-03-22,6240,257,533,790,志學,三等
2020-03-23,6240,190,361,551,志學,三等
2020-03-24,6240,192,225,417,志學,三等
2020-03-25,6240,198,208,406,志學,三等
2020-03-26,6240,311,157,468,志學,三等
2020-03-27,6240,475,234,709,志學,三等
2020-03-28,6240,303,239,542,志學,三等
2020-03-29,6240,227,371,598,志學,三等
2020-03-30,6240,225,281,506,志學,三等
2020-03-31,6240,434,226,660,志學,三等
2020-04-01,6240,1401,226,1627,志學,三等
2020-04-02,6240,1129,225,1354,志學,三等
2020-04-03,6240,307,170,477,志學,三等
2020-04-04,6240,200,246,446,志學,三等
2020-04-05,6240,204,840,1044,志學,三等
2020-04-06,6240,208,1943,2151,志學,三等
2020-04-07,6240,179,478,657,志學,三等
2020-04-08,6240,184,201,385,志學,三等
2020-04-09,6240,230,172,402,志學,三等
2020-04-10,6240,461,207,668,志學,三等
2020-04-11,6240,222,205,427,志學,三等
2020-04-12,6240,209,280,489,志學,三等
2020-04-13,6240,177,304,481,志學,三等
2020-04-14,6240,173,183,356,志學,三等
2020-04-15,6240,237,209,446,志學,三等
2020-04-16,6240,253,170,423,志學,三等
2020-04-17,6240,457,204,661,志學,三等
2020-04-18,6240,228,176,404,志學,三等
2020-04-19,6240,187,334,521,志學,三等
2020-04-20,6240,182,292,474,志學,三等
2020-04-21,6240,159,195,354,志學,三等
2020-04-22,6240,209,403,612,志學,三等
2020-04-23,6240,640,312,952,志學,三等
2020-04-24,6240,534,231,765,志學,三等
2020-04-25,6240,273,216,489,志學,三等
2020-04-26,6240,201,389,590,志學,三等
2020-04-27,6240,177,336,513,志學,三等
2020-04-28,6240,172,196,368,志學,三等
2020-04-29,6240,214,177,391,志學,三等
2020-04-30,6240,398,219,617,志學,三等
2020-05-01,6240,695,259,954,志學,三等
2020-05-02,6240,288,216,504,志學,三等
2020-05-03,6240,250,614,864,志學,三等
2020-05-04,6240,228,430,658,志學,三等
2020-05-05,6240,183,246,429,志學,三等
2020-05-06,6240,242,189,431,志學,三等
2020-05-07,6240,467,181,648,志學,三等
2020-05-08,6240,1129,234,1363,志學,三等
2020-05-09,6240,362,218,580,志學,三等
2020-05-10,6240,238,823,1061,志學,三等
2020-05-11,6240,226,762,988,志學,三等
2020-05-12,6240,202,294,496,志學,三等
2020-05-13,6240,194,188,382,志學,三等
2020-05-14,6240,325,220,545,志學,三等
2020-05-15,6240,596,246,842,志學,三等
2020-05-16,6240,297,240,537,志學,三等
2020-05-17,6240,269,535,804,志學,三等
2020-05-18,6240,214,383,597,志學,三等
2020-05-19,6240,168,193,361,志學,三等
2020-05-20,6240,216,174,390,志學,三等
2020-05-21,6240,298,163,461,志學,三等
2020-05-22,6240,575,242,817,志學,三等
2020-05-23,6240,346,226,572,志學,三等
2020-05-24,6240,212,559,771,志學,三等
2020-05-25,6240,240,434,674,志學,三等
2020-05-26,6240,208,241,449,志學,三等
2020-05-27,6240,237,194,431,志學,三等
2020-05-28,6240,332,202,534,志學,三等
2020-05-29,6240,585,284,869,志學,三等
2020-05-30,6240,291,213,504,志學,三等
2020-05-31,6240,306,525,831,志學,三等
2020-06-01,6240,257,395,652,志學,三等
2020-06-02,6240,196,214,410,志學,三等
2020-06-03,6240,256,195,451,志學,三等
2020-06-04,6240,380,246,626,志學,三等
2020-06-05,6240,724,239,963,志學,三等
2020-06-06,6240,378,335,713,志學,三等
2020-06-07,6240,252,635,887,志學,三等
2020-06-08,6240,229,429,658,志學,三等
2020-06-09,6240,197,249,446,志學,三等
2020-06-10,6240,262,225,487,志學,三等
2020-06-11,6240,267,188,455,志學,三等
2020-06-12,6240,480,275,755,志學,三等
2020-06-13,6240,293,211,504,志學,三等
2020-06-14,6240,230,420,650,志學,三等
2020-06-15,6240,214,297,511,志學,三等
2020-06-16,6240,178,189,367,志學,三等
2020-06-17,6240,204,205,409,志學,三等
2020-06-18,6240,261,171,432,志學,三等
2020-06-19,6240,567,230,797,志學,三等
2020-06-20,6240,599,318,917,志學,三等
2020-06-21,6240,539,402,941,志學,三等
2020-06-22,6240,454,297,751,志學,三等
2020-06-23,6240,539,237,776,志學,三等
2020-06-24,6240,707,284,991,志學,三等
2020-06-25,6240,628,262,890,志學,三等
2020-06-26,6240,366,224,590,志學,三等
2020-06-27,6240,388,258,646,志學,三等
2020-06-28,6240,258,420,678,志學,三等
2020-06-29,6240,329,339,668,志學,三等
2020-06-30,6240,321,252,573,志學,三等
2020-07-01,6240,260,243,503,志學,三等
2020-07-02,6240,333,199,532,志學,三等
2020-07-03,6240,362,272,634,志學,三等
2020-07-04,6240,276,251,527,志學,三等
2020-07-05,6240,218,317,535,志學,三等
2020-07-06,6240,327,280,607,志學,三等
2020-07-07,6240,454,221,675,志學,三等
2020-07-08,6240,216,174,390,志學,三等
2020-07-09,6240,258,190,448,志學,三等
2020-07-10,6240,266,241,507,志學,三等
2020-07-11,6240,189,149,338,志學,三等
2020-07-12,6240,254,264,518,志學,三等
2020-07-13,6240,249,252,501,志學,三等
2020-07-14,6240,220,223,443,志學,三等
2020-07-15,6240,227,235,462,志學,三等
2020-07-16,6240,240,182,422,志學,三等
2020-07-17,6240,278,207,485,志學,三等
2020-07-18,6240,209,199,408,志學,三等
2020-07-19,6240,249,240,489,志學,三等
2020-07-20,6240,237,227,464,志學,三等
2020-07-21,6240,193,188,381,志學,三等
2020-07-22,6240,196,157,353,志學,三等
2020-07-23,6240,215,157,372,志學,三等
2020-07-24,6240,298,213,511,志學,三等
2020-07-25,6240,215,170,385,志學,三等
2020-07-26,6240,221,272,493,志學,三等
2020-07-27,6240,223,242,465,志學,三等
2020-07-28,6240,196,179,375,志學,三等
2020-07-29,6240,196,183,379,志學,三等
2020-07-30,6240,250,179,429,志學,三等
2020-07-31,6240,347,222,569,志學,三等
2020-08-01,6240,259,200,459,志學,三等
2020-08-02,6240,217,239,456,志學,三等
2020-08-03,6240,183,208,391,志學,三等
2020-08-04,6240,175,163,338,志學,三等
2020-08-05,6240,170,184,354,志學,三等
2020-08-06,6240,220,166,386,志學,三等
2020-08-07,6240,334,197,531,志學,三等
2020-08-08,6240,230,145,375,志學,三等
2020-08-09,6240,178,271,449,志學,三等
2020-08-10,6240,205,234,439,志學,三等
2020-08-11,6240,154,181,335,志學,三等
2020-08-12,6240,186,198,384,志學,三等
2020-08-13,6240,233,163,396,志學,三等
2020-08-14,6240,320,214,534,志學,三等
2020-08-15,6240,251,208,459,志學,三等
2020-08-16,6240,249,250,499,志學,三等
2020-08-17,6240,229,232,461,志學,三等
2020-08-18,6240,161,197,358,志學,三等
2020-08-19,6240,208,149,357,志學,三等
2020-08-20,6240,226,158,384,志學,三等
2020-08-21,6240,272,191,463,志學,三等
2020-08-22,6240,209,176,385,志學,三等
2020-08-23,6240,180,248,428,志學,三等
2020-08-24,6240,219,241,460,志學,三等
2020-08-25,6240,199,203,402,志學,三等
2020-08-26,6240,199,168,367,志學,三等
2020-08-27,6240,208,170,378,志學,三等
2020-08-28,6240,287,216,503,志學,三等
2020-08-29,6240,196,160,356,志學,三等
2020-08-30,6240,240,276,516,志學,三等
2020-08-31,6240,276,210,486,志學,三等
2020-09-01,6240,253,190,443,志學,三等
2020-09-02,6240,231,202,433,志學,三等
2020-09-03,6240,251,245,496,志學,三等
2020-09-04,6240,263,254,517,志學,三等
2020-09-05,6240,246,189,435,志學,三等
2020-09-06,6240,226,297,523,志學,三等
2020-09-07,6240,259,257,516,志學,三等
2020-09-08,6240,208,296,504,志學,三等
2020-09-09,6240,192,297,489,志學,三等
2020-09-10,6240,228,635,863,志學,三等
2020-09-11,6240,397,685,1082,志學,三等
2020-09-12,6240,334,807,1141,志學,三等
2020-09-13,6240,419,878,1297,志學,三等
2020-09-14,6240,256,346,602,志學,三等
2020-09-15,6240,200,196,396,志學,三等
2020-09-16,6240,219,206,425,志學,三等
2020-09-17,6240,300,225,525,志學,三等
2020-09-18,6240,603,284,887,志學,三等
2020-09-19,6240,472,328,800,志學,三等
2020-09-20,6240,337,578,915,志學,三等
2020-09-21,6240,248,313,561,志學,三等
2020-09-22,6240,192,213,405,志學,三等
2020-09-23,6240,205,205,410,志學,三等
2020-09-24,6240,287,179,466,志學,三等
2020-09-25,6240,457,210,667,志學,三等
2020-09-26,6240,390,288,678,志學,三等
2020-09-27,6240,281,456,737,志學,三等
2020-09-28,6240,218,308,526,志學,三等
2020-09-29,6240,313,204,517,志學,三等
2020-09-30,6240,1639,275,1914,志學,三等
2020-10-01,6240,1760,221,1981,志學,三等
2020-10-02,6240,296,219,515,志學,三等
2020-10-03,6240,213,379,592,志學,三等
2020-10-04,6240,291,2392,2683,志學,三等
2020-10-05,6240,243,939,1182,志學,三等
2020-10-06,6240,202,239,441,志學,三等
2020-10-07,6240,299,216,515,志學,三等
2020-10-08,6240,921,280,1201,志學,三等
2020-10-09,6240,951,345,1296,志學,三等
2020-10-10,6240,367,349,716,志學,三等
2020-10-11,6240,375,1308,1683,志學,三等
2020-10-12,6240,258,600,858,志學,三等
2020-10-13,6240,200,214,414,志學,三等
2020-10-14,6240,238,176,414,志學,三等
2020-10-15,6240,326,243,569,志學,三等
2020-10-16,6240,609,273,882,志學,三等
2020-10-17,6240,422,288,710,志學,三等
2020-10-18,6240,331,593,924,志學,三等
2020-10-19,6240,244,391,635,志學,三等
2020-10-20,6240,210,226,436,志學,三等
2020-10-21,6240,230,204,434,志學,三等
2020-10-22,6240,371,206,577,志學,三等
2020-10-23,6240,812,333,1145,志學,三等
2020-10-24,6240,454,361,815,志學,三等
2020-10-25,6240,423,729,1152,志學,三等
2020-10-26,6240,234,453,687,志學,三等
2020-10-27,6240,210,253,463,志學,三等
2020-10-28,6240,290,217,507,志學,三等
2020-10-29,6240,378,217,595,志學,三等
2020-10-30,6240,853,278,1131,志學,三等
2020-10-31,6240,450,287,737,志學,三等
2020-11-01,6240,267,750,1017,志學,三等
2020-11-02,6240,262,528,790,志學,三等
2020-11-03,6240,193,253,446,志學,三等
2020-11-04,6240,237,230,467,志學,三等
2020-11-05,6240,347,221,568,志學,三等
2020-11-06,6240,674,250,924,志學,三等
2020-11-07,6240,347,259,606,志學,三等
2020-11-08,6240,263,569,832,志學,三等
2020-11-09,6240,233,398,631,志學,三等
2020-11-10,6240,199,224,423,志學,三等
2020-11-11,6240,258,230,488,志學,三等
2020-11-12,6240,483,231,714,志學,三等
2020-11-13,6240,1119,305,1424,志學,三等
2020-11-14,6240,443,292,735,志學,三等
2020-11-15,6240,363,927,1290,志學,三等
2020-11-16,6240,288,549,837,志學,三等
2020-11-17,6240,298,491,789,志學,三等
2020-11-18,6240,240,309,549,志學,三等
2020-11-19,6240,434,228,662,志學,三等
2020-11-20,6240,1019,266,1285,志學,三等
2020-11-21,6240,378,298,676,志學,三等
2020-11-22,6240,352,855,1207,志學,三等
2020-11-23,6240,231,489,720,志學,三等
2020-11-24,6240,207,241,448,志學,三等
2020-11-25,6240,250,217,467,志學,三等
2020-11-26,6240,393,200,593,志學,三等
2020-11-27,6240,883,306,1189,志學,三等
2020-11-28,6240,397,310,707,志學,三等
2020-11-29,6240,307,772,1079,志學,三等
2020-11-30,6240,226,517,743,志學,三等
2020-12-01,6240,201,255,456,志學,三等
2020-12-02,6240,280,218,498,志學,三等
2020-12-03,6240,423,209,632,志學,三等
2020-12-04,6240,1097,230,1327,志學,三等
2020-12-05,6240,463,276,739,志學,三等
2020-12-06,6240,291,993,1284,志學,三等
2020-12-07,6240,207,620,827,志學,三等
2020-12-08,6240,198,244,442,志學,三等
2020-12-09,6240,243,170,413,志學,三等
2020-12-10,6240,409,227,636,志學,三等
2020-12-11,6240,991,369,1360,志學,三等
2020-12-12,6240,478,296,774,志學,三等
2020-12-13,6240,338,865,1203,志學,三等
2020-12-14,6240,240,534,774,志學,三等
2020-12-15,6240,215,240,455,志學,三等
2020-12-16,6240,268,244,512,志學,三等
2020-12-17,6240,435,204,639,志學,三等
2020-12-18,6240,901,290,1191,志學,三等
2020-12-19,6240,468,368,836,志學,三等
2020-12-20,6240,364,803,1167,志學,三等
2020-12-21,6240,233,533,766,志學,三等
2020-12-22,6240,227,255,482,志學,三等
2020-12-23,6240,262,193,455,志學,三等
2020-12-24,6240,476,196,672,志學,三等
2020-12-25,6240,803,311,1114,志學,三等
2020-12-26,6240,418,312,730,志學,三等
2020-12-27,6240,317,744,1061,志學,三等
2020-12-28,6240,266,462,728,志學,三等
2020-12-29,6240,264,239,503,志學,三等
2020-12-30,6240,496,247,743,志學,三等
2020-12-31,6240,1510,267,1777,志學,三等
2020-01-01,6250,404,344,748,吉安,三等
2020-01-02,6250,449,395,844,吉安,三等
2020-01-03,6250,456,480,936,吉安,三等
2020-01-04,6250,389,363,752,吉安,三等
2020-01-05,6250,456,392,848,吉安,三等
2020-01-06,6250,504,406,910,吉安,三等
2020-01-07,6250,407,398,805,吉安,三等
2020-01-08,6250,441,419,860,吉安,三等
2020-01-09,6250,466,481,947,吉安,三等
2020-01-10,6250,515,688,1203,吉安,三等
2020-01-11,6250,545,535,1080,吉安,三等
2020-01-12,6250,498,433,931,吉安,三等
2020-01-13,6250,505,425,930,吉安,三等
2020-01-14,6250,491,427,918,吉安,三等
2020-01-15,6250,436,391,827,吉安,三等
2020-01-16,6250,485,394,879,吉安,三等
2020-01-17,6250,516,564,1080,吉安,三等
2020-01-18,6250,372,383,755,吉安,三等
2020-01-19,6250,466,410,876,吉安,三等
2020-01-20,6250,491,513,1004,吉安,三等
2020-01-21,6250,430,521,951,吉安,三等
2020-01-22,6250,542,686,1228,吉安,三等
2020-01-23,6250,474,599,1073,吉安,三等
2020-01-24,6250,488,537,1025,吉安,三等
2020-01-25,6250,497,597,1094,吉安,三等
2020-01-26,6250,695,640,1335,吉安,三等
2020-01-27,6250,649,659,1308,吉安,三等
2020-01-28,6250,553,574,1127,吉安,三等
2020-01-29,6250,522,529,1051,吉安,三等
2020-01-30,6250,555,479,1034,吉安,三等
2020-01-31,6250,532,528,1060,吉安,三等
2020-02-01,6250,415,341,756,吉安,三等
2020-02-02,6250,431,368,799,吉安,三等
2020-02-03,6250,471,409,880,吉安,三等
2020-02-04,6250,440,460,900,吉安,三等
2020-02-05,6250,385,385,770,吉安,三等
2020-02-06,6250,382,351,733,吉安,三等
2020-02-07,6250,499,537,1036,吉安,三等
2020-02-08,6250,367,320,687,吉安,三等
2020-02-09,6250,411,410,821,吉安,三等
2020-02-10,6250,451,410,861,吉安,三等
2020-02-11,6250,444,440,884,吉安,三等
2020-02-12,6250,465,401,866,吉安,三等
2020-02-13,6250,415,380,795,吉安,三等
2020-02-14,6250,427,416,843,吉安,三等
2020-02-15,6250,384,343,727,吉安,三等
2020-02-16,6250,344,327,671,吉安,三等
2020-02-17,6250,428,337,765,吉安,三等
2020-02-18,6250,422,333,755,吉安,三等
2020-02-19,6250,425,373,798,吉安,三等
2020-02-20,6250,391,371,762,吉安,三等
2020-02-21,6250,428,509,937,吉安,三等
2020-02-22,6250,333,348,681,吉安,三等
2020-02-23,6250,471,371,842,吉安,三等
2020-02-24,6250,468,416,884,吉安,三等
2020-02-25,6250,359,368,727,吉安,三等
2020-02-26,6250,382,387,769,吉安,三等
2020-02-27,6250,527,577,1104,吉安,三等
2020-02-28,6250,414,471,885,吉安,三等
2020-02-29,6250,389,339,728,吉安,三等
2020-03-01,6250,534,463,997,吉安,三等
2020-03-02,6250,438,386,824,吉安,三等
2020-03-03,6250,399,393,792,吉安,三等
2020-03-04,6250,378,353,731,吉安,三等
2020-03-05,6250,360,349,709,吉安,三等
2020-03-06,6250,513,509,1022,吉安,三等
2020-03-07,6250,310,321,631,吉安,三等
2020-03-08,6250,449,387,836,吉安,三等
2020-03-09,6250,446,410,856,吉安,三等
2020-03-10,6250,371,357,728,吉安,三等
2020-03-11,6250,437,430,867,吉安,三等
2020-03-12,6250,399,394,793,吉安,三等
2020-03-13,6250,516,503,1019,吉安,三等
2020-03-14,6250,359,358,717,吉安,三等
2020-03-15,6250,412,400,812,吉安,三等
2020-03-16,6250,448,411,859,吉安,三等
2020-03-17,6250,357,362,719,吉安,三等
2020-03-18,6250,411,379,790,吉安,三等
2020-03-19,6250,396,369,765,吉安,三等
2020-03-20,6250,444,514,958,吉安,三等
2020-03-21,6250,321,317,638,吉安,三等
2020-03-22,6250,403,337,740,吉安,三等
2020-03-23,6250,418,369,787,吉安,三等
2020-03-24,6250,338,322,660,吉安,三等
2020-03-25,6250,329,342,671,吉安,三等
2020-03-26,6250,384,341,725,吉安,三等
2020-03-27,6250,457,460,917,吉安,三等
2020-03-28,6250,317,280,597,吉安,三等
2020-03-29,6250,381,361,742,吉安,三等
2020-03-30,6250,379,429,808,吉安,三等
2020-03-31,6250,384,536,920,吉安,三等
2020-04-01,6250,482,631,1113,吉安,三等
2020-04-02,6250,429,570,999,吉安,三等
2020-04-03,6250,389,424,813,吉安,三等
2020-04-04,6250,398,298,696,吉安,三等
2020-04-05,6250,469,410,879,吉安,三等
2020-04-06,6250,514,398,912,吉安,三等
2020-04-07,6250,339,325,664,吉安,三等
2020-04-08,6250,330,299,629,吉安,三等
2020-04-09,6250,338,370,708,吉安,三等
2020-04-10,6250,406,437,843,吉安,三等
2020-04-11,6250,243,255,498,吉安,三等
2020-04-12,6250,296,233,529,吉安,三等
2020-04-13,6250,363,294,657,吉安,三等
2020-04-14,6250,355,336,691,吉安,三等
2020-04-15,6250,333,338,671,吉安,三等
2020-04-16,6250,350,357,707,吉安,三等
2020-04-17,6250,449,482,931,吉安,三等
2020-04-18,6250,301,261,562,吉安,三等
2020-04-19,6250,378,280,658,吉安,三等
2020-04-20,6250,385,324,709,吉安,三等
2020-04-21,6250,361,329,690,吉安,三等
2020-04-22,6250,320,340,660,吉安,三等
2020-04-23,6250,341,357,698,吉安,三等
2020-04-24,6250,403,417,820,吉安,三等
2020-04-25,6250,249,277,526,吉安,三等
2020-04-26,6250,349,295,644,吉安,三等
2020-04-27,6250,388,358,746,吉安,三等
2020-04-28,6250,294,274,568,吉安,三等
2020-04-29,6250,265,286,551,吉安,三等
2020-04-30,6250,376,404,780,吉安,三等
2020-05-01,6250,445,483,928,吉安,三等
2020-05-02,6250,306,260,566,吉安,三等
2020-05-03,6250,442,356,798,吉安,三等
2020-05-04,6250,412,347,759,吉安,三等
2020-05-05,6250,325,334,659,吉安,三等
2020-05-06,6250,342,315,657,吉安,三等
2020-05-07,6250,361,376,737,吉安,三等
2020-05-08,6250,493,597,1090,吉安,三等
2020-05-09,6250,360,345,705,吉安,三等
2020-05-10,6250,498,430,928,吉安,三等
2020-05-11,6250,450,383,833,吉安,三等
2020-05-12,6250,342,322,664,吉安,三等
2020-05-13,6250,352,348,700,吉安,三等
2020-05-14,6250,345,306,651,吉安,三等
2020-05-15,6250,432,457,889,吉安,三等
2020-05-16,6250,311,313,624,吉安,三等
2020-05-17,6250,394,367,761,吉安,三等
2020-05-18,6250,388,348,736,吉安,三等
2020-05-19,6250,337,298,635,吉安,三等
2020-05-20,6250,358,321,679,吉安,三等
2020-05-21,6250,350,367,717,吉安,三等
2020-05-22,6250,443,492,935,吉安,三等
2020-05-23,6250,307,289,596,吉安,三等
2020-05-24,6250,424,372,796,吉安,三等
2020-05-25,6250,442,360,802,吉安,三等
2020-05-26,6250,388,372,760,吉安,三等
2020-05-27,6250,340,323,663,吉安,三等
2020-05-28,6250,351,339,690,吉安,三等
2020-05-29,6250,453,468,921,吉安,三等
2020-05-30,6250,329,318,647,吉安,三等
2020-05-31,6250,408,379,787,吉安,三等
2020-06-01,6250,441,342,783,吉安,三等
2020-06-02,6250,385,327,712,吉安,三等
2020-06-03,6250,332,342,674,吉安,三等
2020-06-04,6250,441,403,844,吉安,三等
2020-06-05,6250,459,505,964,吉安,三等
2020-06-06,6250,421,423,844,吉安,三等
2020-06-07,6250,430,407,837,吉安,三等
2020-06-08,6250,458,418,876,吉安,三等
2020-06-09,6250,398,380,778,吉安,三等
2020-06-10,6250,386,421,807,吉安,三等
2020-06-11,6250,382,382,764,吉安,三等
2020-06-12,6250,486,532,1018,吉安,三等
2020-06-13,6250,373,369,742,吉安,三等
2020-06-14,6250,393,434,827,吉安,三等
2020-06-15,6250,476,388,864,吉安,三等
2020-06-16,6250,417,366,783,吉安,三等
2020-06-17,6250,358,381,739,吉安,三等
2020-06-18,6250,366,355,721,吉安,三等
2020-06-19,6250,417,446,863,吉安,三等
2020-06-20,6250,439,408,847,吉安,三等
2020-06-21,6250,431,370,801,吉安,三等
2020-06-22,6250,408,386,794,吉安,三等
2020-06-23,6250,383,391,774,吉安,三等
2020-06-24,6250,502,703,1205,吉安,三等
2020-06-25,6250,521,689,1210,吉安,三等
2020-06-26,6250,466,446,912,吉安,三等
2020-06-27,6250,477,368,845,吉安,三等
2020-06-28,6250,496,511,1007,吉安,三等
2020-06-29,6250,542,448,990,吉安,三等
2020-06-30,6250,452,412,864,吉安,三等
2020-07-01,6250,365,365,730,吉安,三等
2020-07-02,6250,357,344,701,吉安,三等
2020-07-03,6250,463,579,1042,吉安,三等
2020-07-04,6250,332,313,645,吉安,三等
2020-07-05,6250,432,446,878,吉安,三等
2020-07-06,6250,428,432,860,吉安,三等
2020-07-07,6250,414,407,821,吉安,三等
2020-07-08,6250,420,389,809,吉安,三等
2020-07-09,6250,465,414,879,吉安,三等
2020-07-10,6250,492,574,1066,吉安,三等
2020-07-11,6250,387,436,823,吉安,三等
2020-07-12,6250,420,470,890,吉安,三等
2020-07-13,6250,456,413,869,吉安,三等
2020-07-14,6250,490,393,883,吉安,三等
2020-07-15,6250,420,408,828,吉安,三等
2020-07-16,6250,415,407,822,吉安,三等
2020-07-17,6250,576,599,1175,吉安,三等
2020-07-18,6250,413,433,846,吉安,三等
2020-07-19,6250,446,410,856,吉安,三等
2020-07-20,6250,518,451,969,吉安,三等
2020-07-21,6250,387,436,823,吉安,三等
2020-07-22,6250,414,461,875,吉安,三等
2020-07-23,6250,454,395,849,吉安,三等
2020-07-24,6250,551,582,1133,吉安,三等
2020-07-25,6250,478,448,926,吉安,三等
2020-07-26,6250,424,434,858,吉安,三等
2020-07-27,6250,471,474,945,吉安,三等
2020-07-28,6250,436,416,852,吉安,三等
2020-07-29,6250,412,381,793,吉安,三等
2020-07-30,6250,496,428,924,吉安,三等
2020-07-31,6250,515,522,1037,吉安,三等
2020-08-01,6250,468,471,939,吉安,三等
2020-08-02,6250,518,470,988,吉安,三等
2020-08-03,6250,446,436,882,吉安,三等
2020-08-04,6250,449,412,861,吉安,三等
2020-08-05,6250,399,386,785,吉安,三等
2020-08-06,6250,405,452,857,吉安,三等
2020-08-07,6250,481,668,1149,吉安,三等
2020-08-08,6250,404,431,835,吉安,三等
2020-08-09,6250,530,444,974,吉安,三等
2020-08-10,6250,508,457,965,吉安,三等
2020-08-11,6250,506,423,929,吉安,三等
2020-08-12,6250,447,432,879,吉安,三等
2020-08-13,6250,470,473,943,吉安,三等
2020-08-14,6250,486,638,1124,吉安,三等
2020-08-15,6250,468,447,915,吉安,三等
2020-08-16,6250,512,538,1050,吉安,三等
2020-08-17,6250,492,495,987,吉安,三等
2020-08-18,6250,401,446,847,吉安,三等
2020-08-19,6250,468,470,938,吉安,三等
2020-08-20,6250,493,501,994,吉安,三等
2020-08-21,6250,562,635,1197,吉安,三等
2020-08-22,6250,407,469,876,吉安,三等
2020-08-23,6250,520,470,990,吉安,三等
2020-08-24,6250,507,459,966,吉安,三等
2020-08-25,6250,422,464,886,吉安,三等
2020-08-26,6250,406,407,813,吉安,三等
2020-08-27,6250,405,380,785,吉安,三等
2020-08-28,6250,453,483,936,吉安,三等
2020-08-29,6250,452,428,880,吉安,三等
2020-08-30,6250,483,391,874,吉安,三等
2020-08-31,6250,480,425,905,吉安,三等
2020-09-01,6250,383,428,811,吉安,三等
2020-09-02,6250,427,385,812,吉安,三等
2020-09-03,6250,428,368,796,吉安,三等
2020-09-04,6250,501,546,1047,吉安,三等
2020-09-05,6250,376,339,715,吉安,三等
2020-09-06,6250,428,441,869,吉安,三等
2020-09-07,6250,435,415,850,吉安,三等
2020-09-08,6250,429,366,795,吉安,三等
2020-09-09,6250,430,355,785,吉安,三等
2020-09-10,6250,391,470,861,吉安,三等
2020-09-11,6250,550,552,1102,吉安,三等
2020-09-12,6250,555,386,941,吉安,三等
2020-09-13,6250,452,439,891,吉安,三等
2020-09-14,6250,406,387,793,吉安,三等
2020-09-15,6250,390,357,747,吉安,三等
2020-09-16,6250,390,371,761,吉安,三等
2020-09-17,6250,360,337,697,吉安,三等
2020-09-18,6250,491,521,1012,吉安,三等
2020-09-19,6250,377,362,739,吉安,三等
2020-09-20,6250,422,485,907,吉安,三等
2020-09-21,6250,457,393,850,吉安,三等
2020-09-22,6250,424,403,827,吉安,三等
2020-09-23,6250,385,349,734,吉安,三等
2020-09-24,6250,407,376,783,吉安,三等
2020-09-25,6250,427,445,872,吉安,三等
2020-09-26,6250,388,308,696,吉安,三等
2020-09-27,6250,405,442,847,吉安,三等
2020-09-28,6250,403,401,804,吉安,三等
2020-09-29,6250,420,482,902,吉安,三等
2020-09-30,6250,530,792,1322,吉安,三等
2020-10-01,6250,523,648,1171,吉安,三等
2020-10-02,6250,547,550,1097,吉安,三等
2020-10-03,6250,498,457,955,吉安,三等
2020-10-04,6250,611,469,1080,吉安,三等
2020-10-05,6250,634,462,1096,吉安,三等
2020-10-06,6250,348,368,716,吉安,三等
2020-10-07,6250,378,381,759,吉安,三等
2020-10-08,6250,567,612,1179,吉安,三等
2020-10-09,6250,519,570,1089,吉安,三等
2020-10-10,6250,422,379,801,吉安,三等
2020-10-11,6250,540,512,1052,吉安,三等
2020-10-12,6250,490,397,887,吉安,三等
2020-10-13,6250,379,408,787,吉安,三等
2020-10-14,6250,431,366,797,吉安,三等
2020-10-15,6250,443,401,844,吉安,三等
2020-10-16,6250,489,478,967,吉安,三等
2020-10-17,6250,372,437,809,吉安,三等
2020-10-18,6250,498,421,919,吉安,三等
2020-10-19,6250,425,421,846,吉安,三等
2020-10-20,6250,420,427,847,吉安,三等
2020-10-21,6250,399,383,782,吉安,三等
2020-10-22,6250,457,387,844,吉安,三等
2020-10-23,6250,570,473,1043,吉安,三等
2020-10-24,6250,404,369,773,吉安,三等
2020-10-25,6250,431,444,875,吉安,三等
2020-10-26,6250,477,402,879,吉安,三等
2020-10-27,6250,416,360,776,吉安,三等
2020-10-28,6250,410,358,768,吉安,三等
2020-10-29,6250,374,349,723,吉安,三等
2020-10-30,6250,462,507,969,吉安,三等
2020-10-31,6250,431,405,836,吉安,三等
2020-11-01,6250,465,483,948,吉安,三等
2020-11-02,6250,474,435,909,吉安,三等
2020-11-03,6250,351,357,708,吉安,三等
2020-11-04,6250,370,365,735,吉安,三等
2020-11-05,6250,387,450,837,吉安,三等
2020-11-06,6250,510,564,1074,吉安,三等
2020-11-07,6250,396,411,807,吉安,三等
2020-11-08,6250,468,433,901,吉安,三等
2020-11-09,6250,435,386,821,吉安,三等
2020-11-10,6250,376,367,743,吉安,三等
2020-11-11,6250,408,356,764,吉安,三等
2020-11-12,6250,363,361,724,吉安,三等
2020-11-13,6250,466,574,1040,吉安,三等
2020-11-14,6250,338,406,744,吉安,三等
2020-11-15,6250,476,446,922,吉安,三等
2020-11-16,6250,468,468,936,吉安,三等
2020-11-17,6250,387,383,770,吉安,三等
2020-11-18,6250,409,364,773,吉安,三等
2020-11-19,6250,416,406,822,吉安,三等
2020-11-20,6250,518,608,1126,吉安,三等
2020-11-21,6250,377,387,764,吉安,三等
2020-11-22,6250,510,443,953,吉安,三等
2020-11-23,6250,476,407,883,吉安,三等
2020-11-24,6250,380,375,755,吉安,三等
2020-11-25,6250,393,382,775,吉安,三等
2020-11-26,6250,406,402,808,吉安,三等
2020-11-27,6250,541,519,1060,吉安,三等
2020-11-28,6250,405,345,750,吉安,三等
2020-11-29,6250,460,461,921,吉安,三等
2020-11-30,6250,406,420,826,吉安,三等
2020-12-01,6250,379,354,733,吉安,三等
2020-12-02,6250,373,365,738,吉安,三等
2020-12-03,6250,364,355,719,吉安,三等
2020-12-04,6250,493,515,1008,吉安,三等
2020-12-05,6250,387,372,759,吉安,三等
2020-12-06,6250,448,508,956,吉安,三等
2020-12-07,6250,421,423,844,吉安,三等
2020-12-08,6250,358,374,732,吉安,三等
2020-12-09,6250,415,381,796,吉安,三等
2020-12-10,6250,420,360,780,吉安,三等
2020-12-11,6250,568,523,1091,吉安,三等
2020-12-12,6250,484,430,914,吉安,三等
2020-12-13,6250,507,443,950,吉安,三等
2020-12-14,6250,436,381,817,吉安,三等
2020-12-15,6250,391,400,791,吉安,三等
2020-12-16,6250,414,379,793,吉安,三等
2020-12-17,6250,402,387,789,吉安,三等
2020-12-18,6250,644,607,1251,吉安,三等
2020-12-19,6250,424,398,822,吉安,三等
2020-12-20,6250,439,389,828,吉安,三等
2020-12-21,6250,435,405,840,吉安,三等
2020-12-22,6250,410,404,814,吉安,三等
2020-12-23,6250,360,367,727,吉安,三等
2020-12-24,6250,403,417,820,吉安,三等
2020-12-25,6250,523,531,1054,吉安,三等
2020-12-26,6250,364,361,725,吉安,三等
2020-12-27,6250,528,471,999,吉安,三等
2020-12-28,6250,488,391,879,吉安,三等
2020-12-29,6250,431,424,855,吉安,三等
2020-12-30,6250,396,438,834,吉安,三等
2020-12-31,6250,512,606,1118,吉安,三等
2020-01-01,7000,13822,11744,25566,花蓮,特等
2020-01-02,7000,11493,11197,22690,花蓮,特等
2020-01-03,7000,14033,12972,27005,花蓮,特等
2020-01-04,7000,13285,12290,25575,花蓮,特等
2020-01-05,7000,14793,13985,28778,花蓮,特等
2020-01-06,7000,10558,10844,21402,花蓮,特等
2020-01-07,7000,9676,9633,19309,花蓮,特等
2020-01-08,7000,10351,9620,19971,花蓮,特等
2020-01-09,7000,12274,11380,23654,花蓮,特等
2020-01-10,7000,19860,19404,39264,花蓮,特等
2020-01-11,7000,16807,17394,34201,花蓮,特等
2020-01-12,7000,20139,16931,37070,花蓮,特等
2020-01-13,7000,12298,12906,25204,花蓮,特等
2020-01-14,7000,11201,11069,22270,花蓮,特等
2020-01-15,7000,11312,10189,21501,花蓮,特等
2020-01-16,7000,12330,10660,22990,花蓮,特等
2020-01-17,7000,13592,14094,27686,花蓮,特等
2020-01-18,7000,13199,14725,27924,花蓮,特等
2020-01-19,7000,16648,14711,31359,花蓮,特等
2020-01-20,7000,12538,12644,25182,花蓮,特等
2020-01-21,7000,11945,13512,25457,花蓮,特等
2020-01-22,7000,15395,19534,34929,花蓮,特等
2020-01-23,7000,15022,23213,38235,花蓮,特等
2020-01-24,7000,12171,19249,31420,花蓮,特等
2020-01-25,7000,17777,23863,41640,花蓮,特等
2020-01-26,7000,23656,24934,48590,花蓮,特等
2020-01-27,7000,26027,21876,47903,花蓮,特等
2020-01-28,7000,27350,17810,45160,花蓮,特等
2020-01-29,7000,27045,17978,45023,花蓮,特等
2020-01-30,7000,17014,14236,31250,花蓮,特等
2020-01-31,7000,14764,13009,27773,花蓮,特等
2020-02-01,7000,14129,12357,26486,花蓮,特等
2020-02-02,7000,15996,13441,29437,花蓮,特等
2020-02-03,7000,10792,10713,21505,花蓮,特等
2020-02-04,7000,9342,9242,18584,花蓮,特等
2020-02-05,7000,9784,9516,19300,花蓮,特等
2020-02-06,7000,10618,10238,20856,花蓮,特等
2020-02-07,7000,13150,12735,25885,花蓮,特等
2020-02-08,7000,10798,10739,21537,花蓮,特等
2020-02-09,7000,14181,12180,26361,花蓮,特等
2020-02-10,7000,9526,10917,20443,花蓮,特等
2020-02-11,7000,8281,8826,17107,花蓮,特等
2020-02-12,7000,8656,8651,17307,花蓮,特等
2020-02-13,7000,9101,9018,18119,花蓮,特等
2020-02-14,7000,10749,10553,21302,花蓮,特等
2020-02-15,7000,10090,10611,20701,花蓮,特等
2020-02-16,7000,11853,11256,23109,花蓮,特等
2020-02-17,7000,8419,9010,17429,花蓮,特等
2020-02-18,7000,7650,7980,15630,花蓮,特等
2020-02-19,7000,7912,8237,16149,花蓮,特等
2020-02-20,7000,8514,8305,16819,花蓮,特等
2020-02-21,7000,11236,11660,22896,花蓮,特等
2020-02-22,7000,9041,9992,19033,花蓮,特等
2020-02-23,7000,12903,11257,24160,花蓮,特等
2020-02-24,7000,8415,9887,18302,花蓮,特等
2020-02-25,7000,7011,7298,14309,花蓮,特等
2020-02-26,7000,7583,7438,15021,花蓮,特等
2020-02-27,7000,12907,15070,27977,花蓮,特等
2020-02-28,7000,10439,17096,27535,花蓮,特等
2020-02-29,7000,11219,8305,19524,花蓮,特等
2020-03-01,7000,23582,14817,38399,花蓮,特等
2020-03-02,7000,7732,7829,15561,花蓮,特等
2020-03-03,7000,6288,6381,12669,花蓮,特等
2020-03-04,7000,5991,6005,11996,花蓮,特等
2020-03-05,7000,6777,6681,13458,花蓮,特等
2020-03-06,7000,9955,10937,20892,花蓮,特等
2020-03-07,7000,7976,8727,16703,花蓮,特等
2020-03-08,7000,11520,10150,21670,花蓮,特等
2020-03-09,7000,7403,7535,14938,花蓮,特等
2020-03-10,7000,6384,6216,12600,花蓮,特等
2020-03-11,7000,6570,6712,13282,花蓮,特等
2020-03-12,7000,7227,7149,14376,花蓮,特等
2020-03-13,7000,11457,11559,23016,花蓮,特等
2020-03-14,7000,8312,9642,17954,花蓮,特等
2020-03-15,7000,12624,10651,23275,花蓮,特等
2020-03-16,7000,7512,7867,15379,花蓮,特等
2020-03-17,7000,6448,6330,12778,花蓮,特等
2020-03-18,7000,6357,6589,12946,花蓮,特等
2020-03-19,7000,6777,6919,13696,花蓮,特等
2020-03-20,7000,11100,11470,22570,花蓮,特等
2020-03-21,7000,8072,9801,17873,花蓮,特等
2020-03-22,7000,13077,10212,23289,花蓮,特等
2020-03-23,7000,6793,7029,13822,花蓮,特等
2020-03-24,7000,5624,6555,12179,花蓮,特等
2020-03-25,7000,5627,7440,13067,花蓮,特等
2020-03-26,7000,6206,8091,14297,花蓮,特等
2020-03-27,7000,9754,11946,21700,花蓮,特等
2020-03-28,7000,6936,9527,16463,花蓮,特等
2020-03-29,7000,10574,9778,20352,花蓮,特等
2020-03-30,7000,6291,7547,13838,花蓮,特等
2020-03-31,7000,6465,7662,14127,花蓮,特等
2020-04-01,7000,14045,16331,30376,花蓮,特等
2020-04-02,7000,11331,18569,29900,花蓮,特等
2020-04-03,7000,7964,9727,17691,花蓮,特等
2020-04-04,7000,12849,6898,19747,花蓮,特等
2020-04-05,7000,22208,13560,35768,花蓮,特等
2020-04-06,7000,8718,8989,17707,花蓮,特等
2020-04-07,7000,5084,5443,10527,花蓮,特等
2020-04-08,7000,5126,4939,10065,花蓮,特等
2020-04-09,7000,5474,5242,10716,花蓮,特等
2020-04-10,7000,8641,8800,17441,花蓮,特等
2020-04-11,7000,5339,6027,11366,花蓮,特等
2020-04-12,7000,8155,7329,15484,花蓮,特等
2020-04-13,7000,5578,5848,11426,花蓮,特等
2020-04-14,7000,4927,5059,9986,花蓮,特等
2020-04-15,7000,5448,5334,10782,花蓮,特等
2020-04-16,7000,5741,5504,11245,花蓮,特等
2020-04-17,7000,9204,8722,17926,花蓮,特等
2020-04-18,7000,6489,6611,13100,花蓮,特等
2020-04-19,7000,8296,7460,15756,花蓮,特等
2020-04-20,7000,5840,5966,11806,花蓮,特等
2020-04-21,7000,4946,5404,10350,花蓮,特等
2020-04-22,7000,5210,5878,11088,花蓮,特等
2020-04-23,7000,7135,6112,13247,花蓮,特等
2020-04-24,7000,8388,7943,16331,花蓮,特等
2020-04-25,7000,6050,5872,11922,花蓮,特等
2020-04-26,7000,7271,7275,14546,花蓮,特等
2020-04-27,7000,5364,5620,10984,花蓮,特等
2020-04-28,7000,4804,5000,9804,花蓮,特等
2020-04-29,7000,5123,5100,10223,花蓮,特等
2020-04-30,7000,7607,8272,15879,花蓮,特等
2020-05-01,7000,8221,11944,20165,花蓮,特等
2020-05-02,7000,6801,6422,13223,花蓮,特等
2020-05-03,7000,13159,9268,22427,花蓮,特等
2020-05-04,7000,6453,6228,12681,花蓮,特等
2020-05-05,7000,5293,5459,10752,花蓮,特等
2020-05-06,7000,5583,5476,11059,花蓮,特等
2020-05-07,7000,6630,6270,12900,花蓮,特等
2020-05-08,7000,11233,11963,23196,花蓮,特等
2020-05-09,7000,7542,8215,15757,花蓮,特等
2020-05-10,7000,12540,10948,23488,花蓮,特等
2020-05-11,7000,7892,7911,15803,花蓮,特等
2020-05-12,7000,6041,6232,12273,花蓮,特等
2020-05-13,7000,6023,6297,12320,花蓮,特等
2020-05-14,7000,6519,6590,13109,花蓮,特等
2020-05-15,7000,10034,10824,20858,花蓮,特等
2020-05-16,7000,7016,7697,14713,花蓮,特等
2020-05-17,7000,11022,9584,20606,花蓮,特等
2020-05-18,7000,7557,7119,14676,花蓮,特等
2020-05-19,7000,5960,5806,11766,花蓮,特等
2020-05-20,7000,5965,6235,12200,花蓮,特等
2020-05-21,7000,6607,6526,13133,花蓮,特等
2020-05-22,7000,9506,10340,19846,花蓮,特等
2020-05-23,7000,7485,8616,16101,花蓮,特等
2020-05-24,7000,11326,9612,20938,花蓮,特等
2020-05-25,7000,7470,7516,14986,花蓮,特等
2020-05-26,7000,6596,6918,13514,花蓮,特等
2020-05-27,7000,6593,6591,13184,花蓮,特等
2020-05-28,7000,6947,7078,14025,花蓮,特等
2020-05-29,7000,10909,13091,24000,花蓮,特等
2020-05-30,7000,9547,10259,19806,花蓮,特等
2020-05-31,7000,14279,10963,25242,花蓮,特等
2020-06-01,7000,7627,7378,15005,花蓮,特等
2020-06-02,7000,6489,6897,13386,花蓮,特等
2020-06-03,7000,7076,6942,14018,花蓮,特等
2020-06-04,7000,7521,7406,14927,花蓮,特等
2020-06-05,7000,11856,12258,24114,花蓮,特等
2020-06-06,7000,8783,10160,18943,花蓮,特等
2020-06-07,7000,13514,11485,24999,花蓮,特等
2020-06-08,7000,8530,8390,16920,花蓮,特等
2020-06-09,7000,7613,7430,15043,花蓮,特等
2020-06-10,7000,7465,7775,15240,花蓮,特等
2020-06-11,7000,8421,8351,16772,花蓮,特等
2020-06-12,7000,12307,13684,25991,花蓮,特等
2020-06-13,7000,9896,11761,21657,花蓮,特等
2020-06-14,7000,14888,12651,27539,花蓮,特等
2020-06-15,7000,9685,9382,19067,花蓮,特等
2020-06-16,7000,8326,8079,16405,花蓮,特等
2020-06-17,7000,8286,8310,16596,花蓮,特等
2020-06-18,7000,8479,8590,17069,花蓮,特等
2020-06-19,7000,10545,11303,21848,花蓮,特等
2020-06-20,7000,9807,10489,20296,花蓮,特等
2020-06-21,7000,13111,11936,25047,花蓮,特等
2020-06-22,7000,9810,9959,19769,花蓮,特等
2020-06-23,7000,9511,9880,19391,花蓮,特等
2020-06-24,7000,15778,18523,34301,花蓮,特等
2020-06-25,7000,14043,23375,37418,花蓮,特等
2020-06-26,7000,11879,14214,26093,花蓮,特等
2020-06-27,7000,18363,11905,30268,花蓮,特等
2020-06-28,7000,27353,17430,44783,花蓮,特等
2020-06-29,7000,12213,11047,23260,花蓮,特等
2020-06-30,7000,9355,8563,17918,花蓮,特等
2020-07-01,7000,7933,8480,16413,花蓮,特等
2020-07-02,7000,9276,8786,18062,花蓮,特等
2020-07-03,7000,11763,12427,24190,花蓮,特等
2020-07-04,7000,9730,11105,20835,花蓮,特等
2020-07-05,7000,13566,12147,25713,花蓮,特等
2020-07-06,7000,10079,10585,20664,花蓮,特等
2020-07-07,7000,9000,9412,18412,花蓮,特等
2020-07-08,7000,9787,10071,19858,花蓮,特等
2020-07-09,7000,10209,10128,20337,花蓮,特等
2020-07-10,7000,13451,14824,28275,花蓮,特等
2020-07-11,7000,10954,12685,23639,花蓮,特等
2020-07-12,7000,16948,14242,31190,花蓮,特等
2020-07-13,7000,10984,10456,21440,花蓮,特等
2020-07-14,7000,10991,10155,21146,花蓮,特等
2020-07-15,7000,11196,12448,23644,花蓮,特等
2020-07-16,7000,11202,13003,24205,花蓮,特等
2020-07-17,7000,15019,17161,32180,花蓮,特等
2020-07-18,7000,13353,14494,27847,花蓮,特等
2020-07-19,7000,18938,15179,34117,花蓮,特等
2020-07-20,7000,13296,12751,26047,花蓮,特等
2020-07-21,7000,10806,11225,22031,花蓮,特等
2020-07-22,7000,11699,11463,23162,花蓮,特等
2020-07-23,7000,11888,12573,24461,花蓮,特等
2020-07-24,7000,14843,16822,31665,花蓮,特等
2020-07-25,7000,13075,14049,27124,花蓮,特等
2020-07-26,7000,19204,15279,34483,花蓮,特等
2020-07-27,7000,13170,12611,25781,花蓮,特等
2020-07-28,7000,10903,11098,22001,花蓮,特等
2020-07-29,7000,10939,11079,22018,花蓮,特等
2020-07-30,7000,11836,12417,24253,花蓮,特等
2020-07-31,7000,15012,17100,32112,花蓮,特等
2020-08-01,7000,13992,15325,29317,花蓮,特等
2020-08-02,7000,19904,15223,35127,花蓮,特等
2020-08-03,7000,12325,11845,24170,花蓮,特等
2020-08-04,7000,10503,10752,21255,花蓮,特等
2020-08-05,7000,10331,11022,21353,花蓮,特等
2020-08-06,7000,11960,11842,23802,花蓮,特等
2020-08-07,7000,15176,18605,33781,花蓮,特等
2020-08-08,7000,13008,14673,27681,花蓮,特等
2020-08-09,7000,20783,17738,38521,花蓮,特等
2020-08-10,7000,14204,13806,28010,花蓮,特等
2020-08-11,7000,11941,11718,23659,花蓮,特等
2020-08-12,7000,12379,12755,25134,花蓮,特等
2020-08-13,7000,13066,13786,26852,花蓮,特等
2020-08-14,7000,16780,19337,36117,花蓮,特等
2020-08-15,7000,15028,16105,31133,花蓮,特等
2020-08-16,7000,21218,17745,38963,花蓮,特等
2020-08-17,7000,15584,14966,30550,花蓮,特等
2020-08-18,7000,13768,12358,26126,花蓮,特等
2020-08-19,7000,12166,11516,23682,花蓮,特等
2020-08-20,7000,12438,13633,26071,花蓮,特等
2020-08-21,7000,15438,19728,35166,花蓮,特等
2020-08-22,7000,14677,16613,31290,花蓮,特等
2020-08-23,7000,21635,16774,38409,花蓮,特等
2020-08-24,7000,16789,13077,29866,花蓮,特等
2020-08-25,7000,12556,11847,24403,花蓮,特等
2020-08-26,7000,12399,11678,24077,花蓮,特等
2020-08-27,7000,12254,12311,24565,花蓮,特等
2020-08-28,7000,14226,16378,30604,花蓮,特等
2020-08-29,7000,13258,13955,27213,花蓮,特等
2020-08-30,7000,19114,14200,33314,花蓮,特等
2020-08-31,7000,10565,9749,20314,花蓮,特等
2020-09-01,7000,9241,9444,18685,花蓮,特等
2020-09-02,7000,8481,8822,17303,花蓮,特等
2020-09-03,7000,10277,10481,20758,花蓮,特等
2020-09-04,7000,13188,14844,28032,花蓮,特等
2020-09-05,7000,12737,13504,26241,花蓮,特等
2020-09-06,7000,18383,14607,32990,花蓮,特等
2020-09-07,7000,11597,11467,23064,花蓮,特等
2020-09-08,7000,9796,10312,20108,花蓮,特等
2020-09-09,7000,10257,9375,19632,花蓮,特等
2020-09-10,7000,10618,10568,21186,花蓮,特等
2020-09-11,7000,14810,16126,30936,花蓮,特等
2020-09-12,7000,12293,14937,27230,花蓮,特等
2020-09-13,7000,18243,15642,33885,花蓮,特等
2020-09-14,7000,10494,9437,19931,花蓮,特等
2020-09-15,7000,8674,8214,16888,花蓮,特等
2020-09-16,7000,8344,8762,17106,花蓮,特等
2020-09-17,7000,9150,11316,20466,花蓮,特等
2020-09-18,7000,15096,17990,33086,花蓮,特等
2020-09-19,7000,14173,16657,30830,花蓮,特等
2020-09-20,7000,21953,15736,37689,花蓮,特等
2020-09-21,7000,12998,11411,24409,花蓮,特等
2020-09-22,7000,9701,9606,19307,花蓮,特等
2020-09-23,7000,10970,9713,20683,花蓮,特等
2020-09-24,7000,10165,10076,20241,花蓮,特等
2020-09-25,7000,11845,12477,24322,花蓮,特等
2020-09-26,7000,11125,12592,23717,花蓮,特等
2020-09-27,7000,14421,12399,26820,花蓮,特等
2020-09-28,7000,10105,9653,19758,花蓮,特等
2020-09-29,7000,10001,10067,20068,花蓮,特等
2020-09-30,7000,19549,21245,40794,花蓮,特等
2020-10-01,7000,15640,25262,40902,花蓮,特等
2020-10-02,7000,11713,14982,26695,花蓮,特等
2020-10-03,7000,19865,11648,31513,花蓮,特等
2020-10-04,7000,29687,21591,51278,花蓮,特等
2020-10-05,7000,12814,11546,24360,花蓮,特等
2020-10-06,7000,8459,8657,17116,花蓮,特等
2020-10-07,7000,8849,9060,17909,花蓮,特等
2020-10-08,7000,15539,17910,33449,花蓮,特等
2020-10-09,7000,14201,20939,35140,花蓮,特等
2020-10-10,7000,12829,10856,23685,花蓮,特等
2020-10-11,7000,25525,18803,44328,花蓮,特等
2020-10-12,7000,10635,10498,21133,花蓮,特等
2020-10-13,7000,9344,9273,18617,花蓮,特等
2020-10-14,7000,8903,9122,18025,花蓮,特等
2020-10-15,7000,9963,9964,19927,花蓮,特等
2020-10-16,7000,13704,16050,29754,花蓮,特等
2020-10-17,7000,12310,16190,28500,花蓮,特等
2020-10-18,7000,19388,17173,36561,花蓮,特等
2020-10-19,7000,11985,10676,22661,花蓮,特等
2020-10-20,7000,10611,9747,20358,花蓮,特等
2020-10-21,7000,10390,9492,19882,花蓮,特等
2020-10-22,7000,10409,10072,20481,花蓮,特等
2020-10-23,7000,16159,16965,33124,花蓮,特等
2020-10-24,7000,13058,15075,28133,花蓮,特等
2020-10-25,7000,18835,15626,34461,花蓮,特等
2020-10-26,7000,11371,10394,21765,花蓮,特等
2020-10-27,7000,9674,9490,19164,花蓮,特等
2020-10-28,7000,8335,8746,17081,花蓮,特等
2020-10-29,7000,9160,9618,18778,花蓮,特等
2020-10-30,7000,14149,14374,28523,花蓮,特等
2020-10-31,7000,11857,13475,25332,花蓮,特等
2020-11-01,7000,18022,14967,32989,花蓮,特等
2020-11-02,7000,9617,9009,18626,花蓮,特等
2020-11-03,7000,8213,7940,16153,花蓮,特等
2020-11-04,7000,7967,7685,15652,花蓮,特等
2020-11-05,7000,9004,9007,18011,花蓮,特等
2020-11-06,7000,13296,19332,32628,花蓮,特等
2020-11-07,7000,19071,15838,34909,花蓮,特等
2020-11-08,7000,19892,14215,34107,花蓮,特等
2020-11-09,7000,10303,9430,19733,花蓮,特等
2020-11-10,7000,8269,8246,16515,花蓮,特等
2020-11-11,7000,7877,8690,16567,花蓮,特等
2020-11-12,7000,9488,9859,19347,花蓮,特等
2020-11-13,7000,15746,16811,32557,花蓮,特等
2020-11-14,7000,12439,14553,26992,花蓮,特等
2020-11-15,7000,19273,16346,35619,花蓮,特等
2020-11-16,7000,11448,10715,22163,花蓮,特等
2020-11-17,7000,8639,9278,17917,花蓮,特等
2020-11-18,7000,9331,9434,18765,花蓮,特等
2020-11-19,7000,10158,9974,20132,花蓮,特等
2020-11-20,7000,14887,16242,31129,花蓮,特等
2020-11-21,7000,12320,14251,26571,花蓮,特等
2020-11-22,7000,18628,15403,34031,花蓮,特等
2020-11-23,7000,11101,10718,21819,花蓮,特等
2020-11-24,7000,9122,9156,18278,花蓮,特等
2020-11-25,7000,9201,8653,17854,花蓮,特等
2020-11-26,7000,9590,10323,19913,花蓮,特等
2020-11-27,7000,14620,16225,30845,花蓮,特等
2020-11-28,7000,11482,13512,24994,花蓮,特等
2020-11-29,7000,19235,15067,34302,花蓮,特等
2020-11-30,7000,10445,9658,20103,花蓮,特等
2020-12-01,7000,8031,7900,15931,花蓮,特等
2020-12-02,7000,7725,7769,15494,花蓮,特等
2020-12-03,7000,9030,8549,17579,花蓮,特等
2020-12-04,7000,17185,16863,34048,花蓮,特等
2020-12-05,7000,14115,14671,28786,花蓮,特等
2020-12-06,7000,18870,17926,36796,花蓮,特等
2020-12-07,7000,10495,10063,20558,花蓮,特等
2020-12-08,7000,8332,7857,16189,花蓮,特等
2020-12-09,7000,7656,8258,15914,花蓮,特等
2020-12-10,7000,9013,8408,17421,花蓮,特等
2020-12-11,7000,15727,14988,30715,花蓮,特等
2020-12-12,7000,12825,13821,26646,花蓮,特等
2020-12-13,7000,17987,17030,35017,花蓮,特等
2020-12-14,7000,9992,9790,19782,花蓮,特等
2020-12-15,7000,8634,8315,16949,花蓮,特等
2020-12-16,7000,8107,8735,16842,花蓮,特等
2020-12-17,7000,9272,9426,18698,花蓮,特等
2020-12-18,7000,15741,15692,31433,花蓮,特等
2020-12-19,7000,12283,13690,25973,花蓮,特等
2020-12-20,7000,16574,14961,31535,花蓮,特等
2020-12-21,7000,10306,9733,20039,花蓮,特等
2020-12-22,7000,8002,7852,15854,花蓮,特等
2020-12-23,7000,8202,8318,16520,花蓮,特等
2020-12-24,7000,8574,8752,17326,花蓮,特等
2020-12-25,7000,12857,12924,25781,花蓮,特等
2020-12-26,7000,10992,11690,22682,花蓮,特等
2020-12-27,7000,15255,14743,29998,花蓮,特等
2020-12-28,7000,9492,9494,18986,花蓮,特等
2020-12-29,7000,8425,8285,16710,花蓮,特等
2020-12-30,7000,9365,11127,20492,花蓮,特等
2020-12-31,7000,18276,21959,40235,花蓮,特等
2020-01-01,7010,166,134,300,北埔,三等
2020-01-02,7010,152,192,344,北埔,三等
2020-01-03,7010,177,165,342,北埔,三等
2020-01-04,7010,120,173,293,北埔,三等
2020-01-05,7010,125,148,273,北埔,三等
2020-01-06,7010,158,141,299,北埔,三等
2020-01-07,7010,164,171,335,北埔,三等
2020-01-08,7010,180,206,386,北埔,三等
2020-01-09,7010,208,200,408,北埔,三等
2020-01-10,7010,212,190,402,北埔,三等
2020-01-11,7010,136,192,328,北埔,三等
2020-01-12,7010,104,115,219,北埔,三等
2020-01-13,7010,164,173,337,北埔,三等
2020-01-14,7010,164,158,322,北埔,三等
2020-01-15,7010,177,178,355,北埔,三等
2020-01-16,7010,154,214,368,北埔,三等
2020-01-17,7010,166,179,345,北埔,三等
2020-01-18,7010,142,126,268,北埔,三等
2020-01-19,7010,108,129,237,北埔,三等
2020-01-20,7010,141,146,287,北埔,三等
2020-01-21,7010,120,120,240,北埔,三等
2020-01-22,7010,159,117,276,北埔,三等
2020-01-23,7010,153,131,284,北埔,三等
2020-01-24,7010,101,94,195,北埔,三等
2020-01-25,7010,112,111,223,北埔,三等
2020-01-26,7010,145,133,278,北埔,三等
2020-01-27,7010,104,151,255,北埔,三等
2020-01-28,7010,148,98,246,北埔,三等
2020-01-29,7010,143,116,259,北埔,三等
2020-01-30,7010,126,136,262,北埔,三等
2020-01-31,7010,133,102,235,北埔,三等
2020-02-01,7010,81,93,174,北埔,三等
2020-02-02,7010,60,63,123,北埔,三等
2020-02-03,7010,113,111,224,北埔,三等
2020-02-04,7010,103,104,207,北埔,三等
2020-02-05,7010,108,109,217,北埔,三等
2020-02-06,7010,133,118,251,北埔,三等
2020-02-07,7010,138,136,274,北埔,三等
2020-02-08,7010,97,98,195,北埔,三等
2020-02-09,7010,64,78,142,北埔,三等
2020-02-10,7010,118,129,247,北埔,三等
2020-02-11,7010,108,100,208,北埔,三等
2020-02-12,7010,132,120,252,北埔,三等
2020-02-13,7010,116,106,222,北埔,三等
2020-02-14,7010,130,120,250,北埔,三等
2020-02-15,7010,89,79,168,北埔,三等
2020-02-16,7010,88,87,175,北埔,三等
2020-02-17,7010,105,102,207,北埔,三等
2020-02-18,7010,144,126,270,北埔,三等
2020-02-19,7010,125,130,255,北埔,三等
2020-02-20,7010,111,109,220,北埔,三等
2020-02-21,7010,164,143,307,北埔,三等
2020-02-22,7010,71,63,134,北埔,三等
2020-02-23,7010,59,65,124,北埔,三等
2020-02-24,7010,120,112,232,北埔,三等
2020-02-25,7010,152,135,287,北埔,三等
2020-02-26,7010,119,133,252,北埔,三等
2020-02-27,7010,147,157,304,北埔,三等
2020-02-28,7010,128,147,275,北埔,三等
2020-02-29,7010,83,78,161,北埔,三等
2020-03-01,7010,94,104,198,北埔,三等
2020-03-02,7010,140,136,276,北埔,三等
2020-03-03,7010,141,155,296,北埔,三等
2020-03-04,7010,147,142,289,北埔,三等
2020-03-05,7010,140,138,278,北埔,三等
2020-03-06,7010,170,175,345,北埔,三等
2020-03-07,7010,117,127,244,北埔,三等
2020-03-08,7010,50,86,136,北埔,三等
2020-03-09,7010,141,127,268,北埔,三等
2020-03-10,7010,135,124,259,北埔,三等
2020-03-11,7010,150,146,296,北埔,三等
2020-03-12,7010,139,142,281,北埔,三等
2020-03-13,7010,159,148,307,北埔,三等
2020-03-14,7010,78,97,175,北埔,三等
2020-03-15,7010,90,90,180,北埔,三等
2020-03-16,7010,148,141,289,北埔,三等
2020-03-17,7010,136,138,274,北埔,三等
2020-03-18,7010,118,126,244,北埔,三等
2020-03-19,7010,130,128,258,北埔,三等
2020-03-20,7010,159,156,315,北埔,三等
2020-03-21,7010,81,97,178,北埔,三等
2020-03-22,7010,53,72,125,北埔,三等
2020-03-23,7010,134,123,257,北埔,三等
2020-03-24,7010,156,176,332,北埔,三等
2020-03-25,7010,146,125,271,北埔,三等
2020-03-26,7010,129,133,262,北埔,三等
2020-03-27,7010,139,148,287,北埔,三等
2020-03-28,7010,87,99,186,北埔,三等
2020-03-29,7010,89,85,174,北埔,三等
2020-03-30,7010,132,116,248,北埔,三等
2020-03-31,7010,124,123,247,北埔,三等
2020-04-01,7010,152,146,298,北埔,三等
2020-04-02,7010,88,139,227,北埔,三等
2020-04-03,7010,98,91,189,北埔,三等
2020-04-04,7010,72,56,128,北埔,三等
2020-04-05,7010,84,65,149,北埔,三等
2020-04-06,7010,133,119,252,北埔,三等
2020-04-07,7010,137,130,267,北埔,三等
2020-04-08,7010,125,127,252,北埔,三等
2020-04-09,7010,132,130,262,北埔,三等
2020-04-10,7010,152,160,312,北埔,三等
2020-04-11,7010,72,109,181,北埔,三等
2020-04-12,7010,54,53,107,北埔,三等
2020-04-13,7010,133,139,272,北埔,三等
2020-04-14,7010,126,124,250,北埔,三等
2020-04-15,7010,128,133,261,北埔,三等
2020-04-16,7010,133,124,257,北埔,三等
2020-04-17,7010,150,141,291,北埔,三等
2020-04-18,7010,78,88,166,北埔,三等
2020-04-19,7010,68,77,145,北埔,三等
2020-04-20,7010,133,123,256,北埔,三等
2020-04-21,7010,136,127,263,北埔,三等
2020-04-22,7010,127,141,268,北埔,三等
2020-04-23,7010,134,127,261,北埔,三等
2020-04-24,7010,129,143,272,北埔,三等
2020-04-25,7010,83,92,175,北埔,三等
2020-04-26,7010,68,82,150,北埔,三等
2020-04-27,7010,148,126,274,北埔,三等
2020-04-28,7010,142,135,277,北埔,三等
2020-04-29,7010,124,124,248,北埔,三等
2020-04-30,7010,133,141,274,北埔,三等
2020-05-01,7010,138,142,280,北埔,三等
2020-05-02,7010,68,93,161,北埔,三等
2020-05-03,7010,72,69,141,北埔,三等
2020-05-04,7010,129,130,259,北埔,三等
2020-05-05,7010,123,119,242,北埔,三等
2020-05-06,7010,136,148,284,北埔,三等
2020-05-07,7010,124,136,260,北埔,三等
2020-05-08,7010,125,136,261,北埔,三等
2020-05-09,7010,86,104,190,北埔,三等
2020-05-10,7010,80,81,161,北埔,三等
2020-05-11,7010,123,121,244,北埔,三等
2020-05-12,7010,132,121,253,北埔,三等
2020-05-13,7010,130,119,249,北埔,三等
2020-05-14,7010,131,128,259,北埔,三等
2020-05-15,7010,141,151,292,北埔,三等
2020-05-16,7010,62,73,135,北埔,三等
2020-05-17,7010,60,67,127,北埔,三等
2020-05-18,7010,129,109,238,北埔,三等
2020-05-19,7010,115,115,230,北埔,三等
2020-05-20,7010,120,114,234,北埔,三等
2020-05-21,7010,126,123,249,北埔,三等
2020-05-22,7010,128,138,266,北埔,三等
2020-05-23,7010,129,184,313,北埔,三等
2020-05-24,7010,69,77,146,北埔,三等
2020-05-25,7010,115,117,232,北埔,三等
2020-05-26,7010,132,129,261,北埔,三等
2020-05-27,7010,118,148,266,北埔,三等
2020-05-28,7010,111,127,238,北埔,三等
2020-05-29,7010,137,127,264,北埔,三等
2020-05-30,7010,80,92,172,北埔,三等
2020-05-31,7010,53,83,136,北埔,三等
2020-06-01,7010,117,121,238,北埔,三等
2020-06-02,7010,131,120,251,北埔,三等
2020-06-03,7010,123,127,250,北埔,三等
2020-06-04,7010,129,131,260,北埔,三等
2020-06-05,7010,125,130,255,北埔,三等
2020-06-06,7010,60,89,149,北埔,三等
2020-06-07,7010,66,88,154,北埔,三等
2020-06-08,7010,131,109,240,北埔,三等
2020-06-09,7010,121,133,254,北埔,三等
2020-06-10,7010,126,121,247,北埔,三等
2020-06-11,7010,104,109,213,北埔,三等
2020-06-12,7010,117,124,241,北埔,三等
2020-06-13,7010,76,110,186,北埔,三等
2020-06-14,7010,75,79,154,北埔,三等
2020-06-15,7010,120,128,248,北埔,三等
2020-06-16,7010,118,137,255,北埔,三等
2020-06-17,7010,111,123,234,北埔,三等
2020-06-18,7010,124,117,241,北埔,三等
2020-06-19,7010,112,131,243,北埔,三等
2020-06-20,7010,83,81,164,北埔,三等
2020-06-21,7010,66,72,138,北埔,三等
2020-06-22,7010,115,103,218,北埔,三等
2020-06-23,7010,115,122,237,北埔,三等
2020-06-24,7010,155,150,305,北埔,三等
2020-06-25,7010,114,145,259,北埔,三等
2020-06-26,7010,120,98,218,北埔,三等
2020-06-27,7010,77,87,164,北埔,三等
2020-06-28,7010,81,85,166,北埔,三等
2020-06-29,7010,119,121,240,北埔,三等
2020-06-30,7010,124,169,293,北埔,三等
2020-07-01,7010,128,125,253,北埔,三等
2020-07-02,7010,140,117,257,北埔,三等
2020-07-03,7010,143,150,293,北埔,三等
2020-07-04,7010,102,118,220,北埔,三等
2020-07-05,7010,65,71,136,北埔,三等
2020-07-06,7010,120,107,227,北埔,三等
2020-07-07,7010,123,113,236,北埔,三等
2020-07-08,7010,109,120,229,北埔,三等
2020-07-09,7010,108,117,225,北埔,三等
2020-07-10,7010,121,113,234,北埔,三等
2020-07-11,7010,81,72,153,北埔,三等
2020-07-12,7010,68,79,147,北埔,三等
2020-07-13,7010,99,115,214,北埔,三等
2020-07-14,7010,122,112,234,北埔,三等
2020-07-15,7010,113,121,234,北埔,三等
2020-07-16,7010,114,96,210,北埔,三等
2020-07-17,7010,140,136,276,北埔,三等
2020-07-18,7010,117,96,213,北埔,三等
2020-07-19,7010,62,80,142,北埔,三等
2020-07-20,7010,115,125,240,北埔,三等
2020-07-21,7010,99,102,201,北埔,三等
2020-07-22,7010,105,114,219,北埔,三等
2020-07-23,7010,105,107,212,北埔,三等
2020-07-24,7010,124,101,225,北埔,三等
2020-07-25,7010,88,83,171,北埔,三等
2020-07-26,7010,73,72,145,北埔,三等
2020-07-27,7010,89,109,198,北埔,三等
2020-07-28,7010,121,102,223,北埔,三等
2020-07-29,7010,96,76,172,北埔,三等
2020-07-30,7010,115,108,223,北埔,三等
2020-07-31,7010,120,130,250,北埔,三等
2020-08-01,7010,110,81,191,北埔,三等
2020-08-02,7010,67,97,164,北埔,三等
2020-08-03,7010,90,106,196,北埔,三等
2020-08-04,7010,101,89,190,北埔,三等
2020-08-05,7010,122,100,222,北埔,三等
2020-08-06,7010,124,105,229,北埔,三等
2020-08-07,7010,123,139,262,北埔,三等
2020-08-08,7010,90,103,193,北埔,三等
2020-08-09,7010,58,82,140,北埔,三等
2020-08-10,7010,129,137,266,北埔,三等
2020-08-11,7010,107,106,213,北埔,三等
2020-08-12,7010,100,85,185,北埔,三等
2020-08-13,7010,121,119,240,北埔,三等
2020-08-14,7010,155,115,270,北埔,三等
2020-08-15,7010,92,88,180,北埔,三等
2020-08-16,7010,97,102,199,北埔,三等
2020-08-17,7010,118,109,227,北埔,三等
2020-08-18,7010,89,90,179,北埔,三等
2020-08-19,7010,121,104,225,北埔,三等
2020-08-20,7010,122,113,235,北埔,三等
2020-08-21,7010,132,121,253,北埔,三等
2020-08-22,7010,83,73,156,北埔,三等
2020-08-23,7010,73,84,157,北埔,三等
2020-08-24,7010,95,102,197,北埔,三等
2020-08-25,7010,98,92,190,北埔,三等
2020-08-26,7010,113,80,193,北埔,三等
2020-08-27,7010,110,110,220,北埔,三等
2020-08-28,7010,102,89,191,北埔,三等
2020-08-29,7010,101,65,166,北埔,三等
2020-08-30,7010,61,87,148,北埔,三等
2020-08-31,7010,142,116,258,北埔,三等
2020-09-01,7010,131,136,267,北埔,三等
2020-09-02,7010,126,124,250,北埔,三等
2020-09-03,7010,129,138,267,北埔,三等
2020-09-04,7010,123,144,267,北埔,三等
2020-09-05,7010,60,75,135,北埔,三等
2020-09-06,7010,66,66,132,北埔,三等
2020-09-07,7010,142,130,272,北埔,三等
2020-09-08,7010,126,139,265,北埔,三等
2020-09-09,7010,144,136,280,北埔,三等
2020-09-10,7010,120,145,265,北埔,三等
2020-09-11,7010,149,141,290,北埔,三等
2020-09-12,7010,73,97,170,北埔,三等
2020-09-13,7010,70,102,172,北埔,三等
2020-09-14,7010,125,120,245,北埔,三等
2020-09-15,7010,125,130,255,北埔,三等
2020-09-16,7010,140,140,280,北埔,三等
2020-09-17,7010,125,136,261,北埔,三等
2020-09-18,7010,168,170,338,北埔,三等
2020-09-19,7010,122,139,261,北埔,三等
2020-09-20,7010,93,90,183,北埔,三等
2020-09-21,7010,138,141,279,北埔,三等
2020-09-22,7010,124,147,271,北埔,三等
2020-09-23,7010,121,145,266,北埔,三等
2020-09-24,7010,140,145,285,北埔,三等
2020-09-25,7010,116,140,256,北埔,三等
2020-09-26,7010,111,110,221,北埔,三等
2020-09-27,7010,79,77,156,北埔,三等
2020-09-28,7010,126,166,292,北埔,三等
2020-09-29,7010,135,133,268,北埔,三等
2020-09-30,7010,162,169,331,北埔,三等
2020-10-01,7010,121,136,257,北埔,三等
2020-10-02,7010,138,129,267,北埔,三等
2020-10-03,7010,93,76,169,北埔,三等
2020-10-04,7010,102,97,199,北埔,三等
2020-10-05,7010,131,135,266,北埔,三等
2020-10-06,7010,130,120,250,北埔,三等
2020-10-07,7010,132,157,289,北埔,三等
2020-10-08,7010,159,173,332,北埔,三等
2020-10-09,7010,139,109,248,北埔,三等
2020-10-10,7010,77,75,152,北埔,三等
2020-10-11,7010,72,88,160,北埔,三等
2020-10-12,7010,132,152,284,北埔,三等
2020-10-13,7010,140,147,287,北埔,三等
2020-10-14,7010,144,153,297,北埔,三等
2020-10-15,7010,152,154,306,北埔,三等
2020-10-16,7010,126,229,355,北埔,三等
2020-10-17,7010,69,70,139,北埔,三等
2020-10-18,7010,74,72,146,北埔,三等
2020-10-19,7010,126,165,291,北埔,三等
2020-10-20,7010,130,146,276,北埔,三等
2020-10-21,7010,128,132,260,北埔,三等
2020-10-22,7010,138,142,280,北埔,三等
2020-10-23,7010,143,172,315,北埔,三等
2020-10-24,7010,118,113,231,北埔,三等
2020-10-25,7010,83,78,161,北埔,三等
2020-10-26,7010,133,143,276,北埔,三等
2020-10-27,7010,116,139,255,北埔,三等
2020-10-28,7010,100,139,239,北埔,三等
2020-10-29,7010,109,115,224,北埔,三等
2020-10-30,7010,132,122,254,北埔,三等
2020-10-31,7010,109,113,222,北埔,三等
2020-11-01,7010,84,80,164,北埔,三等
2020-11-02,7010,119,129,248,北埔,三等
2020-11-03,7010,109,132,241,北埔,三等
2020-11-04,7010,111,135,246,北埔,三等
2020-11-05,7010,120,123,243,北埔,三等
2020-11-06,7010,130,153,283,北埔,三等
2020-11-07,7010,124,108,232,北埔,三等
2020-11-08,7010,92,79,171,北埔,三等
2020-11-09,7010,124,122,246,北埔,三等
2020-11-10,7010,120,134,254,北埔,三等
2020-11-11,7010,116,113,229,北埔,三等
2020-11-12,7010,118,131,249,北埔,三等
2020-11-13,7010,115,133,248,北埔,三等
2020-11-14,7010,76,101,177,北埔,三等
2020-11-15,7010,80,90,170,北埔,三等
2020-11-16,7010,137,153,290,北埔,三等
2020-11-17,7010,122,141,263,北埔,三等
2020-11-18,7010,138,134,272,北埔,三等
2020-11-19,7010,119,136,255,北埔,三等
2020-11-20,7010,145,144,289,北埔,三等
2020-11-21,7010,63,71,134,北埔,三等
2020-11-22,7010,72,72,144,北埔,三等
2020-11-23,7010,108,132,240,北埔,三等
2020-11-24,7010,164,178,342,北埔,三等
2020-11-25,7010,122,120,242,北埔,三等
2020-11-26,7010,126,136,262,北埔,三等
2020-11-27,7010,126,138,264,北埔,三等
2020-11-28,7010,81,76,157,北埔,三等
2020-11-29,7010,96,98,194,北埔,三等
2020-11-30,7010,129,146,275,北埔,三等
2020-12-01,7010,94,138,232,北埔,三等
2020-12-02,7010,118,114,232,北埔,三等
2020-12-03,7010,118,129,247,北埔,三等
2020-12-04,7010,124,138,262,北埔,三等
2020-12-05,7010,75,92,167,北埔,三等
2020-12-06,7010,68,91,159,北埔,三等
2020-12-07,7010,104,119,223,北埔,三等
2020-12-08,7010,93,124,217,北埔,三等
2020-12-09,7010,112,115,227,北埔,三等
2020-12-10,7010,108,154,262,北埔,三等
2020-12-11,7010,145,124,269,北埔,三等
2020-12-12,7010,116,91,207,北埔,三等
2020-12-13,7010,94,125,219,北埔,三等
2020-12-14,7010,125,121,246,北埔,三等
2020-12-15,7010,104,133,237,北埔,三等
2020-12-16,7010,111,124,235,北埔,三等
2020-12-17,7010,117,129,246,北埔,三等
2020-12-18,7010,144,138,282,北埔,三等
2020-12-19,7010,91,89,180,北埔,三等
2020-12-20,7010,67,90,157,北埔,三等
2020-12-21,7010,116,122,238,北埔,三等
2020-12-22,7010,127,118,245,北埔,三等
2020-12-23,7010,118,122,240,北埔,三等
2020-12-24,7010,130,128,258,北埔,三等
2020-12-25,7010,124,142,266,北埔,三等
2020-12-26,7010,109,77,186,北埔,三等
2020-12-27,7010,55,102,157,北埔,三等
2020-12-28,7010,111,147,258,北埔,三等
2020-12-29,7010,134,144,278,北埔,三等
2020-12-30,7010,137,117,254,北埔,三等
2020-12-31,7010,123,126,249,北埔,三等
2020-01-01,7020,5,22,27,景美,乙簡
2020-01-02,7020,13,20,33,景美,乙簡
2020-01-03,7020,22,33,55,景美,乙簡
2020-01-04,7020,14,29,43,景美,乙簡
2020-01-05,7020,4,21,25,景美,乙簡
2020-01-06,7020,24,25,49,景美,乙簡
2020-01-07,7020,26,31,57,景美,乙簡
2020-01-08,7020,40,50,90,景美,乙簡
2020-01-09,7020,26,33,59,景美,乙簡
2020-01-10,7020,16,40,56,景美,乙簡
2020-01-11,7020,5,26,31,景美,乙簡
2020-01-12,7020,11,8,19,景美,乙簡
2020-01-13,7020,38,27,65,景美,乙簡
2020-01-14,7020,9,40,49,景美,乙簡
2020-01-15,7020,14,35,49,景美,乙簡
2020-01-16,7020,40,41,81,景美,乙簡
2020-01-17,7020,10,26,36,景美,乙簡
2020-01-18,7020,5,18,23,景美,乙簡
2020-01-19,7020,9,14,23,景美,乙簡
2020-01-20,7020,15,17,32,景美,乙簡
2020-01-21,7020,12,12,24,景美,乙簡
2020-01-22,7020,6,19,25,景美,乙簡
2020-01-23,7020,3,64,67,景美,乙簡
2020-01-24,7020,6,4,10,景美,乙簡
2020-01-25,7020,5,8,13,景美,乙簡
2020-01-26,7020,4,14,18,景美,乙簡
2020-01-27,7020,3,7,10,景美,乙簡
2020-01-28,7020,3,20,23,景美,乙簡
2020-01-29,7020,3,12,15,景美,乙簡
2020-01-30,7020,5,19,24,景美,乙簡
2020-01-31,7020,5,8,13,景美,乙簡
2020-02-01,7020,1,8,9,景美,乙簡
2020-02-02,7020,4,10,14,景美,乙簡
2020-02-03,7020,7,11,18,景美,乙簡
2020-02-04,7020,11,11,22,景美,乙簡
2020-02-05,7020,1,17,18,景美,乙簡
2020-02-06,7020,4,10,14,景美,乙簡
2020-02-07,7020,4,12,16,景美,乙簡
2020-02-08,7020,3,8,11,景美,乙簡
2020-02-09,7020,2,6,8,景美,乙簡
2020-02-10,7020,10,13,23,景美,乙簡
2020-02-11,7020,2,16,18,景美,乙簡
2020-02-12,7020,6,9,15,景美,乙簡
2020-02-13,7020,6,6,12,景美,乙簡
2020-02-14,7020,6,11,17,景美,乙簡
2020-02-15,7020,7,6,13,景美,乙簡
2020-02-16,7020,1,13,14,景美,乙簡
2020-02-17,7020,2,4,6,景美,乙簡
2020-02-18,7020,5,11,16,景美,乙簡
2020-02-19,7020,6,17,23,景美,乙簡
2020-02-20,7020,12,13,25,景美,乙簡
2020-02-21,7020,6,13,19,景美,乙簡
2020-02-22,7020,4,13,17,景美,乙簡
2020-02-23,7020,4,14,18,景美,乙簡
2020-02-24,7020,3,17,20,景美,乙簡
2020-02-25,7020,32,15,47,景美,乙簡
2020-02-26,7020,25,23,48,景美,乙簡
2020-02-27,7020,23,30,53,景美,乙簡
2020-02-28,7020,12,31,43,景美,乙簡
2020-02-29,7020,8,8,16,景美,乙簡
2020-03-01,7020,2,8,10,景美,乙簡
2020-03-02,7020,25,14,39,景美,乙簡
2020-03-03,7020,24,29,53,景美,乙簡
2020-03-04,7020,23,26,49,景美,乙簡
2020-03-05,7020,20,30,50,景美,乙簡
2020-03-06,7020,8,24,32,景美,乙簡
2020-03-07,7020,3,34,37,景美,乙簡
2020-03-08,7020,4,12,16,景美,乙簡
2020-03-09,7020,7,16,23,景美,乙簡
2020-03-10,7020,14,25,39,景美,乙簡
2020-03-11,7020,5,22,27,景美,乙簡
2020-03-12,7020,20,26,46,景美,乙簡
2020-03-13,7020,22,28,50,景美,乙簡
2020-03-14,7020,2,24,26,景美,乙簡
2020-03-15,7020,4,8,12,景美,乙簡
2020-03-16,7020,20,13,33,景美,乙簡
2020-03-17,7020,13,32,45,景美,乙簡
2020-03-18,7020,23,32,55,景美,乙簡
2020-03-19,7020,20,30,50,景美,乙簡
2020-03-20,7020,21,28,49,景美,乙簡
2020-03-21,7020,10,29,39,景美,乙簡
2020-03-22,7020,5,9,14,景美,乙簡
2020-03-23,7020,21,18,39,景美,乙簡
2020-03-24,7020,25,33,58,景美,乙簡
2020-03-25,7020,10,26,36,景美,乙簡
2020-03-26,7020,8,22,30,景美,乙簡
2020-03-27,7020,7,28,35,景美,乙簡
2020-03-28,7020,32,55,87,景美,乙簡
2020-03-29,7020,6,7,13,景美,乙簡
2020-03-30,7020,25,15,40,景美,乙簡
2020-03-31,7020,25,32,57,景美,乙簡
2020-04-01,7020,17,32,49,景美,乙簡
2020-04-02,7020,7,26,33,景美,乙簡
2020-04-03,7020,6,14,20,景美,乙簡
2020-04-04,7020,4,18,22,景美,乙簡
2020-04-05,7020,3,15,18,景美,乙簡
2020-04-06,7020,26,22,48,景美,乙簡
2020-04-07,7020,21,28,49,景美,乙簡
2020-04-08,7020,8,34,42,景美,乙簡
2020-04-09,7020,18,33,51,景美,乙簡
2020-04-10,7020,8,28,36,景美,乙簡
2020-04-11,7020,3,23,26,景美,乙簡
2020-04-12,7020,5,8,13,景美,乙簡
2020-04-13,7020,22,22,44,景美,乙簡
2020-04-14,7020,11,23,34,景美,乙簡
2020-04-15,7020,18,34,52,景美,乙簡
2020-04-16,7020,21,29,50,景美,乙簡
2020-04-17,7020,22,29,51,景美,乙簡
2020-04-18,7020,27,77,104,景美,乙簡
2020-04-19,7020,9,11,20,景美,乙簡
2020-04-20,7020,13,22,35,景美,乙簡
2020-04-21,7020,11,28,39,景美,乙簡
2020-04-22,7020,22,30,52,景美,乙簡
2020-04-23,7020,25,40,65,景美,乙簡
2020-04-24,7020,24,30,54,景美,乙簡
2020-04-25,7020,8,25,33,景美,乙簡
2020-04-26,7020,8,12,20,景美,乙簡
2020-04-27,7020,19,12,31,景美,乙簡
2020-04-28,7020,6,23,29,景美,乙簡
2020-04-29,7020,9,30,39,景美,乙簡
2020-04-30,7020,19,25,44,景美,乙簡
2020-05-01,7020,19,25,44,景美,乙簡
2020-05-02,7020,9,23,32,景美,乙簡
2020-05-03,7020,8,5,13,景美,乙簡
2020-05-04,7020,21,16,37,景美,乙簡
2020-05-05,7020,21,22,43,景美,乙簡
2020-05-06,7020,21,24,45,景美,乙簡
2020-05-07,7020,13,28,41,景美,乙簡
2020-05-08,7020,21,27,48,景美,乙簡
2020-05-09,7020,5,24,29,景美,乙簡
2020-05-10,7020,5,9,14,景美,乙簡
2020-05-11,7020,11,14,25,景美,乙簡
2020-05-12,7020,22,27,49,景美,乙簡
2020-05-13,7020,10,27,37,景美,乙簡
2020-05-14,7020,9,26,35,景美,乙簡
2020-05-15,7020,20,21,41,景美,乙簡
2020-05-16,7020,12,31,43,景美,乙簡
2020-05-17,7020,4,10,14,景美,乙簡
2020-05-18,7020,10,10,20,景美,乙簡
2020-05-19,7020,21,25,46,景美,乙簡
2020-05-20,7020,22,22,44,景美,乙簡
2020-05-21,7020,16,29,45,景美,乙簡
2020-05-22,7020,19,21,40,景美,乙簡
2020-05-23,7020,3,21,24,景美,乙簡
2020-05-24,7020,5,11,16,景美,乙簡
2020-05-25,7020,19,11,30,景美,乙簡
2020-05-26,7020,18,23,41,景美,乙簡
2020-05-27,7020,17,26,43,景美,乙簡
2020-05-28,7020,23,25,48,景美,乙簡
2020-05-29,7020,26,35,61,景美,乙簡
2020-05-30,7020,5,24,29,景美,乙簡
2020-05-31,7020,2,10,12,景美,乙簡
2020-06-01,7020,9,16,25,景美,乙簡
2020-06-02,7020,17,22,39,景美,乙簡
2020-06-03,7020,19,25,44,景美,乙簡
2020-06-04,7020,21,21,42,景美,乙簡
2020-06-05,7020,11,23,34,景美,乙簡
2020-06-06,7020,6,23,29,景美,乙簡
2020-06-07,7020,30,36,66,景美,乙簡
2020-06-08,7020,19,8,27,景美,乙簡
2020-06-09,7020,21,23,44,景美,乙簡
2020-06-10,7020,24,17,41,景美,乙簡
2020-06-11,7020,19,18,37,景美,乙簡
2020-06-12,7020,13,12,25,景美,乙簡
2020-06-13,7020,5,19,24,景美,乙簡
2020-06-14,7020,4,15,19,景美,乙簡
2020-06-15,7020,9,17,26,景美,乙簡
2020-06-16,7020,14,18,32,景美,乙簡
2020-06-17,7020,14,15,29,景美,乙簡
2020-06-18,7020,7,17,24,景美,乙簡
2020-06-19,7020,8,12,20,景美,乙簡
2020-06-20,7020,19,19,38,景美,乙簡
2020-06-21,7020,7,16,23,景美,乙簡
2020-06-22,7020,23,16,39,景美,乙簡
2020-06-23,7020,14,17,31,景美,乙簡
2020-06-24,7020,14,20,34,景美,乙簡
2020-06-25,7020,10,20,30,景美,乙簡
2020-06-26,7020,4,9,13,景美,乙簡
2020-06-27,7020,4,5,9,景美,乙簡
2020-06-28,7020,5,13,18,景美,乙簡
2020-06-29,7020,21,12,33,景美,乙簡
2020-06-30,7020,19,23,42,景美,乙簡
2020-07-01,7020,15,18,33,景美,乙簡
2020-07-02,7020,16,17,33,景美,乙簡
2020-07-03,7020,15,21,36,景美,乙簡
2020-07-04,7020,4,16,20,景美,乙簡
2020-07-05,7020,6,25,31,景美,乙簡
2020-07-06,7020,6,6,12,景美,乙簡
2020-07-07,7020,14,13,27,景美,乙簡
2020-07-08,7020,14,16,30,景美,乙簡
2020-07-09,7020,9,17,26,景美,乙簡
2020-07-10,7020,4,23,27,景美,乙簡
2020-07-11,7020,6,31,37,景美,乙簡
2020-07-12,7020,9,23,32,景美,乙簡
2020-07-13,7020,24,19,43,景美,乙簡
2020-07-14,7020,20,22,42,景美,乙簡
2020-07-15,7020,7,24,31,景美,乙簡
2020-07-16,7020,13,12,25,景美,乙簡
2020-07-17,7020,8,10,18,景美,乙簡
2020-07-18,7020,8,16,24,景美,乙簡
2020-07-19,7020,4,8,12,景美,乙簡
2020-07-20,7020,4,7,11,景美,乙簡
2020-07-21,7020,1,8,9,景美,乙簡
2020-07-22,7020,3,8,11,景美,乙簡
2020-07-23,7020,7,11,18,景美,乙簡
2020-07-24,7020,3,10,13,景美,乙簡
2020-07-25,7020,5,20,25,景美,乙簡
2020-07-26,7020,20,31,51,景美,乙簡
2020-07-27,7020,6,10,16,景美,乙簡
2020-07-28,7020,4,10,14,景美,乙簡
2020-07-29,7020,7,20,27,景美,乙簡
2020-07-30,7020,11,11,22,景美,乙簡
2020-07-31,7020,7,16,23,景美,乙簡
2020-08-01,7020,2,8,10,景美,乙簡
2020-08-02,7020,4,7,11,景美,乙簡
2020-08-03,7020,1,10,11,景美,乙簡
2020-08-04,7020,1,12,13,景美,乙簡
2020-08-05,7020,0,7,7,景美,乙簡
2020-08-06,7020,6,5,11,景美,乙簡
2020-08-07,7020,8,17,25,景美,乙簡
2020-08-08,7020,4,10,14,景美,乙簡
2020-08-09,7020,6,16,22,景美,乙簡
2020-08-10,7020,2,18,20,景美,乙簡
2020-08-11,7020,3,6,9,景美,乙簡
2020-08-12,7020,5,11,16,景美,乙簡
2020-08-13,7020,3,4,7,景美,乙簡
2020-08-14,7020,5,11,16,景美,乙簡
2020-08-15,7020,5,16,21,景美,乙簡
2020-08-16,7020,3,8,11,景美,乙簡
2020-08-17,7020,10,18,28,景美,乙簡
2020-08-18,7020,7,12,19,景美,乙簡
2020-08-19,7020,20,13,33,景美,乙簡
2020-08-20,7020,9,12,21,景美,乙簡
2020-08-21,7020,3,9,12,景美,乙簡
2020-08-22,7020,1,4,5,景美,乙簡
2020-08-23,7020,7,7,14,景美,乙簡
2020-08-24,7020,4,8,12,景美,乙簡
2020-08-25,7020,7,9,16,景美,乙簡
2020-08-26,7020,4,6,10,景美,乙簡
2020-08-27,7020,2,14,16,景美,乙簡
2020-08-28,7020,8,7,15,景美,乙簡
2020-08-29,7020,7,16,23,景美,乙簡
2020-08-30,7020,3,6,9,景美,乙簡
2020-08-31,7020,12,13,25,景美,乙簡
2020-09-01,7020,22,20,42,景美,乙簡
2020-09-02,7020,23,35,58,景美,乙簡
2020-09-03,7020,9,26,35,景美,乙簡
2020-09-04,7020,14,26,40,景美,乙簡
2020-09-05,7020,4,21,25,景美,乙簡
2020-09-06,7020,4,5,9,景美,乙簡
2020-09-07,7020,13,9,22,景美,乙簡
2020-09-08,7020,18,29,47,景美,乙簡
2020-09-09,7020,18,23,41,景美,乙簡
2020-09-10,7020,12,31,43,景美,乙簡
2020-09-11,7020,20,27,47,景美,乙簡
2020-09-12,7020,13,24,37,景美,乙簡
2020-09-13,7020,3,9,12,景美,乙簡
2020-09-14,7020,8,11,19,景美,乙簡
2020-09-15,7020,43,30,73,景美,乙簡
2020-09-16,7020,8,28,36,景美,乙簡
2020-09-17,7020,20,21,41,景美,乙簡
2020-09-18,7020,14,25,39,景美,乙簡
2020-09-19,7020,4,21,25,景美,乙簡
2020-09-20,7020,4,4,8,景美,乙簡
2020-09-21,7020,23,23,46,景美,乙簡
2020-09-22,7020,11,19,30,景美,乙簡
2020-09-23,7020,21,20,41,景美,乙簡
2020-09-24,7020,18,22,40,景美,乙簡
2020-09-25,7020,10,21,31,景美,乙簡
2020-09-26,7020,19,18,37,景美,乙簡
2020-09-27,7020,6,16,22,景美,乙簡
2020-09-28,7020,10,20,30,景美,乙簡
2020-09-29,7020,16,24,40,景美,乙簡
2020-09-30,7020,13,25,38,景美,乙簡
2020-10-01,7020,8,14,22,景美,乙簡
2020-10-02,7020,21,24,45,景美,乙簡
2020-10-03,7020,6,1,7,景美,乙簡
2020-10-04,7020,6,4,10,景美,乙簡
2020-10-05,7020,17,20,37,景美,乙簡
2020-10-06,7020,9,21,30,景美,乙簡
2020-10-07,7020,18,19,37,景美,乙簡
2020-10-08,7020,15,23,38,景美,乙簡
2020-10-09,7020,2,21,23,景美,乙簡
2020-10-10,7020,4,9,13,景美,乙簡
2020-10-11,7020,15,21,36,景美,乙簡
2020-10-12,7020,20,22,42,景美,乙簡
2020-10-13,7020,21,30,51,景美,乙簡
2020-10-14,7020,23,28,51,景美,乙簡
2020-10-15,7020,24,25,49,景美,乙簡
2020-10-16,7020,17,29,46,景美,乙簡
2020-10-17,7020,5,21,26,景美,乙簡
2020-10-18,7020,8,2,10,景美,乙簡
2020-10-19,7020,19,23,42,景美,乙簡
2020-10-20,7020,16,24,40,景美,乙簡
2020-10-21,7020,12,22,34,景美,乙簡
2020-10-22,7020,14,16,30,景美,乙簡
2020-10-23,7020,16,25,41,景美,乙簡
2020-10-24,7020,0,10,10,景美,乙簡
2020-10-25,7020,5,5,10,景美,乙簡
2020-10-26,7020,18,20,38,景美,乙簡
2020-10-27,7020,14,21,35,景美,乙簡
2020-10-28,7020,12,22,34,景美,乙簡
2020-10-29,7020,9,19,28,景美,乙簡
2020-10-30,7020,10,20,30,景美,乙簡
2020-10-31,7020,4,12,16,景美,乙簡
2020-11-01,7020,1,3,4,景美,乙簡
2020-11-02,7020,18,23,41,景美,乙簡
2020-11-03,7020,6,24,30,景美,乙簡
2020-11-04,7020,20,22,42,景美,乙簡
2020-11-05,7020,9,14,23,景美,乙簡
2020-11-06,7020,10,17,27,景美,乙簡
2020-11-07,7020,4,3,7,景美,乙簡
2020-11-08,7020,4,6,10,景美,乙簡
2020-11-09,7020,6,23,29,景美,乙簡
2020-11-10,7020,26,29,55,景美,乙簡
2020-11-11,7020,24,26,50,景美,乙簡
2020-11-12,7020,8,24,32,景美,乙簡
2020-11-13,7020,8,19,27,景美,乙簡
2020-11-14,7020,2,5,7,景美,乙簡
2020-11-15,7020,7,11,18,景美,乙簡
2020-11-16,7020,22,19,41,景美,乙簡
2020-11-17,7020,17,27,44,景美,乙簡
2020-11-18,7020,23,24,47,景美,乙簡
2020-11-19,7020,9,26,35,景美,乙簡
2020-11-20,7020,9,22,31,景美,乙簡
2020-11-21,7020,0,9,9,景美,乙簡
2020-11-22,7020,2,6,8,景美,乙簡
2020-11-23,7020,12,24,36,景美,乙簡
2020-11-24,7020,19,27,46,景美,乙簡
2020-11-25,7020,20,23,43,景美,乙簡
2020-11-26,7020,15,24,39,景美,乙簡
2020-11-27,7020,21,27,48,景美,乙簡
2020-11-28,7020,6,2,8,景美,乙簡
2020-11-29,7020,7,8,15,景美,乙簡
2020-11-30,7020,17,23,40,景美,乙簡
2020-12-01,7020,7,22,29,景美,乙簡
2020-12-02,7020,10,28,38,景美,乙簡
2020-12-03,7020,20,25,45,景美,乙簡
2020-12-04,7020,8,60,68,景美,乙簡
2020-12-05,7020,4,10,14,景美,乙簡
2020-12-06,7020,8,7,15,景美,乙簡
2020-12-07,7020,7,25,32,景美,乙簡
2020-12-08,7020,21,21,42,景美,乙簡
2020-12-09,7020,7,20,27,景美,乙簡
2020-12-10,7020,18,25,43,景美,乙簡
2020-12-11,7020,9,28,37,景美,乙簡
2020-12-12,7020,7,7,14,景美,乙簡
2020-12-13,7020,8,8,16,景美,乙簡
2020-12-14,7020,12,21,33,景美,乙簡
2020-12-15,7020,19,21,40,景美,乙簡
2020-12-16,7020,16,26,42,景美,乙簡
2020-12-17,7020,11,27,38,景美,乙簡
2020-12-18,7020,17,31,48,景美,乙簡
2020-12-19,7020,10,13,23,景美,乙簡
2020-12-20,7020,1,4,5,景美,乙簡
2020-12-21,7020,14,29,43,景美,乙簡
2020-12-22,7020,10,21,31,景美,乙簡
2020-12-23,7020,10,24,34,景美,乙簡
2020-12-24,7020,39,55,94,景美,乙簡
2020-12-25,7020,4,31,35,景美,乙簡
2020-12-26,7020,0,6,6,景美,乙簡
2020-12-27,7020,8,12,20,景美,乙簡
2020-12-28,7020,17,15,32,景美,乙簡
2020-12-29,7020,11,21,32,景美,乙簡
2020-12-30,7020,19,21,40,景美,乙簡
2020-12-31,7020,11,19,30,景美,乙簡
2020-01-01,7030,1442,1081,2523,新城,二等
2020-01-02,7030,1683,877,2560,新城,二等
2020-01-03,7030,1740,983,2723,新城,二等
2020-01-04,7030,1362,966,2328,新城,二等
2020-01-05,7030,1286,736,2022,新城,二等
2020-01-06,7030,1418,929,2347,新城,二等
2020-01-07,7030,1007,771,1778,新城,二等
2020-01-08,7030,1187,708,1895,新城,二等
2020-01-09,7030,1699,842,2541,新城,二等
2020-01-10,7030,1037,939,1976,新城,二等
2020-01-11,7030,1252,734,1986,新城,二等
2020-01-12,7030,1159,705,1864,新城,二等
2020-01-13,7030,1147,976,2123,新城,二等
2020-01-14,7030,938,1105,2043,新城,二等
2020-01-15,7030,1138,1499,2637,新城,二等
2020-01-16,7030,1493,851,2344,新城,二等
2020-01-17,7030,1669,1297,2966,新城,二等
2020-01-18,7030,1501,719,2220,新城,二等
2020-01-19,7030,1746,469,2215,新城,二等
2020-01-20,7030,1379,968,2347,新城,二等
2020-01-21,7030,953,496,1449,新城,二等
2020-01-22,7030,1191,555,1746,新城,二等
2020-01-23,7030,1017,920,1937,新城,二等
2020-01-24,7030,1072,806,1878,新城,二等
2020-01-25,7030,1298,1271,2569,新城,二等
2020-01-26,7030,1584,854,2438,新城,二等
2020-01-27,7030,1701,991,2692,新城,二等
2020-01-28,7030,1652,1081,2733,新城,二等
2020-01-29,7030,1699,647,2346,新城,二等
2020-01-30,7030,1561,732,2293,新城,二等
2020-01-31,7030,1168,703,1871,新城,二等
2020-02-01,7030,1252,650,1902,新城,二等
2020-02-02,7030,1224,631,1855,新城,二等
2020-02-03,7030,1131,796,1927,新城,二等
2020-02-04,7030,773,805,1578,新城,二等
2020-02-05,7030,580,407,987,新城,二等
2020-02-06,7030,633,596,1229,新城,二等
2020-02-07,7030,837,662,1499,新城,二等
2020-02-08,7030,725,797,1522,新城,二等
2020-02-09,7030,629,647,1276,新城,二等
2020-02-10,7030,574,469,1043,新城,二等
2020-02-11,7030,543,282,825,新城,二等
2020-02-12,7030,521,505,1026,新城,二等
2020-02-13,7030,447,457,904,新城,二等
2020-02-14,7030,640,561,1201,新城,二等
2020-02-15,7030,520,490,1010,新城,二等
2020-02-16,7030,512,385,897,新城,二等
2020-02-17,7030,360,280,640,新城,二等
2020-02-18,7030,512,308,820,新城,二等
2020-02-19,7030,387,276,663,新城,二等
2020-02-20,7030,407,300,707,新城,二等
2020-02-21,7030,598,422,1020,新城,二等
2020-02-22,7030,357,369,726,新城,二等
2020-02-23,7030,467,227,694,新城,二等
2020-02-24,7030,350,316,666,新城,二等
2020-02-25,7030,465,385,850,新城,二等
2020-02-26,7030,419,323,742,新城,二等
2020-02-27,7030,419,476,895,新城,二等
2020-02-28,7030,437,830,1267,新城,二等
2020-02-29,7030,458,590,1048,新城,二等
2020-03-01,7030,542,246,788,新城,二等
2020-03-02,7030,432,351,783,新城,二等
2020-03-03,7030,370,338,708,新城,二等
2020-03-04,7030,367,308,675,新城,二等
2020-03-05,7030,442,334,776,新城,二等
2020-03-06,7030,477,462,939,新城,二等
2020-03-07,7030,395,465,860,新城,二等
2020-03-08,7030,497,237,734,新城,二等
2020-03-09,7030,411,367,778,新城,二等
2020-03-10,7030,385,309,694,新城,二等
2020-03-11,7030,433,460,893,新城,二等
2020-03-12,7030,388,331,719,新城,二等
2020-03-13,7030,487,431,918,新城,二等
2020-03-14,7030,336,413,749,新城,二等
2020-03-15,7030,463,325,788,新城,二等
2020-03-16,7030,436,401,837,新城,二等
2020-03-17,7030,388,334,722,新城,二等
2020-03-18,7030,397,886,1283,新城,二等
2020-03-19,7030,408,322,730,新城,二等
2020-03-20,7030,552,456,1008,新城,二等
2020-03-21,7030,356,358,714,新城,二等
2020-03-22,7030,474,198,672,新城,二等
2020-03-23,7030,412,320,732,新城,二等
2020-03-24,7030,356,318,674,新城,二等
2020-03-25,7030,308,558,866,新城,二等
2020-03-26,7030,344,343,687,新城,二等
2020-03-27,7030,378,407,785,新城,二等
2020-03-28,7030,253,338,591,新城,二等
2020-03-29,7030,304,200,504,新城,二等
2020-03-30,7030,340,319,659,新城,二等
2020-03-31,7030,319,318,637,新城,二等
2020-04-01,7030,357,489,846,新城,二等
2020-04-02,7030,258,671,929,新城,二等
2020-04-03,7030,373,606,979,新城,二等
2020-04-04,7030,452,379,831,新城,二等
2020-04-05,7030,619,268,887,新城,二等
2020-04-06,7030,449,354,803,新城,二等
2020-04-07,7030,318,599,917,新城,二等
2020-04-08,7030,320,500,820,新城,二等
2020-04-09,7030,287,613,900,新城,二等
2020-04-10,7030,327,405,732,新城,二等
2020-04-11,7030,211,396,607,新城,二等
2020-04-12,7030,261,173,434,新城,二等
2020-04-13,7030,283,332,615,新城,二等
2020-04-14,7030,297,546,843,新城,二等
2020-04-15,7030,337,321,658,新城,二等
2020-04-16,7030,431,559,990,新城,二等
2020-04-17,7030,332,388,720,新城,二等
2020-04-18,7030,239,381,620,新城,二等
2020-04-19,7030,239,252,491,新城,二等
2020-04-20,7030,356,309,665,新城,二等
2020-04-21,7030,277,547,824,新城,二等
2020-04-22,7030,325,345,670,新城,二等
2020-04-23,7030,305,518,823,新城,二等
2020-04-24,7030,377,295,672,新城,二等
2020-04-25,7030,164,299,463,新城,二等
2020-04-26,7030,240,170,410,新城,二等
2020-04-27,7030,301,282,583,新城,二等
2020-04-28,7030,283,534,817,新城,二等
2020-04-29,7030,289,272,561,新城,二等
2020-04-30,7030,325,371,696,新城,二等
2020-05-01,7030,349,473,822,新城,二等
2020-05-02,7030,300,261,561,新城,二等
2020-05-03,7030,356,187,543,新城,二等
2020-05-04,7030,365,328,693,新城,二等
2020-05-05,7030,296,303,599,新城,二等
2020-05-06,7030,325,389,714,新城,二等
2020-05-07,7030,284,322,606,新城,二等
2020-05-08,7030,425,436,861,新城,二等
2020-05-09,7030,251,324,575,新城,二等
2020-05-10,7030,358,223,581,新城,二等
2020-05-11,7030,380,301,681,新城,二等
2020-05-12,7030,343,295,638,新城,二等
2020-05-13,7030,318,329,647,新城,二等
2020-05-14,7030,316,322,638,新城,二等
2020-05-15,7030,373,451,824,新城,二等
2020-05-16,7030,289,322,611,新城,二等
2020-05-17,7030,292,209,501,新城,二等
2020-05-18,7030,307,341,648,新城,二等
2020-05-19,7030,289,315,604,新城,二等
2020-05-20,7030,332,306,638,新城,二等
2020-05-21,7030,302,315,617,新城,二等
2020-05-22,7030,382,417,799,新城,二等
2020-05-23,7030,233,271,504,新城,二等
2020-05-24,7030,351,309,660,新城,二等
2020-05-25,7030,334,330,664,新城,二等
2020-05-26,7030,339,303,642,新城,二等
2020-05-27,7030,343,360,703,新城,二等
2020-05-28,7030,324,304,628,新城,二等
2020-05-29,7030,400,417,817,新城,二等
2020-05-30,7030,244,298,542,新城,二等
2020-05-31,7030,376,282,658,新城,二等
2020-06-01,7030,379,334,713,新城,二等
2020-06-02,7030,316,310,626,新城,二等
2020-06-03,7030,349,356,705,新城,二等
2020-06-04,7030,330,349,679,新城,二等
2020-06-05,7030,474,454,928,新城,二等
2020-06-06,7030,344,441,785,新城,二等
2020-06-07,7030,463,342,805,新城,二等
2020-06-08,7030,373,383,756,新城,二等
2020-06-09,7030,322,350,672,新城,二等
2020-06-10,7030,339,809,1148,新城,二等
2020-06-11,7030,406,467,873,新城,二等
2020-06-12,7030,634,531,1165,新城,二等
2020-06-13,7030,411,529,940,新城,二等
2020-06-14,7030,439,279,718,新城,二等
2020-06-15,7030,404,599,1003,新城,二等
2020-06-16,7030,625,352,977,新城,二等
2020-06-17,7030,380,359,739,新城,二等
2020-06-18,7030,356,353,709,新城,二等
2020-06-19,7030,452,432,884,新城,二等
2020-06-20,7030,474,491,965,新城,二等
2020-06-21,7030,479,427,906,新城,二等
2020-06-22,7030,398,757,1155,新城,二等
2020-06-23,7030,380,328,708,新城,二等
2020-06-24,7030,411,450,861,新城,二等
2020-06-25,7030,383,655,1038,新城,二等
2020-06-26,7030,510,504,1014,新城,二等
2020-06-27,7030,529,367,896,新城,二等
2020-06-28,7030,528,290,818,新城,二等
2020-06-29,7030,448,873,1321,新城,二等
2020-06-30,7030,353,335,688,新城,二等
2020-07-01,7030,339,427,766,新城,二等
2020-07-02,7030,406,472,878,新城,二等
2020-07-03,7030,406,447,853,新城,二等
2020-07-04,7030,344,777,1121,新城,二等
2020-07-05,7030,754,284,1038,新城,二等
2020-07-06,7030,388,411,799,新城,二等
2020-07-07,7030,379,391,770,新城,二等
2020-07-08,7030,325,402,727,新城,二等
2020-07-09,7030,381,382,763,新城,二等
2020-07-10,7030,459,651,1110,新城,二等
2020-07-11,7030,427,479,906,新城,二等
2020-07-12,7030,521,437,958,新城,二等
2020-07-13,7030,374,452,826,新城,二等
2020-07-14,7030,435,463,898,新城,二等
2020-07-15,7030,322,505,827,新城,二等
2020-07-16,7030,338,468,806,新城,二等
2020-07-17,7030,410,429,839,新城,二等
2020-07-18,7030,390,497,887,新城,二等
2020-07-19,7030,498,312,810,新城,二等
2020-07-20,7030,478,337,815,新城,二等
2020-07-21,7030,442,339,781,新城,二等
2020-07-22,7030,419,321,740,新城,二等
2020-07-23,7030,391,464,855,新城,二等
2020-07-24,7030,420,433,853,新城,二等
2020-07-25,7030,410,516,926,新城,二等
2020-07-26,7030,579,499,1078,新城,二等
2020-07-27,7030,393,349,742,新城,二等
2020-07-28,7030,361,413,774,新城,二等
2020-07-29,7030,454,406,860,新城,二等
2020-07-30,7030,318,519,837,新城,二等
2020-07-31,7030,473,536,1009,新城,二等
2020-08-01,7030,482,493,975,新城,二等
2020-08-02,7030,596,496,1092,新城,二等
2020-08-03,7030,366,388,754,新城,二等
2020-08-04,7030,332,295,627,新城,二等
2020-08-05,7030,389,443,832,新城,二等
2020-08-06,7030,381,487,868,新城,二等
2020-08-07,7030,441,484,925,新城,二等
2020-08-08,7030,297,560,857,新城,二等
2020-08-09,7030,544,536,1080,新城,二等
2020-08-10,7030,442,379,821,新城,二等
2020-08-11,7030,377,987,1364,新城,二等
2020-08-12,7030,386,421,807,新城,二等
2020-08-13,7030,404,461,865,新城,二等
2020-08-14,7030,444,689,1133,新城,二等
2020-08-15,7030,619,501,1120,新城,二等
2020-08-16,7030,534,521,1055,新城,二等
2020-08-17,7030,518,451,969,新城,二等
2020-08-18,7030,384,444,828,新城,二等
2020-08-19,7030,400,413,813,新城,二等
2020-08-20,7030,428,450,878,新城,二等
2020-08-21,7030,505,446,951,新城,二等
2020-08-22,7030,374,599,973,新城,二等
2020-08-23,7030,457,448,905,新城,二等
2020-08-24,7030,434,371,805,新城,二等
2020-08-25,7030,471,433,904,新城,二等
2020-08-26,7030,395,397,792,新城,二等
2020-08-27,7030,398,340,738,新城,二等
2020-08-28,7030,317,547,864,新城,二等
2020-08-29,7030,393,464,857,新城,二等
2020-08-30,7030,398,910,1308,新城,二等
2020-08-31,7030,404,356,760,新城,二等
2020-09-01,7030,366,366,732,新城,二等
2020-09-02,7030,361,354,715,新城,二等
2020-09-03,7030,408,541,949,新城,二等
2020-09-04,7030,443,670,1113,新城,二等
2020-09-05,7030,332,400,732,新城,二等
2020-09-06,7030,515,510,1025,新城,二等
2020-09-07,7030,451,383,834,新城,二等
2020-09-08,7030,411,409,820,新城,二等
2020-09-09,7030,370,457,827,新城,二等
2020-09-10,7030,388,381,769,新城,二等
2020-09-11,7030,509,548,1057,新城,二等
2020-09-12,7030,357,516,873,新城,二等
2020-09-13,7030,456,323,779,新城,二等
2020-09-14,7030,398,377,775,新城,二等
2020-09-15,7030,382,356,738,新城,二等
2020-09-16,7030,314,720,1034,新城,二等
2020-09-17,7030,612,538,1150,新城,二等
2020-09-18,7030,749,468,1217,新城,二等
2020-09-19,7030,362,708,1070,新城,二等
2020-09-20,7030,414,410,824,新城,二等
2020-09-21,7030,390,370,760,新城,二等
2020-09-22,7030,375,357,732,新城,二等
2020-09-23,7030,592,451,1043,新城,二等
2020-09-24,7030,377,449,826,新城,二等
2020-09-25,7030,576,518,1094,新城,二等
2020-09-26,7030,394,538,932,新城,二等
2020-09-27,7030,322,260,582,新城,二等
2020-09-28,7030,420,584,1004,新城,二等
2020-09-29,7030,347,373,720,新城,二等
2020-09-30,7030,418,598,1016,新城,二等
2020-10-01,7030,344,677,1021,新城,二等
2020-10-02,7030,547,581,1128,新城,二等
2020-10-03,7030,537,379,916,新城,二等
2020-10-04,7030,557,317,874,新城,二等
2020-10-05,7030,458,382,840,新城,二等
2020-10-06,7030,377,498,875,新城,二等
2020-10-07,7030,388,483,871,新城,二等
2020-10-08,7030,477,461,938,新城,二等
2020-10-09,7030,529,579,1108,新城,二等
2020-10-10,7030,451,326,777,新城,二等
2020-10-11,7030,490,385,875,新城,二等
2020-10-12,7030,385,346,731,新城,二等
2020-10-13,7030,364,400,764,新城,二等
2020-10-14,7030,345,737,1082,新城,二等
2020-10-15,7030,430,454,884,新城,二等
2020-10-16,7030,787,548,1335,新城,二等
2020-10-17,7030,367,400,767,新城,二等
2020-10-18,7030,430,278,708,新城,二等
2020-10-19,7030,431,385,816,新城,二等
2020-10-20,7030,402,327,729,新城,二等
2020-10-21,7030,362,319,681,新城,二等
2020-10-22,7030,353,376,729,新城,二等
2020-10-23,7030,475,623,1098,新城,二等
2020-10-24,7030,967,998,1965,新城,二等
2020-10-25,7030,461,282,743,新城,二等
2020-10-26,7030,378,509,887,新城,二等
2020-10-27,7030,361,342,703,新城,二等
2020-10-28,7030,383,529,912,新城,二等
2020-10-29,7030,389,413,802,新城,二等
2020-10-30,7030,455,519,974,新城,二等
2020-10-31,7030,407,616,1023,新城,二等
2020-11-01,7030,647,293,940,新城,二等
2020-11-02,7030,356,359,715,新城,二等
2020-11-03,7030,347,497,844,新城,二等
2020-11-04,7030,310,323,633,新城,二等
2020-11-05,7030,356,340,696,新城,二等
2020-11-06,7030,435,988,1423,新城,二等
2020-11-07,7030,4067,6872,10939,新城,二等
2020-11-08,7030,572,446,1018,新城,二等
2020-11-09,7030,404,324,728,新城,二等
2020-11-10,7030,316,346,662,新城,二等
2020-11-11,7030,353,544,897,新城,二等
2020-11-12,7030,372,333,705,新城,二等
2020-11-13,7030,632,534,1166,新城,二等
2020-11-14,7030,391,459,850,新城,二等
2020-11-15,7030,431,291,722,新城,二等
2020-11-16,7030,395,431,826,新城,二等
2020-11-17,7030,569,327,896,新城,二等
2020-11-18,7030,372,347,719,新城,二等
2020-11-19,7030,413,661,1074,新城,二等
2020-11-20,7030,774,525,1299,新城,二等
2020-11-21,7030,634,340,974,新城,二等
2020-11-22,7030,452,363,815,新城,二等
2020-11-23,7030,417,398,815,新城,二等
2020-11-24,7030,334,357,691,新城,二等
2020-11-25,7030,339,509,848,新城,二等
2020-11-26,7030,367,478,845,新城,二等
2020-11-27,7030,446,485,931,新城,二等
2020-11-28,7030,349,566,915,新城,二等
2020-11-29,7030,607,353,960,新城,二等
2020-11-30,7030,371,338,709,新城,二等
2020-12-01,7030,356,292,648,新城,二等
2020-12-02,7030,325,800,1125,新城,二等
2020-12-03,7030,342,561,903,新城,二等
2020-12-04,7030,485,459,944,新城,二等
2020-12-05,7030,339,358,697,新城,二等
2020-12-06,7030,355,346,701,新城,二等
2020-12-07,7030,345,288,633,新城,二等
2020-12-08,7030,266,271,537,新城,二等
2020-12-09,7030,278,292,570,新城,二等
2020-12-10,7030,375,360,735,新城,二等
2020-12-11,7030,380,386,766,新城,二等
2020-12-12,7030,336,589,925,新城,二等
2020-12-13,7030,423,331,754,新城,二等
2020-12-14,7030,320,364,684,新城,二等
2020-12-15,7030,317,335,652,新城,二等
2020-12-16,7030,283,513,796,新城,二等
2020-12-17,7030,320,328,648,新城,二等
2020-12-18,7030,732,567,1299,新城,二等
2020-12-19,7030,280,600,880,新城,二等
2020-12-20,7030,376,303,679,新城,二等
2020-12-21,7030,345,320,665,新城,二等
2020-12-22,7030,350,338,688,新城,二等
2020-12-23,7030,299,335,634,新城,二等
2020-12-24,7030,313,373,686,新城,二等
2020-12-25,7030,407,401,808,新城,二等
2020-12-26,7030,513,250,763,新城,二等
2020-12-27,7030,446,358,804,新城,二等
2020-12-28,7030,360,350,710,新城,二等
2020-12-29,7030,354,329,683,新城,二等
2020-12-30,7030,342,363,705,新城,二等
2020-12-31,7030,433,514,947,新城,二等
2020-01-01,7040,28,30,58,崇德,三等
2020-01-02,7040,46,39,85,崇德,三等
2020-01-03,7040,54,50,104,崇德,三等
2020-01-04,7040,40,31,71,崇德,三等
2020-01-05,7040,31,34,65,崇德,三等
2020-01-06,7040,31,35,66,崇德,三等
2020-01-07,7040,49,56,105,崇德,三等
2020-01-08,7040,48,40,88,崇德,三等
2020-01-09,7040,37,53,90,崇德,三等
2020-01-10,7040,37,37,74,崇德,三等
2020-01-11,7040,31,27,58,崇德,三等
2020-01-12,7040,12,15,27,崇德,三等
2020-01-13,7040,42,31,73,崇德,三等
2020-01-14,7040,33,32,65,崇德,三等
2020-01-15,7040,44,40,84,崇德,三等
2020-01-16,7040,32,37,69,崇德,三等
2020-01-17,7040,21,44,65,崇德,三等
2020-01-18,7040,11,21,32,崇德,三等
2020-01-19,7040,11,18,29,崇德,三等
2020-01-20,7040,17,16,33,崇德,三等
2020-01-21,7040,15,17,32,崇德,三等
2020-01-22,7040,14,17,31,崇德,三等
2020-01-23,7040,19,12,31,崇德,三等
2020-01-24,7040,23,30,53,崇德,三等
2020-01-25,7040,22,20,42,崇德,三等
2020-01-26,7040,29,39,68,崇德,三等
2020-01-27,7040,30,26,56,崇德,三等
2020-01-28,7040,60,45,105,崇德,三等
2020-01-29,7040,33,18,51,崇德,三等
2020-01-30,7040,15,17,32,崇德,三等
2020-01-31,7040,19,24,43,崇德,三等
2020-02-01,7040,26,30,56,崇德,三等
2020-02-02,7040,25,24,49,崇德,三等
2020-02-03,7040,19,20,39,崇德,三等
2020-02-04,7040,25,27,52,崇德,三等
2020-02-05,7040,12,19,31,崇德,三等
2020-02-06,7040,27,15,42,崇德,三等
2020-02-07,7040,22,18,40,崇德,三等
2020-02-08,7040,20,28,48,崇德,三等
2020-02-09,7040,17,23,40,崇德,三等
2020-02-10,7040,12,9,21,崇德,三等
2020-02-11,7040,14,21,35,崇德,三等
2020-02-12,7040,18,14,32,崇德,三等
2020-02-13,7040,14,14,28,崇德,三等
2020-02-14,7040,19,12,31,崇德,三等
2020-02-15,7040,19,27,46,崇德,三等
2020-02-16,7040,31,23,54,崇德,三等
2020-02-17,7040,12,15,27,崇德,三等
2020-02-18,7040,18,14,32,崇德,三等
2020-02-19,7040,33,28,61,崇德,三等
2020-02-20,7040,17,18,35,崇德,三等
2020-02-21,7040,20,33,53,崇德,三等
2020-02-22,7040,17,18,35,崇德,三等
2020-02-23,7040,34,23,57,崇德,三等
2020-02-24,7040,20,21,41,崇德,三等
2020-02-25,7040,33,33,66,崇德,三等
2020-02-26,7040,47,34,81,崇德,三等
2020-02-27,7040,36,33,69,崇德,三等
2020-02-28,7040,13,24,37,崇德,三等
2020-02-29,7040,14,25,39,崇德,三等
2020-03-01,7040,26,22,48,崇德,三等
2020-03-02,7040,41,40,81,崇德,三等
2020-03-03,7040,38,41,79,崇德,三等
2020-03-04,7040,37,39,76,崇德,三等
2020-03-05,7040,38,40,78,崇德,三等
2020-03-06,7040,29,32,61,崇德,三等
2020-03-07,7040,12,25,37,崇德,三等
2020-03-08,7040,21,8,29,崇德,三等
2020-03-09,7040,34,35,69,崇德,三等
2020-03-10,7040,29,32,61,崇德,三等
2020-03-11,7040,42,35,77,崇德,三等
2020-03-12,7040,33,36,69,崇德,三等
2020-03-13,7040,43,38,81,崇德,三等
2020-03-14,7040,15,27,42,崇德,三等
2020-03-15,7040,22,24,46,崇德,三等
2020-03-16,7040,41,40,81,崇德,三等
2020-03-17,7040,34,39,73,崇德,三等
2020-03-18,7040,44,33,77,崇德,三等
2020-03-19,7040,30,33,63,崇德,三等
2020-03-20,7040,35,33,68,崇德,三等
2020-03-21,7040,27,27,54,崇德,三等
2020-03-22,7040,23,17,40,崇德,三等
2020-03-23,7040,40,47,87,崇德,三等
2020-03-24,7040,30,29,59,崇德,三等
2020-03-25,7040,19,27,46,崇德,三等
2020-03-26,7040,39,37,76,崇德,三等
2020-03-27,7040,32,31,63,崇德,三等
2020-03-28,7040,39,45,84,崇德,三等
2020-03-29,7040,13,8,21,崇德,三等
2020-03-30,7040,37,33,70,崇德,三等
2020-03-31,7040,38,33,71,崇德,三等
2020-04-01,7040,44,49,93,崇德,三等
2020-04-02,7040,18,19,37,崇德,三等
2020-04-03,7040,13,23,36,崇德,三等
2020-04-04,7040,27,17,44,崇德,三等
2020-04-05,7040,24,14,38,崇德,三等
2020-04-06,7040,38,28,66,崇德,三等
2020-04-07,7040,31,30,61,崇德,三等
2020-04-08,7040,33,38,71,崇德,三等
2020-04-09,7040,35,29,64,崇德,三等
2020-04-10,7040,44,34,78,崇德,三等
2020-04-11,7040,23,17,40,崇德,三等
2020-04-12,7040,20,30,50,崇德,三等
2020-04-13,7040,36,41,77,崇德,三等
2020-04-14,7040,33,36,69,崇德,三等
2020-04-15,7040,38,32,70,崇德,三等
2020-04-16,7040,40,34,74,崇德,三等
2020-04-17,7040,35,31,66,崇德,三等
2020-04-18,7040,20,20,40,崇德,三等
2020-04-19,7040,11,16,27,崇德,三等
2020-04-20,7040,34,30,64,崇德,三等
2020-04-21,7040,31,37,68,崇德,三等
2020-04-22,7040,34,33,67,崇德,三等
2020-04-23,7040,31,34,65,崇德,三等
2020-04-24,7040,39,34,73,崇德,三等
2020-04-25,7040,27,25,52,崇德,三等
2020-04-26,7040,22,15,37,崇德,三等
2020-04-27,7040,32,28,60,崇德,三等
2020-04-28,7040,31,33,64,崇德,三等
2020-04-29,7040,30,26,56,崇德,三等
2020-04-30,7040,31,29,60,崇德,三等
2020-05-01,7040,38,38,76,崇德,三等
2020-05-02,7040,13,31,44,崇德,三等
2020-05-03,7040,33,20,53,崇德,三等
2020-05-04,7040,43,40,83,崇德,三等
2020-05-05,7040,38,38,76,崇德,三等
2020-05-06,7040,39,33,72,崇德,三等
2020-05-07,7040,35,28,63,崇德,三等
2020-05-08,7040,43,32,75,崇德,三等
2020-05-09,7040,14,21,35,崇德,三等
2020-05-10,7040,20,24,44,崇德,三等
2020-05-11,7040,29,31,60,崇德,三等
2020-05-12,7040,26,33,59,崇德,三等
2020-05-13,7040,32,32,64,崇德,三等
2020-05-14,7040,39,30,69,崇德,三等
2020-05-15,7040,36,38,74,崇德,三等
2020-05-16,7040,22,25,47,崇德,三等
2020-05-17,7040,21,18,39,崇德,三等
2020-05-18,7040,41,33,74,崇德,三等
2020-05-19,7040,34,27,61,崇德,三等
2020-05-20,7040,36,34,70,崇德,三等
2020-05-21,7040,32,32,64,崇德,三等
2020-05-22,7040,35,26,61,崇德,三等
2020-05-23,7040,13,16,29,崇德,三等
2020-05-24,7040,13,19,32,崇德,三等
2020-05-25,7040,30,34,64,崇德,三等
2020-05-26,7040,37,33,70,崇德,三等
2020-05-27,7040,23,36,59,崇德,三等
2020-05-28,7040,30,31,61,崇德,三等
2020-05-29,7040,63,65,128,崇德,三等
2020-05-30,7040,17,27,44,崇德,三等
2020-05-31,7040,33,19,52,崇德,三等
2020-06-01,7040,43,35,78,崇德,三等
2020-06-02,7040,33,37,70,崇德,三等
2020-06-03,7040,30,31,61,崇德,三等
2020-06-04,7040,34,32,66,崇德,三等
2020-06-05,7040,27,34,61,崇德,三等
2020-06-06,7040,20,18,38,崇德,三等
2020-06-07,7040,69,69,138,崇德,三等
2020-06-08,7040,33,34,67,崇德,三等
2020-06-09,7040,31,29,60,崇德,三等
2020-06-10,7040,28,35,63,崇德,三等
2020-06-11,7040,35,27,62,崇德,三等
2020-06-12,7040,35,37,72,崇德,三等
2020-06-13,7040,51,53,104,崇德,三等
2020-06-14,7040,26,22,48,崇德,三等
2020-06-15,7040,27,30,57,崇德,三等
2020-06-16,7040,39,35,74,崇德,三等
2020-06-17,7040,25,29,54,崇德,三等
2020-06-18,7040,23,27,50,崇德,三等
2020-06-19,7040,29,24,53,崇德,三等
2020-06-20,7040,24,37,61,崇德,三等
2020-06-21,7040,20,12,32,崇德,三等
2020-06-22,7040,32,38,70,崇德,三等
2020-06-23,7040,22,31,53,崇德,三等
2020-06-24,7040,28,31,59,崇德,三等
2020-06-25,7040,23,33,56,崇德,三等
2020-06-26,7040,35,55,90,崇德,三等
2020-06-27,7040,47,28,75,崇德,三等
2020-06-28,7040,41,23,64,崇德,三等
2020-06-29,7040,39,33,72,崇德,三等
2020-06-30,7040,27,27,54,崇德,三等
2020-07-01,7040,29,35,64,崇德,三等
2020-07-02,7040,36,36,72,崇德,三等
2020-07-03,7040,22,26,48,崇德,三等
2020-07-04,7040,20,31,51,崇德,三等
2020-07-05,7040,16,16,32,崇德,三等
2020-07-06,7040,23,31,54,崇德,三等
2020-07-07,7040,33,22,55,崇德,三等
2020-07-08,7040,36,41,77,崇德,三等
2020-07-09,7040,33,33,66,崇德,三等
2020-07-10,7040,36,28,64,崇德,三等
2020-07-11,7040,15,31,46,崇德,三等
2020-07-12,7040,32,18,50,崇德,三等
2020-07-13,7040,31,32,63,崇德,三等
2020-07-14,7040,33,32,65,崇德,三等
2020-07-15,7040,17,24,41,崇德,三等
2020-07-16,7040,14,23,37,崇德,三等
2020-07-17,7040,26,14,40,崇德,三等
2020-07-18,7040,38,26,64,崇德,三等
2020-07-19,7040,22,27,49,崇德,三等
2020-07-20,7040,24,25,49,崇德,三等
2020-07-21,7040,26,27,53,崇德,三等
2020-07-22,7040,51,23,74,崇德,三等
2020-07-23,7040,24,24,48,崇德,三等
2020-07-24,7040,36,23,59,崇德,三等
2020-07-25,7040,22,27,49,崇德,三等
2020-07-26,7040,23,26,49,崇德,三等
2020-07-27,7040,34,19,53,崇德,三等
2020-07-28,7040,17,29,46,崇德,三等
2020-07-29,7040,23,20,43,崇德,三等
2020-07-30,7040,45,39,84,崇德,三等
2020-07-31,7040,26,41,67,崇德,三等
2020-08-01,7040,22,31,53,崇德,三等
2020-08-02,7040,36,22,58,崇德,三等
2020-08-03,7040,22,24,46,崇德,三等
2020-08-04,7040,21,22,43,崇德,三等
2020-08-05,7040,15,14,29,崇德,三等
2020-08-06,7040,24,15,39,崇德,三等
2020-08-07,7040,20,17,37,崇德,三等
2020-08-08,7040,20,31,51,崇德,三等
2020-08-09,7040,12,14,26,崇德,三等
2020-08-10,7040,19,18,37,崇德,三等
2020-08-11,7040,23,17,40,崇德,三等
2020-08-12,7040,24,18,42,崇德,三等
2020-08-13,7040,18,33,51,崇德,三等
2020-08-14,7040,53,38,91,崇德,三等
2020-08-15,7040,31,26,57,崇德,三等
2020-08-16,7040,32,32,64,崇德,三等
2020-08-17,7040,21,47,68,崇德,三等
2020-08-18,7040,37,22,59,崇德,三等
2020-08-19,7040,32,19,51,崇德,三等
2020-08-20,7040,16,24,40,崇德,三等
2020-08-21,7040,21,20,41,崇德,三等
2020-08-22,7040,15,13,28,崇德,三等
2020-08-23,7040,29,32,61,崇德,三等
2020-08-24,7040,27,23,50,崇德,三等
2020-08-25,7040,44,45,89,崇德,三等
2020-08-26,7040,30,37,67,崇德,三等
2020-08-27,7040,31,49,80,崇德,三等
2020-08-28,7040,26,31,57,崇德,三等
2020-08-29,7040,17,31,48,崇德,三等
2020-08-30,7040,29,12,41,崇德,三等
2020-08-31,7040,28,27,55,崇德,三等
2020-09-01,7040,27,26,53,崇德,三等
2020-09-02,7040,28,24,52,崇德,三等
2020-09-03,7040,37,29,66,崇德,三等
2020-09-04,7040,33,26,59,崇德,三等
2020-09-05,7040,14,20,34,崇德,三等
2020-09-06,7040,15,15,30,崇德,三等
2020-09-07,7040,37,32,69,崇德,三等
2020-09-08,7040,33,41,74,崇德,三等
2020-09-09,7040,35,42,77,崇德,三等
2020-09-10,7040,31,37,68,崇德,三等
2020-09-11,7040,43,31,74,崇德,三等
2020-09-12,7040,20,24,44,崇德,三等
2020-09-13,7040,13,16,29,崇德,三等
2020-09-14,7040,32,32,64,崇德,三等
2020-09-15,7040,26,27,53,崇德,三等
2020-09-16,7040,28,32,60,崇德,三等
2020-09-17,7040,35,30,65,崇德,三等
2020-09-18,7040,37,33,70,崇德,三等
2020-09-19,7040,36,33,69,崇德,三等
2020-09-20,7040,25,29,54,崇德,三等
2020-09-21,7040,31,30,61,崇德,三等
2020-09-22,7040,34,27,61,崇德,三等
2020-09-23,7040,29,26,55,崇德,三等
2020-09-24,7040,28,30,58,崇德,三等
2020-09-25,7040,29,29,58,崇德,三等
2020-09-26,7040,33,29,62,崇德,三等
2020-09-27,7040,20,24,44,崇德,三等
2020-09-28,7040,30,36,66,崇德,三等
2020-09-29,7040,24,28,52,崇德,三等
2020-09-30,7040,41,38,79,崇德,三等
2020-10-01,7040,14,33,47,崇德,三等
2020-10-02,7040,46,39,85,崇德,三等
2020-10-03,7040,30,27,57,崇德,三等
2020-10-04,7040,22,21,43,崇德,三等
2020-10-05,7040,27,31,58,崇德,三等
2020-10-06,7040,33,30,63,崇德,三等
2020-10-07,7040,39,26,65,崇德,三等
2020-10-08,7040,32,28,60,崇德,三等
2020-10-09,7040,20,32,52,崇德,三等
2020-10-10,7040,33,45,78,崇德,三等
2020-10-11,7040,29,16,45,崇德,三等
2020-10-12,7040,33,35,68,崇德,三等
2020-10-13,7040,24,26,50,崇德,三等
2020-10-14,7040,28,29,57,崇德,三等
2020-10-15,7040,31,38,69,崇德,三等
2020-10-16,7040,29,36,65,崇德,三等
2020-10-17,7040,17,20,37,崇德,三等
2020-10-18,7040,16,16,32,崇德,三等
2020-10-19,7040,34,37,71,崇德,三等
2020-10-20,7040,28,28,56,崇德,三等
2020-10-21,7040,27,23,50,崇德,三等
2020-10-22,7040,28,27,55,崇德,三等
2020-10-23,7040,27,33,60,崇德,三等
2020-10-24,7040,10,20,30,崇德,三等
2020-10-25,7040,14,12,26,崇德,三等
2020-10-26,7040,31,34,65,崇德,三等
2020-10-27,7040,34,31,65,崇德,三等
2020-10-28,7040,29,28,57,崇德,三等
2020-10-29,7040,32,27,59,崇德,三等
2020-10-30,7040,44,43,87,崇德,三等
2020-10-31,7040,22,16,38,崇德,三等
2020-11-01,7040,14,19,33,崇德,三等
2020-11-02,7040,35,28,63,崇德,三等
2020-11-03,7040,28,28,56,崇德,三等
2020-11-04,7040,25,26,51,崇德,三等
2020-11-05,7040,27,25,52,崇德,三等
2020-11-06,7040,26,30,56,崇德,三等
2020-11-07,7040,12,21,33,崇德,三等
2020-11-08,7040,11,20,31,崇德,三等
2020-11-09,7040,20,31,51,崇德,三等
2020-11-10,7040,28,28,56,崇德,三等
2020-11-11,7040,25,28,53,崇德,三等
2020-11-12,7040,34,27,61,崇德,三等
2020-11-13,7040,31,38,69,崇德,三等
2020-11-14,7040,15,20,35,崇德,三等
2020-11-15,7040,15,17,32,崇德,三等
2020-11-16,7040,34,37,71,崇德,三等
2020-11-17,7040,25,33,58,崇德,三等
2020-11-18,7040,27,38,65,崇德,三等
2020-11-19,7040,27,31,58,崇德,三等
2020-11-20,7040,24,27,51,崇德,三等
2020-11-21,7040,12,7,19,崇德,三等
2020-11-22,7040,30,31,61,崇德,三等
2020-11-23,7040,30,32,62,崇德,三等
2020-11-24,7040,31,27,58,崇德,三等
2020-11-25,7040,28,30,58,崇德,三等
2020-11-26,7040,27,32,59,崇德,三等
2020-11-27,7040,41,35,76,崇德,三等
2020-11-28,7040,16,19,35,崇德,三等
2020-11-29,7040,12,18,30,崇德,三等
2020-11-30,7040,21,37,58,崇德,三等
2020-12-01,7040,22,21,43,崇德,三等
2020-12-02,7040,31,32,63,崇德,三等
2020-12-03,7040,30,25,55,崇德,三等
2020-12-04,7040,29,27,56,崇德,三等
2020-12-05,7040,40,33,73,崇德,三等
2020-12-06,7040,14,15,29,崇德,三等
2020-12-07,7040,23,28,51,崇德,三等
2020-12-08,7040,17,26,43,崇德,三等
2020-12-09,7040,28,29,57,崇德,三等
2020-12-10,7040,20,20,40,崇德,三等
2020-12-11,7040,33,33,66,崇德,三等
2020-12-12,7040,17,16,33,崇德,三等
2020-12-13,7040,67,11,78,崇德,三等
2020-12-14,7040,33,37,70,崇德,三等
2020-12-15,7040,30,26,56,崇德,三等
2020-12-16,7040,25,24,49,崇德,三等
2020-12-17,7040,27,27,54,崇德,三等
2020-12-18,7040,31,29,60,崇德,三等
2020-12-19,7040,13,20,33,崇德,三等
2020-12-20,7040,12,11,23,崇德,三等
2020-12-21,7040,26,33,59,崇德,三等
2020-12-22,7040,35,35,70,崇德,三等
2020-12-23,7040,30,37,67,崇德,三等
2020-12-24,7040,29,35,64,崇德,三等
2020-12-25,7040,31,28,59,崇德,三等
2020-12-26,7040,14,15,29,崇德,三等
2020-12-27,7040,20,16,36,崇德,三等
2020-12-28,7040,21,22,43,崇德,三等
2020-12-29,7040,16,17,33,崇德,三等
2020-12-30,7040,30,25,55,崇德,三等
2020-12-31,7040,37,33,70,崇德,三等
2020-01-01,7050,46,58,104,和仁,三等
2020-01-02,7050,84,94,178,和仁,三等
2020-01-03,7050,74,88,162,和仁,三等
2020-01-04,7050,36,37,73,和仁,三等
2020-01-05,7050,25,42,67,和仁,三等
2020-01-06,7050,70,83,153,和仁,三等
2020-01-07,7050,75,84,159,和仁,三等
2020-01-08,7050,75,74,149,和仁,三等
2020-01-09,7050,81,92,173,和仁,三等
2020-01-10,7050,78,83,161,和仁,三等
2020-01-11,7050,28,38,66,和仁,三等
2020-01-12,7050,26,27,53,和仁,三等
2020-01-13,7050,65,92,157,和仁,三等
2020-01-14,7050,69,77,146,和仁,三等
2020-01-15,7050,69,73,142,和仁,三等
2020-01-16,7050,74,88,162,和仁,三等
2020-01-17,7050,82,96,178,和仁,三等
2020-01-18,7050,29,42,71,和仁,三等
2020-01-19,7050,19,32,51,和仁,三等
2020-01-20,7050,58,80,138,和仁,三等
2020-01-21,7050,66,77,143,和仁,三等
2020-01-22,7050,56,65,121,和仁,三等
2020-01-23,7050,33,35,68,和仁,三等
2020-01-24,7050,15,23,38,和仁,三等
2020-01-25,7050,12,16,28,和仁,三等
2020-01-26,7050,14,12,26,和仁,三等
2020-01-27,7050,10,14,24,和仁,三等
2020-01-28,7050,13,16,29,和仁,三等
2020-01-29,7050,21,31,52,和仁,三等
2020-01-30,7050,73,90,163,和仁,三等
2020-01-31,7050,72,91,163,和仁,三等
2020-02-01,7050,43,45,88,和仁,三等
2020-02-02,7050,30,38,68,和仁,三等
2020-02-03,7050,71,95,166,和仁,三等
2020-02-04,7050,71,89,160,和仁,三等
2020-02-05,7050,78,91,169,和仁,三等
2020-02-06,7050,71,78,149,和仁,三等
2020-02-07,7050,63,75,138,和仁,三等
2020-02-08,7050,24,20,44,和仁,三等
2020-02-09,7050,23,31,54,和仁,三等
2020-02-10,7050,65,80,145,和仁,三等
2020-02-11,7050,62,73,135,和仁,三等
2020-02-12,7050,75,78,153,和仁,三等
2020-02-13,7050,62,69,131,和仁,三等
2020-02-14,7050,70,78,148,和仁,三等
2020-02-15,7050,27,35,62,和仁,三等
2020-02-16,7050,15,21,36,和仁,三等
2020-02-17,7050,62,71,133,和仁,三等
2020-02-18,7050,62,72,134,和仁,三等
2020-02-19,7050,66,74,140,和仁,三等
2020-02-20,7050,72,82,154,和仁,三等
2020-02-21,7050,69,77,146,和仁,三等
2020-02-22,7050,22,26,48,和仁,三等
2020-02-23,7050,22,33,55,和仁,三等
2020-02-24,7050,59,72,131,和仁,三等
2020-02-25,7050,73,83,156,和仁,三等
2020-02-26,7050,63,78,141,和仁,三等
2020-02-27,7050,74,84,158,和仁,三等
2020-02-28,7050,51,63,114,和仁,三等
2020-02-29,7050,39,37,76,和仁,三等
2020-03-01,7050,28,29,57,和仁,三等
2020-03-02,7050,86,83,169,和仁,三等
2020-03-03,7050,77,81,158,和仁,三等
2020-03-04,7050,78,74,152,和仁,三等
2020-03-05,7050,79,96,175,和仁,三等
2020-03-06,7050,82,80,162,和仁,三等
2020-03-07,7050,18,28,46,和仁,三等
2020-03-08,7050,24,32,56,和仁,三等
2020-03-09,7050,75,85,160,和仁,三等
2020-03-10,7050,79,87,166,和仁,三等
2020-03-11,7050,75,85,160,和仁,三等
2020-03-12,7050,78,84,162,和仁,三等
2020-03-13,7050,76,87,163,和仁,三等
2020-03-14,7050,29,39,68,和仁,三等
2020-03-15,7050,18,16,34,和仁,三等
2020-03-16,7050,79,86,165,和仁,三等
2020-03-17,7050,78,87,165,和仁,三等
2020-03-18,7050,79,85,164,和仁,三等
2020-03-19,7050,71,84,155,和仁,三等
2020-03-20,7050,71,85,156,和仁,三等
2020-03-21,7050,26,35,61,和仁,三等
2020-03-22,7050,28,25,53,和仁,三等
2020-03-23,7050,74,86,160,和仁,三等
2020-03-24,7050,76,86,162,和仁,三等
2020-03-25,7050,67,81,148,和仁,三等
2020-03-26,7050,78,94,172,和仁,三等
2020-03-27,7050,69,67,136,和仁,三等
2020-03-28,7050,54,59,113,和仁,三等
2020-03-29,7050,17,33,50,和仁,三等
2020-03-30,7050,74,75,149,和仁,三等
2020-03-31,7050,66,68,134,和仁,三等
2020-04-01,7050,64,67,131,和仁,三等
2020-04-02,7050,44,58,102,和仁,三等
2020-04-03,7050,38,46,84,和仁,三等
2020-04-04,7050,13,22,35,和仁,三等
2020-04-05,7050,32,33,65,和仁,三等
2020-04-06,7050,76,82,158,和仁,三等
2020-04-07,7050,76,72,148,和仁,三等
2020-04-08,7050,67,68,135,和仁,三等
2020-04-09,7050,69,80,149,和仁,三等
2020-04-10,7050,67,76,143,和仁,三等
2020-04-11,7050,24,29,53,和仁,三等
2020-04-12,7050,24,38,62,和仁,三等
2020-04-13,7050,69,77,146,和仁,三等
2020-04-14,7050,69,76,145,和仁,三等
2020-04-15,7050,71,82,153,和仁,三等
2020-04-16,7050,71,73,144,和仁,三等
2020-04-17,7050,64,69,133,和仁,三等
2020-04-18,7050,12,21,33,和仁,三等
2020-04-19,7050,19,25,44,和仁,三等
2020-04-20,7050,81,70,151,和仁,三等
2020-04-21,7050,79,80,159,和仁,三等
2020-04-22,7050,68,80,148,和仁,三等
2020-04-23,7050,71,79,150,和仁,三等
2020-04-24,7050,70,83,153,和仁,三等
2020-04-25,7050,29,30,59,和仁,三等
2020-04-26,7050,19,20,39,和仁,三等
2020-04-27,7050,76,77,153,和仁,三等
2020-04-28,7050,74,83,157,和仁,三等
2020-04-29,7050,56,70,126,和仁,三等
2020-04-30,7050,70,74,144,和仁,三等
2020-05-01,7050,45,51,96,和仁,三等
2020-05-02,7050,25,30,55,和仁,三等
2020-05-03,7050,18,29,47,和仁,三等
2020-05-04,7050,72,74,146,和仁,三等
2020-05-05,7050,66,72,138,和仁,三等
2020-05-06,7050,63,69,132,和仁,三等
2020-05-07,7050,71,82,153,和仁,三等
2020-05-08,7050,63,76,139,和仁,三等
2020-05-09,7050,29,30,59,和仁,三等
2020-05-10,7050,18,20,38,和仁,三等
2020-05-11,7050,64,73,137,和仁,三等
2020-05-12,7050,69,74,143,和仁,三等
2020-05-13,7050,66,68,134,和仁,三等
2020-05-14,7050,65,64,129,和仁,三等
2020-05-15,7050,66,77,143,和仁,三等
2020-05-16,7050,32,41,73,和仁,三等
2020-05-17,7050,38,42,80,和仁,三等
2020-05-18,7050,69,71,140,和仁,三等
2020-05-19,7050,63,64,127,和仁,三等
2020-05-20,7050,69,68,137,和仁,三等
2020-05-21,7050,69,76,145,和仁,三等
2020-05-22,7050,68,69,137,和仁,三等
2020-05-23,7050,25,25,50,和仁,三等
2020-05-24,7050,14,31,45,和仁,三等
2020-05-25,7050,66,73,139,和仁,三等
2020-05-26,7050,69,71,140,和仁,三等
2020-05-27,7050,66,69,135,和仁,三等
2020-05-28,7050,62,69,131,和仁,三等
2020-05-29,7050,66,69,135,和仁,三等
2020-05-30,7050,31,33,64,和仁,三等
2020-05-31,7050,24,34,58,和仁,三等
2020-06-01,7050,69,73,142,和仁,三等
2020-06-02,7050,66,72,138,和仁,三等
2020-06-03,7050,66,75,141,和仁,三等
2020-06-04,7050,67,75,142,和仁,三等
2020-06-05,7050,63,72,135,和仁,三等
2020-06-06,7050,40,31,71,和仁,三等
2020-06-07,7050,21,23,44,和仁,三等
2020-06-08,7050,62,77,139,和仁,三等
2020-06-09,7050,70,73,143,和仁,三等
2020-06-10,7050,63,72,135,和仁,三等
2020-06-11,7050,65,71,136,和仁,三等
2020-06-12,7050,76,84,160,和仁,三等
2020-06-13,7050,20,33,53,和仁,三等
2020-06-14,7050,18,30,48,和仁,三等
2020-06-15,7050,74,83,157,和仁,三等
2020-06-16,7050,64,73,137,和仁,三等
2020-06-17,7050,60,68,128,和仁,三等
2020-06-18,7050,61,73,134,和仁,三等
2020-06-19,7050,68,76,144,和仁,三等
2020-06-20,7050,29,34,63,和仁,三等
2020-06-21,7050,16,33,49,和仁,三等
2020-06-22,7050,61,71,132,和仁,三等
2020-06-23,7050,82,71,153,和仁,三等
2020-06-24,7050,65,74,139,和仁,三等
2020-06-25,7050,39,44,83,和仁,三等
2020-06-26,7050,50,60,110,和仁,三等
2020-06-27,7050,43,33,76,和仁,三等
2020-06-28,7050,18,24,42,和仁,三等
2020-06-29,7050,60,70,130,和仁,三等
2020-06-30,7050,67,73,140,和仁,三等
2020-07-01,7050,63,72,135,和仁,三等
2020-07-02,7050,64,87,151,和仁,三等
2020-07-03,7050,71,72,143,和仁,三等
2020-07-04,7050,40,31,71,和仁,三等
2020-07-05,7050,23,27,50,和仁,三等
2020-07-06,7050,60,72,132,和仁,三等
2020-07-07,7050,61,67,128,和仁,三等
2020-07-08,7050,61,66,127,和仁,三等
2020-07-09,7050,59,71,130,和仁,三等
2020-07-10,7050,64,68,132,和仁,三等
2020-07-11,7050,30,41,71,和仁,三等
2020-07-12,7050,29,27,56,和仁,三等
2020-07-13,7050,68,79,147,和仁,三等
2020-07-14,7050,74,69,143,和仁,三等
2020-07-15,7050,59,70,129,和仁,三等
2020-07-16,7050,55,58,113,和仁,三等
2020-07-17,7050,61,51,112,和仁,三等
2020-07-18,7050,22,45,67,和仁,三等
2020-07-19,7050,18,28,46,和仁,三等
2020-07-20,7050,54,82,136,和仁,三等
2020-07-21,7050,69,66,135,和仁,三等
2020-07-22,7050,51,69,120,和仁,三等
2020-07-23,7050,64,64,128,和仁,三等
2020-07-24,7050,54,61,115,和仁,三等
2020-07-25,7050,28,27,55,和仁,三等
2020-07-26,7050,23,23,46,和仁,三等
2020-07-27,7050,57,76,133,和仁,三等
2020-07-28,7050,58,60,118,和仁,三等
2020-07-29,7050,54,56,110,和仁,三等
2020-07-30,7050,55,60,115,和仁,三等
2020-07-31,7050,57,66,123,和仁,三等
2020-08-01,7050,28,33,61,和仁,三等
2020-08-02,7050,23,20,43,和仁,三等
2020-08-03,7050,52,60,112,和仁,三等
2020-08-04,7050,55,67,122,和仁,三等
2020-08-05,7050,61,71,132,和仁,三等
2020-08-06,7050,57,67,124,和仁,三等
2020-08-07,7050,60,60,120,和仁,三等
2020-08-08,7050,31,30,61,和仁,三等
2020-08-09,7050,22,35,57,和仁,三等
2020-08-10,7050,56,68,124,和仁,三等
2020-08-11,7050,52,53,105,和仁,三等
2020-08-12,7050,57,60,117,和仁,三等
2020-08-13,7050,57,62,119,和仁,三等
2020-08-14,7050,58,70,128,和仁,三等
2020-08-15,7050,26,31,57,和仁,三等
2020-08-16,7050,10,26,36,和仁,三等
2020-08-17,7050,61,73,134,和仁,三等
2020-08-18,7050,58,64,122,和仁,三等
2020-08-19,7050,56,61,117,和仁,三等
2020-08-20,7050,61,77,138,和仁,三等
2020-08-21,7050,62,61,123,和仁,三等
2020-08-22,7050,19,26,45,和仁,三等
2020-08-23,7050,39,44,83,和仁,三等
2020-08-24,7050,71,72,143,和仁,三等
2020-08-25,7050,55,64,119,和仁,三等
2020-08-26,7050,68,64,132,和仁,三等
2020-08-27,7050,62,66,128,和仁,三等
2020-08-28,7050,50,61,111,和仁,三等
2020-08-29,7050,21,29,50,和仁,三等
2020-08-30,7050,27,32,59,和仁,三等
2020-08-31,7050,70,81,151,和仁,三等
2020-09-01,7050,64,73,137,和仁,三等
2020-09-02,7050,59,69,128,和仁,三等
2020-09-03,7050,55,63,118,和仁,三等
2020-09-04,7050,63,63,126,和仁,三等
2020-09-05,7050,36,46,82,和仁,三等
2020-09-06,7050,32,27,59,和仁,三等
2020-09-07,7050,66,73,139,和仁,三等
2020-09-08,7050,60,64,124,和仁,三等
2020-09-09,7050,61,70,131,和仁,三等
2020-09-10,7050,63,69,132,和仁,三等
2020-09-11,7050,67,69,136,和仁,三等
2020-09-12,7050,23,27,50,和仁,三等
2020-09-13,7050,25,33,58,和仁,三等
2020-09-14,7050,63,76,139,和仁,三等
2020-09-15,7050,64,64,128,和仁,三等
2020-09-16,7050,63,65,128,和仁,三等
2020-09-17,7050,62,68,130,和仁,三等
2020-09-18,7050,60,68,128,和仁,三等
2020-09-19,7050,31,34,65,和仁,三等
2020-09-20,7050,24,31,55,和仁,三等
2020-09-21,7050,62,68,130,和仁,三等
2020-09-22,7050,62,65,127,和仁,三等
2020-09-23,7050,58,65,123,和仁,三等
2020-09-24,7050,54,69,123,和仁,三等
2020-09-25,7050,64,66,130,和仁,三等
2020-09-26,7050,37,39,76,和仁,三等
2020-09-27,7050,31,28,59,和仁,三等
2020-09-28,7050,58,67,125,和仁,三等
2020-09-29,7050,55,64,119,和仁,三等
2020-09-30,7050,56,71,127,和仁,三等
2020-10-01,7050,41,42,83,和仁,三等
2020-10-02,7050,25,29,54,和仁,三等
2020-10-03,7050,27,29,56,和仁,三等
2020-10-04,7050,28,24,52,和仁,三等
2020-10-05,7050,68,71,139,和仁,三等
2020-10-06,7050,56,64,120,和仁,三等
2020-10-07,7050,64,66,130,和仁,三等
2020-10-08,7050,54,74,128,和仁,三等
2020-10-09,7050,43,60,103,和仁,三等
2020-10-10,7050,35,37,72,和仁,三等
2020-10-11,7050,26,25,51,和仁,三等
2020-10-12,7050,59,67,126,和仁,三等
2020-10-13,7050,57,58,115,和仁,三等
2020-10-14,7050,72,67,139,和仁,三等
2020-10-15,7050,61,64,125,和仁,三等
2020-10-16,7050,56,66,122,和仁,三等
2020-10-17,7050,27,25,52,和仁,三等
2020-10-18,7050,28,31,59,和仁,三等
2020-10-19,7050,63,69,132,和仁,三等
2020-10-20,7050,58,66,124,和仁,三等
2020-10-21,7050,61,70,131,和仁,三等
2020-10-22,7050,67,64,131,和仁,三等
2020-10-23,7050,63,77,140,和仁,三等
2020-10-24,7050,18,35,53,和仁,三等
2020-10-25,7050,27,19,46,和仁,三等
2020-10-26,7050,55,71,126,和仁,三等
2020-10-27,7050,63,69,132,和仁,三等
2020-10-28,7050,63,67,130,和仁,三等
2020-10-29,7050,62,70,132,和仁,三等
2020-10-30,7050,67,70,137,和仁,三等
2020-10-31,7050,31,44,75,和仁,三等
2020-11-01,7050,38,26,64,和仁,三等
2020-11-02,7050,73,76,149,和仁,三等
2020-11-03,7050,62,66,128,和仁,三等
2020-11-04,7050,67,84,151,和仁,三等
2020-11-05,7050,62,73,135,和仁,三等
2020-11-06,7050,75,69,144,和仁,三等
2020-11-07,7050,30,38,68,和仁,三等
2020-11-08,7050,16,23,39,和仁,三等
2020-11-09,7050,75,84,159,和仁,三等
2020-11-10,7050,65,71,136,和仁,三等
2020-11-11,7050,58,60,118,和仁,三等
2020-11-12,7050,67,71,138,和仁,三等
2020-11-13,7050,64,72,136,和仁,三等
2020-11-14,7050,33,39,72,和仁,三等
2020-11-15,7050,29,20,49,和仁,三等
2020-11-16,7050,69,76,145,和仁,三等
2020-11-17,7050,55,62,117,和仁,三等
2020-11-18,7050,65,73,138,和仁,三等
2020-11-19,7050,57,68,125,和仁,三等
2020-11-20,7050,61,68,129,和仁,三等
2020-11-21,7050,24,32,56,和仁,三等
2020-11-22,7050,13,16,29,和仁,三等
2020-11-23,7050,67,75,142,和仁,三等
2020-11-24,7050,67,64,131,和仁,三等
2020-11-25,7050,63,66,129,和仁,三等
2020-11-26,7050,67,71,138,和仁,三等
2020-11-27,7050,73,62,135,和仁,三等
2020-11-28,7050,41,44,85,和仁,三等
2020-11-29,7050,29,27,56,和仁,三等
2020-11-30,7050,64,67,131,和仁,三等
2020-12-01,7050,66,67,133,和仁,三等
2020-12-02,7050,61,70,131,和仁,三等
2020-12-03,7050,74,65,139,和仁,三等
2020-12-04,7050,63,64,127,和仁,三等
2020-12-05,7050,18,37,55,和仁,三等
2020-12-06,7050,22,21,43,和仁,三等
2020-12-07,7050,58,73,131,和仁,三等
2020-12-08,7050,65,61,126,和仁,三等
2020-12-09,7050,58,60,118,和仁,三等
2020-12-10,7050,60,62,122,和仁,三等
2020-12-11,7050,63,66,129,和仁,三等
2020-12-12,7050,20,22,42,和仁,三等
2020-12-13,7050,27,119,146,和仁,三等
2020-12-14,7050,58,75,133,和仁,三等
2020-12-15,7050,60,61,121,和仁,三等
2020-12-16,7050,70,66,136,和仁,三等
2020-12-17,7050,52,58,110,和仁,三等
2020-12-18,7050,59,64,123,和仁,三等
2020-12-19,7050,32,44,76,和仁,三等
2020-12-20,7050,41,44,85,和仁,三等
2020-12-21,7050,68,62,130,和仁,三等
2020-12-22,7050,67,71,138,和仁,三等
2020-12-23,7050,57,64,121,和仁,三等
2020-12-24,7050,57,60,117,和仁,三等
2020-12-25,7050,60,71,131,和仁,三等
2020-12-26,7050,27,29,56,和仁,三等
2020-12-27,7050,14,22,36,和仁,三等
2020-12-28,7050,59,65,124,和仁,三等
2020-12-29,7050,65,68,133,和仁,三等
2020-12-30,7050,65,76,141,和仁,三等
2020-12-31,7050,59,63,122,和仁,三等
2020-01-01,7060,716,772,1488,和平,二等
2020-01-02,7060,905,907,1812,和平,二等
2020-01-03,7060,975,973,1948,和平,二等
2020-01-04,7060,330,366,696,和平,二等
2020-01-05,7060,283,324,607,和平,二等
2020-01-06,7060,972,1006,1978,和平,二等
2020-01-07,7060,907,925,1832,和平,二等
2020-01-08,7060,872,1007,1879,和平,二等
2020-01-09,7060,913,920,1833,和平,二等
2020-01-10,7060,974,916,1890,和平,二等
2020-01-11,7060,275,320,595,和平,二等
2020-01-12,7060,232,322,554,和平,二等
2020-01-13,7060,917,978,1895,和平,二等
2020-01-14,7060,945,931,1876,和平,二等
2020-01-15,7060,891,927,1818,和平,二等
2020-01-16,7060,895,922,1817,和平,二等
2020-01-17,7060,896,900,1796,和平,二等
2020-01-18,7060,347,351,698,和平,二等
2020-01-19,7060,271,302,573,和平,二等
2020-01-20,7060,853,965,1818,和平,二等
2020-01-21,7060,863,854,1717,和平,二等
2020-01-22,7060,831,841,1672,和平,二等
2020-01-23,7060,665,747,1412,和平,二等
2020-01-24,7060,573,598,1171,和平,二等
2020-01-25,7060,359,325,684,和平,二等
2020-01-26,7060,257,304,561,和平,二等
2020-01-27,7060,744,717,1461,和平,二等
2020-01-28,7060,756,761,1517,和平,二等
2020-01-29,7060,695,751,1446,和平,二等
2020-01-30,7060,819,897,1716,和平,二等
2020-01-31,7060,854,874,1728,和平,二等
2020-02-01,7060,311,328,639,和平,二等
2020-02-02,7060,280,328,608,和平,二等
2020-02-03,7060,860,895,1755,和平,二等
2020-02-04,7060,819,819,1638,和平,二等
2020-02-05,7060,839,831,1670,和平,二等
2020-02-06,7060,864,882,1746,和平,二等
2020-02-07,7060,943,864,1807,和平,二等
2020-02-08,7060,339,348,687,和平,二等
2020-02-09,7060,193,256,449,和平,二等
2020-02-10,7060,831,898,1729,和平,二等
2020-02-11,7060,839,864,1703,和平,二等
2020-02-12,7060,834,857,1691,和平,二等
2020-02-13,7060,808,784,1592,和平,二等
2020-02-14,7060,852,822,1674,和平,二等
2020-02-15,7060,383,350,733,和平,二等
2020-02-16,7060,176,208,384,和平,二等
2020-02-17,7060,782,754,1536,和平,二等
2020-02-18,7060,780,803,1583,和平,二等
2020-02-19,7060,768,794,1562,和平,二等
2020-02-20,7060,772,772,1544,和平,二等
2020-02-21,7060,828,794,1622,和平,二等
2020-02-22,7060,221,226,447,和平,二等
2020-02-23,7060,172,204,376,和平,二等
2020-02-24,7060,776,839,1615,和平,二等
2020-02-25,7060,871,859,1730,和平,二等
2020-02-26,7060,647,660,1307,和平,二等
2020-02-27,7060,766,784,1550,和平,二等
2020-02-28,7060,549,542,1091,和平,二等
2020-02-29,7060,261,246,507,和平,二等
2020-03-01,7060,238,242,480,和平,二等
2020-03-02,7060,860,902,1762,和平,二等
2020-03-03,7060,859,853,1712,和平,二等
2020-03-04,7060,817,847,1664,和平,二等
2020-03-05,7060,835,864,1699,和平,二等
2020-03-06,7060,935,888,1823,和平,二等
2020-03-07,7060,253,272,525,和平,二等
2020-03-08,7060,184,208,392,和平,二等
2020-03-09,7060,897,923,1820,和平,二等
2020-03-10,7060,877,898,1775,和平,二等
2020-03-11,7060,897,873,1770,和平,二等
2020-03-12,7060,884,903,1787,和平,二等
2020-03-13,7060,925,920,1845,和平,二等
2020-03-14,7060,246,262,508,和平,二等
2020-03-15,7060,210,228,438,和平,二等
2020-03-16,7060,902,918,1820,和平,二等
2020-03-17,7060,897,925,1822,和平,二等
2020-03-18,7060,880,878,1758,和平,二等
2020-03-19,7060,866,869,1735,和平,二等
2020-03-20,7060,951,900,1851,和平,二等
2020-03-21,7060,255,268,523,和平,二等
2020-03-22,7060,186,210,396,和平,二等
2020-03-23,7060,867,899,1766,和平,二等
2020-03-24,7060,855,865,1720,和平,二等
2020-03-25,7060,808,863,1671,和平,二等
2020-03-26,7060,834,859,1693,和平,二等
2020-03-27,7060,902,876,1778,和平,二等
2020-03-28,7060,220,238,458,和平,二等
2020-03-29,7060,185,203,388,和平,二等
2020-03-30,7060,832,870,1702,和平,二等
2020-03-31,7060,779,809,1588,和平,二等
2020-04-01,7060,874,866,1740,和平,二等
2020-04-02,7060,690,779,1469,和平,二等
2020-04-03,7060,704,713,1417,和平,二等
2020-04-04,7060,173,174,347,和平,二等
2020-04-05,7060,216,187,403,和平,二等
2020-04-06,7060,848,869,1717,和平,二等
2020-04-07,7060,827,811,1638,和平,二等
2020-04-08,7060,804,792,1596,和平,二等
2020-04-09,7060,785,810,1595,和平,二等
2020-04-10,7060,859,830,1689,和平,二等
2020-04-11,7060,195,238,433,和平,二等
2020-04-12,7060,154,173,327,和平,二等
2020-04-13,7060,823,831,1654,和平,二等
2020-04-14,7060,801,825,1626,和平,二等
2020-04-15,7060,794,820,1614,和平,二等
2020-04-16,7060,814,807,1621,和平,二等
2020-04-17,7060,830,827,1657,和平,二等
2020-04-18,7060,188,229,417,和平,二等
2020-04-19,7060,165,163,328,和平,二等
2020-04-20,7060,815,817,1632,和平,二等
2020-04-21,7060,795,821,1616,和平,二等
2020-04-22,7060,808,817,1625,和平,二等
2020-04-23,7060,816,821,1637,和平,二等
2020-04-24,7060,824,816,1640,和平,二等
2020-04-25,7060,227,250,477,和平,二等
2020-04-26,7060,173,168,341,和平,二等
2020-04-27,7060,674,707,1381,和平,二等
2020-04-28,7060,707,702,1409,和平,二等
2020-04-29,7060,546,553,1099,和平,二等
2020-04-30,7060,767,742,1509,和平,二等
2020-05-01,7060,759,764,1523,和平,二等
2020-05-02,7060,213,269,482,和平,二等
2020-05-03,7060,186,192,378,和平,二等
2020-05-04,7060,849,846,1695,和平,二等
2020-05-05,7060,787,804,1591,和平,二等
2020-05-06,7060,809,823,1632,和平,二等
2020-05-07,7060,809,832,1641,和平,二等
2020-05-08,7060,855,866,1721,和平,二等
2020-05-09,7060,245,244,489,和平,二等
2020-05-10,7060,197,187,384,和平,二等
2020-05-11,7060,834,852,1686,和平,二等
2020-05-12,7060,815,826,1641,和平,二等
2020-05-13,7060,787,821,1608,和平,二等
2020-05-14,7060,833,815,1648,和平,二等
2020-05-15,7060,864,867,1731,和平,二等
2020-05-16,7060,219,237,456,和平,二等
2020-05-17,7060,218,195,413,和平,二等
2020-05-18,7060,813,847,1660,和平,二等
2020-05-19,7060,826,803,1629,和平,二等
2020-05-20,7060,848,848,1696,和平,二等
2020-05-21,7060,843,850,1693,和平,二等
2020-05-22,7060,863,848,1711,和平,二等
2020-05-23,7060,180,186,366,和平,二等
2020-05-24,7060,175,170,345,和平,二等
2020-05-25,7060,803,836,1639,和平,二等
2020-05-26,7060,804,803,1607,和平,二等
2020-05-27,7060,814,813,1627,和平,二等
2020-05-28,7060,800,807,1607,和平,二等
2020-05-29,7060,810,821,1631,和平,二等
2020-05-30,7060,229,236,465,和平,二等
2020-05-31,7060,194,181,375,和平,二等
2020-06-01,7060,843,841,1684,和平,二等
2020-06-02,7060,798,816,1614,和平,二等
2020-06-03,7060,802,810,1612,和平,二等
2020-06-04,7060,754,772,1526,和平,二等
2020-06-05,7060,824,820,1644,和平,二等
2020-06-06,7060,193,219,412,和平,二等
2020-06-07,7060,204,212,416,和平,二等
2020-06-08,7060,799,832,1631,和平,二等
2020-06-09,7060,806,819,1625,和平,二等
2020-06-10,7060,806,823,1629,和平,二等
2020-06-11,7060,795,822,1617,和平,二等
2020-06-12,7060,930,917,1847,和平,二等
2020-06-13,7060,220,244,464,和平,二等
2020-06-14,7060,210,220,430,和平,二等
2020-06-15,7060,804,796,1600,和平,二等
2020-06-16,7060,794,806,1600,和平,二等
2020-06-17,7060,811,832,1643,和平,二等
2020-06-18,7060,811,861,1672,和平,二等
2020-06-19,7060,774,788,1562,和平,二等
2020-06-20,7060,314,293,607,和平,二等
2020-06-21,7060,208,222,430,和平,二等
2020-06-22,7060,837,823,1660,和平,二等
2020-06-23,7060,811,835,1646,和平,二等
2020-06-24,7060,839,840,1679,和平,二等
2020-06-25,7060,685,707,1392,和平,二等
2020-06-26,7060,594,609,1203,和平,二等
2020-06-27,7060,237,237,474,和平,二等
2020-06-28,7060,233,226,459,和平,二等
2020-06-29,7060,700,694,1394,和平,二等
2020-06-30,7060,760,797,1557,和平,二等
2020-07-01,7060,784,787,1571,和平,二等
2020-07-02,7060,801,806,1607,和平,二等
2020-07-03,7060,830,818,1648,和平,二等
2020-07-04,7060,256,301,557,和平,二等
2020-07-05,7060,223,218,441,和平,二等
2020-07-06,7060,834,855,1689,和平,二等
2020-07-07,7060,794,797,1591,和平,二等
2020-07-08,7060,786,805,1591,和平,二等
2020-07-09,7060,805,821,1626,和平,二等
2020-07-10,7060,859,851,1710,和平,二等
2020-07-11,7060,221,235,456,和平,二等
2020-07-12,7060,199,211,410,和平,二等
2020-07-13,7060,777,787,1564,和平,二等
2020-07-14,7060,822,793,1615,和平,二等
2020-07-15,7060,756,770,1526,和平,二等
2020-07-16,7060,769,803,1572,和平,二等
2020-07-17,7060,773,779,1552,和平,二等
2020-07-18,7060,257,291,548,和平,二等
2020-07-19,7060,253,206,459,和平,二等
2020-07-20,7060,784,805,1589,和平,二等
2020-07-21,7060,755,773,1528,和平,二等
2020-07-22,7060,766,736,1502,和平,二等
2020-07-23,7060,748,770,1518,和平,二等
2020-07-24,7060,789,740,1529,和平,二等
2020-07-25,7060,194,257,451,和平,二等
2020-07-26,7060,182,175,357,和平,二等
2020-07-27,7060,791,783,1574,和平,二等
2020-07-28,7060,760,777,1537,和平,二等
2020-07-29,7060,739,723,1462,和平,二等
2020-07-30,7060,730,735,1465,和平,二等
2020-07-31,7060,745,757,1502,和平,二等
2020-08-01,7060,222,230,452,和平,二等
2020-08-02,7060,190,181,371,和平,二等
2020-08-03,7060,739,742,1481,和平,二等
2020-08-04,7060,749,733,1482,和平,二等
2020-08-05,7060,744,748,1492,和平,二等
2020-08-06,7060,729,779,1508,和平,二等
2020-08-07,7060,829,758,1587,和平,二等
2020-08-08,7060,233,254,487,和平,二等
2020-08-09,7060,154,172,326,和平,二等
2020-08-10,7060,763,799,1562,和平,二等
2020-08-11,7060,736,725,1461,和平,二等
2020-08-12,7060,751,720,1471,和平,二等
2020-08-13,7060,742,726,1468,和平,二等
2020-08-14,7060,751,758,1509,和平,二等
2020-08-15,7060,312,326,638,和平,二等
2020-08-16,7060,177,168,345,和平,二等
2020-08-17,7060,753,753,1506,和平,二等
2020-08-18,7060,765,759,1524,和平,二等
2020-08-19,7060,754,748,1502,和平,二等
2020-08-20,7060,788,763,1551,和平,二等
2020-08-21,7060,796,774,1570,和平,二等
2020-08-22,7060,166,166,332,和平,二等
2020-08-23,7060,233,208,441,和平,二等
2020-08-24,7060,723,761,1484,和平,二等
2020-08-25,7060,742,753,1495,和平,二等
2020-08-26,7060,618,596,1214,和平,二等
2020-08-27,7060,546,544,1090,和平,二等
2020-08-28,7060,443,409,852,和平,二等
2020-08-29,7060,171,201,372,和平,二等
2020-08-30,7060,225,206,431,和平,二等
2020-08-31,7060,882,913,1795,和平,二等
2020-09-01,7060,828,806,1634,和平,二等
2020-09-02,7060,806,803,1609,和平,二等
2020-09-03,7060,831,837,1668,和平,二等
2020-09-04,7060,859,888,1747,和平,二等
2020-09-05,7060,194,260,454,和平,二等
2020-09-06,7060,214,199,413,和平,二等
2020-09-07,7060,866,850,1716,和平,二等
2020-09-08,7060,920,925,1845,和平,二等
2020-09-09,7060,814,844,1658,和平,二等
2020-09-10,7060,923,902,1825,和平,二等
2020-09-11,7060,895,906,1801,和平,二等
2020-09-12,7060,303,295,598,和平,二等
2020-09-13,7060,251,202,453,和平,二等
2020-09-14,7060,855,867,1722,和平,二等
2020-09-15,7060,826,817,1643,和平,二等
2020-09-16,7060,818,821,1639,和平,二等
2020-09-17,7060,818,829,1647,和平,二等
2020-09-18,7060,824,847,1671,和平,二等
2020-09-19,7060,230,277,507,和平,二等
2020-09-20,7060,516,474,990,和平,二等
2020-09-21,7060,835,831,1666,和平,二等
2020-09-22,7060,847,840,1687,和平,二等
2020-09-23,7060,828,839,1667,和平,二等
2020-09-24,7060,807,822,1629,和平,二等
2020-09-25,7060,819,828,1647,和平,二等
2020-09-26,7060,283,324,607,和平,二等
2020-09-27,7060,208,149,357,和平,二等
2020-09-28,7060,842,837,1679,和平,二等
2020-09-29,7060,789,808,1597,和平,二等
2020-09-30,7060,886,901,1787,和平,二等
2020-10-01,7060,650,662,1312,和平,二等
2020-10-02,7060,680,703,1383,和平,二等
2020-10-03,7060,211,220,431,和平,二等
2020-10-04,7060,234,216,450,和平,二等
2020-10-05,7060,894,911,1805,和平,二等
2020-10-06,7060,814,827,1641,和平,二等
2020-10-07,7060,817,819,1636,和平,二等
2020-10-08,7060,828,927,1755,和平,二等
2020-10-09,7060,728,731,1459,和平,二等
2020-10-10,7060,202,208,410,和平,二等
2020-10-11,7060,235,197,432,和平,二等
2020-10-12,7060,824,833,1657,和平,二等
2020-10-13,7060,804,804,1608,和平,二等
2020-10-14,7060,803,815,1618,和平,二等
2020-10-15,7060,813,794,1607,和平,二等
2020-10-16,7060,821,848,1669,和平,二等
2020-10-17,7060,162,164,326,和平,二等
2020-10-18,7060,177,164,341,和平,二等
2020-10-19,7060,863,885,1748,和平,二等
2020-10-20,7060,798,801,1599,和平,二等
2020-10-21,7060,809,781,1590,和平,二等
2020-10-22,7060,764,769,1533,和平,二等
2020-10-23,7060,845,892,1737,和平,二等
2020-10-24,7060,297,221,518,和平,二等
2020-10-25,7060,184,191,375,和平,二等
2020-10-26,7060,835,839,1674,和平,二等
2020-10-27,7060,794,793,1587,和平,二等
2020-10-28,7060,559,544,1103,和平,二等
2020-10-29,7060,467,474,941,和平,二等
2020-10-30,7060,585,609,1194,和平,二等
2020-10-31,7060,1028,1003,2031,和平,二等
2020-11-01,7060,185,189,374,和平,二等
2020-11-02,7060,796,803,1599,和平,二等
2020-11-03,7060,744,756,1500,和平,二等
2020-11-04,7060,741,750,1491,和平,二等
2020-11-05,7060,742,754,1496,和平,二等
2020-11-06,7060,817,834,1651,和平,二等
2020-11-07,7060,185,190,375,和平,二等
2020-11-08,7060,178,149,327,和平,二等
2020-11-09,7060,781,806,1587,和平,二等
2020-11-10,7060,734,755,1489,和平,二等
2020-11-11,7060,773,780,1553,和平,二等
2020-11-12,7060,770,758,1528,和平,二等
2020-11-13,7060,967,1123,2090,和平,二等
2020-11-14,7060,229,252,481,和平,二等
2020-11-15,7060,209,186,395,和平,二等
2020-11-16,7060,811,799,1610,和平,二等
2020-11-17,7060,810,819,1629,和平,二等
2020-11-18,7060,819,826,1645,和平,二等
2020-11-19,7060,808,809,1617,和平,二等
2020-11-20,7060,848,907,1755,和平,二等
2020-11-21,7060,196,206,402,和平,二等
2020-11-22,7060,213,199,412,和平,二等
2020-11-23,7060,816,810,1626,和平,二等
2020-11-24,7060,804,822,1626,和平,二等
2020-11-25,7060,824,804,1628,和平,二等
2020-11-26,7060,835,831,1666,和平,二等
2020-11-27,7060,850,883,1733,和平,二等
2020-11-28,7060,250,232,482,和平,二等
2020-11-29,7060,200,226,426,和平,二等
2020-11-30,7060,852,830,1682,和平,二等
2020-12-01,7060,790,822,1612,和平,二等
2020-12-02,7060,829,822,1651,和平,二等
2020-12-03,7060,806,806,1612,和平,二等
2020-12-04,7060,831,844,1675,和平,二等
2020-12-05,7060,218,237,455,和平,二等
2020-12-06,7060,184,213,397,和平,二等
2020-12-07,7060,864,821,1685,和平,二等
2020-12-08,7060,793,752,1545,和平,二等
2020-12-09,7060,804,803,1607,和平,二等
2020-12-10,7060,808,820,1628,和平,二等
2020-12-11,7060,797,825,1622,和平,二等
2020-12-12,7060,218,199,417,和平,二等
2020-12-13,7060,207,205,412,和平,二等
2020-12-14,7060,804,822,1626,和平,二等
2020-12-15,7060,749,761,1510,和平,二等
2020-12-16,7060,777,779,1556,和平,二等
2020-12-17,7060,799,812,1611,和平,二等
2020-12-18,7060,834,874,1708,和平,二等
2020-12-19,7060,212,175,387,和平,二等
2020-12-20,7060,197,172,369,和平,二等
2020-12-21,7060,784,779,1563,和平,二等
2020-12-22,7060,767,787,1554,和平,二等
2020-12-23,7060,754,783,1537,和平,二等
2020-12-24,7060,786,792,1578,和平,二等
2020-12-25,7060,789,809,1598,和平,二等
2020-12-26,7060,173,191,364,和平,二等
2020-12-27,7060,187,186,373,和平,二等
2020-12-28,7060,775,779,1554,和平,二等
2020-12-29,7060,765,780,1545,和平,二等
2020-12-30,7060,638,662,1300,和平,二等
2020-12-31,7060,779,770,1549,和平,二等
2020-01-01,7070,33,36,69,漢本,三等
2020-01-02,7070,11,21,32,漢本,三等
2020-01-03,7070,18,17,35,漢本,三等
2020-01-04,7070,16,18,34,漢本,三等
2020-01-05,7070,24,16,40,漢本,三等
2020-01-06,7070,14,20,34,漢本,三等
2020-01-07,7070,21,18,39,漢本,三等
2020-01-08,7070,8,18,26,漢本,三等
2020-01-09,7070,19,21,40,漢本,三等
2020-01-10,7070,28,15,43,漢本,三等
2020-01-11,7070,40,16,56,漢本,三等
2020-01-12,7070,13,12,25,漢本,三等
2020-01-13,7070,7,20,27,漢本,三等
2020-01-14,7070,11,11,22,漢本,三等
2020-01-15,7070,15,9,24,漢本,三等
2020-01-16,7070,14,15,29,漢本,三等
2020-01-17,7070,14,10,24,漢本,三等
2020-01-18,7070,20,13,33,漢本,三等
2020-01-19,7070,10,19,29,漢本,三等
2020-01-20,7070,10,10,20,漢本,三等
2020-01-21,7070,12,10,22,漢本,三等
2020-01-22,7070,3,7,10,漢本,三等
2020-01-23,7070,13,3,16,漢本,三等
2020-01-24,7070,3,4,7,漢本,三等
2020-01-25,7070,4,8,12,漢本,三等
2020-01-26,7070,4,1,5,漢本,三等
2020-01-27,7070,12,6,18,漢本,三等
2020-01-28,7070,14,13,27,漢本,三等
2020-01-29,7070,2,6,8,漢本,三等
2020-01-30,7070,9,5,14,漢本,三等
2020-01-31,7070,9,7,16,漢本,三等
2020-02-01,7070,8,13,21,漢本,三等
2020-02-02,7070,5,6,11,漢本,三等
2020-02-03,7070,8,9,17,漢本,三等
2020-02-04,7070,7,12,19,漢本,三等
2020-02-05,7070,11,14,25,漢本,三等
2020-02-06,7070,10,9,19,漢本,三等
2020-02-07,7070,12,12,24,漢本,三等
2020-02-08,7070,4,8,12,漢本,三等
2020-02-09,7070,10,10,20,漢本,三等
2020-02-10,7070,8,10,18,漢本,三等
2020-02-11,7070,25,18,43,漢本,三等
2020-02-12,7070,12,10,22,漢本,三等
2020-02-13,7070,13,12,25,漢本,三等
2020-02-14,7070,12,12,24,漢本,三等
2020-02-15,7070,9,11,20,漢本,三等
2020-02-16,7070,7,12,19,漢本,三等
2020-02-17,7070,13,20,33,漢本,三等
2020-02-18,7070,10,10,20,漢本,三等
2020-02-19,7070,14,13,27,漢本,三等
2020-02-20,7070,15,14,29,漢本,三等
2020-02-21,7070,13,10,23,漢本,三等
2020-02-22,7070,7,11,18,漢本,三等
2020-02-23,7070,3,7,10,漢本,三等
2020-02-24,7070,11,12,23,漢本,三等
2020-02-25,7070,12,17,29,漢本,三等
2020-02-26,7070,9,11,20,漢本,三等
2020-02-27,7070,9,9,18,漢本,三等
2020-02-28,7070,15,15,30,漢本,三等
2020-02-29,7070,20,18,38,漢本,三等
2020-03-01,7070,12,13,25,漢本,三等
2020-03-02,7070,8,13,21,漢本,三等
2020-03-03,7070,17,11,28,漢本,三等
2020-03-04,7070,17,13,30,漢本,三等
2020-03-05,7070,11,7,18,漢本,三等
2020-03-06,7070,11,10,21,漢本,三等
2020-03-07,7070,6,9,15,漢本,三等
2020-03-08,7070,6,8,14,漢本,三等
2020-03-09,7070,10,10,20,漢本,三等
2020-03-10,7070,17,17,34,漢本,三等
2020-03-11,7070,16,17,33,漢本,三等
2020-03-12,7070,9,11,20,漢本,三等
2020-03-13,7070,14,7,21,漢本,三等
2020-03-14,7070,3,6,9,漢本,三等
2020-03-15,7070,20,12,32,漢本,三等
2020-03-16,7070,9,15,24,漢本,三等
2020-03-17,7070,10,14,24,漢本,三等
2020-03-18,7070,13,11,24,漢本,三等
2020-03-19,7070,12,11,23,漢本,三等
2020-03-20,7070,11,13,24,漢本,三等
2020-03-21,7070,11,12,23,漢本,三等
2020-03-22,7070,12,5,17,漢本,三等
2020-03-23,7070,12,22,34,漢本,三等
2020-03-24,7070,12,9,21,漢本,三等
2020-03-25,7070,5,8,13,漢本,三等
2020-03-26,7070,9,8,17,漢本,三等
2020-03-27,7070,8,8,16,漢本,三等
2020-03-28,7070,31,31,62,漢本,三等
2020-03-29,7070,7,7,14,漢本,三等
2020-03-30,7070,11,12,23,漢本,三等
2020-03-31,7070,11,14,25,漢本,三等
2020-04-01,7070,6,7,13,漢本,三等
2020-04-02,7070,10,10,20,漢本,三等
2020-04-03,7070,16,11,27,漢本,三等
2020-04-04,7070,15,8,23,漢本,三等
2020-04-05,7070,2,2,4,漢本,三等
2020-04-06,7070,3,6,9,漢本,三等
2020-04-07,7070,6,9,15,漢本,三等
2020-04-08,7070,4,4,8,漢本,三等
2020-04-09,7070,8,11,19,漢本,三等
2020-04-10,7070,11,10,21,漢本,三等
2020-04-11,7070,15,13,28,漢本,三等
2020-04-12,7070,7,4,11,漢本,三等
2020-04-13,7070,10,11,21,漢本,三等
2020-04-14,7070,6,5,11,漢本,三等
2020-04-15,7070,5,7,12,漢本,三等
2020-04-16,7070,4,7,11,漢本,三等
2020-04-17,7070,5,9,14,漢本,三等
2020-04-18,7070,9,8,17,漢本,三等
2020-04-19,7070,6,5,11,漢本,三等
2020-04-20,7070,16,16,32,漢本,三等
2020-04-21,7070,17,22,39,漢本,三等
2020-04-22,7070,9,14,23,漢本,三等
2020-04-23,7070,4,8,12,漢本,三等
2020-04-24,7070,4,8,12,漢本,三等
2020-04-25,7070,14,20,34,漢本,三等
2020-04-26,7070,4,4,8,漢本,三等
2020-04-27,7070,5,4,9,漢本,三等
2020-04-28,7070,4,15,19,漢本,三等
2020-04-29,7070,5,8,13,漢本,三等
2020-04-30,7070,10,6,16,漢本,三等
2020-05-01,7070,1,2,3,漢本,三等
2020-05-02,7070,7,6,13,漢本,三等
2020-05-03,7070,11,4,15,漢本,三等
2020-05-04,7070,3,3,6,漢本,三等
2020-05-05,7070,4,9,13,漢本,三等
2020-05-06,7070,7,8,15,漢本,三等
2020-05-07,7070,9,9,18,漢本,三等
2020-05-08,7070,8,7,15,漢本,三等
2020-05-09,7070,14,13,27,漢本,三等
2020-05-10,7070,49,60,109,漢本,三等
2020-05-11,7070,13,21,34,漢本,三等
2020-05-12,7070,14,13,27,漢本,三等
2020-05-13,7070,20,21,41,漢本,三等
2020-05-14,7070,31,34,65,漢本,三等
2020-05-15,7070,8,15,23,漢本,三等
2020-05-16,7070,33,29,62,漢本,三等
2020-05-17,7070,33,29,62,漢本,三等
2020-05-18,7070,8,7,15,漢本,三等
2020-05-19,7070,20,16,36,漢本,三等
2020-05-20,7070,9,11,20,漢本,三等
2020-05-21,7070,17,22,39,漢本,三等
2020-05-22,7070,12,14,26,漢本,三等
2020-05-23,7070,6,6,12,漢本,三等
2020-05-24,7070,53,50,103,漢本,三等
2020-05-25,7070,15,11,26,漢本,三等
2020-05-26,7070,11,8,19,漢本,三等
2020-05-27,7070,10,12,22,漢本,三等
2020-05-28,7070,10,12,22,漢本,三等
2020-05-29,7070,12,15,27,漢本,三等
2020-05-30,7070,44,47,91,漢本,三等
2020-05-31,7070,16,15,31,漢本,三等
2020-06-01,7070,8,11,19,漢本,三等
2020-06-02,7070,7,7,14,漢本,三等
2020-06-03,7070,9,5,14,漢本,三等
2020-06-04,7070,7,8,15,漢本,三等
2020-06-05,7070,11,13,24,漢本,三等
2020-06-06,7070,10,6,16,漢本,三等
2020-06-07,7070,8,9,17,漢本,三等
2020-06-08,7070,6,5,11,漢本,三等
2020-06-09,7070,7,7,14,漢本,三等
2020-06-10,7070,3,3,6,漢本,三等
2020-06-11,7070,7,8,15,漢本,三等
2020-06-12,7070,9,10,19,漢本,三等
2020-06-13,7070,12,6,18,漢本,三等
2020-06-14,7070,13,3,16,漢本,三等
2020-06-15,7070,8,4,12,漢本,三等
2020-06-16,7070,2,8,10,漢本,三等
2020-06-17,7070,5,10,15,漢本,三等
2020-06-18,7070,6,7,13,漢本,三等
2020-06-19,7070,6,4,10,漢本,三等
2020-06-20,7070,9,13,22,漢本,三等
2020-06-21,7070,5,5,10,漢本,三等
2020-06-22,7070,5,11,16,漢本,三等
2020-06-23,7070,11,13,24,漢本,三等
2020-06-24,7070,8,10,18,漢本,三等
2020-06-25,7070,5,6,11,漢本,三等
2020-06-26,7070,14,8,22,漢本,三等
2020-06-27,7070,19,7,26,漢本,三等
2020-06-28,7070,7,5,12,漢本,三等
2020-06-29,7070,4,9,13,漢本,三等
2020-06-30,7070,9,7,16,漢本,三等
2020-07-01,7070,5,12,17,漢本,三等
2020-07-02,7070,7,6,13,漢本,三等
2020-07-03,7070,5,3,8,漢本,三等
2020-07-04,7070,12,13,25,漢本,三等
2020-07-05,7070,12,7,19,漢本,三等
2020-07-06,7070,3,9,12,漢本,三等
2020-07-07,7070,5,5,10,漢本,三等
2020-07-08,7070,8,5,13,漢本,三等
2020-07-09,7070,10,7,17,漢本,三等
2020-07-10,7070,7,10,17,漢本,三等
2020-07-11,7070,6,7,13,漢本,三等
2020-07-12,7070,6,3,9,漢本,三等
2020-07-13,7070,8,8,16,漢本,三等
2020-07-14,7070,6,7,13,漢本,三等
2020-07-15,7070,9,9,18,漢本,三等
2020-07-16,7070,3,5,8,漢本,三等
2020-07-17,7070,7,7,14,漢本,三等
2020-07-18,7070,10,4,14,漢本,三等
2020-07-19,7070,3,2,5,漢本,三等
2020-07-20,7070,9,5,14,漢本,三等
2020-07-21,7070,3,4,7,漢本,三等
2020-07-22,7070,3,6,9,漢本,三等
2020-07-23,7070,7,7,14,漢本,三等
2020-07-24,7070,15,8,23,漢本,三等
2020-07-25,7070,4,3,7,漢本,三等
2020-07-26,7070,3,6,9,漢本,三等
2020-07-27,7070,4,3,7,漢本,三等
2020-07-28,7070,7,11,18,漢本,三等
2020-07-29,7070,2,2,4,漢本,三等
2020-07-30,7070,2,5,7,漢本,三等
2020-07-31,7070,6,4,10,漢本,三等
2020-08-01,7070,7,9,16,漢本,三等
2020-08-02,7070,7,6,13,漢本,三等
2020-08-03,7070,4,9,13,漢本,三等
2020-08-04,7070,7,6,13,漢本,三等
2020-08-05,7070,2,4,6,漢本,三等
2020-08-06,7070,6,6,12,漢本,三等
2020-08-07,7070,4,4,8,漢本,三等
2020-08-08,7070,10,7,17,漢本,三等
2020-08-09,7070,7,4,11,漢本,三等
2020-08-10,7070,9,9,18,漢本,三等
2020-08-11,7070,4,5,9,漢本,三等
2020-08-12,7070,7,6,13,漢本,三等
2020-08-13,7070,4,3,7,漢本,三等
2020-08-14,7070,4,6,10,漢本,三等
2020-08-15,7070,6,12,18,漢本,三等
2020-08-16,7070,10,4,14,漢本,三等
2020-08-17,7070,8,11,19,漢本,三等
2020-08-18,7070,6,6,12,漢本,三等
2020-08-19,7070,10,9,19,漢本,三等
2020-08-20,7070,10,13,23,漢本,三等
2020-08-21,7070,15,9,24,漢本,三等
2020-08-22,7070,5,5,10,漢本,三等
2020-08-23,7070,9,2,11,漢本,三等
2020-08-24,7070,7,11,18,漢本,三等
2020-08-25,7070,13,17,30,漢本,三等
2020-08-26,7070,14,8,22,漢本,三等
2020-08-27,7070,9,10,19,漢本,三等
2020-08-28,7070,10,9,19,漢本,三等
2020-08-29,7070,6,3,9,漢本,三等
2020-08-30,7070,4,2,6,漢本,三等
2020-08-31,7070,10,7,17,漢本,三等
2020-09-01,7070,9,8,17,漢本,三等
2020-09-02,7070,1,8,9,漢本,三等
2020-09-03,7070,5,4,9,漢本,三等
2020-09-04,7070,12,5,17,漢本,三等
2020-09-05,7070,2,3,5,漢本,三等
2020-09-06,7070,11,3,14,漢本,三等
2020-09-07,7070,8,6,14,漢本,三等
2020-09-08,7070,5,5,10,漢本,三等
2020-09-09,7070,9,4,13,漢本,三等
2020-09-10,7070,4,5,9,漢本,三等
2020-09-11,7070,9,8,17,漢本,三等
2020-09-12,7070,5,2,7,漢本,三等
2020-09-13,7070,4,1,5,漢本,三等
2020-09-14,7070,6,5,11,漢本,三等
2020-09-15,7070,6,5,11,漢本,三等
2020-09-16,7070,7,10,17,漢本,三等
2020-09-17,7070,10,7,17,漢本,三等
2020-09-18,7070,5,8,13,漢本,三等
2020-09-19,7070,8,9,17,漢本,三等
2020-09-20,7070,3,3,6,漢本,三等
2020-09-21,7070,7,7,14,漢本,三等
2020-09-22,7070,5,8,13,漢本,三等
2020-09-23,7070,8,8,16,漢本,三等
2020-09-24,7070,5,5,10,漢本,三等
2020-09-25,7070,8,7,15,漢本,三等
2020-09-26,7070,6,2,8,漢本,三等
2020-09-27,7070,6,5,11,漢本,三等
2020-09-28,7070,6,4,10,漢本,三等
2020-09-29,7070,5,6,11,漢本,三等
2020-09-30,7070,11,6,17,漢本,三等
2020-10-01,7070,7,9,16,漢本,三等
2020-10-02,7070,9,9,18,漢本,三等
2020-10-03,7070,18,3,21,漢本,三等
2020-10-04,7070,2,6,8,漢本,三等
2020-10-05,7070,7,5,12,漢本,三等
2020-10-06,7070,6,6,12,漢本,三等
2020-10-07,7070,7,7,14,漢本,三等
2020-10-08,7070,12,10,22,漢本,三等
2020-10-09,7070,7,6,13,漢本,三等
2020-10-10,7070,8,7,15,漢本,三等
2020-10-11,7070,12,2,14,漢本,三等
2020-10-12,7070,6,6,12,漢本,三等
2020-10-13,7070,11,7,18,漢本,三等
2020-10-14,7070,16,14,30,漢本,三等
2020-10-15,7070,16,13,29,漢本,三等
2020-10-16,7070,4,7,11,漢本,三等
2020-10-17,7070,7,6,13,漢本,三等
2020-10-18,7070,7,18,25,漢本,三等
2020-10-19,7070,8,8,16,漢本,三等
2020-10-20,7070,18,13,31,漢本,三等
2020-10-21,7070,7,12,19,漢本,三等
2020-10-22,7070,5,4,9,漢本,三等
2020-10-23,7070,13,13,26,漢本,三等
2020-10-24,7070,10,11,21,漢本,三等
2020-10-25,7070,9,6,15,漢本,三等
2020-10-26,7070,7,11,18,漢本,三等
2020-10-27,7070,8,7,15,漢本,三等
2020-10-28,7070,5,5,10,漢本,三等
2020-10-29,7070,6,10,16,漢本,三等
2020-10-30,7070,11,8,19,漢本,三等
2020-10-31,7070,8,7,15,漢本,三等
2020-11-01,7070,4,4,8,漢本,三等
2020-11-02,7070,5,3,8,漢本,三等
2020-11-03,7070,5,8,13,漢本,三等
2020-11-04,7070,3,2,5,漢本,三等
2020-11-05,7070,5,5,10,漢本,三等
2020-11-06,7070,4,6,10,漢本,三等
2020-11-07,7070,7,4,11,漢本,三等
2020-11-08,7070,5,5,10,漢本,三等
2020-11-09,7070,6,8,14,漢本,三等
2020-11-10,7070,2,5,7,漢本,三等
2020-11-11,7070,6,5,11,漢本,三等
2020-11-12,7070,10,11,21,漢本,三等
2020-11-13,7070,5,12,17,漢本,三等
2020-11-14,7070,7,2,9,漢本,三等
2020-11-15,7070,7,6,13,漢本,三等
2020-11-16,7070,5,15,20,漢本,三等
2020-11-17,7070,10,11,21,漢本,三等
2020-11-18,7070,14,16,30,漢本,三等
2020-11-19,7070,8,8,16,漢本,三等
2020-11-20,7070,8,7,15,漢本,三等
2020-11-21,7070,3,5,8,漢本,三等
2020-11-22,7070,3,3,6,漢本,三等
2020-11-23,7070,11,47,58,漢本,三等
2020-11-24,7070,13,11,24,漢本,三等
2020-11-25,7070,8,8,16,漢本,三等
2020-11-26,7070,9,7,16,漢本,三等
2020-11-27,7070,7,10,17,漢本,三等
2020-11-28,7070,2,5,7,漢本,三等
2020-11-29,7070,4,1,5,漢本,三等
2020-11-30,7070,8,10,18,漢本,三等
2020-12-01,7070,6,8,14,漢本,三等
2020-12-02,7070,6,7,13,漢本,三等
2020-12-03,7070,5,6,11,漢本,三等
2020-12-04,7070,3,5,8,漢本,三等
2020-12-05,7070,5,3,8,漢本,三等
2020-12-06,7070,8,5,13,漢本,三等
2020-12-07,7070,8,6,14,漢本,三等
2020-12-08,7070,3,5,8,漢本,三等
2020-12-09,7070,5,5,10,漢本,三等
2020-12-10,7070,3,5,8,漢本,三等
2020-12-11,7070,6,5,11,漢本,三等
2020-12-12,7070,10,6,16,漢本,三等
2020-12-13,7070,8,4,12,漢本,三等
2020-12-14,7070,12,7,19,漢本,三等
2020-12-15,7070,8,6,14,漢本,三等
2020-12-16,7070,9,8,17,漢本,三等
2020-12-17,7070,11,14,25,漢本,三等
2020-12-18,7070,13,11,24,漢本,三等
2020-12-19,7070,8,10,18,漢本,三等
2020-12-20,7070,3,7,10,漢本,三等
2020-12-21,7070,8,8,16,漢本,三等
2020-12-22,7070,12,11,23,漢本,三等
2020-12-23,7070,5,9,14,漢本,三等
2020-12-24,7070,10,9,19,漢本,三等
2020-12-25,7070,5,9,14,漢本,三等
2020-12-26,7070,4,2,6,漢本,三等
2020-12-27,7070,4,5,9,漢本,三等
2020-12-28,7070,7,6,13,漢本,三等
2020-12-29,7070,8,4,12,漢本,三等
2020-12-30,7070,8,6,14,漢本,三等
2020-12-31,7070,7,7,14,漢本,三等
2020-01-01,7080,29,22,51,武塔,乙簡
2020-01-02,7080,16,26,42,武塔,乙簡
2020-01-03,7080,28,30,58,武塔,乙簡
2020-01-04,7080,16,22,38,武塔,乙簡
2020-01-05,7080,4,39,43,武塔,乙簡
2020-01-06,7080,17,21,38,武塔,乙簡
2020-01-07,7080,12,18,30,武塔,乙簡
2020-01-08,7080,19,20,39,武塔,乙簡
2020-01-09,7080,14,24,38,武塔,乙簡
2020-01-10,7080,23,32,55,武塔,乙簡
2020-01-11,7080,10,25,35,武塔,乙簡
2020-01-12,7080,14,5,19,武塔,乙簡
2020-01-13,7080,16,25,41,武塔,乙簡
2020-01-14,7080,19,26,45,武塔,乙簡
2020-01-15,7080,18,26,44,武塔,乙簡
2020-01-16,7080,20,21,41,武塔,乙簡
2020-01-17,7080,18,17,35,武塔,乙簡
2020-01-18,7080,2,10,12,武塔,乙簡
2020-01-19,7080,17,18,35,武塔,乙簡
2020-01-20,7080,8,18,26,武塔,乙簡
2020-01-21,7080,13,10,23,武塔,乙簡
2020-01-22,7080,9,12,21,武塔,乙簡
2020-01-23,7080,7,14,21,武塔,乙簡
2020-01-24,7080,15,16,31,武塔,乙簡
2020-01-25,7080,12,3,15,武塔,乙簡
2020-01-26,7080,15,14,29,武塔,乙簡
2020-01-27,7080,17,18,35,武塔,乙簡
2020-01-28,7080,10,11,21,武塔,乙簡
2020-01-29,7080,10,5,15,武塔,乙簡
2020-01-30,7080,18,10,28,武塔,乙簡
2020-01-31,7080,16,16,32,武塔,乙簡
2020-02-01,7080,9,25,34,武塔,乙簡
2020-02-02,7080,20,9,29,武塔,乙簡
2020-02-03,7080,16,20,36,武塔,乙簡
2020-02-04,7080,9,16,25,武塔,乙簡
2020-02-05,7080,19,20,39,武塔,乙簡
2020-02-06,7080,10,17,27,武塔,乙簡
2020-02-07,7080,8,13,21,武塔,乙簡
2020-02-08,7080,7,9,16,武塔,乙簡
2020-02-09,7080,9,4,13,武塔,乙簡
2020-02-10,7080,27,24,51,武塔,乙簡
2020-02-11,7080,15,21,36,武塔,乙簡
2020-02-12,7080,19,23,42,武塔,乙簡
2020-02-13,7080,24,26,50,武塔,乙簡
2020-02-14,7080,11,14,25,武塔,乙簡
2020-02-15,7080,12,13,25,武塔,乙簡
2020-02-16,7080,14,11,25,武塔,乙簡
2020-02-17,7080,17,25,42,武塔,乙簡
2020-02-18,7080,17,13,30,武塔,乙簡
2020-02-19,7080,25,21,46,武塔,乙簡
2020-02-20,7080,10,9,19,武塔,乙簡
2020-02-21,7080,15,12,27,武塔,乙簡
2020-02-22,7080,5,8,13,武塔,乙簡
2020-02-23,7080,6,2,8,武塔,乙簡
2020-02-24,7080,16,16,32,武塔,乙簡
2020-02-25,7080,22,18,40,武塔,乙簡
2020-02-26,7080,18,16,34,武塔,乙簡
2020-02-27,7080,19,15,34,武塔,乙簡
2020-02-28,7080,14,7,21,武塔,乙簡
2020-02-29,7080,14,15,29,武塔,乙簡
2020-03-01,7080,14,8,22,武塔,乙簡
2020-03-02,7080,22,25,47,武塔,乙簡
2020-03-03,7080,24,17,41,武塔,乙簡
2020-03-04,7080,17,18,35,武塔,乙簡
2020-03-05,7080,15,15,30,武塔,乙簡
2020-03-06,7080,18,25,43,武塔,乙簡
2020-03-07,7080,8,8,16,武塔,乙簡
2020-03-08,7080,13,6,19,武塔,乙簡
2020-03-09,7080,17,19,36,武塔,乙簡
2020-03-10,7080,15,26,41,武塔,乙簡
2020-03-11,7080,18,17,35,武塔,乙簡
2020-03-12,7080,13,17,30,武塔,乙簡
2020-03-13,7080,19,25,44,武塔,乙簡
2020-03-14,7080,4,3,7,武塔,乙簡
2020-03-15,7080,9,10,19,武塔,乙簡
2020-03-16,7080,15,18,33,武塔,乙簡
2020-03-17,7080,18,22,40,武塔,乙簡
2020-03-18,7080,13,14,27,武塔,乙簡
2020-03-19,7080,17,16,33,武塔,乙簡
2020-03-20,7080,16,16,32,武塔,乙簡
2020-03-21,7080,6,14,20,武塔,乙簡
2020-03-22,7080,10,2,12,武塔,乙簡
2020-03-23,7080,12,13,25,武塔,乙簡
2020-03-24,7080,15,14,29,武塔,乙簡
2020-03-25,7080,22,21,43,武塔,乙簡
2020-03-26,7080,15,17,32,武塔,乙簡
2020-03-27,7080,13,16,29,武塔,乙簡
2020-03-28,7080,26,35,61,武塔,乙簡
2020-03-29,7080,9,6,15,武塔,乙簡
2020-03-30,7080,16,18,34,武塔,乙簡
2020-03-31,7080,16,19,35,武塔,乙簡
2020-04-01,7080,14,19,33,武塔,乙簡
2020-04-02,7080,13,12,25,武塔,乙簡
2020-04-03,7080,10,11,21,武塔,乙簡
2020-04-04,7080,12,17,29,武塔,乙簡
2020-04-05,7080,13,4,17,武塔,乙簡
2020-04-06,7080,16,17,33,武塔,乙簡
2020-04-07,7080,12,17,29,武塔,乙簡
2020-04-08,7080,16,10,26,武塔,乙簡
2020-04-09,7080,14,14,28,武塔,乙簡
2020-04-10,7080,19,14,33,武塔,乙簡
2020-04-11,7080,5,7,12,武塔,乙簡
2020-04-12,7080,12,49,61,武塔,乙簡
2020-04-13,7080,17,17,34,武塔,乙簡
2020-04-14,7080,20,20,40,武塔,乙簡
2020-04-15,7080,14,18,32,武塔,乙簡
2020-04-16,7080,13,12,25,武塔,乙簡
2020-04-17,7080,14,15,29,武塔,乙簡
2020-04-18,7080,3,8,11,武塔,乙簡
2020-04-19,7080,5,6,11,武塔,乙簡
2020-04-20,7080,15,19,34,武塔,乙簡
2020-04-21,7080,15,22,37,武塔,乙簡
2020-04-22,7080,15,19,34,武塔,乙簡
2020-04-23,7080,15,14,29,武塔,乙簡
2020-04-24,7080,20,13,33,武塔,乙簡
2020-04-25,7080,5,12,17,武塔,乙簡
2020-04-26,7080,7,5,12,武塔,乙簡
2020-04-27,7080,23,23,46,武塔,乙簡
2020-04-28,7080,18,21,39,武塔,乙簡
2020-04-29,7080,21,21,42,武塔,乙簡
2020-04-30,7080,15,24,39,武塔,乙簡
2020-05-01,7080,12,24,36,武塔,乙簡
2020-05-02,7080,11,9,20,武塔,乙簡
2020-05-03,7080,23,10,33,武塔,乙簡
2020-05-04,7080,17,16,33,武塔,乙簡
2020-05-05,7080,16,20,36,武塔,乙簡
2020-05-06,7080,18,19,37,武塔,乙簡
2020-05-07,7080,18,13,31,武塔,乙簡
2020-05-08,7080,16,18,34,武塔,乙簡
2020-05-09,7080,17,23,40,武塔,乙簡
2020-05-10,7080,13,16,29,武塔,乙簡
2020-05-11,7080,18,21,39,武塔,乙簡
2020-05-12,7080,14,18,32,武塔,乙簡
2020-05-13,7080,15,18,33,武塔,乙簡
2020-05-14,7080,13,17,30,武塔,乙簡
2020-05-15,7080,16,20,36,武塔,乙簡
2020-05-16,7080,89,88,177,武塔,乙簡
2020-05-17,7080,16,10,26,武塔,乙簡
2020-05-18,7080,17,18,35,武塔,乙簡
2020-05-19,7080,13,12,25,武塔,乙簡
2020-05-20,7080,15,21,36,武塔,乙簡
2020-05-21,7080,16,13,29,武塔,乙簡
2020-05-22,7080,11,17,28,武塔,乙簡
2020-05-23,7080,6,19,25,武塔,乙簡
2020-05-24,7080,4,7,11,武塔,乙簡
2020-05-25,7080,11,12,23,武塔,乙簡
2020-05-26,7080,11,14,25,武塔,乙簡
2020-05-27,7080,12,12,24,武塔,乙簡
2020-05-28,7080,13,18,31,武塔,乙簡
2020-05-29,7080,10,12,22,武塔,乙簡
2020-05-30,7080,7,11,18,武塔,乙簡
2020-05-31,7080,9,4,13,武塔,乙簡
2020-06-01,7080,19,17,36,武塔,乙簡
2020-06-02,7080,17,19,36,武塔,乙簡
2020-06-03,7080,11,45,56,武塔,乙簡
2020-06-04,7080,49,27,76,武塔,乙簡
2020-06-05,7080,15,19,34,武塔,乙簡
2020-06-06,7080,4,15,19,武塔,乙簡
2020-06-07,7080,3,3,6,武塔,乙簡
2020-06-08,7080,18,17,35,武塔,乙簡
2020-06-09,7080,15,17,32,武塔,乙簡
2020-06-10,7080,15,15,30,武塔,乙簡
2020-06-11,7080,13,13,26,武塔,乙簡
2020-06-12,7080,14,13,27,武塔,乙簡
2020-06-13,7080,18,24,42,武塔,乙簡
2020-06-14,7080,10,16,26,武塔,乙簡
2020-06-15,7080,14,10,24,武塔,乙簡
2020-06-16,7080,14,12,26,武塔,乙簡
2020-06-17,7080,13,10,23,武塔,乙簡
2020-06-18,7080,10,52,62,武塔,乙簡
2020-06-19,7080,11,14,25,武塔,乙簡
2020-06-20,7080,5,10,15,武塔,乙簡
2020-06-21,7080,12,10,22,武塔,乙簡
2020-06-22,7080,10,17,27,武塔,乙簡
2020-06-23,7080,13,13,26,武塔,乙簡
2020-06-24,7080,13,14,27,武塔,乙簡
2020-06-25,7080,8,19,27,武塔,乙簡
2020-06-26,7080,10,12,22,武塔,乙簡
2020-06-27,7080,16,9,25,武塔,乙簡
2020-06-28,7080,15,12,27,武塔,乙簡
2020-06-29,7080,14,15,29,武塔,乙簡
2020-06-30,7080,16,13,29,武塔,乙簡
2020-07-01,7080,10,11,21,武塔,乙簡
2020-07-02,7080,12,15,27,武塔,乙簡
2020-07-03,7080,4,9,13,武塔,乙簡
2020-07-04,7080,1,10,11,武塔,乙簡
2020-07-05,7080,12,7,19,武塔,乙簡
2020-07-06,7080,15,13,28,武塔,乙簡
2020-07-07,7080,13,12,25,武塔,乙簡
2020-07-08,7080,13,11,24,武塔,乙簡
2020-07-09,7080,9,13,22,武塔,乙簡
2020-07-10,7080,10,11,21,武塔,乙簡
2020-07-11,7080,7,7,14,武塔,乙簡
2020-07-12,7080,10,0,10,武塔,乙簡
2020-07-13,7080,11,13,24,武塔,乙簡
2020-07-14,7080,8,15,23,武塔,乙簡
2020-07-15,7080,12,16,28,武塔,乙簡
2020-07-16,7080,17,10,27,武塔,乙簡
2020-07-17,7080,42,5,47,武塔,乙簡
2020-07-18,7080,3,15,18,武塔,乙簡
2020-07-19,7080,18,13,31,武塔,乙簡
2020-07-20,7080,10,13,23,武塔,乙簡
2020-07-21,7080,10,11,21,武塔,乙簡
2020-07-22,7080,6,13,19,武塔,乙簡
2020-07-23,7080,13,6,19,武塔,乙簡
2020-07-24,7080,7,11,18,武塔,乙簡
2020-07-25,7080,7,3,10,武塔,乙簡
2020-07-26,7080,9,18,27,武塔,乙簡
2020-07-27,7080,6,11,17,武塔,乙簡
2020-07-28,7080,17,18,35,武塔,乙簡
2020-07-29,7080,4,8,12,武塔,乙簡
2020-07-30,7080,19,15,34,武塔,乙簡
2020-07-31,7080,10,13,23,武塔,乙簡
2020-08-01,7080,5,8,13,武塔,乙簡
2020-08-02,7080,1,2,3,武塔,乙簡
2020-08-03,7080,7,16,23,武塔,乙簡
2020-08-04,7080,7,10,17,武塔,乙簡
2020-08-05,7080,6,11,17,武塔,乙簡
2020-08-06,7080,7,8,15,武塔,乙簡
2020-08-07,7080,10,9,19,武塔,乙簡
2020-08-08,7080,2,7,9,武塔,乙簡
2020-08-09,7080,6,5,11,武塔,乙簡
2020-08-10,7080,14,7,21,武塔,乙簡
2020-08-11,7080,9,5,14,武塔,乙簡
2020-08-12,7080,8,14,22,武塔,乙簡
2020-08-13,7080,8,37,45,武塔,乙簡
2020-08-14,7080,9,7,16,武塔,乙簡
2020-08-15,7080,6,11,17,武塔,乙簡
2020-08-16,7080,5,9,14,武塔,乙簡
2020-08-17,7080,10,14,24,武塔,乙簡
2020-08-18,7080,6,7,13,武塔,乙簡
2020-08-19,7080,12,22,34,武塔,乙簡
2020-08-20,7080,23,10,33,武塔,乙簡
2020-08-21,7080,7,6,13,武塔,乙簡
2020-08-22,7080,5,1,6,武塔,乙簡
2020-08-23,7080,8,5,13,武塔,乙簡
2020-08-24,7080,12,18,30,武塔,乙簡
2020-08-25,7080,3,13,16,武塔,乙簡
2020-08-26,7080,7,16,23,武塔,乙簡
2020-08-27,7080,8,9,17,武塔,乙簡
2020-08-28,7080,10,22,32,武塔,乙簡
2020-08-29,7080,7,17,24,武塔,乙簡
2020-08-30,7080,6,9,15,武塔,乙簡
2020-08-31,7080,19,11,30,武塔,乙簡
2020-09-01,7080,10,11,21,武塔,乙簡
2020-09-02,7080,11,17,28,武塔,乙簡
2020-09-03,7080,14,17,31,武塔,乙簡
2020-09-04,7080,10,14,24,武塔,乙簡
2020-09-05,7080,6,9,15,武塔,乙簡
2020-09-06,7080,5,4,9,武塔,乙簡
2020-09-07,7080,18,20,38,武塔,乙簡
2020-09-08,7080,16,19,35,武塔,乙簡
2020-09-09,7080,9,14,23,武塔,乙簡
2020-09-10,7080,8,14,22,武塔,乙簡
2020-09-11,7080,13,20,33,武塔,乙簡
2020-09-12,7080,4,9,13,武塔,乙簡
2020-09-13,7080,9,1,10,武塔,乙簡
2020-09-14,7080,12,16,28,武塔,乙簡
2020-09-15,7080,16,16,32,武塔,乙簡
2020-09-16,7080,14,17,31,武塔,乙簡
2020-09-17,7080,18,17,35,武塔,乙簡
2020-09-18,7080,16,16,32,武塔,乙簡
2020-09-19,7080,2,10,12,武塔,乙簡
2020-09-20,7080,8,6,14,武塔,乙簡
2020-09-21,7080,19,28,47,武塔,乙簡
2020-09-22,7080,20,16,36,武塔,乙簡
2020-09-23,7080,14,16,30,武塔,乙簡
2020-09-24,7080,18,22,40,武塔,乙簡
2020-09-25,7080,18,22,40,武塔,乙簡
2020-09-26,7080,12,15,27,武塔,乙簡
2020-09-27,7080,2,7,9,武塔,乙簡
2020-09-28,7080,21,22,43,武塔,乙簡
2020-09-29,7080,16,17,33,武塔,乙簡
2020-09-30,7080,17,27,44,武塔,乙簡
2020-10-01,7080,8,11,19,武塔,乙簡
2020-10-02,7080,7,11,18,武塔,乙簡
2020-10-03,7080,10,4,14,武塔,乙簡
2020-10-04,7080,9,7,16,武塔,乙簡
2020-10-05,7080,20,21,41,武塔,乙簡
2020-10-06,7080,21,26,47,武塔,乙簡
2020-10-07,7080,22,16,38,武塔,乙簡
2020-10-08,7080,19,22,41,武塔,乙簡
2020-10-09,7080,2,27,29,武塔,乙簡
2020-10-10,7080,5,7,12,武塔,乙簡
2020-10-11,7080,7,4,11,武塔,乙簡
2020-10-12,7080,16,21,37,武塔,乙簡
2020-10-13,7080,16,19,35,武塔,乙簡
2020-10-14,7080,17,18,35,武塔,乙簡
2020-10-15,7080,12,17,29,武塔,乙簡
2020-10-16,7080,20,21,41,武塔,乙簡
2020-10-17,7080,93,86,179,武塔,乙簡
2020-10-18,7080,2,11,13,武塔,乙簡
2020-10-19,7080,15,26,41,武塔,乙簡
2020-10-20,7080,24,24,48,武塔,乙簡
2020-10-21,7080,14,21,35,武塔,乙簡
2020-10-22,7080,10,14,24,武塔,乙簡
2020-10-23,7080,11,17,28,武塔,乙簡
2020-10-24,7080,3,10,13,武塔,乙簡
2020-10-25,7080,4,8,12,武塔,乙簡
2020-10-26,7080,16,17,33,武塔,乙簡
2020-10-27,7080,12,20,32,武塔,乙簡
2020-10-28,7080,16,16,32,武塔,乙簡
2020-10-29,7080,13,17,30,武塔,乙簡
2020-10-30,7080,10,24,34,武塔,乙簡
2020-10-31,7080,8,9,17,武塔,乙簡
2020-11-01,7080,6,7,13,武塔,乙簡
2020-11-02,7080,16,18,34,武塔,乙簡
2020-11-03,7080,13,17,30,武塔,乙簡
2020-11-04,7080,15,19,34,武塔,乙簡
2020-11-05,7080,14,13,27,武塔,乙簡
2020-11-06,7080,12,11,23,武塔,乙簡
2020-11-07,7080,5,6,11,武塔,乙簡
2020-11-08,7080,5,3,8,武塔,乙簡
2020-11-09,7080,16,18,34,武塔,乙簡
2020-11-10,7080,20,17,37,武塔,乙簡
2020-11-11,7080,18,19,37,武塔,乙簡
2020-11-12,7080,12,9,21,武塔,乙簡
2020-11-13,7080,13,14,27,武塔,乙簡
2020-11-14,7080,6,9,15,武塔,乙簡
2020-11-15,7080,21,18,39,武塔,乙簡
2020-11-16,7080,9,16,25,武塔,乙簡
2020-11-17,7080,14,16,30,武塔,乙簡
2020-11-18,7080,17,18,35,武塔,乙簡
2020-11-19,7080,10,16,26,武塔,乙簡
2020-11-20,7080,18,24,42,武塔,乙簡
2020-11-21,7080,13,15,28,武塔,乙簡
2020-11-22,7080,8,8,16,武塔,乙簡
2020-11-23,7080,23,13,36,武塔,乙簡
2020-11-24,7080,13,20,33,武塔,乙簡
2020-11-25,7080,13,14,27,武塔,乙簡
2020-11-26,7080,12,23,35,武塔,乙簡
2020-11-27,7080,11,28,39,武塔,乙簡
2020-11-28,7080,5,5,10,武塔,乙簡
2020-11-29,7080,7,7,14,武塔,乙簡
2020-11-30,7080,20,17,37,武塔,乙簡
2020-12-01,7080,10,16,26,武塔,乙簡
2020-12-02,7080,12,16,28,武塔,乙簡
2020-12-03,7080,15,17,32,武塔,乙簡
2020-12-04,7080,8,16,24,武塔,乙簡
2020-12-05,7080,3,9,12,武塔,乙簡
2020-12-06,7080,18,9,27,武塔,乙簡
2020-12-07,7080,11,21,32,武塔,乙簡
2020-12-08,7080,15,19,34,武塔,乙簡
2020-12-09,7080,15,14,29,武塔,乙簡
2020-12-10,7080,15,14,29,武塔,乙簡
2020-12-11,7080,14,14,28,武塔,乙簡
2020-12-12,7080,24,24,48,武塔,乙簡
2020-12-13,7080,1,5,6,武塔,乙簡
2020-12-14,7080,15,26,41,武塔,乙簡
2020-12-15,7080,12,10,22,武塔,乙簡
2020-12-16,7080,13,15,28,武塔,乙簡
2020-12-17,7080,10,19,29,武塔,乙簡
2020-12-18,7080,15,17,32,武塔,乙簡
2020-12-19,7080,19,10,29,武塔,乙簡
2020-12-20,7080,10,5,15,武塔,乙簡
2020-12-21,7080,10,14,24,武塔,乙簡
2020-12-22,7080,13,18,31,武塔,乙簡
2020-12-23,7080,23,20,43,武塔,乙簡
2020-12-24,7080,12,18,30,武塔,乙簡
2020-12-25,7080,15,35,50,武塔,乙簡
2020-12-26,7080,19,24,43,武塔,乙簡
2020-12-27,7080,8,9,17,武塔,乙簡
2020-12-28,7080,12,17,29,武塔,乙簡
2020-12-29,7080,12,15,27,武塔,乙簡
2020-12-30,7080,11,17,28,武塔,乙簡
2020-12-31,7080,11,13,24,武塔,乙簡
2020-01-01,7090,785,807,1592,南澳,三等
2020-01-02,7090,931,951,1882,南澳,三等
2020-01-03,7090,987,1070,2057,南澳,三等
2020-01-04,7090,828,777,1605,南澳,三等
2020-01-05,7090,678,581,1259,南澳,三等
2020-01-06,7090,970,973,1943,南澳,三等
2020-01-07,7090,931,965,1896,南澳,三等
2020-01-08,7090,901,938,1839,南澳,三等
2020-01-09,7090,900,925,1825,南澳,三等
2020-01-10,7090,1043,1127,2170,南澳,三等
2020-01-11,7090,785,899,1684,南澳,三等
2020-01-12,7090,660,537,1197,南澳,三等
2020-01-13,7090,928,914,1842,南澳,三等
2020-01-14,7090,984,997,1981,南澳,三等
2020-01-15,7090,966,959,1925,南澳,三等
2020-01-16,7090,1005,991,1996,南澳,三等
2020-01-17,7090,1011,966,1977,南澳,三等
2020-01-18,7090,677,704,1381,南澳,三等
2020-01-19,7090,559,615,1174,南澳,三等
2020-01-20,7090,867,872,1739,南澳,三等
2020-01-21,7090,947,970,1917,南澳,三等
2020-01-22,7090,912,924,1836,南澳,三等
2020-01-23,7090,737,974,1711,南澳,三等
2020-01-24,7090,552,755,1307,南澳,三等
2020-01-25,7090,762,859,1621,南澳,三等
2020-01-26,7090,785,873,1658,南澳,三等
2020-01-27,7090,994,829,1823,南澳,三等
2020-01-28,7090,889,718,1607,南澳,三等
2020-01-29,7090,695,606,1301,南澳,三等
2020-01-30,7090,863,825,1688,南澳,三等
2020-01-31,7090,766,739,1505,南澳,三等
2020-02-01,7090,560,624,1184,南澳,三等
2020-02-02,7090,512,529,1041,南澳,三等
2020-02-03,7090,799,774,1573,南澳,三等
2020-02-04,7090,778,881,1659,南澳,三等
2020-02-05,7090,723,796,1519,南澳,三等
2020-02-06,7090,724,720,1444,南澳,三等
2020-02-07,7090,765,768,1533,南澳,三等
2020-02-08,7090,527,511,1038,南澳,三等
2020-02-09,7090,458,432,890,南澳,三等
2020-02-10,7090,769,784,1553,南澳,三等
2020-02-11,7090,870,858,1728,南澳,三等
2020-02-12,7090,876,839,1715,南澳,三等
2020-02-13,7090,715,729,1444,南澳,三等
2020-02-14,7090,817,761,1578,南澳,三等
2020-02-15,7090,644,732,1376,南澳,三等
2020-02-16,7090,442,417,859,南澳,三等
2020-02-17,7090,752,761,1513,南澳,三等
2020-02-18,7090,767,764,1531,南澳,三等
2020-02-19,7090,743,725,1468,南澳,三等
2020-02-20,7090,749,785,1534,南澳,三等
2020-02-21,7090,787,843,1630,南澳,三等
2020-02-22,7090,481,523,1004,南澳,三等
2020-02-23,7090,373,333,706,南澳,三等
2020-02-24,7090,784,804,1588,南澳,三等
2020-02-25,7090,920,946,1866,南澳,三等
2020-02-26,7090,851,868,1719,南澳,三等
2020-02-27,7090,927,943,1870,南澳,三等
2020-02-28,7090,669,800,1469,南澳,三等
2020-02-29,7090,504,553,1057,南澳,三等
2020-03-01,7090,577,451,1028,南澳,三等
2020-03-02,7090,933,915,1848,南澳,三等
2020-03-03,7090,907,914,1821,南澳,三等
2020-03-04,7090,862,868,1730,南澳,三等
2020-03-05,7090,772,784,1556,南澳,三等
2020-03-06,7090,849,918,1767,南澳,三等
2020-03-07,7090,452,540,992,南澳,三等
2020-03-08,7090,490,355,845,南澳,三等
2020-03-09,7090,922,913,1835,南澳,三等
2020-03-10,7090,821,801,1622,南澳,三等
2020-03-11,7090,914,954,1868,南澳,三等
2020-03-12,7090,834,859,1693,南澳,三等
2020-03-13,7090,954,1034,1988,南澳,三等
2020-03-14,7090,430,478,908,南澳,三等
2020-03-15,7090,508,418,926,南澳,三等
2020-03-16,7090,864,851,1715,南澳,三等
2020-03-17,7090,847,881,1728,南澳,三等
2020-03-18,7090,867,867,1734,南澳,三等
2020-03-19,7090,804,829,1633,南澳,三等
2020-03-20,7090,855,901,1756,南澳,三等
2020-03-21,7090,529,608,1137,南澳,三等
2020-03-22,7090,417,345,762,南澳,三等
2020-03-23,7090,863,837,1700,南澳,三等
2020-03-24,7090,871,879,1750,南澳,三等
2020-03-25,7090,853,834,1687,南澳,三等
2020-03-26,7090,806,821,1627,南澳,三等
2020-03-27,7090,815,876,1691,南澳,三等
2020-03-28,7090,368,431,799,南澳,三等
2020-03-29,7090,435,350,785,南澳,三等
2020-03-30,7090,858,820,1678,南澳,三等
2020-03-31,7090,803,793,1596,南澳,三等
2020-04-01,7090,933,973,1906,南澳,三等
2020-04-02,7090,644,864,1508,南澳,三等
2020-04-03,7090,585,686,1271,南澳,三等
2020-04-04,7090,530,427,957,南澳,三等
2020-04-05,7090,583,329,912,南澳,三等
2020-04-06,7090,851,774,1625,南澳,三等
2020-04-07,7090,788,784,1572,南澳,三等
2020-04-08,7090,807,769,1576,南澳,三等
2020-04-09,7090,753,752,1505,南澳,三等
2020-04-10,7090,840,893,1733,南澳,三等
2020-04-11,7090,535,585,1120,南澳,三等
2020-04-12,7090,473,394,867,南澳,三等
2020-04-13,7090,792,782,1574,南澳,三等
2020-04-14,7090,788,772,1560,南澳,三等
2020-04-15,7090,827,824,1651,南澳,三等
2020-04-16,7090,845,865,1710,南澳,三等
2020-04-17,7090,907,937,1844,南澳,三等
2020-04-18,7090,480,546,1026,南澳,三等
2020-04-19,7090,519,412,931,南澳,三等
2020-04-20,7090,803,792,1595,南澳,三等
2020-04-21,7090,831,826,1657,南澳,三等
2020-04-22,7090,833,850,1683,南澳,三等
2020-04-23,7090,749,766,1515,南澳,三等
2020-04-24,7090,770,774,1544,南澳,三等
2020-04-25,7090,434,471,905,南澳,三等
2020-04-26,7090,352,318,670,南澳,三等
2020-04-27,7090,810,757,1567,南澳,三等
2020-04-28,7090,831,816,1647,南澳,三等
2020-04-29,7090,802,818,1620,南澳,三等
2020-04-30,7090,884,892,1776,南澳,三等
2020-05-01,7090,773,905,1678,南澳,三等
2020-05-02,7090,494,545,1039,南澳,三等
2020-05-03,7090,590,467,1057,南澳,三等
2020-05-04,7090,852,849,1701,南澳,三等
2020-05-05,7090,819,830,1649,南澳,三等
2020-05-06,7090,834,809,1643,南澳,三等
2020-05-07,7090,783,796,1579,南澳,三等
2020-05-08,7090,871,929,1800,南澳,三等
2020-05-09,7090,513,611,1124,南澳,三等
2020-05-10,7090,578,410,988,南澳,三等
2020-05-11,7090,855,804,1659,南澳,三等
2020-05-12,7090,835,852,1687,南澳,三等
2020-05-13,7090,836,784,1620,南澳,三等
2020-05-14,7090,829,845,1674,南澳,三等
2020-05-15,7090,879,907,1786,南澳,三等
2020-05-16,7090,507,536,1043,南澳,三等
2020-05-17,7090,404,386,790,南澳,三等
2020-05-18,7090,810,850,1660,南澳,三等
2020-05-19,7090,770,831,1601,南澳,三等
2020-05-20,7090,822,820,1642,南澳,三等
2020-05-21,7090,815,841,1656,南澳,三等
2020-05-22,7090,836,872,1708,南澳,三等
2020-05-23,7090,493,512,1005,南澳,三等
2020-05-24,7090,502,421,923,南澳,三等
2020-05-25,7090,850,817,1667,南澳,三等
2020-05-26,7090,778,801,1579,南澳,三等
2020-05-27,7090,842,840,1682,南澳,三等
2020-05-28,7090,771,774,1545,南澳,三等
2020-05-29,7090,868,906,1774,南澳,三等
2020-05-30,7090,550,645,1195,南澳,三等
2020-05-31,7090,558,392,950,南澳,三等
2020-06-01,7090,795,817,1612,南澳,三等
2020-06-02,7090,862,827,1689,南澳,三等
2020-06-03,7090,855,864,1719,南澳,三等
2020-06-04,7090,762,804,1566,南澳,三等
2020-06-05,7090,893,882,1775,南澳,三等
2020-06-06,7090,628,691,1319,南澳,三等
2020-06-07,7090,511,391,902,南澳,三等
2020-06-08,7090,866,865,1731,南澳,三等
2020-06-09,7090,825,820,1645,南澳,三等
2020-06-10,7090,855,845,1700,南澳,三等
2020-06-11,7090,920,900,1820,南澳,三等
2020-06-12,7090,929,938,1867,南澳,三等
2020-06-13,7090,558,635,1193,南澳,三等
2020-06-14,7090,631,554,1185,南澳,三等
2020-06-15,7090,889,863,1752,南澳,三等
2020-06-16,7090,819,830,1649,南澳,三等
2020-06-17,7090,874,877,1751,南澳,三等
2020-06-18,7090,817,822,1639,南澳,三等
2020-06-19,7090,943,962,1905,南澳,三等
2020-06-20,7090,644,718,1362,南澳,三等
2020-06-21,7090,555,483,1038,南澳,三等
2020-06-22,7090,871,833,1704,南澳,三等
2020-06-23,7090,880,901,1781,南澳,三等
2020-06-24,7090,924,1067,1991,南澳,三等
2020-06-25,7090,750,991,1741,南澳,三等
2020-06-26,7090,832,884,1716,南澳,三等
2020-06-27,7090,763,668,1431,南澳,三等
2020-06-28,7090,708,485,1193,南澳,三等
2020-06-29,7090,970,879,1849,南澳,三等
2020-06-30,7090,916,909,1825,南澳,三等
2020-07-01,7090,842,830,1672,南澳,三等
2020-07-02,7090,787,784,1571,南澳,三等
2020-07-03,7090,854,905,1759,南澳,三等
2020-07-04,7090,607,701,1308,南澳,三等
2020-07-05,7090,518,459,977,南澳,三等
2020-07-06,7090,900,903,1803,南澳,三等
2020-07-07,7090,797,809,1606,南澳,三等
2020-07-08,7090,805,784,1589,南澳,三等
2020-07-09,7090,764,809,1573,南澳,三等
2020-07-10,7090,934,996,1930,南澳,三等
2020-07-11,7090,691,759,1450,南澳,三等
2020-07-12,7090,614,556,1170,南澳,三等
2020-07-13,7090,782,752,1534,南澳,三等
2020-07-14,7090,788,847,1635,南澳,三等
2020-07-15,7090,791,810,1601,南澳,三等
2020-07-16,7090,811,819,1630,南澳,三等
2020-07-17,7090,812,807,1619,南澳,三等
2020-07-18,7090,595,682,1277,南澳,三等
2020-07-19,7090,547,466,1013,南澳,三等
2020-07-20,7090,753,788,1541,南澳,三等
2020-07-21,7090,807,811,1618,南澳,三等
2020-07-22,7090,800,774,1574,南澳,三等
2020-07-23,7090,719,755,1474,南澳,三等
2020-07-24,7090,793,826,1619,南澳,三等
2020-07-25,7090,558,580,1138,南澳,三等
2020-07-26,7090,556,438,994,南澳,三等
2020-07-27,7090,772,780,1552,南澳,三等
2020-07-28,7090,884,844,1728,南澳,三等
2020-07-29,7090,809,821,1630,南澳,三等
2020-07-30,7090,817,830,1647,南澳,三等
2020-07-31,7090,834,885,1719,南澳,三等
2020-08-01,7090,590,635,1225,南澳,三等
2020-08-02,7090,709,604,1313,南澳,三等
2020-08-03,7090,785,777,1562,南澳,三等
2020-08-04,7090,813,813,1626,南澳,三等
2020-08-05,7090,841,852,1693,南澳,三等
2020-08-06,7090,828,829,1657,南澳,三等
2020-08-07,7090,951,968,1919,南澳,三等
2020-08-08,7090,551,632,1183,南澳,三等
2020-08-09,7090,556,474,1030,南澳,三等
2020-08-10,7090,897,869,1766,南澳,三等
2020-08-11,7090,867,832,1699,南澳,三等
2020-08-12,7090,831,808,1639,南澳,三等
2020-08-13,7090,874,970,1844,南澳,三等
2020-08-14,7090,999,1001,2000,南澳,三等
2020-08-15,7090,915,947,1862,南澳,三等
2020-08-16,7090,635,560,1195,南澳,三等
2020-08-17,7090,885,907,1792,南澳,三等
2020-08-18,7090,873,838,1711,南澳,三等
2020-08-19,7090,808,795,1603,南澳,三等
2020-08-20,7090,854,842,1696,南澳,三等
2020-08-21,7090,831,838,1669,南澳,三等
2020-08-22,7090,507,506,1013,南澳,三等
2020-08-23,7090,471,462,933,南澳,三等
2020-08-24,7090,795,768,1563,南澳,三等
2020-08-25,7090,826,850,1676,南澳,三等
2020-08-26,7090,886,874,1760,南澳,三等
2020-08-27,7090,827,878,1705,南澳,三等
2020-08-28,7090,899,923,1822,南澳,三等
2020-08-29,7090,596,613,1209,南澳,三等
2020-08-30,7090,603,562,1165,南澳,三等
2020-08-31,7090,956,905,1861,南澳,三等
2020-09-01,7090,913,941,1854,南澳,三等
2020-09-02,7090,873,876,1749,南澳,三等
2020-09-03,7090,901,904,1805,南澳,三等
2020-09-04,7090,920,963,1883,南澳,三等
2020-09-05,7090,560,664,1224,南澳,三等
2020-09-06,7090,601,464,1065,南澳,三等
2020-09-07,7090,1003,928,1931,南澳,三等
2020-09-08,7090,887,907,1794,南澳,三等
2020-09-09,7090,904,879,1783,南澳,三等
2020-09-10,7090,886,863,1749,南澳,三等
2020-09-11,7090,931,989,1920,南澳,三等
2020-09-12,7090,585,681,1266,南澳,三等
2020-09-13,7090,637,520,1157,南澳,三等
2020-09-14,7090,852,831,1683,南澳,三等
2020-09-15,7090,914,919,1833,南澳,三等
2020-09-16,7090,937,906,1843,南澳,三等
2020-09-17,7090,904,915,1819,南澳,三等
2020-09-18,7090,912,974,1886,南澳,三等
2020-09-19,7090,591,676,1267,南澳,三等
2020-09-20,7090,641,531,1172,南澳,三等
2020-09-21,7090,862,812,1674,南澳,三等
2020-09-22,7090,869,880,1749,南澳,三等
2020-09-23,7090,917,922,1839,南澳,三等
2020-09-24,7090,850,847,1697,南澳,三等
2020-09-25,7090,893,901,1794,南澳,三等
2020-09-26,7090,774,774,1548,南澳,三等
2020-09-27,7090,511,441,952,南澳,三等
2020-09-28,7090,940,872,1812,南澳,三等
2020-09-29,7090,867,896,1763,南澳,三等
2020-09-30,7090,1057,1147,2204,南澳,三等
2020-10-01,7090,664,948,1612,南澳,三等
2020-10-02,7090,844,843,1687,南澳,三等
2020-10-03,7090,760,582,1342,南澳,三等
2020-10-04,7090,691,422,1113,南澳,三等
2020-10-05,7090,889,874,1763,南澳,三等
2020-10-06,7090,926,907,1833,南澳,三等
2020-10-07,7090,901,901,1802,南澳,三等
2020-10-08,7090,938,999,1937,南澳,三等
2020-10-09,7090,726,899,1625,南澳,三等
2020-10-10,7090,652,649,1301,南澳,三等
2020-10-11,7090,659,488,1147,南澳,三等
2020-10-12,7090,914,874,1788,南澳,三等
2020-10-13,7090,865,863,1728,南澳,三等
2020-10-14,7090,837,811,1648,南澳,三等
2020-10-15,7090,748,765,1513,南澳,三等
2020-10-16,7090,831,917,1748,南澳,三等
2020-10-17,7090,608,622,1230,南澳,三等
2020-10-18,7090,533,432,965,南澳,三等
2020-10-19,7090,886,890,1776,南澳,三等
2020-10-20,7090,892,897,1789,南澳,三等
2020-10-21,7090,938,864,1802,南澳,三等
2020-10-22,7090,835,859,1694,南澳,三等
2020-10-23,7090,857,1046,1903,南澳,三等
2020-10-24,7090,590,617,1207,南澳,三等
2020-10-25,7090,588,450,1038,南澳,三等
2020-10-26,7090,865,867,1732,南澳,三等
2020-10-27,7090,861,872,1733,南澳,三等
2020-10-28,7090,852,854,1706,南澳,三等
2020-10-29,7090,808,813,1621,南澳,三等
2020-10-30,7090,918,1003,1921,南澳,三等
2020-10-31,7090,532,602,1134,南澳,三等
2020-11-01,7090,695,591,1286,南澳,三等
2020-11-02,7090,906,873,1779,南澳,三等
2020-11-03,7090,786,782,1568,南澳,三等
2020-11-04,7090,860,852,1712,南澳,三等
2020-11-05,7090,810,857,1667,南澳,三等
2020-11-06,7090,909,1064,1973,南澳,三等
2020-11-07,7090,534,584,1118,南澳,三等
2020-11-08,7090,675,528,1203,南澳,三等
2020-11-09,7090,865,880,1745,南澳,三等
2020-11-10,7090,923,914,1837,南澳,三等
2020-11-11,7090,908,917,1825,南澳,三等
2020-11-12,7090,803,813,1616,南澳,三等
2020-11-13,7090,890,947,1837,南澳,三等
2020-11-14,7090,506,594,1100,南澳,三等
2020-11-15,7090,659,530,1189,南澳,三等
2020-11-16,7090,926,909,1835,南澳,三等
2020-11-17,7090,903,910,1813,南澳,三等
2020-11-18,7090,893,878,1771,南澳,三等
2020-11-19,7090,891,944,1835,南澳,三等
2020-11-20,7090,959,993,1952,南澳,三等
2020-11-21,7090,614,752,1366,南澳,三等
2020-11-22,7090,600,432,1032,南澳,三等
2020-11-23,7090,913,889,1802,南澳,三等
2020-11-24,7090,837,789,1626,南澳,三等
2020-11-25,7090,882,903,1785,南澳,三等
2020-11-26,7090,877,877,1754,南澳,三等
2020-11-27,7090,858,992,1850,南澳,三等
2020-11-28,7090,493,559,1052,南澳,三等
2020-11-29,7090,561,453,1014,南澳,三等
2020-11-30,7090,837,809,1646,南澳,三等
2020-12-01,7090,765,827,1592,南澳,三等
2020-12-02,7090,802,817,1619,南澳,三等
2020-12-03,7090,792,768,1560,南澳,三等
2020-12-04,7090,817,723,1540,南澳,三等
2020-12-05,7090,532,661,1193,南澳,三等
2020-12-06,7090,398,290,688,南澳,三等
2020-12-07,7090,768,770,1538,南澳,三等
2020-12-08,7090,751,731,1482,南澳,三等
2020-12-09,7090,784,748,1532,南澳,三等
2020-12-10,7090,769,778,1547,南澳,三等
2020-12-11,7090,898,1054,1952,南澳,三等
2020-12-12,7090,575,599,1174,南澳,三等
2020-12-13,7090,627,449,1076,南澳,三等
2020-12-14,7090,831,808,1639,南澳,三等
2020-12-15,7090,886,829,1715,南澳,三等
2020-12-16,7090,762,779,1541,南澳,三等
2020-12-17,7090,780,794,1574,南澳,三等
2020-12-18,7090,870,958,1828,南澳,三等
2020-12-19,7090,494,586,1080,南澳,三等
2020-12-20,7090,550,416,966,南澳,三等
2020-12-21,7090,821,810,1631,南澳,三等
2020-12-22,7090,825,832,1657,南澳,三等
2020-12-23,7090,803,826,1629,南澳,三等
2020-12-24,7090,823,836,1659,南澳,三等
2020-12-25,7090,895,959,1854,南澳,三等
2020-12-26,7090,436,492,928,南澳,三等
2020-12-27,7090,554,382,936,南澳,三等
2020-12-28,7090,854,829,1683,南澳,三等
2020-12-29,7090,919,906,1825,南澳,三等
2020-12-30,7090,846,820,1666,南澳,三等
2020-12-31,7090,823,933,1756,南澳,三等
2020-01-01,7100,183,127,310,東澳,二等
2020-01-02,7100,188,197,385,東澳,二等
2020-01-03,7100,260,324,584,東澳,二等
2020-01-04,7100,128,146,274,東澳,二等
2020-01-05,7100,111,130,241,東澳,二等
2020-01-06,7100,204,195,399,東澳,二等
2020-01-07,7100,199,189,388,東澳,二等
2020-01-08,7100,178,183,361,東澳,二等
2020-01-09,7100,190,198,388,東澳,二等
2020-01-10,7100,216,227,443,東澳,二等
2020-01-11,7100,137,138,275,東澳,二等
2020-01-12,7100,186,96,282,東澳,二等
2020-01-13,7100,219,202,421,東澳,二等
2020-01-14,7100,185,279,464,東澳,二等
2020-01-15,7100,284,201,485,東澳,二等
2020-01-16,7100,259,247,506,東澳,二等
2020-01-17,7100,174,287,461,東澳,二等
2020-01-18,7100,164,176,340,東澳,二等
2020-01-19,7100,187,177,364,東澳,二等
2020-01-20,7100,206,213,419,東澳,二等
2020-01-21,7100,227,217,444,東澳,二等
2020-01-22,7100,192,200,392,東澳,二等
2020-01-23,7100,150,198,348,東澳,二等
2020-01-24,7100,140,150,290,東澳,二等
2020-01-25,7100,174,191,365,東澳,二等
2020-01-26,7100,128,121,249,東澳,二等
2020-01-27,7100,161,162,323,東澳,二等
2020-01-28,7100,131,155,286,東澳,二等
2020-01-29,7100,138,164,302,東澳,二等
2020-01-30,7100,176,188,364,東澳,二等
2020-01-31,7100,169,182,351,東澳,二等
2020-02-01,7100,120,115,235,東澳,二等
2020-02-02,7100,113,113,226,東澳,二等
2020-02-03,7100,184,201,385,東澳,二等
2020-02-04,7100,160,164,324,東澳,二等
2020-02-05,7100,175,148,323,東澳,二等
2020-02-06,7100,151,157,308,東澳,二等
2020-02-07,7100,149,156,305,東澳,二等
2020-02-08,7100,109,112,221,東澳,二等
2020-02-09,7100,100,91,191,東澳,二等
2020-02-10,7100,164,159,323,東澳,二等
2020-02-11,7100,179,181,360,東澳,二等
2020-02-12,7100,158,158,316,東澳,二等
2020-02-13,7100,164,170,334,東澳,二等
2020-02-14,7100,174,161,335,東澳,二等
2020-02-15,7100,166,129,295,東澳,二等
2020-02-16,7100,84,80,164,東澳,二等
2020-02-17,7100,192,155,347,東澳,二等
2020-02-18,7100,151,154,305,東澳,二等
2020-02-19,7100,144,156,300,東澳,二等
2020-02-20,7100,182,167,349,東澳,二等
2020-02-21,7100,212,169,381,東澳,二等
2020-02-22,7100,113,128,241,東澳,二等
2020-02-23,7100,85,86,171,東澳,二等
2020-02-24,7100,159,165,324,東澳,二等
2020-02-25,7100,185,194,379,東澳,二等
2020-02-26,7100,206,190,396,東澳,二等
2020-02-27,7100,191,213,404,東澳,二等
2020-02-28,7100,157,195,352,東澳,二等
2020-02-29,7100,160,144,304,東澳,二等
2020-03-01,7100,120,93,213,東澳,二等
2020-03-02,7100,179,173,352,東澳,二等
2020-03-03,7100,199,193,392,東澳,二等
2020-03-04,7100,192,173,365,東澳,二等
2020-03-05,7100,180,180,360,東澳,二等
2020-03-06,7100,180,182,362,東澳,二等
2020-03-07,7100,113,116,229,東澳,二等
2020-03-08,7100,87,91,178,東澳,二等
2020-03-09,7100,200,185,385,東澳,二等
2020-03-10,7100,194,200,394,東澳,二等
2020-03-11,7100,167,164,331,東澳,二等
2020-03-12,7100,183,173,356,東澳,二等
2020-03-13,7100,178,190,368,東澳,二等
2020-03-14,7100,106,110,216,東澳,二等
2020-03-15,7100,132,126,258,東澳,二等
2020-03-16,7100,208,187,395,東澳,二等
2020-03-17,7100,213,201,414,東澳,二等
2020-03-18,7100,171,161,332,東澳,二等
2020-03-19,7100,161,171,332,東澳,二等
2020-03-20,7100,161,175,336,東澳,二等
2020-03-21,7100,116,120,236,東澳,二等
2020-03-22,7100,131,100,231,東澳,二等
2020-03-23,7100,173,168,341,東澳,二等
2020-03-24,7100,220,203,423,東澳,二等
2020-03-25,7100,164,172,336,東澳,二等
2020-03-26,7100,172,189,361,東澳,二等
2020-03-27,7100,162,186,348,東澳,二等
2020-03-28,7100,96,94,190,東澳,二等
2020-03-29,7100,87,78,165,東澳,二等
2020-03-30,7100,192,191,383,東澳,二等
2020-03-31,7100,171,181,352,東澳,二等
2020-04-01,7100,173,173,346,東澳,二等
2020-04-02,7100,191,199,390,東澳,二等
2020-04-03,7100,129,151,280,東澳,二等
2020-04-04,7100,112,113,225,東澳,二等
2020-04-05,7100,118,96,214,東澳,二等
2020-04-06,7100,181,167,348,東澳,二等
2020-04-07,7100,146,155,301,東澳,二等
2020-04-08,7100,181,174,355,東澳,二等
2020-04-09,7100,153,158,311,東澳,二等
2020-04-10,7100,163,169,332,東澳,二等
2020-04-11,7100,105,107,212,東澳,二等
2020-04-12,7100,87,79,166,東澳,二等
2020-04-13,7100,180,173,353,東澳,二等
2020-04-14,7100,158,180,338,東澳,二等
2020-04-15,7100,177,186,363,東澳,二等
2020-04-16,7100,174,181,355,東澳,二等
2020-04-17,7100,184,210,394,東澳,二等
2020-04-18,7100,122,166,288,東澳,二等
2020-04-19,7100,99,93,192,東澳,二等
2020-04-20,7100,187,195,382,東澳,二等
2020-04-21,7100,192,201,393,東澳,二等
2020-04-22,7100,173,206,379,東澳,二等
2020-04-23,7100,169,185,354,東澳,二等
2020-04-24,7100,166,204,370,東澳,二等
2020-04-25,7100,118,138,256,東澳,二等
2020-04-26,7100,109,117,226,東澳,二等
2020-04-27,7100,192,210,402,東澳,二等
2020-04-28,7100,176,186,362,東澳,二等
2020-04-29,7100,178,198,376,東澳,二等
2020-04-30,7100,177,202,379,東澳,二等
2020-05-01,7100,168,174,342,東澳,二等
2020-05-02,7100,128,144,272,東澳,二等
2020-05-03,7100,93,100,193,東澳,二等
2020-05-04,7100,175,186,361,東澳,二等
2020-05-05,7100,213,224,437,東澳,二等
2020-05-06,7100,189,198,387,東澳,二等
2020-05-07,7100,162,177,339,東澳,二等
2020-05-08,7100,178,220,398,東澳,二等
2020-05-09,7100,124,133,257,東澳,二等
2020-05-10,7100,158,106,264,東澳,二等
2020-05-11,7100,181,184,365,東澳,二等
2020-05-12,7100,166,175,341,東澳,二等
2020-05-13,7100,168,182,350,東澳,二等
2020-05-14,7100,174,184,358,東澳,二等
2020-05-15,7100,212,215,427,東澳,二等
2020-05-16,7100,119,148,267,東澳,二等
2020-05-17,7100,102,95,197,東澳,二等
2020-05-18,7100,178,190,368,東澳,二等
2020-05-19,7100,165,168,333,東澳,二等
2020-05-20,7100,178,209,387,東澳,二等
2020-05-21,7100,168,171,339,東澳,二等
2020-05-22,7100,161,184,345,東澳,二等
2020-05-23,7100,104,111,215,東澳,二等
2020-05-24,7100,88,89,177,東澳,二等
2020-05-25,7100,199,181,380,東澳,二等
2020-05-26,7100,180,176,356,東澳,二等
2020-05-27,7100,172,189,361,東澳,二等
2020-05-28,7100,172,181,353,東澳,二等
2020-05-29,7100,189,219,408,東澳,二等
2020-05-30,7100,167,201,368,東澳,二等
2020-05-31,7100,137,105,242,東澳,二等
2020-06-01,7100,192,192,384,東澳,二等
2020-06-02,7100,187,209,396,東澳,二等
2020-06-03,7100,231,213,444,東澳,二等
2020-06-04,7100,176,246,422,東澳,二等
2020-06-05,7100,219,232,451,東澳,二等
2020-06-06,7100,167,209,376,東澳,二等
2020-06-07,7100,160,119,279,東澳,二等
2020-06-08,7100,197,184,381,東澳,二等
2020-06-09,7100,162,171,333,東澳,二等
2020-06-10,7100,211,190,401,東澳,二等
2020-06-11,7100,232,194,426,東澳,二等
2020-06-12,7100,168,188,356,東澳,二等
2020-06-13,7100,136,216,352,東澳,二等
2020-06-14,7100,106,115,221,東澳,二等
2020-06-15,7100,220,215,435,東澳,二等
2020-06-16,7100,182,190,372,東澳,二等
2020-06-17,7100,180,166,346,東澳,二等
2020-06-18,7100,180,168,348,東澳,二等
2020-06-19,7100,169,198,367,東澳,二等
2020-06-20,7100,159,152,311,東澳,二等
2020-06-21,7100,148,146,294,東澳,二等
2020-06-22,7100,196,194,390,東澳,二等
2020-06-23,7100,207,188,395,東澳,二等
2020-06-24,7100,194,220,414,東澳,二等
2020-06-25,7100,226,283,509,東澳,二等
2020-06-26,7100,300,283,583,東澳,二等
2020-06-27,7100,215,194,409,東澳,二等
2020-06-28,7100,173,109,282,東澳,二等
2020-06-29,7100,241,204,445,東澳,二等
2020-06-30,7100,196,177,373,東澳,二等
2020-07-01,7100,235,255,490,東澳,二等
2020-07-02,7100,235,177,412,東澳,二等
2020-07-03,7100,197,287,484,東澳,二等
2020-07-04,7100,196,312,508,東澳,二等
2020-07-05,7100,188,163,351,東澳,二等
2020-07-06,7100,201,209,410,東澳,二等
2020-07-07,7100,210,207,417,東澳,二等
2020-07-08,7100,263,181,444,東澳,二等
2020-07-09,7100,234,207,441,東澳,二等
2020-07-10,7100,237,283,520,東澳,二等
2020-07-11,7100,189,281,470,東澳,二等
2020-07-12,7100,220,142,362,東澳,二等
2020-07-13,7100,300,189,489,東澳,二等
2020-07-14,7100,185,263,448,東澳,二等
2020-07-15,7100,199,289,488,東澳,二等
2020-07-16,7100,271,174,445,東澳,二等
2020-07-17,7100,253,271,524,東澳,二等
2020-07-18,7100,211,332,543,東澳,二等
2020-07-19,7100,246,167,413,東澳,二等
2020-07-20,7100,246,243,489,東澳,二等
2020-07-21,7100,215,219,434,東澳,二等
2020-07-22,7100,202,185,387,東澳,二等
2020-07-23,7100,265,211,476,東澳,二等
2020-07-24,7100,192,217,409,東澳,二等
2020-07-25,7100,197,288,485,東澳,二等
2020-07-26,7100,275,153,428,東澳,二等
2020-07-27,7100,197,191,388,東澳,二等
2020-07-28,7100,159,265,424,東澳,二等
2020-07-29,7100,198,215,413,東澳,二等
2020-07-30,7100,260,184,444,東澳,二等
2020-07-31,7100,204,233,437,東澳,二等
2020-08-01,7100,162,295,457,東澳,二等
2020-08-02,7100,261,124,385,東澳,二等
2020-08-03,7100,205,204,409,東澳,二等
2020-08-04,7100,167,272,439,東澳,二等
2020-08-05,7100,307,194,501,東澳,二等
2020-08-06,7100,296,207,503,東澳,二等
2020-08-07,7100,241,451,692,東澳,二等
2020-08-08,7100,177,277,454,東澳,二等
2020-08-09,7100,307,144,451,東澳,二等
2020-08-10,7100,202,208,410,東澳,二等
2020-08-11,7100,199,294,493,東澳,二等
2020-08-12,7100,260,217,477,東澳,二等
2020-08-13,7100,252,194,446,東澳,二等
2020-08-14,7100,198,339,537,東澳,二等
2020-08-15,7100,235,287,522,東澳,二等
2020-08-16,7100,240,167,407,東澳,二等
2020-08-17,7100,250,209,459,東澳,二等
2020-08-18,7100,189,183,372,東澳,二等
2020-08-19,7100,195,200,395,東澳,二等
2020-08-20,7100,203,195,398,東澳,二等
2020-08-21,7100,217,239,456,東澳,二等
2020-08-22,7100,137,152,289,東澳,二等
2020-08-23,7100,253,136,389,東澳,二等
2020-08-24,7100,180,198,378,東澳,二等
2020-08-25,7100,190,263,453,東澳,二等
2020-08-26,7100,198,213,411,東澳,二等
2020-08-27,7100,172,218,390,東澳,二等
2020-08-28,7100,225,193,418,東澳,二等
2020-08-29,7100,174,148,322,東澳,二等
2020-08-30,7100,247,168,415,東澳,二等
2020-08-31,7100,180,216,396,東澳,二等
2020-09-01,7100,185,241,426,東澳,二等
2020-09-02,7100,171,180,351,東澳,二等
2020-09-03,7100,284,201,485,東澳,二等
2020-09-04,7100,210,218,428,東澳,二等
2020-09-05,7100,126,207,333,東澳,二等
2020-09-06,7100,174,134,308,東澳,二等
2020-09-07,7100,200,213,413,東澳,二等
2020-09-08,7100,172,220,392,東澳,二等
2020-09-09,7100,265,198,463,東澳,二等
2020-09-10,7100,182,189,371,東澳,二等
2020-09-11,7100,193,324,517,東澳,二等
2020-09-12,7100,184,214,398,東澳,二等
2020-09-13,7100,219,110,329,東澳,二等
2020-09-14,7100,175,162,337,東澳,二等
2020-09-15,7100,176,249,425,東澳,二等
2020-09-16,7100,187,179,366,東澳,二等
2020-09-17,7100,151,163,314,東澳,二等
2020-09-18,7100,205,243,448,東澳,二等
2020-09-19,7100,189,296,485,東澳,二等
2020-09-20,7100,270,152,422,東澳,二等
2020-09-21,7100,180,163,343,東澳,二等
2020-09-22,7100,169,171,340,東澳,二等
2020-09-23,7100,175,199,374,東澳,二等
2020-09-24,7100,183,197,380,東澳,二等
2020-09-25,7100,185,210,395,東澳,二等
2020-09-26,7100,168,219,387,東澳,二等
2020-09-27,7100,136,99,235,東澳,二等
2020-09-28,7100,273,184,457,東澳,二等
2020-09-29,7100,162,176,338,東澳,二等
2020-09-30,7100,188,287,475,東澳,二等
2020-10-01,7100,154,209,363,東澳,二等
2020-10-02,7100,207,163,370,東澳,二等
2020-10-03,7100,164,193,357,東澳,二等
2020-10-04,7100,199,115,314,東澳,二等
2020-10-05,7100,191,187,378,東澳,二等
2020-10-06,7100,182,184,366,東澳,二等
2020-10-07,7100,166,213,379,東澳,二等
2020-10-08,7100,194,220,414,東澳,二等
2020-10-09,7100,156,180,336,東澳,二等
2020-10-10,7100,127,148,275,東澳,二等
2020-10-11,7100,245,104,349,東澳,二等
2020-10-12,7100,199,179,378,東澳,二等
2020-10-13,7100,206,234,440,東澳,二等
2020-10-14,7100,176,175,351,東澳,二等
2020-10-15,7100,177,236,413,東澳,二等
2020-10-16,7100,160,190,350,東澳,二等
2020-10-17,7100,109,106,215,東澳,二等
2020-10-18,7100,112,100,212,東澳,二等
2020-10-19,7100,173,162,335,東澳,二等
2020-10-20,7100,169,178,347,東澳,二等
2020-10-21,7100,156,169,325,東澳,二等
2020-10-22,7100,166,178,344,東澳,二等
2020-10-23,7100,182,212,394,東澳,二等
2020-10-24,7100,115,172,287,東澳,二等
2020-10-25,7100,104,89,193,東澳,二等
2020-10-26,7100,193,180,373,東澳,二等
2020-10-27,7100,194,177,371,東澳,二等
2020-10-28,7100,162,159,321,東澳,二等
2020-10-29,7100,174,189,363,東澳,二等
2020-10-30,7100,185,189,374,東澳,二等
2020-10-31,7100,110,134,244,東澳,二等
2020-11-01,7100,139,123,262,東澳,二等
2020-11-02,7100,192,193,385,東澳,二等
2020-11-03,7100,165,164,329,東澳,二等
2020-11-04,7100,188,187,375,東澳,二等
2020-11-05,7100,156,184,340,東澳,二等
2020-11-06,7100,179,180,359,東澳,二等
2020-11-07,7100,117,119,236,東澳,二等
2020-11-08,7100,184,111,295,東澳,二等
2020-11-09,7100,199,214,413,東澳,二等
2020-11-10,7100,159,238,397,東澳,二等
2020-11-11,7100,169,182,351,東澳,二等
2020-11-12,7100,132,149,281,東澳,二等
2020-11-13,7100,152,172,324,東澳,二等
2020-11-14,7100,120,107,227,東澳,二等
2020-11-15,7100,133,122,255,東澳,二等
2020-11-16,7100,198,196,394,東澳,二等
2020-11-17,7100,175,187,362,東澳,二等
2020-11-18,7100,187,193,380,東澳,二等
2020-11-19,7100,181,191,372,東澳,二等
2020-11-20,7100,220,217,437,東澳,二等
2020-11-21,7100,86,111,197,東澳,二等
2020-11-22,7100,190,91,281,東澳,二等
2020-11-23,7100,170,172,342,東澳,二等
2020-11-24,7100,188,258,446,東澳,二等
2020-11-25,7100,175,186,361,東澳,二等
2020-11-26,7100,307,194,501,東澳,二等
2020-11-27,7100,164,191,355,東澳,二等
2020-11-28,7100,87,249,336,東澳,二等
2020-11-29,7100,106,69,175,東澳,二等
2020-11-30,7100,174,168,342,東澳,二等
2020-12-01,7100,166,163,329,東澳,二等
2020-12-02,7100,167,156,323,東澳,二等
2020-12-03,7100,252,176,428,東澳,二等
2020-12-04,7100,163,152,315,東澳,二等
2020-12-05,7100,130,214,344,東澳,二等
2020-12-06,7100,98,103,201,東澳,二等
2020-12-07,7100,182,175,357,東澳,二等
2020-12-08,7100,152,156,308,東澳,二等
2020-12-09,7100,160,170,330,東澳,二等
2020-12-10,7100,184,181,365,東澳,二等
2020-12-11,7100,268,195,463,東澳,二等
2020-12-12,7100,99,145,244,東澳,二等
2020-12-13,7100,139,135,274,東澳,二等
2020-12-14,7100,165,159,324,東澳,二等
2020-12-15,7100,212,268,480,東澳,二等
2020-12-16,7100,167,186,353,東澳,二等
2020-12-17,7100,161,181,342,東澳,二等
2020-12-18,7100,180,210,390,東澳,二等
2020-12-19,7100,116,132,248,東澳,二等
2020-12-20,7100,97,76,173,東澳,二等
2020-12-21,7100,168,189,357,東澳,二等
2020-12-22,7100,185,190,375,東澳,二等
2020-12-23,7100,182,204,386,東澳,二等
2020-12-24,7100,187,197,384,東澳,二等
2020-12-25,7100,200,217,417,東澳,二等
2020-12-26,7100,179,147,326,東澳,二等
2020-12-27,7100,130,236,366,東澳,二等
2020-12-28,7100,183,172,355,東澳,二等
2020-12-29,7100,243,240,483,東澳,二等
2020-12-30,7100,188,188,376,東澳,二等
2020-12-31,7100,173,194,367,東澳,二等
2020-01-01,7110,5,4,9,永樂,三等
2020-01-02,7110,11,10,21,永樂,三等
2020-01-03,7110,9,9,18,永樂,三等
2020-01-04,7110,6,6,12,永樂,三等
2020-01-05,7110,11,10,21,永樂,三等
2020-01-06,7110,11,12,23,永樂,三等
2020-01-07,7110,10,8,18,永樂,三等
2020-01-08,7110,8,14,22,永樂,三等
2020-01-09,7110,11,12,23,永樂,三等
2020-01-10,7110,12,17,29,永樂,三等
2020-01-11,7110,5,3,8,永樂,三等
2020-01-12,7110,6,4,10,永樂,三等
2020-01-13,7110,11,12,23,永樂,三等
2020-01-14,7110,7,12,19,永樂,三等
2020-01-15,7110,14,10,24,永樂,三等
2020-01-16,7110,10,10,20,永樂,三等
2020-01-17,7110,7,13,20,永樂,三等
2020-01-18,7110,7,6,13,永樂,三等
2020-01-19,7110,5,6,11,永樂,三等
2020-01-20,7110,10,6,16,永樂,三等
2020-01-21,7110,7,7,14,永樂,三等
2020-01-22,7110,11,14,25,永樂,三等
2020-01-23,7110,3,6,9,永樂,三等
2020-01-24,7110,7,6,13,永樂,三等
2020-01-25,7110,11,4,15,永樂,三等
2020-01-26,7110,13,7,20,永樂,三等
2020-01-27,7110,8,22,30,永樂,三等
2020-01-28,7110,5,11,16,永樂,三等
2020-01-29,7110,9,9,18,永樂,三等
2020-01-30,7110,14,11,25,永樂,三等
2020-01-31,7110,8,9,17,永樂,三等
2020-02-01,7110,6,3,9,永樂,三等
2020-02-02,7110,14,8,22,永樂,三等
2020-02-03,7110,8,7,15,永樂,三等
2020-02-04,7110,8,9,17,永樂,三等
2020-02-05,7110,8,8,16,永樂,三等
2020-02-06,7110,12,10,22,永樂,三等
2020-02-07,7110,9,11,20,永樂,三等
2020-02-08,7110,8,5,13,永樂,三等
2020-02-09,7110,6,5,11,永樂,三等
2020-02-10,7110,11,8,19,永樂,三等
2020-02-11,7110,9,4,13,永樂,三等
2020-02-12,7110,7,8,15,永樂,三等
2020-02-13,7110,9,8,17,永樂,三等
2020-02-14,7110,10,7,17,永樂,三等
2020-02-15,7110,8,5,13,永樂,三等
2020-02-16,7110,4,6,10,永樂,三等
2020-02-17,7110,7,9,16,永樂,三等
2020-02-18,7110,8,6,14,永樂,三等
2020-02-19,7110,10,7,17,永樂,三等
2020-02-20,7110,10,12,22,永樂,三等
2020-02-21,7110,12,14,26,永樂,三等
2020-02-22,7110,4,3,7,永樂,三等
2020-02-23,7110,2,5,7,永樂,三等
2020-02-24,7110,12,11,23,永樂,三等
2020-02-25,7110,10,13,23,永樂,三等
2020-02-26,7110,11,21,32,永樂,三等
2020-02-27,7110,13,11,24,永樂,三等
2020-02-28,7110,6,6,12,永樂,三等
2020-02-29,7110,5,5,10,永樂,三等
2020-03-01,7110,6,3,9,永樂,三等
2020-03-02,7110,7,6,13,永樂,三等
2020-03-03,7110,10,12,22,永樂,三等
2020-03-04,7110,16,10,26,永樂,三等
2020-03-05,7110,9,9,18,永樂,三等
2020-03-06,7110,9,9,18,永樂,三等
2020-03-07,7110,6,5,11,永樂,三等
2020-03-08,7110,9,4,13,永樂,三等
2020-03-09,7110,11,10,21,永樂,三等
2020-03-10,7110,6,10,16,永樂,三等
2020-03-11,7110,8,4,12,永樂,三等
2020-03-12,7110,9,6,15,永樂,三等
2020-03-13,7110,8,11,19,永樂,三等
2020-03-14,7110,4,2,6,永樂,三等
2020-03-15,7110,4,10,14,永樂,三等
2020-03-16,7110,9,7,16,永樂,三等
2020-03-17,7110,4,6,10,永樂,三等
2020-03-18,7110,9,6,15,永樂,三等
2020-03-19,7110,8,7,15,永樂,三等
2020-03-20,7110,11,12,23,永樂,三等
2020-03-21,7110,7,6,13,永樂,三等
2020-03-22,7110,1,5,6,永樂,三等
2020-03-23,7110,9,8,17,永樂,三等
2020-03-24,7110,9,9,18,永樂,三等
2020-03-25,7110,9,8,17,永樂,三等
2020-03-26,7110,9,12,21,永樂,三等
2020-03-27,7110,7,13,20,永樂,三等
2020-03-28,7110,27,28,55,永樂,三等
2020-03-29,7110,3,7,10,永樂,三等
2020-03-30,7110,9,7,16,永樂,三等
2020-03-31,7110,10,6,16,永樂,三等
2020-04-01,7110,8,12,20,永樂,三等
2020-04-02,7110,11,8,19,永樂,三等
2020-04-03,7110,6,7,13,永樂,三等
2020-04-04,7110,4,7,11,永樂,三等
2020-04-05,7110,3,4,7,永樂,三等
2020-04-06,7110,9,9,18,永樂,三等
2020-04-07,7110,8,6,14,永樂,三等
2020-04-08,7110,9,9,18,永樂,三等
2020-04-09,7110,5,6,11,永樂,三等
2020-04-10,7110,8,12,20,永樂,三等
2020-04-11,7110,14,13,27,永樂,三等
2020-04-12,7110,4,2,6,永樂,三等
2020-04-13,7110,9,11,20,永樂,三等
2020-04-14,7110,7,7,14,永樂,三等
2020-04-15,7110,9,7,16,永樂,三等
2020-04-16,7110,6,7,13,永樂,三等
2020-04-17,7110,9,11,20,永樂,三等
2020-04-18,7110,8,5,13,永樂,三等
2020-04-19,7110,4,5,9,永樂,三等
2020-04-20,7110,11,14,25,永樂,三等
2020-04-21,7110,16,13,29,永樂,三等
2020-04-22,7110,12,21,33,永樂,三等
2020-04-23,7110,22,24,46,永樂,三等
2020-04-24,7110,21,9,30,永樂,三等
2020-04-25,7110,11,10,21,永樂,三等
2020-04-26,7110,3,6,9,永樂,三等
2020-04-27,7110,12,10,22,永樂,三等
2020-04-28,7110,8,9,17,永樂,三等
2020-04-29,7110,11,10,21,永樂,三等
2020-04-30,7110,8,9,17,永樂,三等
2020-05-01,7110,6,7,13,永樂,三等
2020-05-02,7110,6,5,11,永樂,三等
2020-05-03,7110,5,8,13,永樂,三等
2020-05-04,7110,9,7,16,永樂,三等
2020-05-05,7110,10,9,19,永樂,三等
2020-05-06,7110,8,9,17,永樂,三等
2020-05-07,7110,10,6,16,永樂,三等
2020-05-08,7110,9,9,18,永樂,三等
2020-05-09,7110,4,6,10,永樂,三等
2020-05-10,7110,3,6,9,永樂,三等
2020-05-11,7110,12,8,20,永樂,三等
2020-05-12,7110,8,9,17,永樂,三等
2020-05-13,7110,12,11,23,永樂,三等
2020-05-14,7110,10,8,18,永樂,三等
2020-05-15,7110,8,18,26,永樂,三等
2020-05-16,7110,2,3,5,永樂,三等
2020-05-17,7110,8,11,19,永樂,三等
2020-05-18,7110,13,9,22,永樂,三等
2020-05-19,7110,10,10,20,永樂,三等
2020-05-20,7110,90,37,127,永樂,三等
2020-05-21,7110,13,9,22,永樂,三等
2020-05-22,7110,9,6,15,永樂,三等
2020-05-23,7110,11,5,16,永樂,三等
2020-05-24,7110,7,8,15,永樂,三等
2020-05-25,7110,10,6,16,永樂,三等
2020-05-26,7110,11,8,19,永樂,三等
2020-05-27,7110,7,7,14,永樂,三等
2020-05-28,7110,9,8,17,永樂,三等
2020-05-29,7110,9,15,24,永樂,三等
2020-05-30,7110,5,3,8,永樂,三等
2020-05-31,7110,7,7,14,永樂,三等
2020-06-01,7110,13,9,22,永樂,三等
2020-06-02,7110,8,6,14,永樂,三等
2020-06-03,7110,12,9,21,永樂,三等
2020-06-04,7110,10,9,19,永樂,三等
2020-06-05,7110,7,6,13,永樂,三等
2020-06-06,7110,4,5,9,永樂,三等
2020-06-07,7110,5,5,10,永樂,三等
2020-06-08,7110,10,6,16,永樂,三等
2020-06-09,7110,10,8,18,永樂,三等
2020-06-10,7110,5,15,20,永樂,三等
2020-06-11,7110,6,4,10,永樂,三等
2020-06-12,7110,8,5,13,永樂,三等
2020-06-13,7110,7,8,15,永樂,三等
2020-06-14,7110,8,1,9,永樂,三等
2020-06-15,7110,10,6,16,永樂,三等
2020-06-16,7110,5,5,10,永樂,三等
2020-06-17,7110,5,5,10,永樂,三等
2020-06-18,7110,10,7,17,永樂,三等
2020-06-19,7110,10,5,15,永樂,三等
2020-06-20,7110,6,5,11,永樂,三等
2020-06-21,7110,4,4,8,永樂,三等
2020-06-22,7110,11,7,18,永樂,三等
2020-06-23,7110,9,6,15,永樂,三等
2020-06-24,7110,9,11,20,永樂,三等
2020-06-25,7110,12,13,25,永樂,三等
2020-06-26,7110,8,9,17,永樂,三等
2020-06-27,7110,3,7,10,永樂,三等
2020-06-28,7110,4,5,9,永樂,三等
2020-06-29,7110,13,9,22,永樂,三等
2020-06-30,7110,9,8,17,永樂,三等
2020-07-01,7110,9,6,15,永樂,三等
2020-07-02,7110,11,7,18,永樂,三等
2020-07-03,7110,11,9,20,永樂,三等
2020-07-04,7110,8,6,14,永樂,三等
2020-07-05,7110,28,37,65,永樂,三等
2020-07-06,7110,10,8,18,永樂,三等
2020-07-07,7110,9,9,18,永樂,三等
2020-07-08,7110,13,11,24,永樂,三等
2020-07-09,7110,9,8,17,永樂,三等
2020-07-10,7110,9,10,19,永樂,三等
2020-07-11,7110,11,5,16,永樂,三等
2020-07-12,7110,12,6,18,永樂,三等
2020-07-13,7110,11,10,21,永樂,三等
2020-07-14,7110,11,9,20,永樂,三等
2020-07-15,7110,14,12,26,永樂,三等
2020-07-16,7110,9,8,17,永樂,三等
2020-07-17,7110,10,11,21,永樂,三等
2020-07-18,7110,10,4,14,永樂,三等
2020-07-19,7110,11,9,20,永樂,三等
2020-07-20,7110,13,11,24,永樂,三等
2020-07-21,7110,11,10,21,永樂,三等
2020-07-22,7110,16,11,27,永樂,三等
2020-07-23,7110,13,10,23,永樂,三等
2020-07-24,7110,15,10,25,永樂,三等
2020-07-25,7110,4,5,9,永樂,三等
2020-07-26,7110,11,9,20,永樂,三等
2020-07-27,7110,10,6,16,永樂,三等
2020-07-28,7110,12,12,24,永樂,三等
2020-07-29,7110,15,9,24,永樂,三等
2020-07-30,7110,11,22,33,永樂,三等
2020-07-31,7110,16,11,27,永樂,三等
2020-08-01,7110,7,10,17,永樂,三等
2020-08-02,7110,7,7,14,永樂,三等
2020-08-03,7110,13,12,25,永樂,三等
2020-08-04,7110,14,9,23,永樂,三等
2020-08-05,7110,10,13,23,永樂,三等
2020-08-06,7110,8,8,16,永樂,三等
2020-08-07,7110,15,9,24,永樂,三等
2020-08-08,7110,6,9,15,永樂,三等
2020-08-09,7110,5,5,10,永樂,三等
2020-08-10,7110,9,9,18,永樂,三等
2020-08-11,7110,12,8,20,永樂,三等
2020-08-12,7110,13,9,22,永樂,三等
2020-08-13,7110,13,9,22,永樂,三等
2020-08-14,7110,17,7,24,永樂,三等
2020-08-15,7110,8,7,15,永樂,三等
2020-08-16,7110,9,9,18,永樂,三等
2020-08-17,7110,8,5,13,永樂,三等
2020-08-18,7110,11,9,20,永樂,三等
2020-08-19,7110,11,9,20,永樂,三等
2020-08-20,7110,9,8,17,永樂,三等
2020-08-21,7110,8,9,17,永樂,三等
2020-08-22,7110,7,5,12,永樂,三等
2020-08-23,7110,7,4,11,永樂,三等
2020-08-24,7110,14,9,23,永樂,三等
2020-08-25,7110,11,7,18,永樂,三等
2020-08-26,7110,13,10,23,永樂,三等
2020-08-27,7110,6,6,12,永樂,三等
2020-08-28,7110,16,10,26,永樂,三等
2020-08-29,7110,12,6,18,永樂,三等
2020-08-30,7110,8,10,18,永樂,三等
2020-08-31,7110,10,6,16,永樂,三等
2020-09-01,7110,9,9,18,永樂,三等
2020-09-02,7110,12,11,23,永樂,三等
2020-09-03,7110,9,12,21,永樂,三等
2020-09-04,7110,13,14,27,永樂,三等
2020-09-05,7110,9,15,24,永樂,三等
2020-09-06,7110,15,11,26,永樂,三等
2020-09-07,7110,13,10,23,永樂,三等
2020-09-08,7110,11,9,20,永樂,三等
2020-09-09,7110,13,12,25,永樂,三等
2020-09-10,7110,11,12,23,永樂,三等
2020-09-11,7110,11,7,18,永樂,三等
2020-09-12,7110,8,4,12,永樂,三等
2020-09-13,7110,12,10,22,永樂,三等
2020-09-14,7110,12,11,23,永樂,三等
2020-09-15,7110,12,10,22,永樂,三等
2020-09-16,7110,11,9,20,永樂,三等
2020-09-17,7110,8,11,19,永樂,三等
2020-09-18,7110,11,8,19,永樂,三等
2020-09-19,7110,5,6,11,永樂,三等
2020-09-20,7110,5,8,13,永樂,三等
2020-09-21,7110,16,13,29,永樂,三等
2020-09-22,7110,11,8,19,永樂,三等
2020-09-23,7110,11,7,18,永樂,三等
2020-09-24,7110,8,7,15,永樂,三等
2020-09-25,7110,7,7,14,永樂,三等
2020-09-26,7110,7,11,18,永樂,三等
2020-09-27,7110,9,8,17,永樂,三等
2020-09-28,7110,7,6,13,永樂,三等
2020-09-29,7110,12,10,22,永樂,三等
2020-09-30,7110,11,15,26,永樂,三等
2020-10-01,7110,8,10,18,永樂,三等
2020-10-02,7110,16,8,24,永樂,三等
2020-10-03,7110,4,10,14,永樂,三等
2020-10-04,7110,5,3,8,永樂,三等
2020-10-05,7110,14,10,24,永樂,三等
2020-10-06,7110,10,10,20,永樂,三等
2020-10-07,7110,15,12,27,永樂,三等
2020-10-08,7110,12,11,23,永樂,三等
2020-10-09,7110,7,8,15,永樂,三等
2020-10-10,7110,8,10,18,永樂,三等
2020-10-11,7110,4,6,10,永樂,三等
2020-10-12,7110,10,12,22,永樂,三等
2020-10-13,7110,15,11,26,永樂,三等
2020-10-14,7110,11,8,19,永樂,三等
2020-10-15,7110,9,7,16,永樂,三等
2020-10-16,7110,9,13,22,永樂,三等
2020-10-17,7110,8,6,14,永樂,三等
2020-10-18,7110,4,6,10,永樂,三等
2020-10-19,7110,10,9,19,永樂,三等
2020-10-20,7110,11,7,18,永樂,三等
2020-10-21,7110,6,6,12,永樂,三等
2020-10-22,7110,12,8,20,永樂,三等
2020-10-23,7110,9,15,24,永樂,三等
2020-10-24,7110,10,10,20,永樂,三等
2020-10-25,7110,10,7,17,永樂,三等
2020-10-26,7110,27,16,43,永樂,三等
2020-10-27,7110,15,9,24,永樂,三等
2020-10-28,7110,12,10,22,永樂,三等
2020-10-29,7110,11,14,25,永樂,三等
2020-10-30,7110,11,10,21,永樂,三等
2020-10-31,7110,9,5,14,永樂,三等
2020-11-01,7110,5,5,10,永樂,三等
2020-11-02,7110,12,12,24,永樂,三等
2020-11-03,7110,10,11,21,永樂,三等
2020-11-04,7110,9,8,17,永樂,三等
2020-11-05,7110,8,6,14,永樂,三等
2020-11-06,7110,11,15,26,永樂,三等
2020-11-07,7110,8,6,14,永樂,三等
2020-11-08,7110,8,7,15,永樂,三等
2020-11-09,7110,10,7,17,永樂,三等
2020-11-10,7110,11,10,21,永樂,三等
2020-11-11,7110,13,8,21,永樂,三等
2020-11-12,7110,11,12,23,永樂,三等
2020-11-13,7110,12,11,23,永樂,三等
2020-11-14,7110,8,11,19,永樂,三等
2020-11-15,7110,7,8,15,永樂,三等
2020-11-16,7110,12,12,24,永樂,三等
2020-11-17,7110,10,11,21,永樂,三等
2020-11-18,7110,21,23,44,永樂,三等
2020-11-19,7110,26,23,49,永樂,三等
2020-11-20,7110,23,26,49,永樂,三等
2020-11-21,7110,16,16,32,永樂,三等
2020-11-22,7110,5,14,19,永樂,三等
2020-11-23,7110,15,12,27,永樂,三等
2020-11-24,7110,10,10,20,永樂,三等
2020-11-25,7110,11,7,18,永樂,三等
2020-11-26,7110,10,9,19,永樂,三等
2020-11-27,7110,6,8,14,永樂,三等
2020-11-28,7110,13,7,20,永樂,三等
2020-11-29,7110,11,9,20,永樂,三等
2020-11-30,7110,12,10,22,永樂,三等
2020-12-01,7110,10,10,20,永樂,三等
2020-12-02,7110,9,10,19,永樂,三等
2020-12-03,7110,8,7,15,永樂,三等
2020-12-04,7110,15,18,33,永樂,三等
2020-12-05,7110,7,7,14,永樂,三等
2020-12-06,7110,9,5,14,永樂,三等
2020-12-07,7110,12,12,24,永樂,三等
2020-12-08,7110,11,8,19,永樂,三等
2020-12-09,7110,11,9,20,永樂,三等
2020-12-10,7110,12,7,19,永樂,三等
2020-12-11,7110,15,14,29,永樂,三等
2020-12-12,7110,0,3,3,永樂,三等
2020-12-13,7110,6,13,19,永樂,三等
2020-12-14,7110,15,10,25,永樂,三等
2020-12-15,7110,11,8,19,永樂,三等
2020-12-16,7110,15,13,28,永樂,三等
2020-12-17,7110,10,7,17,永樂,三等
2020-12-18,7110,18,12,30,永樂,三等
2020-12-19,7110,6,6,12,永樂,三等
2020-12-20,7110,5,5,10,永樂,三等
2020-12-21,7110,13,12,25,永樂,三等
2020-12-22,7110,12,8,20,永樂,三等
2020-12-23,7110,13,10,23,永樂,三等
2020-12-24,7110,15,15,30,永樂,三等
2020-12-25,7110,15,11,26,永樂,三等
2020-12-26,7110,7,10,17,永樂,三等
2020-12-27,7110,5,5,10,永樂,三等
2020-12-28,7110,15,15,30,永樂,三等
2020-12-29,7110,17,10,27,永樂,三等
2020-12-30,7110,11,11,22,永樂,三等
2020-12-31,7110,15,11,26,永樂,三等
2020-01-01,7120,480,592,1072,蘇澳,二等
2020-01-02,7120,576,627,1203,蘇澳,二等
2020-01-03,7120,637,692,1329,蘇澳,二等
2020-01-04,7120,594,552,1146,蘇澳,二等
2020-01-05,7120,390,399,789,蘇澳,二等
2020-01-06,7120,586,611,1197,蘇澳,二等
2020-01-07,7120,603,563,1166,蘇澳,二等
2020-01-08,7120,624,638,1262,蘇澳,二等
2020-01-09,7120,622,651,1273,蘇澳,二等
2020-01-10,7120,728,734,1462,蘇澳,二等
2020-01-11,7120,408,516,924,蘇澳,二等
2020-01-12,7120,331,438,769,蘇澳,二等
2020-01-13,7120,589,644,1233,蘇澳,二等
2020-01-14,7120,618,672,1290,蘇澳,二等
2020-01-15,7120,612,620,1232,蘇澳,二等
2020-01-16,7120,683,675,1358,蘇澳,二等
2020-01-17,7120,484,479,963,蘇澳,二等
2020-01-18,7120,359,376,735,蘇澳,二等
2020-01-19,7120,351,327,678,蘇澳,二等
2020-01-20,7120,464,478,942,蘇澳,二等
2020-01-21,7120,449,466,915,蘇澳,二等
2020-01-22,7120,448,448,896,蘇澳,二等
2020-01-23,7120,348,457,805,蘇澳,二等
2020-01-24,7120,288,360,648,蘇澳,二等
2020-01-25,7120,526,660,1186,蘇澳,二等
2020-01-26,7120,511,589,1100,蘇澳,二等
2020-01-27,7120,569,504,1073,蘇澳,二等
2020-01-28,7120,473,416,889,蘇澳,二等
2020-01-29,7120,352,356,708,蘇澳,二等
2020-01-30,7120,428,433,861,蘇澳,二等
2020-01-31,7120,393,406,799,蘇澳,二等
2020-02-01,7120,357,390,747,蘇澳,二等
2020-02-02,7120,416,399,815,蘇澳,二等
2020-02-03,7120,459,502,961,蘇澳,二等
2020-02-04,7120,370,457,827,蘇澳,二等
2020-02-05,7120,322,342,664,蘇澳,二等
2020-02-06,7120,370,374,744,蘇澳,二等
2020-02-07,7120,400,401,801,蘇澳,二等
2020-02-08,7120,321,351,672,蘇澳,二等
2020-02-09,7120,386,364,750,蘇澳,二等
2020-02-10,7120,386,447,833,蘇澳,二等
2020-02-11,7120,322,352,674,蘇澳,二等
2020-02-12,7120,414,394,808,蘇澳,二等
2020-02-13,7120,369,373,742,蘇澳,二等
2020-02-14,7120,385,383,768,蘇澳,二等
2020-02-15,7120,379,380,759,蘇澳,二等
2020-02-16,7120,342,367,709,蘇澳,二等
2020-02-17,7120,442,433,875,蘇澳,二等
2020-02-18,7120,368,394,762,蘇澳,二等
2020-02-19,7120,396,356,752,蘇澳,二等
2020-02-20,7120,347,345,692,蘇澳,二等
2020-02-21,7120,422,410,832,蘇澳,二等
2020-02-22,7120,300,350,650,蘇澳,二等
2020-02-23,7120,320,346,666,蘇澳,二等
2020-02-24,7120,388,428,816,蘇澳,二等
2020-02-25,7120,566,588,1154,蘇澳,二等
2020-02-26,7120,562,549,1111,蘇澳,二等
2020-02-27,7120,573,568,1141,蘇澳,二等
2020-02-28,7120,432,438,870,蘇澳,二等
2020-02-29,7120,369,361,730,蘇澳,二等
2020-03-01,7120,325,325,650,蘇澳,二等
2020-03-02,7120,531,548,1079,蘇澳,二等
2020-03-03,7120,543,564,1107,蘇澳,二等
2020-03-04,7120,514,550,1064,蘇澳,二等
2020-03-05,7120,537,562,1099,蘇澳,二等
2020-03-06,7120,558,590,1148,蘇澳,二等
2020-03-07,7120,303,337,640,蘇澳,二等
2020-03-08,7120,298,322,620,蘇澳,二等
2020-03-09,7120,573,574,1147,蘇澳,二等
2020-03-10,7120,528,539,1067,蘇澳,二等
2020-03-11,7120,572,560,1132,蘇澳,二等
2020-03-12,7120,524,597,1121,蘇澳,二等
2020-03-13,7120,599,609,1208,蘇澳,二等
2020-03-14,7120,263,298,561,蘇澳,二等
2020-03-15,7120,303,299,602,蘇澳,二等
2020-03-16,7120,538,540,1078,蘇澳,二等
2020-03-17,7120,535,544,1079,蘇澳,二等
2020-03-18,7120,508,507,1015,蘇澳,二等
2020-03-19,7120,487,493,980,蘇澳,二等
2020-03-20,7120,593,555,1148,蘇澳,二等
2020-03-21,7120,311,299,610,蘇澳,二等
2020-03-22,7120,254,255,509,蘇澳,二等
2020-03-23,7120,528,544,1072,蘇澳,二等
2020-03-24,7120,513,489,1002,蘇澳,二等
2020-03-25,7120,506,500,1006,蘇澳,二等
2020-03-26,7120,508,497,1005,蘇澳,二等
2020-03-27,7120,531,523,1054,蘇澳,二等
2020-03-28,7120,285,296,581,蘇澳,二等
2020-03-29,7120,278,312,590,蘇澳,二等
2020-03-30,7120,513,523,1036,蘇澳,二等
2020-03-31,7120,481,487,968,蘇澳,二等
2020-04-01,7120,532,577,1109,蘇澳,二等
2020-04-02,7120,294,374,668,蘇澳,二等
2020-04-03,7120,335,354,689,蘇澳,二等
2020-04-04,7120,265,231,496,蘇澳,二等
2020-04-05,7120,248,233,481,蘇澳,二等
2020-04-06,7120,494,487,981,蘇澳,二等
2020-04-07,7120,500,500,1000,蘇澳,二等
2020-04-08,7120,503,498,1001,蘇澳,二等
2020-04-09,7120,518,500,1018,蘇澳,二等
2020-04-10,7120,558,518,1076,蘇澳,二等
2020-04-11,7120,292,332,624,蘇澳,二等
2020-04-12,7120,352,409,761,蘇澳,二等
2020-04-13,7120,536,548,1084,蘇澳,二等
2020-04-14,7120,490,498,988,蘇澳,二等
2020-04-15,7120,528,502,1030,蘇澳,二等
2020-04-16,7120,516,505,1021,蘇澳,二等
2020-04-17,7120,577,541,1118,蘇澳,二等
2020-04-18,7120,308,341,649,蘇澳,二等
2020-04-19,7120,273,286,559,蘇澳,二等
2020-04-20,7120,481,471,952,蘇澳,二等
2020-04-21,7120,450,485,935,蘇澳,二等
2020-04-22,7120,457,475,932,蘇澳,二等
2020-04-23,7120,415,462,877,蘇澳,二等
2020-04-24,7120,512,510,1022,蘇澳,二等
2020-04-25,7120,245,217,462,蘇澳,二等
2020-04-26,7120,239,241,480,蘇澳,二等
2020-04-27,7120,524,532,1056,蘇澳,二等
2020-04-28,7120,505,514,1019,蘇澳,二等
2020-04-29,7120,500,490,990,蘇澳,二等
2020-04-30,7120,497,537,1034,蘇澳,二等
2020-05-01,7120,513,563,1076,蘇澳,二等
2020-05-02,7120,320,352,672,蘇澳,二等
2020-05-03,7120,327,241,568,蘇澳,二等
2020-05-04,7120,525,529,1054,蘇澳,二等
2020-05-05,7120,481,498,979,蘇澳,二等
2020-05-06,7120,541,521,1062,蘇澳,二等
2020-05-07,7120,512,532,1044,蘇澳,二等
2020-05-08,7120,593,597,1190,蘇澳,二等
2020-05-09,7120,330,344,674,蘇澳,二等
2020-05-10,7120,389,307,696,蘇澳,二等
2020-05-11,7120,514,513,1027,蘇澳,二等
2020-05-12,7120,497,509,1006,蘇澳,二等
2020-05-13,7120,500,541,1041,蘇澳,二等
2020-05-14,7120,536,528,1064,蘇澳,二等
2020-05-15,7120,595,558,1153,蘇澳,二等
2020-05-16,7120,232,258,490,蘇澳,二等
2020-05-17,7120,290,345,635,蘇澳,二等
2020-05-18,7120,533,515,1048,蘇澳,二等
2020-05-19,7120,527,492,1019,蘇澳,二等
2020-05-20,7120,489,509,998,蘇澳,二等
2020-05-21,7120,542,531,1073,蘇澳,二等
2020-05-22,7120,535,536,1071,蘇澳,二等
2020-05-23,7120,270,284,554,蘇澳,二等
2020-05-24,7120,305,300,605,蘇澳,二等
2020-05-25,7120,535,552,1087,蘇澳,二等
2020-05-26,7120,515,518,1033,蘇澳,二等
2020-05-27,7120,508,526,1034,蘇澳,二等
2020-05-28,7120,508,512,1020,蘇澳,二等
2020-05-29,7120,550,529,1079,蘇澳,二等
2020-05-30,7120,350,390,740,蘇澳,二等
2020-05-31,7120,328,348,676,蘇澳,二等
2020-06-01,7120,524,529,1053,蘇澳,二等
2020-06-02,7120,557,524,1081,蘇澳,二等
2020-06-03,7120,610,596,1206,蘇澳,二等
2020-06-04,7120,523,563,1086,蘇澳,二等
2020-06-05,7120,600,571,1171,蘇澳,二等
2020-06-06,7120,496,499,995,蘇澳,二等
2020-06-07,7120,368,313,681,蘇澳,二等
2020-06-08,7120,523,559,1082,蘇澳,二等
2020-06-09,7120,522,532,1054,蘇澳,二等
2020-06-10,7120,593,569,1162,蘇澳,二等
2020-06-11,7120,589,546,1135,蘇澳,二等
2020-06-12,7120,608,596,1204,蘇澳,二等
2020-06-13,7120,469,515,984,蘇澳,二等
2020-06-14,7120,443,423,866,蘇澳,二等
2020-06-15,7120,593,567,1160,蘇澳,二等
2020-06-16,7120,535,538,1073,蘇澳,二等
2020-06-17,7120,519,560,1079,蘇澳,二等
2020-06-18,7120,536,527,1063,蘇澳,二等
2020-06-19,7120,645,649,1294,蘇澳,二等
2020-06-20,7120,587,597,1184,蘇澳,二等
2020-06-21,7120,395,387,782,蘇澳,二等
2020-06-22,7120,548,544,1092,蘇澳,二等
2020-06-23,7120,523,545,1068,蘇澳,二等
2020-06-24,7120,594,642,1236,蘇澳,二等
2020-06-25,7120,538,673,1211,蘇澳,二等
2020-06-26,7120,654,639,1293,蘇澳,二等
2020-06-27,7120,581,543,1124,蘇澳,二等
2020-06-28,7120,448,413,861,蘇澳,二等
2020-06-29,7120,548,574,1122,蘇澳,二等
2020-06-30,7120,531,518,1049,蘇澳,二等
2020-07-01,7120,496,502,998,蘇澳,二等
2020-07-02,7120,536,479,1015,蘇澳,二等
2020-07-03,7120,590,571,1161,蘇澳,二等
2020-07-04,7120,345,428,773,蘇澳,二等
2020-07-05,7120,442,451,893,蘇澳,二等
2020-07-06,7120,516,575,1091,蘇澳,二等
2020-07-07,7120,524,542,1066,蘇澳,二等
2020-07-08,7120,539,519,1058,蘇澳,二等
2020-07-09,7120,517,555,1072,蘇澳,二等
2020-07-10,7120,654,609,1263,蘇澳,二等
2020-07-11,7120,490,508,998,蘇澳,二等
2020-07-12,7120,428,466,894,蘇澳,二等
2020-07-13,7120,551,536,1087,蘇澳,二等
2020-07-14,7120,588,524,1112,蘇澳,二等
2020-07-15,7120,441,483,924,蘇澳,二等
2020-07-16,7120,489,482,971,蘇澳,二等
2020-07-17,7120,587,539,1126,蘇澳,二等
2020-07-18,7120,444,455,899,蘇澳,二等
2020-07-19,7120,425,428,853,蘇澳,二等
2020-07-20,7120,512,572,1084,蘇澳,二等
2020-07-21,7120,464,475,939,蘇澳,二等
2020-07-22,7120,461,473,934,蘇澳,二等
2020-07-23,7120,561,553,1114,蘇澳,二等
2020-07-24,7120,465,494,959,蘇澳,二等
2020-07-25,7120,482,503,985,蘇澳,二等
2020-07-26,7120,473,468,941,蘇澳,二等
2020-07-27,7120,509,489,998,蘇澳,二等
2020-07-28,7120,439,477,916,蘇澳,二等
2020-07-29,7120,466,446,912,蘇澳,二等
2020-07-30,7120,465,481,946,蘇澳,二等
2020-07-31,7120,517,495,1012,蘇澳,二等
2020-08-01,7120,433,458,891,蘇澳,二等
2020-08-02,7120,552,455,1007,蘇澳,二等
2020-08-03,7120,458,482,940,蘇澳,二等
2020-08-04,7120,420,445,865,蘇澳,二等
2020-08-05,7120,492,498,990,蘇澳,二等
2020-08-06,7120,507,533,1040,蘇澳,二等
2020-08-07,7120,527,534,1061,蘇澳,二等
2020-08-08,7120,406,415,821,蘇澳,二等
2020-08-09,7120,495,418,913,蘇澳,二等
2020-08-10,7120,504,554,1058,蘇澳,二等
2020-08-11,7120,519,517,1036,蘇澳,二等
2020-08-12,7120,474,507,981,蘇澳,二等
2020-08-13,7120,558,549,1107,蘇澳,二等
2020-08-14,7120,603,572,1175,蘇澳,二等
2020-08-15,7120,489,564,1053,蘇澳,二等
2020-08-16,7120,499,424,923,蘇澳,二等
2020-08-17,7120,570,567,1137,蘇澳,二等
2020-08-18,7120,427,428,855,蘇澳,二等
2020-08-19,7120,461,487,948,蘇澳,二等
2020-08-20,7120,503,495,998,蘇澳,二等
2020-08-21,7120,496,480,976,蘇澳,二等
2020-08-22,7120,352,391,743,蘇澳,二等
2020-08-23,7120,394,399,793,蘇澳,二等
2020-08-24,7120,439,457,896,蘇澳,二等
2020-08-25,7120,497,442,939,蘇澳,二等
2020-08-26,7120,398,467,865,蘇澳,二等
2020-08-27,7120,591,626,1217,蘇澳,二等
2020-08-28,7120,664,606,1270,蘇澳,二等
2020-08-29,7120,353,386,739,蘇澳,二等
2020-08-30,7120,417,392,809,蘇澳,二等
2020-08-31,7120,588,630,1218,蘇澳,二等
2020-09-01,7120,605,608,1213,蘇澳,二等
2020-09-02,7120,643,673,1316,蘇澳,二等
2020-09-03,7120,625,650,1275,蘇澳,二等
2020-09-04,7120,671,663,1334,蘇澳,二等
2020-09-05,7120,414,477,891,蘇澳,二等
2020-09-06,7120,427,397,824,蘇澳,二等
2020-09-07,7120,684,699,1383,蘇澳,二等
2020-09-08,7120,650,657,1307,蘇澳,二等
2020-09-09,7120,616,665,1281,蘇澳,二等
2020-09-10,7120,633,647,1280,蘇澳,二等
2020-09-11,7120,662,702,1364,蘇澳,二等
2020-09-12,7120,407,419,826,蘇澳,二等
2020-09-13,7120,393,369,762,蘇澳,二等
2020-09-14,7120,595,613,1208,蘇澳,二等
2020-09-15,7120,516,536,1052,蘇澳,二等
2020-09-16,7120,561,571,1132,蘇澳,二等
2020-09-17,7120,537,545,1082,蘇澳,二等
2020-09-18,7120,646,646,1292,蘇澳,二等
2020-09-19,7120,439,451,890,蘇澳,二等
2020-09-20,7120,409,379,788,蘇澳,二等
2020-09-21,7120,643,659,1302,蘇澳,二等
2020-09-22,7120,595,598,1193,蘇澳,二等
2020-09-23,7120,585,587,1172,蘇澳,二等
2020-09-24,7120,656,632,1288,蘇澳,二等
2020-09-25,7120,652,679,1331,蘇澳,二等
2020-09-26,7120,553,594,1147,蘇澳,二等
2020-09-27,7120,349,342,691,蘇澳,二等
2020-09-28,7120,636,610,1246,蘇澳,二等
2020-09-29,7120,599,596,1195,蘇澳,二等
2020-09-30,7120,631,723,1354,蘇澳,二等
2020-10-01,7120,479,646,1125,蘇澳,二等
2020-10-02,7120,634,617,1251,蘇澳,二等
2020-10-03,7120,515,470,985,蘇澳,二等
2020-10-04,7120,450,379,829,蘇澳,二等
2020-10-05,7120,642,634,1276,蘇澳,二等
2020-10-06,7120,612,646,1258,蘇澳,二等
2020-10-07,7120,632,641,1273,蘇澳,二等
2020-10-08,7120,730,735,1465,蘇澳,二等
2020-10-09,7120,503,584,1087,蘇澳,二等
2020-10-10,7120,419,434,853,蘇澳,二等
2020-10-11,7120,382,362,744,蘇澳,二等
2020-10-12,7120,607,687,1294,蘇澳,二等
2020-10-13,7120,563,598,1161,蘇澳,二等
2020-10-14,7120,601,607,1208,蘇澳,二等
2020-10-15,7120,587,602,1189,蘇澳,二等
2020-10-16,7120,1694,708,2402,蘇澳,二等
2020-10-17,7120,363,391,754,蘇澳,二等
2020-10-18,7120,336,327,663,蘇澳,二等
2020-10-19,7120,649,647,1296,蘇澳,二等
2020-10-20,7120,648,649,1297,蘇澳,二等
2020-10-21,7120,592,574,1166,蘇澳,二等
2020-10-22,7120,586,585,1171,蘇澳,二等
2020-10-23,7120,711,710,1421,蘇澳,二等
2020-10-24,7120,1074,816,1890,蘇澳,二等
2020-10-25,7120,474,416,890,蘇澳,二等
2020-10-26,7120,656,640,1296,蘇澳,二等
2020-10-27,7120,582,613,1195,蘇澳,二等
2020-10-28,7120,617,597,1214,蘇澳,二等
2020-10-29,7120,591,556,1147,蘇澳,二等
2020-10-30,7120,651,677,1328,蘇澳,二等
2020-10-31,7120,454,535,989,蘇澳,二等
2020-11-01,7120,445,405,850,蘇澳,二等
2020-11-02,7120,674,637,1311,蘇澳,二等
2020-11-03,7120,463,485,948,蘇澳,二等
2020-11-04,7120,514,521,1035,蘇澳,二等
2020-11-05,7120,615,595,1210,蘇澳,二等
2020-11-06,7120,624,635,1259,蘇澳,二等
2020-11-07,7120,341,354,695,蘇澳,二等
2020-11-08,7120,351,357,708,蘇澳,二等
2020-11-09,7120,605,621,1226,蘇澳,二等
2020-11-10,7120,564,595,1159,蘇澳,二等
2020-11-11,7120,639,624,1263,蘇澳,二等
2020-11-12,7120,645,621,1266,蘇澳,二等
2020-11-13,7120,609,614,1223,蘇澳,二等
2020-11-14,7120,357,390,747,蘇澳,二等
2020-11-15,7120,354,325,679,蘇澳,二等
2020-11-16,7120,606,615,1221,蘇澳,二等
2020-11-17,7120,629,614,1243,蘇澳,二等
2020-11-18,7120,579,588,1167,蘇澳,二等
2020-11-19,7120,643,654,1297,蘇澳,二等
2020-11-20,7120,627,686,1313,蘇澳,二等
2020-11-21,7120,323,317,640,蘇澳,二等
2020-11-22,7120,368,329,697,蘇澳,二等
2020-11-23,7120,615,623,1238,蘇澳,二等
2020-11-24,7120,583,572,1155,蘇澳,二等
2020-11-25,7120,612,599,1211,蘇澳,二等
2020-11-26,7120,632,633,1265,蘇澳,二等
2020-11-27,7120,622,645,1267,蘇澳,二等
2020-11-28,7120,319,372,691,蘇澳,二等
2020-11-29,7120,342,335,677,蘇澳,二等
2020-11-30,7120,619,595,1214,蘇澳,二等
2020-12-01,7120,604,585,1189,蘇澳,二等
2020-12-02,7120,614,610,1224,蘇澳,二等
2020-12-03,7120,595,584,1179,蘇澳,二等
2020-12-04,7120,422,427,849,蘇澳,二等
2020-12-05,7120,267,286,553,蘇澳,二等
2020-12-06,7120,243,218,461,蘇澳,二等
2020-12-07,7120,545,504,1049,蘇澳,二等
2020-12-08,7120,524,476,1000,蘇澳,二等
2020-12-09,7120,502,541,1043,蘇澳,二等
2020-12-10,7120,556,515,1071,蘇澳,二等
2020-12-11,7120,557,563,1120,蘇澳,二等
2020-12-12,7120,319,299,618,蘇澳,二等
2020-12-13,7120,298,293,591,蘇澳,二等
2020-12-14,7120,567,560,1127,蘇澳,二等
2020-12-15,7120,564,556,1120,蘇澳,二等
2020-12-16,7120,560,521,1081,蘇澳,二等
2020-12-17,7120,605,581,1186,蘇澳,二等
2020-12-18,7120,684,655,1339,蘇澳,二等
2020-12-19,7120,341,378,719,蘇澳,二等
2020-12-20,7120,258,276,534,蘇澳,二等
2020-12-21,7120,599,589,1188,蘇澳,二等
2020-12-22,7120,587,607,1194,蘇澳,二等
2020-12-23,7120,600,553,1153,蘇澳,二等
2020-12-24,7120,602,624,1226,蘇澳,二等
2020-12-25,7120,649,618,1267,蘇澳,二等
2020-12-26,7120,417,445,862,蘇澳,二等
2020-12-27,7120,332,317,649,蘇澳,二等
2020-12-28,7120,623,624,1247,蘇澳,二等
2020-12-29,7120,594,575,1169,蘇澳,二等
2020-12-30,7120,625,600,1225,蘇澳,二等
2020-12-31,7120,678,691,1369,蘇澳,二等
2020-01-01,7130,790,1611,2401,蘇澳新,一等
2020-01-02,7130,886,1906,2792,蘇澳新,一等
2020-01-03,7130,857,1944,2801,蘇澳新,一等
2020-01-04,7130,639,1486,2125,蘇澳新,一等
2020-01-05,7130,583,1364,1947,蘇澳新,一等
2020-01-06,7130,754,1584,2338,蘇澳新,一等
2020-01-07,7130,741,942,1683,蘇澳新,一等
2020-01-08,7130,758,1377,2135,蘇澳新,一等
2020-01-09,7130,782,1544,2326,蘇澳新,一等
2020-01-10,7130,884,1606,2490,蘇澳新,一等
2020-01-11,7130,790,1291,2081,蘇澳新,一等
2020-01-12,7130,658,1254,1912,蘇澳新,一等
2020-01-13,7130,878,1438,2316,蘇澳新,一等
2020-01-14,7130,780,1095,1875,蘇澳新,一等
2020-01-15,7130,863,1755,2618,蘇澳新,一等
2020-01-16,7130,804,1451,2255,蘇澳新,一等
2020-01-17,7130,965,1533,2498,蘇澳新,一等
2020-01-18,7130,776,1689,2465,蘇澳新,一等
2020-01-19,7130,607,1749,2356,蘇澳新,一等
2020-01-20,7130,884,1875,2759,蘇澳新,一等
2020-01-21,7130,794,1269,2063,蘇澳新,一等
2020-01-22,7130,756,1612,2368,蘇澳新,一等
2020-01-23,7130,759,1471,2230,蘇澳新,一等
2020-01-24,7130,610,1238,1848,蘇澳新,一等
2020-01-25,7130,936,1559,2495,蘇澳新,一等
2020-01-26,7130,1008,1778,2786,蘇澳新,一等
2020-01-27,7130,898,1947,2845,蘇澳新,一等
2020-01-28,7130,812,1656,2468,蘇澳新,一等
2020-01-29,7130,653,2004,2657,蘇澳新,一等
2020-01-30,7130,700,1679,2379,蘇澳新,一等
2020-01-31,7130,790,1178,1968,蘇澳新,一等
2020-02-01,7130,631,1171,1802,蘇澳新,一等
2020-02-02,7130,677,1072,1749,蘇澳新,一等
2020-02-03,7130,828,1307,2135,蘇澳新,一等
2020-02-04,7130,686,980,1666,蘇澳新,一等
2020-02-05,7130,656,726,1382,蘇澳新,一等
2020-02-06,7130,649,724,1373,蘇澳新,一等
2020-02-07,7130,718,846,1564,蘇澳新,一等
2020-02-08,7130,478,593,1071,蘇澳新,一等
2020-02-09,7130,534,646,1180,蘇澳新,一等
2020-02-10,7130,661,777,1438,蘇澳新,一等
2020-02-11,7130,609,719,1328,蘇澳新,一等
2020-02-12,7130,692,717,1409,蘇澳新,一等
2020-02-13,7130,696,658,1354,蘇澳新,一等
2020-02-14,7130,684,732,1416,蘇澳新,一等
2020-02-15,7130,470,582,1052,蘇澳新,一等
2020-02-16,7130,404,467,871,蘇澳新,一等
2020-02-17,7130,561,678,1239,蘇澳新,一等
2020-02-18,7130,594,668,1262,蘇澳新,一等
2020-02-19,7130,546,634,1180,蘇澳新,一等
2020-02-20,7130,612,641,1253,蘇澳新,一等
2020-02-21,7130,694,666,1360,蘇澳新,一等
2020-02-22,7130,411,507,918,蘇澳新,一等
2020-02-23,7130,378,448,826,蘇澳新,一等
2020-02-24,7130,630,670,1300,蘇澳新,一等
2020-02-25,7130,659,747,1406,蘇澳新,一等
2020-02-26,7130,560,691,1251,蘇澳新,一等
2020-02-27,7130,706,859,1565,蘇澳新,一等
2020-02-28,7130,601,650,1251,蘇澳新,一等
2020-02-29,7130,462,562,1024,蘇澳新,一等
2020-03-01,7130,536,505,1041,蘇澳新,一等
2020-03-02,7130,608,708,1316,蘇澳新,一等
2020-03-03,7130,612,741,1353,蘇澳新,一等
2020-03-04,7130,603,636,1239,蘇澳新,一等
2020-03-05,7130,585,716,1301,蘇澳新,一等
2020-03-06,7130,669,834,1503,蘇澳新,一等
2020-03-07,7130,468,494,962,蘇澳新,一等
2020-03-08,7130,411,509,920,蘇澳新,一等
2020-03-09,7130,611,755,1366,蘇澳新,一等
2020-03-10,7130,579,704,1283,蘇澳新,一等
2020-03-11,7130,584,748,1332,蘇澳新,一等
2020-03-12,7130,621,693,1314,蘇澳新,一等
2020-03-13,7130,848,840,1688,蘇澳新,一等
2020-03-14,7130,448,456,904,蘇澳新,一等
2020-03-15,7130,477,501,978,蘇澳新,一等
2020-03-16,7130,609,698,1307,蘇澳新,一等
2020-03-17,7130,591,654,1245,蘇澳新,一等
2020-03-18,7130,586,726,1312,蘇澳新,一等
2020-03-19,7130,556,683,1239,蘇澳新,一等
2020-03-20,7130,622,787,1409,蘇澳新,一等
2020-03-21,7130,429,549,978,蘇澳新,一等
2020-03-22,7130,445,450,895,蘇澳新,一等
2020-03-23,7130,608,701,1309,蘇澳新,一等
2020-03-24,7130,544,655,1199,蘇澳新,一等
2020-03-25,7130,545,650,1195,蘇澳新,一等
2020-03-26,7130,564,659,1223,蘇澳新,一等
2020-03-27,7130,646,672,1318,蘇澳新,一等
2020-03-28,7130,336,383,719,蘇澳新,一等
2020-03-29,7130,382,435,817,蘇澳新,一等
2020-03-30,7130,551,675,1226,蘇澳新,一等
2020-03-31,7130,555,612,1167,蘇澳新,一等
2020-04-01,7130,613,777,1390,蘇澳新,一等
2020-04-02,7130,737,653,1390,蘇澳新,一等
2020-04-03,7130,518,547,1065,蘇澳新,一等
2020-04-04,7130,327,391,718,蘇澳新,一等
2020-04-05,7130,442,394,836,蘇澳新,一等
2020-04-06,7130,555,615,1170,蘇澳新,一等
2020-04-07,7130,511,555,1066,蘇澳新,一等
2020-04-08,7130,495,587,1082,蘇澳新,一等
2020-04-09,7130,545,603,1148,蘇澳新,一等
2020-04-10,7130,584,691,1275,蘇澳新,一等
2020-04-11,7130,340,376,716,蘇澳新,一等
2020-04-12,7130,347,361,708,蘇澳新,一等
2020-04-13,7130,536,603,1139,蘇澳新,一等
2020-04-14,7130,489,556,1045,蘇澳新,一等
2020-04-15,7130,506,615,1121,蘇澳新,一等
2020-04-16,7130,564,647,1211,蘇澳新,一等
2020-04-17,7130,603,704,1307,蘇澳新,一等
2020-04-18,7130,458,494,952,蘇澳新,一等
2020-04-19,7130,356,343,699,蘇澳新,一等
2020-04-20,7130,543,568,1111,蘇澳新,一等
2020-04-21,7130,527,610,1137,蘇澳新,一等
2020-04-22,7130,564,619,1183,蘇澳新,一等
2020-04-23,7130,521,535,1056,蘇澳新,一等
2020-04-24,7130,569,669,1238,蘇澳新,一等
2020-04-25,7130,363,359,722,蘇澳新,一等
2020-04-26,7130,342,281,623,蘇澳新,一等
2020-04-27,7130,512,537,1049,蘇澳新,一等
2020-04-28,7130,480,529,1009,蘇澳新,一等
2020-04-29,7130,461,516,977,蘇澳新,一等
2020-04-30,7130,517,584,1101,蘇澳新,一等
2020-05-01,7130,591,708,1299,蘇澳新,一等
2020-05-02,7130,413,404,817,蘇澳新,一等
2020-05-03,7130,443,407,850,蘇澳新,一等
2020-05-04,7130,545,609,1154,蘇澳新,一等
2020-05-05,7130,524,714,1238,蘇澳新,一等
2020-05-06,7130,590,636,1226,蘇澳新,一等
2020-05-07,7130,539,596,1135,蘇澳新,一等
2020-05-08,7130,627,844,1471,蘇澳新,一等
2020-05-09,7130,402,475,877,蘇澳新,一等
2020-05-10,7130,501,445,946,蘇澳新,一等
2020-05-11,7130,609,644,1253,蘇澳新,一等
2020-05-12,7130,559,627,1186,蘇澳新,一等
2020-05-13,7130,543,626,1169,蘇澳新,一等
2020-05-14,7130,564,629,1193,蘇澳新,一等
2020-05-15,7130,660,768,1428,蘇澳新,一等
2020-05-16,7130,418,435,853,蘇澳新,一等
2020-05-17,7130,396,387,783,蘇澳新,一等
2020-05-18,7130,606,623,1229,蘇澳新,一等
2020-05-19,7130,558,588,1146,蘇澳新,一等
2020-05-20,7130,525,598,1123,蘇澳新,一等
2020-05-21,7130,551,587,1138,蘇澳新,一等
2020-05-22,7130,630,732,1362,蘇澳新,一等
2020-05-23,7130,376,418,794,蘇澳新,一等
2020-05-24,7130,442,423,865,蘇澳新,一等
2020-05-25,7130,535,644,1179,蘇澳新,一等
2020-05-26,7130,587,673,1260,蘇澳新,一等
2020-05-27,7130,534,606,1140,蘇澳新,一等
2020-05-28,7130,545,597,1142,蘇澳新,一等
2020-05-29,7130,701,696,1397,蘇澳新,一等
2020-05-30,7130,497,558,1055,蘇澳新,一等
2020-05-31,7130,521,436,957,蘇澳新,一等
2020-06-01,7130,544,602,1146,蘇澳新,一等
2020-06-02,7130,571,630,1201,蘇澳新,一等
2020-06-03,7130,571,596,1167,蘇澳新,一等
2020-06-04,7130,602,648,1250,蘇澳新,一等
2020-06-05,7130,603,745,1348,蘇澳新,一等
2020-06-06,7130,529,607,1136,蘇澳新,一等
2020-06-07,7130,499,478,977,蘇澳新,一等
2020-06-08,7130,588,726,1314,蘇澳新,一等
2020-06-09,7130,566,616,1182,蘇澳新,一等
2020-06-10,7130,697,622,1319,蘇澳新,一等
2020-06-11,7130,567,665,1232,蘇澳新,一等
2020-06-12,7130,677,909,1586,蘇澳新,一等
2020-06-13,7130,491,546,1037,蘇澳新,一等
2020-06-14,7130,472,506,978,蘇澳新,一等
2020-06-15,7130,605,648,1253,蘇澳新,一等
2020-06-16,7130,595,652,1247,蘇澳新,一等
2020-06-17,7130,582,634,1216,蘇澳新,一等
2020-06-18,7130,548,591,1139,蘇澳新,一等
2020-06-19,7130,609,637,1246,蘇澳新,一等
2020-06-20,7130,553,606,1159,蘇澳新,一等
2020-06-21,7130,434,451,885,蘇澳新,一等
2020-06-22,7130,612,653,1265,蘇澳新,一等
2020-06-23,7130,621,669,1290,蘇澳新,一等
2020-06-24,7130,792,782,1574,蘇澳新,一等
2020-06-25,7130,872,813,1685,蘇澳新,一等
2020-06-26,7130,811,867,1678,蘇澳新,一等
2020-06-27,7130,638,725,1363,蘇澳新,一等
2020-06-28,7130,706,593,1299,蘇澳新,一等
2020-06-29,7130,604,932,1536,蘇澳新,一等
2020-06-30,7130,550,602,1152,蘇澳新,一等
2020-07-01,7130,555,600,1155,蘇澳新,一等
2020-07-02,7130,634,620,1254,蘇澳新,一等
2020-07-03,7130,647,732,1379,蘇澳新,一等
2020-07-04,7130,509,554,1063,蘇澳新,一等
2020-07-05,7130,570,489,1059,蘇澳新,一等
2020-07-06,7130,677,727,1404,蘇澳新,一等
2020-07-07,7130,635,647,1282,蘇澳新,一等
2020-07-08,7130,580,645,1225,蘇澳新,一等
2020-07-09,7130,640,738,1378,蘇澳新,一等
2020-07-10,7130,718,751,1469,蘇澳新,一等
2020-07-11,7130,715,677,1392,蘇澳新,一等
2020-07-12,7130,530,585,1115,蘇澳新,一等
2020-07-13,7130,579,650,1229,蘇澳新,一等
2020-07-14,7130,620,693,1313,蘇澳新,一等
2020-07-15,7130,653,625,1278,蘇澳新,一等
2020-07-16,7130,613,656,1269,蘇澳新,一等
2020-07-17,7130,794,785,1579,蘇澳新,一等
2020-07-18,7130,513,536,1049,蘇澳新,一等
2020-07-19,7130,530,556,1086,蘇澳新,一等
2020-07-20,7130,751,702,1453,蘇澳新,一等
2020-07-21,7130,739,768,1507,蘇澳新,一等
2020-07-22,7130,722,761,1483,蘇澳新,一等
2020-07-23,7130,675,669,1344,蘇澳新,一等
2020-07-24,7130,803,843,1646,蘇澳新,一等
2020-07-25,7130,537,693,1230,蘇澳新,一等
2020-07-26,7130,640,591,1231,蘇澳新,一等
2020-07-27,7130,691,719,1410,蘇澳新,一等
2020-07-28,7130,762,747,1509,蘇澳新,一等
2020-07-29,7130,674,749,1423,蘇澳新,一等
2020-07-30,7130,660,777,1437,蘇澳新,一等
2020-07-31,7130,956,793,1749,蘇澳新,一等
2020-08-01,7130,575,755,1330,蘇澳新,一等
2020-08-02,7130,587,627,1214,蘇澳新,一等
2020-08-03,7130,651,655,1306,蘇澳新,一等
2020-08-04,7130,588,614,1202,蘇澳新,一等
2020-08-05,7130,642,679,1321,蘇澳新,一等
2020-08-06,7130,668,740,1408,蘇澳新,一等
2020-08-07,7130,714,840,1554,蘇澳新,一等
2020-08-08,7130,505,551,1056,蘇澳新,一等
2020-08-09,7130,631,714,1345,蘇澳新,一等
2020-08-10,7130,738,758,1496,蘇澳新,一等
2020-08-11,7130,677,726,1403,蘇澳新,一等
2020-08-12,7130,670,738,1408,蘇澳新,一等
2020-08-13,7130,672,678,1350,蘇澳新,一等
2020-08-14,7130,782,816,1598,蘇澳新,一等
2020-08-15,7130,576,632,1208,蘇澳新,一等
2020-08-16,7130,616,680,1296,蘇澳新,一等
2020-08-17,7130,708,747,1455,蘇澳新,一等
2020-08-18,7130,680,711,1391,蘇澳新,一等
2020-08-19,7130,673,682,1355,蘇澳新,一等
2020-08-20,7130,722,741,1463,蘇澳新,一等
2020-08-21,7130,714,768,1482,蘇澳新,一等
2020-08-22,7130,480,601,1081,蘇澳新,一等
2020-08-23,7130,478,533,1011,蘇澳新,一等
2020-08-24,7130,720,734,1454,蘇澳新,一等
2020-08-25,7130,734,704,1438,蘇澳新,一等
2020-08-26,7130,643,649,1292,蘇澳新,一等
2020-08-27,7130,622,870,1492,蘇澳新,一等
2020-08-28,7130,716,732,1448,蘇澳新,一等
2020-08-29,7130,455,551,1006,蘇澳新,一等
2020-08-30,7130,493,399,892,蘇澳新,一等
2020-08-31,7130,620,701,1321,蘇澳新,一等
2020-09-01,7130,608,654,1262,蘇澳新,一等
2020-09-02,7130,593,583,1176,蘇澳新,一等
2020-09-03,7130,627,655,1282,蘇澳新,一等
2020-09-04,7130,724,827,1551,蘇澳新,一等
2020-09-05,7130,536,530,1066,蘇澳新,一等
2020-09-06,7130,475,439,914,蘇澳新,一等
2020-09-07,7130,697,723,1420,蘇澳新,一等
2020-09-08,7130,663,671,1334,蘇澳新,一等
2020-09-09,7130,613,653,1266,蘇澳新,一等
2020-09-10,7130,620,665,1285,蘇澳新,一等
2020-09-11,7130,727,786,1513,蘇澳新,一等
2020-09-12,7130,513,571,1084,蘇澳新,一等
2020-09-13,7130,472,518,990,蘇澳新,一等
2020-09-14,7130,561,632,1193,蘇澳新,一等
2020-09-15,7130,579,770,1349,蘇澳新,一等
2020-09-16,7130,542,607,1149,蘇澳新,一等
2020-09-17,7130,550,629,1179,蘇澳新,一等
2020-09-18,7130,908,890,1798,蘇澳新,一等
2020-09-19,7130,539,640,1179,蘇澳新,一等
2020-09-20,7130,600,528,1128,蘇澳新,一等
2020-09-21,7130,638,1129,1767,蘇澳新,一等
2020-09-22,7130,663,661,1324,蘇澳新,一等
2020-09-23,7130,665,1223,1888,蘇澳新,一等
2020-09-24,7130,646,810,1456,蘇澳新,一等
2020-09-25,7130,684,804,1488,蘇澳新,一等
2020-09-26,7130,1155,698,1853,蘇澳新,一等
2020-09-27,7130,422,434,856,蘇澳新,一等
2020-09-28,7130,651,875,1526,蘇澳新,一等
2020-09-29,7130,598,642,1240,蘇澳新,一等
2020-09-30,7130,738,920,1658,蘇澳新,一等
2020-10-01,7130,745,814,1559,蘇澳新,一等
2020-10-02,7130,787,927,1714,蘇澳新,一等
2020-10-03,7130,704,716,1420,蘇澳新,一等
2020-10-04,7130,746,518,1264,蘇澳新,一等
2020-10-05,7130,640,1245,1885,蘇澳新,一等
2020-10-06,7130,608,824,1432,蘇澳新,一等
2020-10-07,7130,627,715,1342,蘇澳新,一等
2020-10-08,7130,1001,924,1925,蘇澳新,一等
2020-10-09,7130,630,790,1420,蘇澳新,一等
2020-10-10,7130,517,533,1050,蘇澳新,一等
2020-10-11,7130,536,476,1012,蘇澳新,一等
2020-10-12,7130,618,680,1298,蘇澳新,一等
2020-10-13,7130,616,1162,1778,蘇澳新,一等
2020-10-14,7130,667,918,1585,蘇澳新,一等
2020-10-15,7130,622,679,1301,蘇澳新,一等
2020-10-16,7130,1341,824,2165,蘇澳新,一等
2020-10-17,7130,461,649,1110,蘇澳新,一等
2020-10-18,7130,609,505,1114,蘇澳新,一等
2020-10-19,7130,637,655,1292,蘇澳新,一等
2020-10-20,7130,585,957,1542,蘇澳新,一等
2020-10-21,7130,667,782,1449,蘇澳新,一等
2020-10-22,7130,563,595,1158,蘇澳新,一等
2020-10-23,7130,1099,807,1906,蘇澳新,一等
2020-10-24,7130,571,657,1228,蘇澳新,一等
2020-10-25,7130,586,566,1152,蘇澳新,一等
2020-10-26,7130,629,839,1468,蘇澳新,一等
2020-10-27,7130,801,799,1600,蘇澳新,一等
2020-10-28,7130,536,568,1104,蘇澳新,一等
2020-10-29,7130,597,563,1160,蘇澳新,一等
2020-10-30,7130,636,854,1490,蘇澳新,一等
2020-10-31,7130,499,629,1128,蘇澳新,一等
2020-11-01,7130,601,635,1236,蘇澳新,一等
2020-11-02,7130,573,589,1162,蘇澳新,一等
2020-11-03,7130,590,672,1262,蘇澳新,一等
2020-11-04,7130,561,800,1361,蘇澳新,一等
2020-11-05,7130,596,916,1512,蘇澳新,一等
2020-11-06,7130,1132,746,1878,蘇澳新,一等
2020-11-07,7130,438,557,995,蘇澳新,一等
2020-11-08,7130,493,418,911,蘇澳新,一等
2020-11-09,7130,605,1242,1847,蘇澳新,一等
2020-11-10,7130,747,718,1465,蘇澳新,一等
2020-11-11,7130,568,634,1202,蘇澳新,一等
2020-11-12,7130,593,598,1191,蘇澳新,一等
2020-11-13,7130,1157,762,1919,蘇澳新,一等
2020-11-14,7130,517,545,1062,蘇澳新,一等
2020-11-15,7130,533,472,1005,蘇澳新,一等
2020-11-16,7130,625,658,1283,蘇澳新,一等
2020-11-17,7130,614,657,1271,蘇澳新,一等
2020-11-18,7130,623,679,1302,蘇澳新,一等
2020-11-19,7130,715,727,1442,蘇澳新,一等
2020-11-20,7130,720,881,1601,蘇澳新,一等
2020-11-21,7130,489,627,1116,蘇澳新,一等
2020-11-22,7130,599,540,1139,蘇澳新,一等
2020-11-23,7130,643,660,1303,蘇澳新,一等
2020-11-24,7130,673,737,1410,蘇澳新,一等
2020-11-25,7130,543,773,1316,蘇澳新,一等
2020-11-26,7130,631,782,1413,蘇澳新,一等
2020-11-27,7130,816,785,1601,蘇澳新,一等
2020-11-28,7130,473,538,1011,蘇澳新,一等
2020-11-29,7130,514,451,965,蘇澳新,一等
2020-11-30,7130,824,676,1500,蘇澳新,一等
2020-12-01,7130,580,640,1220,蘇澳新,一等
2020-12-02,7130,599,636,1235,蘇澳新,一等
2020-12-03,7130,625,642,1267,蘇澳新,一等
2020-12-04,7130,598,610,1208,蘇澳新,一等
2020-12-05,7130,424,419,843,蘇澳新,一等
2020-12-06,7130,426,367,793,蘇澳新,一等
2020-12-07,7130,534,558,1092,蘇澳新,一等
2020-12-08,7130,494,534,1028,蘇澳新,一等
2020-12-09,7130,510,614,1124,蘇澳新,一等
2020-12-10,7130,534,569,1103,蘇澳新,一等
2020-12-11,7130,608,670,1278,蘇澳新,一等
2020-12-12,7130,472,449,921,蘇澳新,一等
2020-12-13,7130,397,434,831,蘇澳新,一等
2020-12-14,7130,559,632,1191,蘇澳新,一等
2020-12-15,7130,543,710,1253,蘇澳新,一等
2020-12-16,7130,557,577,1134,蘇澳新,一等
2020-12-17,7130,624,645,1269,蘇澳新,一等
2020-12-18,7130,698,763,1461,蘇澳新,一等
2020-12-19,7130,429,435,864,蘇澳新,一等
2020-12-20,7130,436,373,809,蘇澳新,一等
2020-12-21,7130,559,584,1143,蘇澳新,一等
2020-12-22,7130,560,574,1134,蘇澳新,一等
2020-12-23,7130,535,649,1184,蘇澳新,一等
2020-12-24,7130,545,618,1163,蘇澳新,一等
2020-12-25,7130,663,712,1375,蘇澳新,一等
2020-12-26,7130,478,552,1030,蘇澳新,一等
2020-12-27,7130,517,417,934,蘇澳新,一等
2020-12-28,7130,588,801,1389,蘇澳新,一等
2020-12-29,7130,730,600,1330,蘇澳新,一等
2020-12-30,7130,560,631,1191,蘇澳新,一等
2020-12-31,7130,702,793,1495,蘇澳新,一等
2020-01-01,7140,19,23,42,新馬,招呼
2020-01-02,7140,21,20,41,新馬,招呼
2020-01-03,7140,16,20,36,新馬,招呼
2020-01-04,7140,17,29,46,新馬,招呼
2020-01-05,7140,23,41,64,新馬,招呼
2020-01-06,7140,17,17,34,新馬,招呼
2020-01-07,7140,24,25,49,新馬,招呼
2020-01-08,7140,22,29,51,新馬,招呼
2020-01-09,7140,15,21,36,新馬,招呼
2020-01-10,7140,24,36,60,新馬,招呼
2020-01-11,7140,24,34,58,新馬,招呼
2020-01-12,7140,28,38,66,新馬,招呼
2020-01-13,7140,16,28,44,新馬,招呼
2020-01-14,7140,24,37,61,新馬,招呼
2020-01-15,7140,15,16,31,新馬,招呼
2020-01-16,7140,27,32,59,新馬,招呼
2020-01-17,7140,27,32,59,新馬,招呼
2020-01-18,7140,32,32,64,新馬,招呼
2020-01-19,7140,23,29,52,新馬,招呼
2020-01-20,7140,26,27,53,新馬,招呼
2020-01-21,7140,28,35,63,新馬,招呼
2020-01-22,7140,22,23,45,新馬,招呼
2020-01-23,7140,32,31,63,新馬,招呼
2020-01-24,7140,16,28,44,新馬,招呼
2020-01-25,7140,33,46,79,新馬,招呼
2020-01-26,7140,26,28,54,新馬,招呼
2020-01-27,7140,44,55,99,新馬,招呼
2020-01-28,7140,38,48,86,新馬,招呼
2020-01-29,7140,19,30,49,新馬,招呼
2020-01-30,7140,26,28,54,新馬,招呼
2020-01-31,7140,29,44,73,新馬,招呼
2020-02-01,7140,14,15,29,新馬,招呼
2020-02-02,7140,39,36,75,新馬,招呼
2020-02-03,7140,27,26,53,新馬,招呼
2020-02-04,7140,22,21,43,新馬,招呼
2020-02-05,7140,25,32,57,新馬,招呼
2020-02-06,7140,17,32,49,新馬,招呼
2020-02-07,7140,24,26,50,新馬,招呼
2020-02-08,7140,18,43,61,新馬,招呼
2020-02-09,7140,36,56,92,新馬,招呼
2020-02-10,7140,24,26,50,新馬,招呼
2020-02-11,7140,21,28,49,新馬,招呼
2020-02-12,7140,22,25,47,新馬,招呼
2020-02-13,7140,12,19,31,新馬,招呼
2020-02-14,7140,20,37,57,新馬,招呼
2020-02-15,7140,24,24,48,新馬,招呼
2020-02-16,7140,20,32,52,新馬,招呼
2020-02-17,7140,18,27,45,新馬,招呼
2020-02-18,7140,19,24,43,新馬,招呼
2020-02-19,7140,15,15,30,新馬,招呼
2020-02-20,7140,28,26,54,新馬,招呼
2020-02-21,7140,16,22,38,新馬,招呼
2020-02-22,7140,13,18,31,新馬,招呼
2020-02-23,7140,18,28,46,新馬,招呼
2020-02-24,7140,20,30,50,新馬,招呼
2020-02-25,7140,24,27,51,新馬,招呼
2020-02-26,7140,24,23,47,新馬,招呼
2020-02-27,7140,24,41,65,新馬,招呼
2020-02-28,7140,16,23,39,新馬,招呼
2020-02-29,7140,32,36,68,新馬,招呼
2020-03-01,7140,17,26,43,新馬,招呼
2020-03-02,7140,20,23,43,新馬,招呼
2020-03-03,7140,25,24,49,新馬,招呼
2020-03-04,7140,17,23,40,新馬,招呼
2020-03-05,7140,22,26,48,新馬,招呼
2020-03-06,7140,25,29,54,新馬,招呼
2020-03-07,7140,21,37,58,新馬,招呼
2020-03-08,7140,23,27,50,新馬,招呼
2020-03-09,7140,19,21,40,新馬,招呼
2020-03-10,7140,20,22,42,新馬,招呼
2020-03-11,7140,14,19,33,新馬,招呼
2020-03-12,7140,19,19,38,新馬,招呼
2020-03-13,7140,17,26,43,新馬,招呼
2020-03-14,7140,18,20,38,新馬,招呼
2020-03-15,7140,15,24,39,新馬,招呼
2020-03-16,7140,30,26,56,新馬,招呼
2020-03-17,7140,17,16,33,新馬,招呼
2020-03-18,7140,13,14,27,新馬,招呼
2020-03-19,7140,14,18,32,新馬,招呼
2020-03-20,7140,28,29,57,新馬,招呼
2020-03-21,7140,13,12,25,新馬,招呼
2020-03-22,7140,14,8,22,新馬,招呼
2020-03-23,7140,13,19,32,新馬,招呼
2020-03-24,7140,21,17,38,新馬,招呼
2020-03-25,7140,13,13,26,新馬,招呼
2020-03-26,7140,14,15,29,新馬,招呼
2020-03-27,7140,14,23,37,新馬,招呼
2020-03-28,7140,10,13,23,新馬,招呼
2020-03-29,7140,21,18,39,新馬,招呼
2020-03-30,7140,18,22,40,新馬,招呼
2020-03-31,7140,13,23,36,新馬,招呼
2020-04-01,7140,16,20,36,新馬,招呼
2020-04-02,7140,9,22,31,新馬,招呼
2020-04-03,7140,18,25,43,新馬,招呼
2020-04-04,7140,11,12,23,新馬,招呼
2020-04-05,7140,16,18,34,新馬,招呼
2020-04-06,7140,15,21,36,新馬,招呼
2020-04-07,7140,14,18,32,新馬,招呼
2020-04-08,7140,17,19,36,新馬,招呼
2020-04-09,7140,15,16,31,新馬,招呼
2020-04-10,7140,14,20,34,新馬,招呼
2020-04-11,7140,20,16,36,新馬,招呼
2020-04-12,7140,14,28,42,新馬,招呼
2020-04-13,7140,15,25,40,新馬,招呼
2020-04-14,7140,12,13,25,新馬,招呼
2020-04-15,7140,13,13,26,新馬,招呼
2020-04-16,7140,14,26,40,新馬,招呼
2020-04-17,7140,24,26,50,新馬,招呼
2020-04-18,7140,18,30,48,新馬,招呼
2020-04-19,7140,19,23,42,新馬,招呼
2020-04-20,7140,18,22,40,新馬,招呼
2020-04-21,7140,16,16,32,新馬,招呼
2020-04-22,7140,12,12,24,新馬,招呼
2020-04-23,7140,20,12,32,新馬,招呼
2020-04-24,7140,16,21,37,新馬,招呼
2020-04-25,7140,14,16,30,新馬,招呼
2020-04-26,7140,27,18,45,新馬,招呼
2020-04-27,7140,19,16,35,新馬,招呼
2020-04-28,7140,23,27,50,新馬,招呼
2020-04-29,7140,9,16,25,新馬,招呼
2020-04-30,7140,14,20,34,新馬,招呼
2020-05-01,7140,15,27,42,新馬,招呼
2020-05-02,7140,13,22,35,新馬,招呼
2020-05-03,7140,23,16,39,新馬,招呼
2020-05-04,7140,16,24,40,新馬,招呼
2020-05-05,7140,15,27,42,新馬,招呼
2020-05-06,7140,11,21,32,新馬,招呼
2020-05-07,7140,11,27,38,新馬,招呼
2020-05-08,7140,26,29,55,新馬,招呼
2020-05-09,7140,27,39,66,新馬,招呼
2020-05-10,7140,22,29,51,新馬,招呼
2020-05-11,7140,12,23,35,新馬,招呼
2020-05-12,7140,17,24,41,新馬,招呼
2020-05-13,7140,14,22,36,新馬,招呼
2020-05-14,7140,18,24,42,新馬,招呼
2020-05-15,7140,17,24,41,新馬,招呼
2020-05-16,7140,5,16,21,新馬,招呼
2020-05-17,7140,18,16,34,新馬,招呼
2020-05-18,7140,15,20,35,新馬,招呼
2020-05-19,7140,12,15,27,新馬,招呼
2020-05-20,7140,12,14,26,新馬,招呼
2020-05-21,7140,14,16,30,新馬,招呼
2020-05-22,7140,16,28,44,新馬,招呼
2020-05-23,7140,12,16,28,新馬,招呼
2020-05-24,7140,13,14,27,新馬,招呼
2020-05-25,7140,11,25,36,新馬,招呼
2020-05-26,7140,11,13,24,新馬,招呼
2020-05-27,7140,12,17,29,新馬,招呼
2020-05-28,7140,11,20,31,新馬,招呼
2020-05-29,7140,18,22,40,新馬,招呼
2020-05-30,7140,14,26,40,新馬,招呼
2020-05-31,7140,24,27,51,新馬,招呼
2020-06-01,7140,20,16,36,新馬,招呼
2020-06-02,7140,16,16,32,新馬,招呼
2020-06-03,7140,15,19,34,新馬,招呼
2020-06-04,7140,15,20,35,新馬,招呼
2020-06-05,7140,23,35,58,新馬,招呼
2020-06-06,7140,24,34,58,新馬,招呼
2020-06-07,7140,15,21,36,新馬,招呼
2020-06-08,7140,12,26,38,新馬,招呼
2020-06-09,7140,13,21,34,新馬,招呼
2020-06-10,7140,19,24,43,新馬,招呼
2020-06-11,7140,12,19,31,新馬,招呼
2020-06-12,7140,17,23,40,新馬,招呼
2020-06-13,7140,14,29,43,新馬,招呼
2020-06-14,7140,30,37,67,新馬,招呼
2020-06-15,7140,44,22,66,新馬,招呼
2020-06-16,7140,20,25,45,新馬,招呼
2020-06-17,7140,5,13,18,新馬,招呼
2020-06-18,7140,13,22,35,新馬,招呼
2020-06-19,7140,13,19,32,新馬,招呼
2020-06-20,7140,11,21,32,新馬,招呼
2020-06-21,7140,21,19,40,新馬,招呼
2020-06-22,7140,22,36,58,新馬,招呼
2020-06-23,7140,19,20,39,新馬,招呼
2020-06-24,7140,20,23,43,新馬,招呼
2020-06-25,7140,28,53,81,新馬,招呼
2020-06-26,7140,31,30,61,新馬,招呼
2020-06-27,7140,29,31,60,新馬,招呼
2020-06-28,7140,25,24,49,新馬,招呼
2020-06-29,7140,19,25,44,新馬,招呼
2020-06-30,7140,12,19,31,新馬,招呼
2020-07-01,7140,12,17,29,新馬,招呼
2020-07-02,7140,12,21,33,新馬,招呼
2020-07-03,7140,41,50,91,新馬,招呼
2020-07-04,7140,21,32,53,新馬,招呼
2020-07-05,7140,33,36,69,新馬,招呼
2020-07-06,7140,22,30,52,新馬,招呼
2020-07-07,7140,15,31,46,新馬,招呼
2020-07-08,7140,15,17,32,新馬,招呼
2020-07-09,7140,21,20,41,新馬,招呼
2020-07-10,7140,21,22,43,新馬,招呼
2020-07-11,7140,20,27,47,新馬,招呼
2020-07-12,7140,25,45,70,新馬,招呼
2020-07-13,7140,13,19,32,新馬,招呼
2020-07-14,7140,52,60,112,新馬,招呼
2020-07-15,7140,19,21,40,新馬,招呼
2020-07-16,7140,9,17,26,新馬,招呼
2020-07-17,7140,18,25,43,新馬,招呼
2020-07-18,7140,13,25,38,新馬,招呼
2020-07-19,7140,16,24,40,新馬,招呼
2020-07-20,7140,27,36,63,新馬,招呼
2020-07-21,7140,14,35,49,新馬,招呼
2020-07-22,7140,29,30,59,新馬,招呼
2020-07-23,7140,17,33,50,新馬,招呼
2020-07-24,7140,19,23,42,新馬,招呼
2020-07-25,7140,30,36,66,新馬,招呼
2020-07-26,7140,17,13,30,新馬,招呼
2020-07-27,7140,7,23,30,新馬,招呼
2020-07-28,7140,29,21,50,新馬,招呼
2020-07-29,7140,23,30,53,新馬,招呼
2020-07-30,7140,18,28,46,新馬,招呼
2020-07-31,7140,35,44,79,新馬,招呼
2020-08-01,7140,16,64,80,新馬,招呼
2020-08-02,7140,54,30,84,新馬,招呼
2020-08-03,7140,22,32,54,新馬,招呼
2020-08-04,7140,18,22,40,新馬,招呼
2020-08-05,7140,17,22,39,新馬,招呼
2020-08-06,7140,16,31,47,新馬,招呼
2020-08-07,7140,25,30,55,新馬,招呼
2020-08-08,7140,23,26,49,新馬,招呼
2020-08-09,7140,38,43,81,新馬,招呼
2020-08-10,7140,23,43,66,新馬,招呼
2020-08-11,7140,41,56,97,新馬,招呼
2020-08-12,7140,17,25,42,新馬,招呼
2020-08-13,7140,26,28,54,新馬,招呼
2020-08-14,7140,25,28,53,新馬,招呼
2020-08-15,7140,26,38,64,新馬,招呼
2020-08-16,7140,45,56,101,新馬,招呼
2020-08-17,7140,13,29,42,新馬,招呼
2020-08-18,7140,13,16,29,新馬,招呼
2020-08-19,7140,13,27,40,新馬,招呼
2020-08-20,7140,12,27,39,新馬,招呼
2020-08-21,7140,12,56,68,新馬,招呼
2020-08-22,7140,25,25,50,新馬,招呼
2020-08-23,7140,31,29,60,新馬,招呼
2020-08-24,7140,23,36,59,新馬,招呼
2020-08-25,7140,20,89,109,新馬,招呼
2020-08-26,7140,20,39,59,新馬,招呼
2020-08-27,7140,77,54,131,新馬,招呼
2020-08-28,7140,32,26,58,新馬,招呼
2020-08-29,7140,21,30,51,新馬,招呼
2020-08-30,7140,23,22,45,新馬,招呼
2020-08-31,7140,15,18,33,新馬,招呼
2020-09-01,7140,17,23,40,新馬,招呼
2020-09-02,7140,14,21,35,新馬,招呼
2020-09-03,7140,19,26,45,新馬,招呼
2020-09-04,7140,23,24,47,新馬,招呼
2020-09-05,7140,29,30,59,新馬,招呼
2020-09-06,7140,31,34,65,新馬,招呼
2020-09-07,7140,26,39,65,新馬,招呼
2020-09-08,7140,16,16,32,新馬,招呼
2020-09-09,7140,16,19,35,新馬,招呼
2020-09-10,7140,19,27,46,新馬,招呼
2020-09-11,7140,20,38,58,新馬,招呼
2020-09-12,7140,25,27,52,新馬,招呼
2020-09-13,7140,20,20,40,新馬,招呼
2020-09-14,7140,17,18,35,新馬,招呼
2020-09-15,7140,24,23,47,新馬,招呼
2020-09-16,7140,13,16,29,新馬,招呼
2020-09-17,7140,14,19,33,新馬,招呼
2020-09-18,7140,24,40,64,新馬,招呼
2020-09-19,7140,17,33,50,新馬,招呼
2020-09-20,7140,40,41,81,新馬,招呼
2020-09-21,7140,12,19,31,新馬,招呼
2020-09-22,7140,15,21,36,新馬,招呼
2020-09-23,7140,11,13,24,新馬,招呼
2020-09-24,7140,13,18,31,新馬,招呼
2020-09-25,7140,20,32,52,新馬,招呼
2020-09-26,7140,24,21,45,新馬,招呼
2020-09-27,7140,20,28,48,新馬,招呼
2020-09-28,7140,12,11,23,新馬,招呼
2020-09-29,7140,12,15,27,新馬,招呼
2020-09-30,7140,12,25,37,新馬,招呼
2020-10-01,7140,23,39,62,新馬,招呼
2020-10-02,7140,30,30,60,新馬,招呼
2020-10-03,7140,32,48,80,新馬,招呼
2020-10-04,7140,19,28,47,新馬,招呼
2020-10-05,7140,16,28,44,新馬,招呼
2020-10-06,7140,11,20,31,新馬,招呼
2020-10-07,7140,12,19,31,新馬,招呼
2020-10-08,7140,18,29,47,新馬,招呼
2020-10-09,7140,26,37,63,新馬,招呼
2020-10-10,7140,25,39,64,新馬,招呼
2020-10-11,7140,22,26,48,新馬,招呼
2020-10-12,7140,11,15,26,新馬,招呼
2020-10-13,7140,10,13,23,新馬,招呼
2020-10-14,7140,14,18,32,新馬,招呼
2020-10-15,7140,11,11,22,新馬,招呼
2020-10-16,7140,17,15,32,新馬,招呼
2020-10-17,7140,17,15,32,新馬,招呼
2020-10-18,7140,10,13,23,新馬,招呼
2020-10-19,7140,13,27,40,新馬,招呼
2020-10-20,7140,14,17,31,新馬,招呼
2020-10-21,7140,14,19,33,新馬,招呼
2020-10-22,7140,14,20,34,新馬,招呼
2020-10-23,7140,14,27,41,新馬,招呼
2020-10-24,7140,19,49,68,新馬,招呼
2020-10-25,7140,13,24,37,新馬,招呼
2020-10-26,7140,24,30,54,新馬,招呼
2020-10-27,7140,15,21,36,新馬,招呼
2020-10-28,7140,21,17,38,新馬,招呼
2020-10-29,7140,11,22,33,新馬,招呼
2020-10-30,7140,16,26,42,新馬,招呼
2020-10-31,7140,36,22,58,新馬,招呼
2020-11-01,7140,11,21,32,新馬,招呼
2020-11-02,7140,8,11,19,新馬,招呼
2020-11-03,7140,18,18,36,新馬,招呼
2020-11-04,7140,14,13,27,新馬,招呼
2020-11-05,7140,11,21,32,新馬,招呼
2020-11-06,7140,15,16,31,新馬,招呼
2020-11-07,7140,21,26,47,新馬,招呼
2020-11-08,7140,34,40,74,新馬,招呼
2020-11-09,7140,12,11,23,新馬,招呼
2020-11-10,7140,9,12,21,新馬,招呼
2020-11-11,7140,14,20,34,新馬,招呼
2020-11-12,7140,12,16,28,新馬,招呼
2020-11-13,7140,17,20,37,新馬,招呼
2020-11-14,7140,20,28,48,新馬,招呼
2020-11-15,7140,20,29,49,新馬,招呼
2020-11-16,7140,13,12,25,新馬,招呼
2020-11-17,7140,10,18,28,新馬,招呼
2020-11-18,7140,17,27,44,新馬,招呼
2020-11-19,7140,14,18,32,新馬,招呼
2020-11-20,7140,11,19,30,新馬,招呼
2020-11-21,7140,15,20,35,新馬,招呼
2020-11-22,7140,30,28,58,新馬,招呼
2020-11-23,7140,11,15,26,新馬,招呼
2020-11-24,7140,22,19,41,新馬,招呼
2020-11-25,7140,19,24,43,新馬,招呼
2020-11-26,7140,12,20,32,新馬,招呼
2020-11-27,7140,20,58,78,新馬,招呼
2020-11-28,7140,17,14,31,新馬,招呼
2020-11-29,7140,9,17,26,新馬,招呼
2020-11-30,7140,33,28,61,新馬,招呼
2020-12-01,7140,17,17,34,新馬,招呼
2020-12-02,7140,13,13,26,新馬,招呼
2020-12-03,7140,12,17,29,新馬,招呼
2020-12-04,7140,10,17,27,新馬,招呼
2020-12-05,7140,12,21,33,新馬,招呼
2020-12-06,7140,16,27,43,新馬,招呼
2020-12-07,7140,19,18,37,新馬,招呼
2020-12-08,7140,12,14,26,新馬,招呼
2020-12-09,7140,16,17,33,新馬,招呼
2020-12-10,7140,14,17,31,新馬,招呼
2020-12-11,7140,13,20,33,新馬,招呼
2020-12-12,7140,18,25,43,新馬,招呼
2020-12-13,7140,22,37,59,新馬,招呼
2020-12-14,7140,22,18,40,新馬,招呼
2020-12-15,7140,12,15,27,新馬,招呼
2020-12-16,7140,12,20,32,新馬,招呼
2020-12-17,7140,12,17,29,新馬,招呼
2020-12-18,7140,16,28,44,新馬,招呼
2020-12-19,7140,11,16,27,新馬,招呼
2020-12-20,7140,22,24,46,新馬,招呼
2020-12-21,7140,13,15,28,新馬,招呼
2020-12-22,7140,12,23,35,新馬,招呼
2020-12-23,7140,14,14,28,新馬,招呼
2020-12-24,7140,13,15,28,新馬,招呼
2020-12-25,7140,44,53,97,新馬,招呼
2020-12-26,7140,38,51,89,新馬,招呼
2020-12-27,7140,24,28,52,新馬,招呼
2020-12-28,7140,10,17,27,新馬,招呼
2020-12-29,7140,10,14,24,新馬,招呼
2020-12-30,7140,9,15,24,新馬,招呼
2020-12-31,7140,18,26,44,新馬,招呼
2020-01-01,7150,532,529,1061,冬山,三等
2020-01-02,7150,585,601,1186,冬山,三等
2020-01-03,7150,649,727,1376,冬山,三等
2020-01-04,7150,594,687,1281,冬山,三等
2020-01-05,7150,477,441,918,冬山,三等
2020-01-06,7150,627,658,1285,冬山,三等
2020-01-07,7150,574,574,1148,冬山,三等
2020-01-08,7150,626,621,1247,冬山,三等
2020-01-09,7150,564,570,1134,冬山,三等
2020-01-10,7150,635,742,1377,冬山,三等
2020-01-11,7150,542,562,1104,冬山,三等
2020-01-12,7150,443,416,859,冬山,三等
2020-01-13,7150,622,617,1239,冬山,三等
2020-01-14,7150,619,619,1238,冬山,三等
2020-01-15,7150,620,577,1197,冬山,三等
2020-01-16,7150,695,713,1408,冬山,三等
2020-01-17,7150,563,583,1146,冬山,三等
2020-01-18,7150,601,623,1224,冬山,三等
2020-01-19,7150,394,392,786,冬山,三等
2020-01-20,7150,590,566,1156,冬山,三等
2020-01-21,7150,511,545,1056,冬山,三等
2020-01-22,7150,517,526,1043,冬山,三等
2020-01-23,7150,422,469,891,冬山,三等
2020-01-24,7150,309,346,655,冬山,三等
2020-01-25,7150,573,552,1125,冬山,三等
2020-01-26,7150,461,500,961,冬山,三等
2020-01-27,7150,643,620,1263,冬山,三等
2020-01-28,7150,560,514,1074,冬山,三等
2020-01-29,7150,458,428,886,冬山,三等
2020-01-30,7150,488,439,927,冬山,三等
2020-01-31,7150,509,501,1010,冬山,三等
2020-02-01,7150,387,407,794,冬山,三等
2020-02-02,7150,359,327,686,冬山,三等
2020-02-03,7150,464,451,915,冬山,三等
2020-02-04,7150,419,421,840,冬山,三等
2020-02-05,7150,378,405,783,冬山,三等
2020-02-06,7150,442,447,889,冬山,三等
2020-02-07,7150,486,545,1031,冬山,三等
2020-02-08,7150,399,426,825,冬山,三等
2020-02-09,7150,364,371,735,冬山,三等
2020-02-10,7150,446,413,859,冬山,三等
2020-02-11,7150,443,447,890,冬山,三等
2020-02-12,7150,473,469,942,冬山,三等
2020-02-13,7150,431,390,821,冬山,三等
2020-02-14,7150,470,468,938,冬山,三等
2020-02-15,7150,440,452,892,冬山,三等
2020-02-16,7150,356,357,713,冬山,三等
2020-02-17,7150,394,399,793,冬山,三等
2020-02-18,7150,417,425,842,冬山,三等
2020-02-19,7150,455,453,908,冬山,三等
2020-02-20,7150,517,515,1032,冬山,三等
2020-02-21,7150,518,579,1097,冬山,三等
2020-02-22,7150,355,363,718,冬山,三等
2020-02-23,7150,273,248,521,冬山,三等
2020-02-24,7150,444,415,859,冬山,三等
2020-02-25,7150,544,550,1094,冬山,三等
2020-02-26,7150,551,580,1131,冬山,三等
2020-02-27,7150,543,613,1156,冬山,三等
2020-02-28,7150,392,399,791,冬山,三等
2020-02-29,7150,477,498,975,冬山,三等
2020-03-01,7150,425,330,755,冬山,三等
2020-03-02,7150,551,553,1104,冬山,三等
2020-03-03,7150,502,518,1020,冬山,三等
2020-03-04,7150,509,515,1024,冬山,三等
2020-03-05,7150,539,538,1077,冬山,三等
2020-03-06,7150,576,636,1212,冬山,三等
2020-03-07,7150,455,503,958,冬山,三等
2020-03-08,7150,364,328,692,冬山,三等
2020-03-09,7150,572,558,1130,冬山,三等
2020-03-10,7150,522,548,1070,冬山,三等
2020-03-11,7150,546,619,1165,冬山,三等
2020-03-12,7150,525,572,1097,冬山,三等
2020-03-13,7150,596,645,1241,冬山,三等
2020-03-14,7150,346,407,753,冬山,三等
2020-03-15,7150,453,417,870,冬山,三等
2020-03-16,7150,566,555,1121,冬山,三等
2020-03-17,7150,536,570,1106,冬山,三等
2020-03-18,7150,511,542,1053,冬山,三等
2020-03-19,7150,518,537,1055,冬山,三等
2020-03-20,7150,554,683,1237,冬山,三等
2020-03-21,7150,396,380,776,冬山,三等
2020-03-22,7150,326,335,661,冬山,三等
2020-03-23,7150,535,530,1065,冬山,三等
2020-03-24,7150,523,524,1047,冬山,三等
2020-03-25,7150,512,520,1032,冬山,三等
2020-03-26,7150,501,546,1047,冬山,三等
2020-03-27,7150,498,588,1086,冬山,三等
2020-03-28,7150,340,325,665,冬山,三等
2020-03-29,7150,281,241,522,冬山,三等
2020-03-30,7150,542,530,1072,冬山,三等
2020-03-31,7150,497,512,1009,冬山,三等
2020-04-01,7150,549,640,1189,冬山,三等
2020-04-02,7150,386,431,817,冬山,三等
2020-04-03,7150,411,431,842,冬山,三等
2020-04-04,7150,332,309,641,冬山,三等
2020-04-05,7150,305,213,518,冬山,三等
2020-04-06,7150,530,508,1038,冬山,三等
2020-04-07,7150,502,532,1034,冬山,三等
2020-04-08,7150,524,526,1050,冬山,三等
2020-04-09,7150,509,523,1032,冬山,三等
2020-04-10,7150,939,573,1512,冬山,三等
2020-04-11,7150,314,326,640,冬山,三等
2020-04-12,7150,312,269,581,冬山,三等
2020-04-13,7150,510,514,1024,冬山,三等
2020-04-14,7150,491,502,993,冬山,三等
2020-04-15,7150,491,503,994,冬山,三等
2020-04-16,7150,478,495,973,冬山,三等
2020-04-17,7150,536,604,1140,冬山,三等
2020-04-18,7150,411,418,829,冬山,三等
2020-04-19,7150,320,288,608,冬山,三等
2020-04-20,7150,518,496,1014,冬山,三等
2020-04-21,7150,487,497,984,冬山,三等
2020-04-22,7150,479,481,960,冬山,三等
2020-04-23,7150,458,456,914,冬山,三等
2020-04-24,7150,470,621,1091,冬山,三等
2020-04-25,7150,342,330,672,冬山,三等
2020-04-26,7150,311,259,570,冬山,三等
2020-04-27,7150,448,458,906,冬山,三等
2020-04-28,7150,437,476,913,冬山,三等
2020-04-29,7150,390,423,813,冬山,三等
2020-04-30,7150,464,520,984,冬山,三等
2020-05-01,7150,501,596,1097,冬山,三等
2020-05-02,7150,415,396,811,冬山,三等
2020-05-03,7150,365,308,673,冬山,三等
2020-05-04,7150,533,517,1050,冬山,三等
2020-05-05,7150,532,544,1076,冬山,三等
2020-05-06,7150,523,518,1041,冬山,三等
2020-05-07,7150,515,537,1052,冬山,三等
2020-05-08,7150,565,636,1201,冬山,三等
2020-05-09,7150,442,458,900,冬山,三等
2020-05-10,7150,370,305,675,冬山,三等
2020-05-11,7150,552,515,1067,冬山,三等
2020-05-12,7150,545,526,1071,冬山,三等
2020-05-13,7150,522,519,1041,冬山,三等
2020-05-14,7150,530,527,1057,冬山,三等
2020-05-15,7150,568,644,1212,冬山,三等
2020-05-16,7150,333,306,639,冬山,三等
2020-05-17,7150,415,432,847,冬山,三等
2020-05-18,7150,528,507,1035,冬山,三等
2020-05-19,7150,472,508,980,冬山,三等
2020-05-20,7150,533,499,1032,冬山,三等
2020-05-21,7150,533,560,1093,冬山,三等
2020-05-22,7150,519,583,1102,冬山,三等
2020-05-23,7150,430,435,865,冬山,三等
2020-05-24,7150,383,332,715,冬山,三等
2020-05-25,7150,537,507,1044,冬山,三等
2020-05-26,7150,472,510,982,冬山,三等
2020-05-27,7150,487,512,999,冬山,三等
2020-05-28,7150,505,503,1008,冬山,三等
2020-05-29,7150,555,629,1184,冬山,三等
2020-05-30,7150,544,570,1114,冬山,三等
2020-05-31,7150,429,340,769,冬山,三等
2020-06-01,7150,648,617,1265,冬山,三等
2020-06-02,7150,503,492,995,冬山,三等
2020-06-03,7150,589,589,1178,冬山,三等
2020-06-04,7150,514,505,1019,冬山,三等
2020-06-05,7150,548,606,1154,冬山,三等
2020-06-06,7150,435,433,868,冬山,三等
2020-06-07,7150,364,355,719,冬山,三等
2020-06-08,7150,550,512,1062,冬山,三等
2020-06-09,7150,945,1075,2020,冬山,三等
2020-06-10,7150,585,586,1171,冬山,三等
2020-06-11,7150,555,599,1154,冬山,三等
2020-06-12,7150,676,667,1343,冬山,三等
2020-06-13,7150,532,529,1061,冬山,三等
2020-06-14,7150,469,438,907,冬山,三等
2020-06-15,7150,526,489,1015,冬山,三等
2020-06-16,7150,507,551,1058,冬山,三等
2020-06-17,7150,506,450,956,冬山,三等
2020-06-18,7150,492,516,1008,冬山,三等
2020-06-19,7150,544,577,1121,冬山,三等
2020-06-20,7150,540,579,1119,冬山,三等
2020-06-21,7150,399,342,741,冬山,三等
2020-06-22,7150,522,543,1065,冬山,三等
2020-06-23,7150,487,516,1003,冬山,三等
2020-06-24,7150,531,640,1171,冬山,三等
2020-06-25,7150,467,522,989,冬山,三等
2020-06-26,7150,616,587,1203,冬山,三等
2020-06-27,7150,656,639,1295,冬山,三等
2020-06-28,7150,403,389,792,冬山,三等
2020-06-29,7150,538,553,1091,冬山,三等
2020-06-30,7150,506,509,1015,冬山,三等
2020-07-01,7150,569,548,1117,冬山,三等
2020-07-02,7150,474,502,976,冬山,三等
2020-07-03,7150,492,535,1027,冬山,三等
2020-07-04,7150,390,413,803,冬山,三等
2020-07-05,7150,427,413,840,冬山,三等
2020-07-06,7150,527,515,1042,冬山,三等
2020-07-07,7150,499,494,993,冬山,三等
2020-07-08,7150,555,547,1102,冬山,三等
2020-07-09,7150,582,592,1174,冬山,三等
2020-07-10,7150,595,682,1277,冬山,三等
2020-07-11,7150,483,510,993,冬山,三等
2020-07-12,7150,372,375,747,冬山,三等
2020-07-13,7150,480,495,975,冬山,三等
2020-07-14,7150,543,531,1074,冬山,三等
2020-07-15,7150,504,537,1041,冬山,三等
2020-07-16,7150,513,463,976,冬山,三等
2020-07-17,7150,475,518,993,冬山,三等
2020-07-18,7150,505,531,1036,冬山,三等
2020-07-19,7150,371,345,716,冬山,三等
2020-07-20,7150,490,457,947,冬山,三等
2020-07-21,7150,515,437,952,冬山,三等
2020-07-22,7150,449,511,960,冬山,三等
2020-07-23,7150,440,416,856,冬山,三等
2020-07-24,7150,528,571,1099,冬山,三等
2020-07-25,7150,447,419,866,冬山,三等
2020-07-26,7150,507,429,936,冬山,三等
2020-07-27,7150,490,476,966,冬山,三等
2020-07-28,7150,562,559,1121,冬山,三等
2020-07-29,7150,497,476,973,冬山,三等
2020-07-30,7150,556,544,1100,冬山,三等
2020-07-31,7150,493,537,1030,冬山,三等
2020-08-01,7150,447,546,993,冬山,三等
2020-08-02,7150,387,363,750,冬山,三等
2020-08-03,7150,455,412,867,冬山,三等
2020-08-04,7150,458,459,917,冬山,三等
2020-08-05,7150,534,505,1039,冬山,三等
2020-08-06,7150,518,519,1037,冬山,三等
2020-08-07,7150,468,525,993,冬山,三等
2020-08-08,7150,445,494,939,冬山,三等
2020-08-09,7150,431,407,838,冬山,三等
2020-08-10,7150,484,476,960,冬山,三等
2020-08-11,7150,559,502,1061,冬山,三等
2020-08-12,7150,487,471,958,冬山,三等
2020-08-13,7150,510,511,1021,冬山,三等
2020-08-14,7150,544,529,1073,冬山,三等
2020-08-15,7150,594,529,1123,冬山,三等
2020-08-16,7150,395,364,759,冬山,三等
2020-08-17,7150,421,425,846,冬山,三等
2020-08-18,7150,480,503,983,冬山,三等
2020-08-19,7150,532,492,1024,冬山,三等
2020-08-20,7150,579,557,1136,冬山,三等
2020-08-21,7150,527,580,1107,冬山,三等
2020-08-22,7150,362,369,731,冬山,三等
2020-08-23,7150,387,350,737,冬山,三等
2020-08-24,7150,527,460,987,冬山,三等
2020-08-25,7150,546,476,1022,冬山,三等
2020-08-26,7150,528,509,1037,冬山,三等
2020-08-27,7150,507,484,991,冬山,三等
2020-08-28,7150,536,518,1054,冬山,三等
2020-08-29,7150,407,467,874,冬山,三等
2020-08-30,7150,379,326,705,冬山,三等
2020-08-31,7150,589,546,1135,冬山,三等
2020-09-01,7150,559,573,1132,冬山,三等
2020-09-02,7150,520,505,1025,冬山,三等
2020-09-03,7150,579,539,1118,冬山,三等
2020-09-04,7150,569,614,1183,冬山,三等
2020-09-05,7150,547,567,1114,冬山,三等
2020-09-06,7150,378,361,739,冬山,三等
2020-09-07,7150,576,562,1138,冬山,三等
2020-09-08,7150,530,513,1043,冬山,三等
2020-09-09,7150,543,525,1068,冬山,三等
2020-09-10,7150,570,541,1111,冬山,三等
2020-09-11,7150,587,613,1200,冬山,三等
2020-09-12,7150,388,387,775,冬山,三等
2020-09-13,7150,440,383,823,冬山,三等
2020-09-14,7150,554,526,1080,冬山,三等
2020-09-15,7150,606,584,1190,冬山,三等
2020-09-16,7150,547,554,1101,冬山,三等
2020-09-17,7150,554,594,1148,冬山,三等
2020-09-18,7150,566,634,1200,冬山,三等
2020-09-19,7150,447,480,927,冬山,三等
2020-09-20,7150,547,440,987,冬山,三等
2020-09-21,7150,543,513,1056,冬山,三等
2020-09-22,7150,575,536,1111,冬山,三等
2020-09-23,7150,525,530,1055,冬山,三等
2020-09-24,7150,528,525,1053,冬山,三等
2020-09-25,7150,589,658,1247,冬山,三等
2020-09-26,7150,492,592,1084,冬山,三等
2020-09-27,7150,330,306,636,冬山,三等
2020-09-28,7150,532,515,1047,冬山,三等
2020-09-29,7150,551,554,1105,冬山,三等
2020-09-30,7150,551,642,1193,冬山,三等
2020-10-01,7150,619,698,1317,冬山,三等
2020-10-02,7150,877,893,1770,冬山,三等
2020-10-03,7150,839,771,1610,冬山,三等
2020-10-04,7150,510,433,943,冬山,三等
2020-10-05,7150,532,486,1018,冬山,三等
2020-10-06,7150,565,580,1145,冬山,三等
2020-10-07,7150,575,587,1162,冬山,三等
2020-10-08,7150,573,664,1237,冬山,三等
2020-10-09,7150,711,765,1476,冬山,三等
2020-10-10,7150,544,522,1066,冬山,三等
2020-10-11,7150,343,316,659,冬山,三等
2020-10-12,7150,553,512,1065,冬山,三等
2020-10-13,7150,498,492,990,冬山,三等
2020-10-14,7150,507,500,1007,冬山,三等
2020-10-15,7150,531,583,1114,冬山,三等
2020-10-16,7150,561,616,1177,冬山,三等
2020-10-17,7150,380,398,778,冬山,三等
2020-10-18,7150,443,375,818,冬山,三等
2020-10-19,7150,645,543,1188,冬山,三等
2020-10-20,7150,814,794,1608,冬山,三等
2020-10-21,7150,529,554,1083,冬山,三等
2020-10-22,7150,540,539,1079,冬山,三等
2020-10-23,7150,569,744,1313,冬山,三等
2020-10-24,7150,599,714,1313,冬山,三等
2020-10-25,7150,564,455,1019,冬山,三等
2020-10-26,7150,660,614,1274,冬山,三等
2020-10-27,7150,566,557,1123,冬山,三等
2020-10-28,7150,539,538,1077,冬山,三等
2020-10-29,7150,555,538,1093,冬山,三等
2020-10-30,7150,548,665,1213,冬山,三等
2020-10-31,7150,615,628,1243,冬山,三等
2020-11-01,7150,485,530,1015,冬山,三等
2020-11-02,7150,552,521,1073,冬山,三等
2020-11-03,7150,475,491,966,冬山,三等
2020-11-04,7150,492,522,1014,冬山,三等
2020-11-05,7150,492,486,978,冬山,三等
2020-11-06,7150,521,578,1099,冬山,三等
2020-11-07,7150,575,551,1126,冬山,三等
2020-11-08,7150,404,377,781,冬山,三等
2020-11-09,7150,508,492,1000,冬山,三等
2020-11-10,7150,448,478,926,冬山,三等
2020-11-11,7150,465,534,999,冬山,三等
2020-11-12,7150,480,514,994,冬山,三等
2020-11-13,7150,489,559,1048,冬山,三等
2020-11-14,7150,418,405,823,冬山,三等
2020-11-15,7150,514,499,1013,冬山,三等
2020-11-16,7150,567,513,1080,冬山,三等
2020-11-17,7150,553,538,1091,冬山,三等
2020-11-18,7150,603,629,1232,冬山,三等
2020-11-19,7150,572,577,1149,冬山,三等
2020-11-20,7150,581,695,1276,冬山,三等
2020-11-21,7150,401,374,775,冬山,三等
2020-11-22,7150,523,496,1019,冬山,三等
2020-11-23,7150,514,497,1011,冬山,三等
2020-11-24,7150,498,514,1012,冬山,三等
2020-11-25,7150,492,504,996,冬山,三等
2020-11-26,7150,563,569,1132,冬山,三等
2020-11-27,7150,608,676,1284,冬山,三等
2020-11-28,7150,406,451,857,冬山,三等
2020-11-29,7150,313,276,589,冬山,三等
2020-11-30,7150,518,500,1018,冬山,三等
2020-12-01,7150,479,470,949,冬山,三等
2020-12-02,7150,494,486,980,冬山,三等
2020-12-03,7150,576,589,1165,冬山,三等
2020-12-04,7150,435,379,814,冬山,三等
2020-12-05,7150,339,313,652,冬山,三等
2020-12-06,7150,305,245,550,冬山,三等
2020-12-07,7150,488,460,948,冬山,三等
2020-12-08,7150,441,477,918,冬山,三等
2020-12-09,7150,421,436,857,冬山,三等
2020-12-10,7150,476,465,941,冬山,三等
2020-12-11,7150,535,565,1100,冬山,三等
2020-12-12,7150,414,422,836,冬山,三等
2020-12-13,7150,401,365,766,冬山,三等
2020-12-14,7150,518,518,1036,冬山,三等
2020-12-15,7150,482,481,963,冬山,三等
2020-12-16,7150,465,469,934,冬山,三等
2020-12-17,7150,499,508,1007,冬山,三等
2020-12-18,7150,561,642,1203,冬山,三等
2020-12-19,7150,380,399,779,冬山,三等
2020-12-20,7150,298,302,600,冬山,三等
2020-12-21,7150,500,474,974,冬山,三等
2020-12-22,7150,529,501,1030,冬山,三等
2020-12-23,7150,484,485,969,冬山,三等
2020-12-24,7150,550,528,1078,冬山,三等
2020-12-25,7150,520,574,1094,冬山,三等
2020-12-26,7150,831,834,1665,冬山,三等
2020-12-27,7150,490,405,895,冬山,三等
2020-12-28,7150,515,498,1013,冬山,三等
2020-12-29,7150,580,586,1166,冬山,三等
2020-12-30,7150,520,564,1084,冬山,三等
2020-12-31,7150,614,621,1235,冬山,三等
2020-01-01,7160,6840,5725,12565,羅東,二等
2020-01-02,7160,4866,4816,9682,羅東,二等
2020-01-03,7160,6069,5635,11704,羅東,二等
2020-01-04,7160,5542,5987,11529,羅東,二等
2020-01-05,7160,6048,4881,10929,羅東,二等
2020-01-06,7160,5151,4692,9843,羅東,二等
2020-01-07,7160,4749,4510,9259,羅東,二等
2020-01-08,7160,5065,4880,9945,羅東,二等
2020-01-09,7160,4723,4643,9366,羅東,二等
2020-01-10,7160,6388,6614,13002,羅東,二等
2020-01-11,7160,5769,6010,11779,羅東,二等
2020-01-12,7160,5684,5217,10901,羅東,二等
2020-01-13,7160,5043,5016,10059,羅東,二等
2020-01-14,7160,5313,5041,10354,羅東,二等
2020-01-15,7160,4902,4694,9596,羅東,二等
2020-01-16,7160,5750,5868,11618,羅東,二等
2020-01-17,7160,5592,5554,11146,羅東,二等
2020-01-18,7160,5318,5453,10771,羅東,二等
2020-01-19,7160,5346,4654,10000,羅東,二等
2020-01-20,7160,5400,5181,10581,羅東,二等
2020-01-21,7160,5718,5486,11204,羅東,二等
2020-01-22,7160,6242,5992,12234,羅東,二等
2020-01-23,7160,6288,5196,11484,羅東,二等
2020-01-24,7160,4744,3863,8607,羅東,二等
2020-01-25,7160,6833,5896,12729,羅東,二等
2020-01-26,7160,7575,6469,14044,羅東,二等
2020-01-27,7160,7793,8449,16242,羅東,二等
2020-01-28,7160,6740,7876,14616,羅東,二等
2020-01-29,7160,5952,6455,12407,羅東,二等
2020-01-30,7160,5171,5415,10586,羅東,二等
2020-01-31,7160,5613,5324,10937,羅東,二等
2020-02-01,7160,4923,4654,9577,羅東,二等
2020-02-02,7160,4959,4553,9512,羅東,二等
2020-02-03,7160,4707,4620,9327,羅東,二等
2020-02-04,7160,4619,4226,8845,羅東,二等
2020-02-05,7160,4373,4182,8555,羅東,二等
2020-02-06,7160,4279,4018,8297,羅東,二等
2020-02-07,7160,5087,5035,10122,羅東,二等
2020-02-08,7160,4089,4000,8089,羅東,二等
2020-02-09,7160,4627,3919,8546,羅東,二等
2020-02-10,7160,4653,4442,9095,羅東,二等
2020-02-11,7160,4457,4313,8770,羅東,二等
2020-02-12,7160,4482,4460,8942,羅東,二等
2020-02-13,7160,4179,4054,8233,羅東,二等
2020-02-14,7160,4667,4496,9163,羅東,二等
2020-02-15,7160,4431,4317,8748,羅東,二等
2020-02-16,7160,4338,3985,8323,羅東,二等
2020-02-17,7160,4138,4045,8183,羅東,二等
2020-02-18,7160,3939,3785,7724,羅東,二等
2020-02-19,7160,3926,3947,7873,羅東,二等
2020-02-20,7160,4073,3906,7979,羅東,二等
2020-02-21,7160,4784,4717,9501,羅東,二等
2020-02-22,7160,4210,4041,8251,羅東,二等
2020-02-23,7160,4307,3735,8042,羅東,二等
2020-02-24,7160,4292,4121,8413,羅東,二等
2020-02-25,7160,4353,4076,8429,羅東,二等
2020-02-26,7160,4242,4027,8269,羅東,二等
2020-02-27,7160,5427,5156,10583,羅東,二等
2020-02-28,7160,5483,5392,10875,羅東,二等
2020-02-29,7160,5277,4733,10010,羅東,二等
2020-03-01,7160,5346,4678,10024,羅東,二等
2020-03-02,7160,4264,3980,8244,羅東,二等
2020-03-03,7160,3596,3494,7090,羅東,二等
2020-03-04,7160,3638,3621,7259,羅東,二等
2020-03-05,7160,3808,3503,7311,羅東,二等
2020-03-06,7160,5116,4803,9919,羅東,二等
2020-03-07,7160,4068,3946,8014,羅東,二等
2020-03-08,7160,4314,3921,8235,羅東,二等
2020-03-09,7160,4170,3991,8161,羅東,二等
2020-03-10,7160,3659,3571,7230,羅東,二等
2020-03-11,7160,3888,3812,7700,羅東,二等
2020-03-12,7160,3860,3684,7544,羅東,二等
2020-03-13,7160,5016,5009,10025,羅東,二等
2020-03-14,7160,3623,3707,7330,羅東,二等
2020-03-15,7160,4592,4070,8662,羅東,二等
2020-03-16,7160,4039,3798,7837,羅東,二等
2020-03-17,7160,3835,3705,7540,羅東,二等
2020-03-18,7160,3836,3618,7454,羅東,二等
2020-03-19,7160,3683,3561,7244,羅東,二等
2020-03-20,7160,4881,4741,9622,羅東,二等
2020-03-21,7160,3745,3911,7656,羅東,二等
2020-03-22,7160,3914,3411,7325,羅東,二等
2020-03-23,7160,3860,3624,7484,羅東,二等
2020-03-24,7160,3533,3307,6840,羅東,二等
2020-03-25,7160,3551,3316,6867,羅東,二等
2020-03-26,7160,3557,3406,6963,羅東,二等
2020-03-27,7160,4379,4209,8588,羅東,二等
2020-03-28,7160,3002,3057,6059,羅東,二等
2020-03-29,7160,3720,3207,6927,羅東,二等
2020-03-30,7160,3838,3574,7412,羅東,二等
2020-03-31,7160,3624,3311,6935,羅東,二等
2020-04-01,7160,5388,5197,10585,羅東,二等
2020-04-02,7160,4486,4185,8671,羅東,二等
2020-04-03,7160,4100,3795,7895,羅東,二等
2020-04-04,7160,3544,3385,6929,羅東,二等
2020-04-05,7160,3858,3897,7755,羅東,二等
2020-04-06,7160,3848,3580,7428,羅東,二等
2020-04-07,7160,3242,3019,6261,羅東,二等
2020-04-08,7160,3193,3048,6241,羅東,二等
2020-04-09,7160,3367,3246,6613,羅東,二等
2020-04-10,7160,4247,4077,8324,羅東,二等
2020-04-11,7160,2959,2883,5842,羅東,二等
2020-04-12,7160,3319,2937,6256,羅東,二等
2020-04-13,7160,3590,3246,6836,羅東,二等
2020-04-14,7160,3274,3084,6358,羅東,二等
2020-04-15,7160,3438,3235,6673,羅東,二等
2020-04-16,7160,3440,3373,6813,羅東,二等
2020-04-17,7160,4417,4401,8818,羅東,二等
2020-04-18,7160,3172,3184,6356,羅東,二等
2020-04-19,7160,3492,3106,6598,羅東,二等
2020-04-20,7160,3449,3265,6714,羅東,二等
2020-04-21,7160,3293,3045,6338,羅東,二等
2020-04-22,7160,3364,3147,6511,羅東,二等
2020-04-23,7160,3246,3099,6345,羅東,二等
2020-04-24,7160,4032,3866,7898,羅東,二等
2020-04-25,7160,2633,2699,5332,羅東,二等
2020-04-26,7160,2902,2667,5569,羅東,二等
2020-04-27,7160,3480,3298,6778,羅東,二等
2020-04-28,7160,3200,3008,6208,羅東,二等
2020-04-29,7160,3273,3175,6448,羅東,二等
2020-04-30,7160,3953,3919,7872,羅東,二等
2020-05-01,7160,4735,4565,9300,羅東,二等
2020-05-02,7160,3636,3633,7269,羅東,二等
2020-05-03,7160,4008,3671,7679,羅東,二等
2020-05-04,7160,3724,3459,7183,羅東,二等
2020-05-05,7160,3583,3363,6946,羅東,二等
2020-05-06,7160,3538,3412,6950,羅東,二等
2020-05-07,7160,3449,3437,6886,羅東,二等
2020-05-08,7160,4908,4976,9884,羅東,二等
2020-05-09,7160,3986,3854,7840,羅東,二等
2020-05-10,7160,4161,3902,8063,羅東,二等
2020-05-11,7160,3963,3684,7647,羅東,二等
2020-05-12,7160,3613,3408,7021,羅東,二等
2020-05-13,7160,3651,3508,7159,羅東,二等
2020-05-14,7160,3728,3624,7352,羅東,二等
2020-05-15,7160,5226,5106,10332,羅東,二等
2020-05-16,7160,3248,3409,6657,羅東,二等
2020-05-17,7160,4266,3596,7862,羅東,二等
2020-05-18,7160,3836,3577,7413,羅東,二等
2020-05-19,7160,3476,3224,6700,羅東,二等
2020-05-20,7160,3436,3381,6817,羅東,二等
2020-05-21,7160,3495,3369,6864,羅東,二等
2020-05-22,7160,4455,4243,8698,羅東,二等
2020-05-23,7160,3489,3580,7069,羅東,二等
2020-05-24,7160,4455,3799,8254,羅東,二等
2020-05-25,7160,3894,3650,7544,羅東,二等
2020-05-26,7160,3697,3483,7180,羅東,二等
2020-05-27,7160,3638,3530,7168,羅東,二等
2020-05-28,7160,3538,3485,7023,羅東,二等
2020-05-29,7160,4666,4699,9365,羅東,二等
2020-05-30,7160,4582,4599,9181,羅東,二等
2020-05-31,7160,4896,4312,9208,羅東,二等
2020-06-01,7160,4014,3730,7744,羅東,二等
2020-06-02,7160,3781,3660,7441,羅東,二等
2020-06-03,7160,4035,3856,7891,羅東,二等
2020-06-04,7160,3752,3630,7382,羅東,二等
2020-06-05,7160,5067,5076,10143,羅東,二等
2020-06-06,7160,4906,4935,9841,羅東,二等
2020-06-07,7160,4698,4052,8750,羅東,二等
2020-06-08,7160,4260,3990,8250,羅東,二等
2020-06-09,7160,3956,3712,7668,羅東,二等
2020-06-10,7160,4267,4125,8392,羅東,二等
2020-06-11,7160,4350,4053,8403,羅東,二等
2020-06-12,7160,5187,5413,10600,羅東,二等
2020-06-13,7160,5355,5506,10861,羅東,二等
2020-06-14,7160,5491,4617,10108,羅東,二等
2020-06-15,7160,4516,4234,8750,羅東,二等
2020-06-16,7160,4292,4114,8406,羅東,二等
2020-06-17,7160,4041,3889,7930,羅東,二等
2020-06-18,7160,4174,3902,8076,羅東,二等
2020-06-19,7160,4889,4899,9788,羅東,二等
2020-06-20,7160,4681,4781,9462,羅東,二等
2020-06-21,7160,5024,4447,9471,羅東,二等
2020-06-22,7160,4484,4412,8896,羅東,二等
2020-06-23,7160,4433,4221,8654,羅東,二等
2020-06-24,7160,6295,5973,12268,羅東,二等
2020-06-25,7160,7099,6316,13415,羅東,二等
2020-06-26,7160,7128,6869,13997,羅東,二等
2020-06-27,7160,6555,6337,12892,羅東,二等
2020-06-28,7160,6267,5632,11899,羅東,二等
2020-06-29,7160,4810,4781,9591,羅東,二等
2020-06-30,7160,4444,4285,8729,羅東,二等
2020-07-01,7160,4281,4136,8417,羅東,二等
2020-07-02,7160,4083,4153,8236,羅東,二等
2020-07-03,7160,4895,4830,9725,羅東,二等
2020-07-04,7160,4668,4775,9443,羅東,二等
2020-07-05,7160,4936,4242,9178,羅東,二等
2020-07-06,7160,4711,4563,9274,羅東,二等
2020-07-07,7160,4436,4291,8727,羅東,二等
2020-07-08,7160,4598,4241,8839,羅東,二等
2020-07-09,7160,4554,4428,8982,羅東,二等
2020-07-10,7160,5762,5854,11616,羅東,二等
2020-07-11,7160,5219,5154,10373,羅東,二等
2020-07-12,7160,5641,4953,10594,羅東,二等
2020-07-13,7160,4872,4917,9789,羅東,二等
2020-07-14,7160,4874,5027,9901,羅東,二等
2020-07-15,7160,4910,4854,9764,羅東,二等
2020-07-16,7160,5057,4970,10027,羅東,二等
2020-07-17,7160,6010,5838,11848,羅東,二等
2020-07-18,7160,5787,5550,11337,羅東,二等
2020-07-19,7160,5618,5006,10624,羅東,二等
2020-07-20,7160,5046,4930,9976,羅東,二等
2020-07-21,7160,5004,4606,9610,羅東,二等
2020-07-22,7160,4767,4887,9654,羅東,二等
2020-07-23,7160,4845,4663,9508,羅東,二等
2020-07-24,7160,5556,5711,11267,羅東,二等
2020-07-25,7160,5336,5573,10909,羅東,二等
2020-07-26,7160,5741,5320,11061,羅東,二等
2020-07-27,7160,5093,4945,10038,羅東,二等
2020-07-28,7160,4849,4881,9730,羅東,二等
2020-07-29,7160,4846,4885,9731,羅東,二等
2020-07-30,7160,5148,5022,10170,羅東,二等
2020-07-31,7160,5914,6141,12055,羅東,二等
2020-08-01,7160,5535,5688,11223,羅東,二等
2020-08-02,7160,6184,5564,11748,羅東,二等
2020-08-03,7160,4744,4493,9237,羅東,二等
2020-08-04,7160,4564,4615,9179,羅東,二等
2020-08-05,7160,4720,4692,9412,羅東,二等
2020-08-06,7160,4993,4701,9694,羅東,二等
2020-08-07,7160,6041,5986,12027,羅東,二等
2020-08-08,7160,5402,5405,10807,羅東,二等
2020-08-09,7160,5938,5483,11421,羅東,二等
2020-08-10,7160,5261,5189,10450,羅東,二等
2020-08-11,7160,5045,4941,9986,羅東,二等
2020-08-12,7160,5174,5162,10336,羅東,二等
2020-08-13,7160,5298,5170,10468,羅東,二等
2020-08-14,7160,6172,5925,12097,羅東,二等
2020-08-15,7160,6041,6190,12231,羅東,二等
2020-08-16,7160,6286,5745,12031,羅東,二等
2020-08-17,7160,5525,5500,11025,羅東,二等
2020-08-18,7160,5062,4827,9889,羅東,二等
2020-08-19,7160,5003,4853,9856,羅東,二等
2020-08-20,7160,5064,5059,10123,羅東,二等
2020-08-21,7160,6124,5836,11960,羅東,二等
2020-08-22,7160,5112,5080,10192,羅東,二等
2020-08-23,7160,5858,5398,11256,羅東,二等
2020-08-24,7160,5039,5127,10166,羅東,二等
2020-08-25,7160,5300,5040,10340,羅東,二等
2020-08-26,7160,4918,4871,9789,羅東,二等
2020-08-27,7160,4765,4622,9387,羅東,二等
2020-08-28,7160,5495,5355,10850,羅東,二等
2020-08-29,7160,4998,5373,10371,羅東,二等
2020-08-30,7160,5659,4796,10455,羅東,二等
2020-08-31,7160,4573,4372,8945,羅東,二等
2020-09-01,7160,4379,4250,8629,羅東,二等
2020-09-02,7160,4320,4154,8474,羅東,二等
2020-09-03,7160,4715,4641,9356,羅東,二等
2020-09-04,7160,5275,5308,10583,羅東,二等
2020-09-05,7160,5122,5407,10529,羅東,二等
2020-09-06,7160,5514,5142,10656,羅東,二等
2020-09-07,7160,5118,4639,9757,羅東,二等
2020-09-08,7160,4462,4143,8605,羅東,二等
2020-09-09,7160,4484,4273,8757,羅東,二等
2020-09-10,7160,4578,4407,8985,羅東,二等
2020-09-11,7160,5811,5641,11452,羅東,二等
2020-09-12,7160,5171,5099,10270,羅東,二等
2020-09-13,7160,5653,4903,10556,羅東,二等
2020-09-14,7160,4385,4094,8479,羅東,二等
2020-09-15,7160,4009,3867,7876,羅東,二等
2020-09-16,7160,3974,3981,7955,羅東,二等
2020-09-17,7160,4468,4191,8659,羅東,二等
2020-09-18,7160,5709,5744,11453,羅東,二等
2020-09-19,7160,5389,5574,10963,羅東,二等
2020-09-20,7160,6023,5484,11507,羅東,二等
2020-09-21,7160,4549,4215,8764,羅東,二等
2020-09-22,7160,4095,4070,8165,羅東,二等
2020-09-23,7160,4456,4260,8716,羅東,二等
2020-09-24,7160,4207,4191,8398,羅東,二等
2020-09-25,7160,4505,4937,9442,羅東,二等
2020-09-26,7160,5029,4831,9860,羅東,二等
2020-09-27,7160,5103,4184,9287,羅東,二等
2020-09-28,7160,4454,3971,8425,羅東,二等
2020-09-29,7160,4138,4046,8184,羅東,二等
2020-09-30,7160,6540,6649,13189,羅東,二等
2020-10-01,7160,7514,7183,14697,羅東,二等
2020-10-02,7160,7189,6902,14091,羅東,二等
2020-10-03,7160,6504,6911,13415,羅東,二等
2020-10-04,7160,6791,6336,13127,羅東,二等
2020-10-05,7160,4550,4249,8799,羅東,二等
2020-10-06,7160,4243,3905,8148,羅東,二等
2020-10-07,7160,4169,3962,8131,羅東,二等
2020-10-08,7160,6152,5884,12036,羅東,二等
2020-10-09,7160,6704,7023,13727,羅東,二等
2020-10-10,7160,6227,5807,12034,羅東,二等
2020-10-11,7160,6483,5309,11792,羅東,二等
2020-10-12,7160,4528,4276,8804,羅東,二等
2020-10-13,7160,4144,3752,7896,羅東,二等
2020-10-14,7160,4035,3945,7980,羅東,二等
2020-10-15,7160,4196,4048,8244,羅東,二等
2020-10-16,7160,5536,5301,10837,羅東,二等
2020-10-17,7160,4684,5226,9910,羅東,二等
2020-10-18,7160,5485,4682,10167,羅東,二等
2020-10-19,7160,4773,4270,9043,羅東,二等
2020-10-20,7160,4042,3805,7847,羅東,二等
2020-10-21,7160,4012,3676,7688,羅東,二等
2020-10-22,7160,3927,3890,7817,羅東,二等
2020-10-23,7160,5652,5629,11281,羅東,二等
2020-10-24,7160,5565,6057,11622,羅東,二等
2020-10-25,7160,5610,4999,10609,羅東,二等
2020-10-26,7160,4703,4327,9030,羅東,二等
2020-10-27,7160,4297,4059,8356,羅東,二等
2020-10-28,7160,3959,3810,7769,羅東,二等
2020-10-29,7160,4256,4003,8259,羅東,二等
2020-10-30,7160,5221,5590,10811,羅東,二等
2020-10-31,7160,5524,5454,10978,羅東,二等
2020-11-01,7160,5680,4944,10624,羅東,二等
2020-11-02,7160,4447,4023,8470,羅東,二等
2020-11-03,7160,3687,3501,7188,羅東,二等
2020-11-04,7160,4112,3836,7948,羅東,二等
2020-11-05,7160,3912,3870,7782,羅東,二等
2020-11-06,7160,5620,5065,10685,羅東,二等
2020-11-07,7160,4709,5203,9912,羅東,二等
2020-11-08,7160,5321,4674,9995,羅東,二等
2020-11-09,7160,4490,3952,8442,羅東,二等
2020-11-10,7160,3955,3729,7684,羅東,二等
2020-11-11,7160,4240,4095,8335,羅東,二等
2020-11-12,7160,4013,4062,8075,羅東,二等
2020-11-13,7160,5617,5651,11268,羅東,二等
2020-11-14,7160,5038,5015,10053,羅東,二等
2020-11-15,7160,6005,5445,11450,羅東,二等
2020-11-16,7160,4583,4127,8710,羅東,二等
2020-11-17,7160,4268,4040,8308,羅東,二等
2020-11-18,7160,4497,4303,8800,羅東,二等
2020-11-19,7160,4446,4543,8989,羅東,二等
2020-11-20,7160,5792,5773,11565,羅東,二等
2020-11-21,7160,4513,4768,9281,羅東,二等
2020-11-22,7160,5794,5267,11061,羅東,二等
2020-11-23,7160,4722,4082,8804,羅東,二等
2020-11-24,7160,3973,3779,7752,羅東,二等
2020-11-25,7160,4036,3908,7944,羅東,二等
2020-11-26,7160,4198,4259,8457,羅東,二等
2020-11-27,7160,5842,5785,11627,羅東,二等
2020-11-28,7160,4350,4433,8783,羅東,二等
2020-11-29,7160,4832,4273,9105,羅東,二等
2020-11-30,7160,4382,3867,8249,羅東,二等
2020-12-01,7160,3631,3422,7053,羅東,二等
2020-12-02,7160,3858,3644,7502,羅東,二等
2020-12-03,7160,3733,3904,7637,羅東,二等
2020-12-04,7160,5509,6933,12442,羅東,二等
2020-12-05,7160,6609,6912,13521,羅東,二等
2020-12-06,7160,8250,7119,15369,羅東,二等
2020-12-07,7160,6441,5876,12317,羅東,二等
2020-12-08,7160,5270,5149,10419,羅東,二等
2020-12-09,7160,5297,5307,10604,羅東,二等
2020-12-10,7160,5461,6060,11521,羅東,二等
2020-12-11,7160,8300,9391,17691,羅東,二等
2020-12-12,7160,7446,8193,15639,羅東,二等
2020-12-13,7160,9613,8759,18372,羅東,二等
2020-12-14,7160,5246,4465,9711,羅東,二等
2020-12-15,7160,4129,3820,7949,羅東,二等
2020-12-16,7160,3783,3667,7450,羅東,二等
2020-12-17,7160,4047,4049,8096,羅東,二等
2020-12-18,7160,5709,5972,11681,羅東,二等
2020-12-19,7160,4959,5180,10139,羅東,二等
2020-12-20,7160,5243,4371,9614,羅東,二等
2020-12-21,7160,4300,3917,8217,羅東,二等
2020-12-22,7160,3792,3616,7408,羅東,二等
2020-12-23,7160,3819,3721,7540,羅東,二等
2020-12-24,7160,4305,3949,8254,羅東,二等
2020-12-25,7160,5019,5505,10524,羅東,二等
2020-12-26,7160,5001,5191,10192,羅東,二等
2020-12-27,7160,5471,4562,10033,羅東,二等
2020-12-28,7160,4360,3927,8287,羅東,二等
2020-12-29,7160,4216,4188,8404,羅東,二等
2020-12-30,7160,4229,4141,8370,羅東,二等
2020-12-31,7160,6976,7523,14499,羅東,二等
2020-01-01,7170,1,3,4,中里,招呼
2020-01-02,7170,1,8,9,中里,招呼
2020-01-03,7170,5,6,11,中里,招呼
2020-01-04,7170,0,7,7,中里,招呼
2020-01-05,7170,4,1,5,中里,招呼
2020-01-06,7170,0,4,4,中里,招呼
2020-01-07,7170,4,7,11,中里,招呼
2020-01-08,7170,0,5,5,中里,招呼
2020-01-09,7170,3,5,8,中里,招呼
2020-01-10,7170,7,3,10,中里,招呼
2020-01-11,7170,0,2,2,中里,招呼
2020-01-12,7170,2,8,10,中里,招呼
2020-01-13,7170,6,6,12,中里,招呼
2020-01-14,7170,2,5,7,中里,招呼
2020-01-15,7170,3,4,7,中里,招呼
2020-01-16,7170,1,6,7,中里,招呼
2020-01-17,7170,2,7,9,中里,招呼
2020-01-18,7170,4,9,13,中里,招呼
2020-01-19,7170,2,3,5,中里,招呼
2020-01-20,7170,5,5,10,中里,招呼
2020-01-21,7170,2,6,8,中里,招呼
2020-01-22,7170,2,9,11,中里,招呼
2020-01-23,7170,0,5,5,中里,招呼
2020-01-24,7170,1,4,5,中里,招呼
2020-01-25,7170,1,5,6,中里,招呼
2020-01-26,7170,0,2,2,中里,招呼
2020-01-27,7170,0,5,5,中里,招呼
2020-01-28,7170,2,3,5,中里,招呼
2020-01-29,7170,2,4,6,中里,招呼
2020-01-30,7170,2,3,5,中里,招呼
2020-01-31,7170,1,2,3,中里,招呼
2020-02-01,7170,4,9,13,中里,招呼
2020-02-02,7170,0,3,3,中里,招呼
2020-02-03,7170,1,5,6,中里,招呼
2020-02-04,7170,3,6,9,中里,招呼
2020-02-05,7170,0,4,4,中里,招呼
2020-02-06,7170,1,4,5,中里,招呼
2020-02-07,7170,1,7,8,中里,招呼
2020-02-08,7170,1,2,3,中里,招呼
2020-02-09,7170,1,2,3,中里,招呼
2020-02-10,7170,2,2,4,中里,招呼
2020-02-11,7170,2,2,4,中里,招呼
2020-02-12,7170,0,3,3,中里,招呼
2020-02-13,7170,0,5,5,中里,招呼
2020-02-14,7170,2,4,6,中里,招呼
2020-02-15,7170,1,4,5,中里,招呼
2020-02-16,7170,0,4,4,中里,招呼
2020-02-17,7170,1,4,5,中里,招呼
2020-02-18,7170,1,4,5,中里,招呼
2020-02-19,7170,1,3,4,中里,招呼
2020-02-20,7170,2,2,4,中里,招呼
2020-02-21,7170,3,2,5,中里,招呼
2020-02-22,7170,0,3,3,中里,招呼
2020-02-23,7170,0,2,2,中里,招呼
2020-02-24,7170,1,1,2,中里,招呼
2020-02-25,7170,1,4,5,中里,招呼
2020-02-26,7170,1,4,5,中里,招呼
2020-02-27,7170,1,3,4,中里,招呼
2020-02-28,7170,1,5,6,中里,招呼
2020-02-29,7170,0,3,3,中里,招呼
2020-03-01,7170,1,1,2,中里,招呼
2020-03-02,7170,3,5,8,中里,招呼
2020-03-03,7170,2,5,7,中里,招呼
2020-03-04,7170,0,3,3,中里,招呼
2020-03-05,7170,0,5,5,中里,招呼
2020-03-06,7170,3,1,4,中里,招呼
2020-03-07,7170,1,3,4,中里,招呼
2020-03-08,7170,3,0,3,中里,招呼
2020-03-09,7170,1,1,2,中里,招呼
2020-03-10,7170,3,8,11,中里,招呼
2020-03-11,7170,1,4,5,中里,招呼
2020-03-12,7170,2,2,4,中里,招呼
2020-03-13,7170,2,2,4,中里,招呼
2020-03-14,7170,2,2,4,中里,招呼
2020-03-15,7170,2,2,4,中里,招呼
2020-03-16,7170,1,2,3,中里,招呼
2020-03-17,7170,0,0,0,中里,招呼
2020-03-18,7170,1,3,4,中里,招呼
2020-03-19,7170,1,6,7,中里,招呼
2020-03-20,7170,1,3,4,中里,招呼
2020-03-21,7170,0,0,0,中里,招呼
2020-03-22,7170,2,0,2,中里,招呼
2020-03-23,7170,2,3,5,中里,招呼
2020-03-24,7170,1,1,2,中里,招呼
2020-03-25,7170,0,3,3,中里,招呼
2020-03-26,7170,3,3,6,中里,招呼
2020-03-27,7170,1,2,3,中里,招呼
2020-03-28,7170,1,1,2,中里,招呼
2020-03-29,7170,0,0,0,中里,招呼
2020-03-30,7170,0,1,1,中里,招呼
2020-03-31,7170,1,2,3,中里,招呼
2020-04-01,7170,1,5,6,中里,招呼
2020-04-02,7170,0,1,1,中里,招呼
2020-04-03,7170,1,0,1,中里,招呼
2020-04-04,7170,0,0,0,中里,招呼
2020-04-05,7170,1,1,2,中里,招呼
2020-04-06,7170,0,1,1,中里,招呼
2020-04-07,7170,3,3,6,中里,招呼
2020-04-08,7170,1,2,3,中里,招呼
2020-04-09,7170,1,1,2,中里,招呼
2020-04-10,7170,2,0,2,中里,招呼
2020-04-11,7170,0,0,0,中里,招呼
2020-04-12,7170,0,4,4,中里,招呼
2020-04-13,7170,2,1,3,中里,招呼
2020-04-14,7170,1,1,2,中里,招呼
2020-04-15,7170,1,3,4,中里,招呼
2020-04-16,7170,0,2,2,中里,招呼
2020-04-17,7170,1,2,3,中里,招呼
2020-04-18,7170,1,0,1,中里,招呼
2020-04-19,7170,0,2,2,中里,招呼
2020-04-20,7170,1,2,3,中里,招呼
2020-04-21,7170,2,2,4,中里,招呼
2020-04-22,7170,0,2,2,中里,招呼
2020-04-23,7170,2,3,5,中里,招呼
2020-04-24,7170,3,1,4,中里,招呼
2020-04-25,7170,1,4,5,中里,招呼
2020-04-26,7170,1,3,4,中里,招呼
2020-04-27,7170,1,2,3,中里,招呼
2020-04-28,7170,2,3,5,中里,招呼
2020-04-29,7170,3,3,6,中里,招呼
2020-04-30,7170,1,6,7,中里,招呼
2020-05-01,7170,1,1,2,中里,招呼
2020-05-02,7170,0,1,1,中里,招呼
2020-05-03,7170,0,1,1,中里,招呼
2020-05-04,7170,5,1,6,中里,招呼
2020-05-05,7170,0,2,2,中里,招呼
2020-05-06,7170,1,2,3,中里,招呼
2020-05-07,7170,0,1,1,中里,招呼
2020-05-08,7170,1,0,1,中里,招呼
2020-05-09,7170,0,2,2,中里,招呼
2020-05-10,7170,0,0,0,中里,招呼
2020-05-11,7170,3,1,4,中里,招呼
2020-05-12,7170,0,2,2,中里,招呼
2020-05-13,7170,2,5,7,中里,招呼
2020-05-14,7170,2,3,5,中里,招呼
2020-05-15,7170,1,1,2,中里,招呼
2020-05-16,7170,1,1,2,中里,招呼
2020-05-17,7170,2,1,3,中里,招呼
2020-05-18,7170,2,1,3,中里,招呼
2020-05-19,7170,2,2,4,中里,招呼
2020-05-20,7170,2,3,5,中里,招呼
2020-05-21,7170,2,1,3,中里,招呼
2020-05-22,7170,1,2,3,中里,招呼
2020-05-23,7170,0,1,1,中里,招呼
2020-05-24,7170,2,3,5,中里,招呼
2020-05-25,7170,3,1,4,中里,招呼
2020-05-26,7170,2,2,4,中里,招呼
2020-05-27,7170,1,3,4,中里,招呼
2020-05-28,7170,2,2,4,中里,招呼
2020-05-29,7170,2,1,3,中里,招呼
2020-05-30,7170,0,0,0,中里,招呼
2020-05-31,7170,2,4,6,中里,招呼
2020-06-01,7170,3,1,4,中里,招呼
2020-06-02,7170,3,7,10,中里,招呼
2020-06-03,7170,1,2,3,中里,招呼
2020-06-04,7170,2,6,8,中里,招呼
2020-06-05,7170,2,1,3,中里,招呼
2020-06-06,7170,0,0,0,中里,招呼
2020-06-07,7170,0,2,2,中里,招呼
2020-06-08,7170,1,3,4,中里,招呼
2020-06-09,7170,1,2,3,中里,招呼
2020-06-10,7170,1,2,3,中里,招呼
2020-06-11,7170,0,0,0,中里,招呼
2020-06-12,7170,1,0,1,中里,招呼
2020-06-13,7170,1,0,1,中里,招呼
2020-06-14,7170,0,5,5,中里,招呼
2020-06-15,7170,2,3,5,中里,招呼
2020-06-16,7170,2,3,5,中里,招呼
2020-06-17,7170,1,2,3,中里,招呼
2020-06-18,7170,1,0,1,中里,招呼
2020-06-19,7170,2,1,3,中里,招呼
2020-06-20,7170,0,1,1,中里,招呼
2020-06-21,7170,0,2,2,中里,招呼
2020-06-22,7170,3,1,4,中里,招呼
2020-06-23,7170,0,5,5,中里,招呼
2020-06-24,7170,0,2,2,中里,招呼
2020-06-25,7170,1,3,4,中里,招呼
2020-06-26,7170,0,2,2,中里,招呼
2020-06-27,7170,0,1,1,中里,招呼
2020-06-28,7170,1,1,2,中里,招呼
2020-06-29,7170,0,1,1,中里,招呼
2020-06-30,7170,2,3,5,中里,招呼
2020-07-01,7170,1,2,3,中里,招呼
2020-07-02,7170,1,1,2,中里,招呼
2020-07-03,7170,2,0,2,中里,招呼
2020-07-04,7170,0,2,2,中里,招呼
2020-07-05,7170,0,1,1,中里,招呼
2020-07-06,7170,2,3,5,中里,招呼
2020-07-07,7170,3,3,6,中里,招呼
2020-07-08,7170,1,2,3,中里,招呼
2020-07-09,7170,2,2,4,中里,招呼
2020-07-10,7170,0,2,2,中里,招呼
2020-07-11,7170,0,0,0,中里,招呼
2020-07-12,7170,0,2,2,中里,招呼
2020-07-13,7170,1,1,2,中里,招呼
2020-07-14,7170,5,6,11,中里,招呼
2020-07-15,7170,1,2,3,中里,招呼
2020-07-16,7170,1,1,2,中里,招呼
2020-07-17,7170,2,1,3,中里,招呼
2020-07-18,7170,0,3,3,中里,招呼
2020-07-19,7170,1,2,3,中里,招呼
2020-07-20,7170,1,1,2,中里,招呼
2020-07-21,7170,3,4,7,中里,招呼
2020-07-22,7170,0,1,1,中里,招呼
2020-07-23,7170,2,2,4,中里,招呼
2020-07-24,7170,1,0,1,中里,招呼
2020-07-25,7170,0,4,4,中里,招呼
2020-07-26,7170,0,0,0,中里,招呼
2020-07-27,7170,1,2,3,中里,招呼
2020-07-28,7170,0,2,2,中里,招呼
2020-07-29,7170,1,2,3,中里,招呼
2020-07-30,7170,1,4,5,中里,招呼
2020-07-31,7170,4,3,7,中里,招呼
2020-08-01,7170,4,1,5,中里,招呼
2020-08-02,7170,0,5,5,中里,招呼
2020-08-03,7170,1,1,2,中里,招呼
2020-08-04,7170,4,6,10,中里,招呼
2020-08-05,7170,0,1,1,中里,招呼
2020-08-06,7170,1,3,4,中里,招呼
2020-08-07,7170,1,2,3,中里,招呼
2020-08-08,7170,1,0,1,中里,招呼
2020-08-09,7170,1,0,1,中里,招呼
2020-08-10,7170,2,1,3,中里,招呼
2020-08-11,7170,2,3,5,中里,招呼
2020-08-12,7170,2,6,8,中里,招呼
2020-08-13,7170,2,2,4,中里,招呼
2020-08-14,7170,2,0,2,中里,招呼
2020-08-15,7170,0,1,1,中里,招呼
2020-08-16,7170,0,1,1,中里,招呼
2020-08-17,7170,2,3,5,中里,招呼
2020-08-18,7170,0,3,3,中里,招呼
2020-08-19,7170,0,1,1,中里,招呼
2020-08-20,7170,4,3,7,中里,招呼
2020-08-21,7170,1,2,3,中里,招呼
2020-08-22,7170,0,1,1,中里,招呼
2020-08-23,7170,0,0,0,中里,招呼
2020-08-24,7170,2,5,7,中里,招呼
2020-08-25,7170,2,2,4,中里,招呼
2020-08-26,7170,1,2,3,中里,招呼
2020-08-27,7170,1,2,3,中里,招呼
2020-08-28,7170,2,1,3,中里,招呼
2020-08-29,7170,0,0,0,中里,招呼
2020-08-30,7170,1,1,2,中里,招呼
2020-08-31,7170,3,1,4,中里,招呼
2020-09-01,7170,1,3,4,中里,招呼
2020-09-02,7170,1,2,3,中里,招呼
2020-09-03,7170,0,0,0,中里,招呼
2020-09-04,7170,1,2,3,中里,招呼
2020-09-05,7170,0,1,1,中里,招呼
2020-09-06,7170,0,1,1,中里,招呼
2020-09-07,7170,2,1,3,中里,招呼
2020-09-08,7170,2,2,4,中里,招呼
2020-09-09,7170,2,3,5,中里,招呼
2020-09-10,7170,5,3,8,中里,招呼
2020-09-11,7170,1,0,1,中里,招呼
2020-09-12,7170,0,2,2,中里,招呼
2020-09-13,7170,0,2,2,中里,招呼
2020-09-14,7170,0,1,1,中里,招呼
2020-09-15,7170,2,3,5,中里,招呼
2020-09-16,7170,2,0,2,中里,招呼
2020-09-17,7170,0,2,2,中里,招呼
2020-09-18,7170,1,1,2,中里,招呼
2020-09-19,7170,0,0,0,中里,招呼
2020-09-20,7170,0,0,0,中里,招呼
2020-09-21,7170,1,1,2,中里,招呼
2020-09-22,7170,1,1,2,中里,招呼
2020-09-23,7170,1,2,3,中里,招呼
2020-09-24,7170,1,4,5,中里,招呼
2020-09-25,7170,1,1,2,中里,招呼
2020-09-26,7170,0,1,1,中里,招呼
2020-09-27,7170,1,0,1,中里,招呼
2020-09-28,7170,2,2,4,中里,招呼
2020-09-29,7170,0,1,1,中里,招呼
2020-09-30,7170,1,3,4,中里,招呼
2020-10-01,7170,1,2,3,中里,招呼
2020-10-02,7170,0,1,1,中里,招呼
2020-10-03,7170,0,0,0,中里,招呼
2020-10-04,7170,2,3,5,中里,招呼
2020-10-05,7170,2,1,3,中里,招呼
2020-10-06,7170,0,2,2,中里,招呼
2020-10-07,7170,0,2,2,中里,招呼
2020-10-08,7170,1,3,4,中里,招呼
2020-10-09,7170,1,2,3,中里,招呼
2020-10-10,7170,0,3,3,中里,招呼
2020-10-11,7170,0,1,1,中里,招呼
2020-10-12,7170,3,3,6,中里,招呼
2020-10-13,7170,2,2,4,中里,招呼
2020-10-14,7170,1,3,4,中里,招呼
2020-10-15,7170,1,2,3,中里,招呼
2020-10-16,7170,2,0,2,中里,招呼
2020-10-17,7170,0,0,0,中里,招呼
2020-10-18,7170,0,1,1,中里,招呼
2020-10-19,7170,2,3,5,中里,招呼
2020-10-20,7170,2,4,6,中里,招呼
2020-10-21,7170,1,2,3,中里,招呼
2020-10-22,7170,2,3,5,中里,招呼
2020-10-23,7170,2,0,2,中里,招呼
2020-10-24,7170,0,5,5,中里,招呼
2020-10-25,7170,1,0,1,中里,招呼
2020-10-26,7170,1,6,7,中里,招呼
2020-10-27,7170,4,3,7,中里,招呼
2020-10-28,7170,2,3,5,中里,招呼
2020-10-29,7170,1,1,2,中里,招呼
2020-10-30,7170,1,2,3,中里,招呼
2020-10-31,7170,2,2,4,中里,招呼
2020-11-01,7170,0,2,2,中里,招呼
2020-11-02,7170,2,1,3,中里,招呼
2020-11-03,7170,1,2,3,中里,招呼
2020-11-04,7170,2,3,5,中里,招呼
2020-11-05,7170,2,3,5,中里,招呼
2020-11-06,7170,2,1,3,中里,招呼
2020-11-07,7170,0,2,2,中里,招呼
2020-11-08,7170,2,1,3,中里,招呼
2020-11-09,7170,2,1,3,中里,招呼
2020-11-10,7170,1,2,3,中里,招呼
2020-11-11,7170,1,2,3,中里,招呼
2020-11-12,7170,2,4,6,中里,招呼
2020-11-13,7170,3,0,3,中里,招呼
2020-11-14,7170,0,1,1,中里,招呼
2020-11-15,7170,2,2,4,中里,招呼
2020-11-16,7170,4,2,6,中里,招呼
2020-11-17,7170,2,2,4,中里,招呼
2020-11-18,7170,0,2,2,中里,招呼
2020-11-19,7170,0,1,1,中里,招呼
2020-11-20,7170,1,6,7,中里,招呼
2020-11-21,7170,0,0,0,中里,招呼
2020-11-22,7170,1,2,3,中里,招呼
2020-11-23,7170,1,1,2,中里,招呼
2020-11-24,7170,1,4,5,中里,招呼
2020-11-25,7170,0,4,4,中里,招呼
2020-11-26,7170,1,3,4,中里,招呼
2020-11-27,7170,3,0,3,中里,招呼
2020-11-28,7170,2,0,2,中里,招呼
2020-11-29,7170,1,3,4,中里,招呼
2020-11-30,7170,3,2,5,中里,招呼
2020-12-01,7170,2,1,3,中里,招呼
2020-12-02,7170,1,3,4,中里,招呼
2020-12-03,7170,2,0,2,中里,招呼
2020-12-04,7170,2,1,3,中里,招呼
2020-12-05,7170,0,0,0,中里,招呼
2020-12-06,7170,0,2,2,中里,招呼
2020-12-07,7170,2,1,3,中里,招呼
2020-12-08,7170,2,1,3,中里,招呼
2020-12-09,7170,0,2,2,中里,招呼
2020-12-10,7170,1,2,3,中里,招呼
2020-12-11,7170,2,1,3,中里,招呼
2020-12-12,7170,0,3,3,中里,招呼
2020-12-13,7170,0,2,2,中里,招呼
2020-12-14,7170,3,1,4,中里,招呼
2020-12-15,7170,1,2,3,中里,招呼
2020-12-16,7170,1,1,2,中里,招呼
2020-12-17,7170,0,2,2,中里,招呼
2020-12-18,7170,0,1,1,中里,招呼
2020-12-19,7170,2,0,2,中里,招呼
2020-12-20,7170,0,4,4,中里,招呼
2020-12-21,7170,3,0,3,中里,招呼
2020-12-22,7170,0,0,0,中里,招呼
2020-12-23,7170,1,4,5,中里,招呼
2020-12-24,7170,0,1,1,中里,招呼
2020-12-25,7170,7,8,15,中里,招呼
2020-12-26,7170,8,16,24,中里,招呼
2020-12-27,7170,14,14,28,中里,招呼
2020-12-28,7170,9,16,25,中里,招呼
2020-12-29,7170,10,14,24,中里,招呼
2020-12-30,7170,13,17,30,中里,招呼
2020-12-31,7170,21,29,50,中里,招呼
2020-01-01,7180,135,158,293,二結,三等
2020-01-02,7180,188,194,382,二結,三等
2020-01-03,7180,187,204,391,二結,三等
2020-01-04,7180,155,169,324,二結,三等
2020-01-05,7180,142,118,260,二結,三等
2020-01-06,7180,185,174,359,二結,三等
2020-01-07,7180,191,206,397,二結,三等
2020-01-08,7180,187,183,370,二結,三等
2020-01-09,7180,170,186,356,二結,三等
2020-01-10,7180,175,197,372,二結,三等
2020-01-11,7180,136,118,254,二結,三等
2020-01-12,7180,104,91,195,二結,三等
2020-01-13,7180,188,196,384,二結,三等
2020-01-14,7180,183,206,389,二結,三等
2020-01-15,7180,171,185,356,二結,三等
2020-01-16,7180,196,188,384,二結,三等
2020-01-17,7180,156,191,347,二結,三等
2020-01-18,7180,123,119,242,二結,三等
2020-01-19,7180,99,105,204,二結,三等
2020-01-20,7180,162,162,324,二結,三等
2020-01-21,7180,137,137,274,二結,三等
2020-01-22,7180,153,125,278,二結,三等
2020-01-23,7180,103,141,244,二結,三等
2020-01-24,7180,92,99,191,二結,三等
2020-01-25,7180,154,115,269,二結,三等
2020-01-26,7180,119,108,227,二結,三等
2020-01-27,7180,209,220,429,二結,三等
2020-01-28,7180,137,157,294,二結,三等
2020-01-29,7180,137,109,246,二結,三等
2020-01-30,7180,145,168,313,二結,三等
2020-01-31,7180,160,149,309,二結,三等
2020-02-01,7180,135,120,255,二結,三等
2020-02-02,7180,186,99,285,二結,三等
2020-02-03,7180,165,135,300,二結,三等
2020-02-04,7180,139,128,267,二結,三等
2020-02-05,7180,135,129,264,二結,三等
2020-02-06,7180,122,127,249,二結,三等
2020-02-07,7180,130,122,252,二結,三等
2020-02-08,7180,94,100,194,二結,三等
2020-02-09,7180,89,72,161,二結,三等
2020-02-10,7180,127,128,255,二結,三等
2020-02-11,7180,132,120,252,二結,三等
2020-02-12,7180,133,122,255,二結,三等
2020-02-13,7180,132,139,271,二結,三等
2020-02-14,7180,113,95,208,二結,三等
2020-02-15,7180,122,116,238,二結,三等
2020-02-16,7180,105,92,197,二結,三等
2020-02-17,7180,146,122,268,二結,三等
2020-02-18,7180,122,129,251,二結,三等
2020-02-19,7180,129,129,258,二結,三等
2020-02-20,7180,125,132,257,二結,三等
2020-02-21,7180,147,156,303,二結,三等
2020-02-22,7180,88,83,171,二結,三等
2020-02-23,7180,72,81,153,二結,三等
2020-02-24,7180,162,163,325,二結,三等
2020-02-25,7180,160,166,326,二結,三等
2020-02-26,7180,162,182,344,二結,三等
2020-02-27,7180,156,188,344,二結,三等
2020-02-28,7180,130,159,289,二結,三等
2020-02-29,7180,126,142,268,二結,三等
2020-03-01,7180,106,107,213,二結,三等
2020-03-02,7180,153,174,327,二結,三等
2020-03-03,7180,150,184,334,二結,三等
2020-03-04,7180,156,172,328,二結,三等
2020-03-05,7180,140,158,298,二結,三等
2020-03-06,7180,168,196,364,二結,三等
2020-03-07,7180,117,133,250,二結,三等
2020-03-08,7180,79,78,157,二結,三等
2020-03-09,7180,175,172,347,二結,三等
2020-03-10,7180,153,175,328,二結,三等
2020-03-11,7180,144,179,323,二結,三等
2020-03-12,7180,134,159,293,二結,三等
2020-03-13,7180,156,198,354,二結,三等
2020-03-14,7180,104,98,202,二結,三等
2020-03-15,7180,103,109,212,二結,三等
2020-03-16,7180,168,178,346,二結,三等
2020-03-17,7180,147,167,314,二結,三等
2020-03-18,7180,145,184,329,二結,三等
2020-03-19,7180,161,166,327,二結,三等
2020-03-20,7180,149,194,343,二結,三等
2020-03-21,7180,89,99,188,二結,三等
2020-03-22,7180,95,85,180,二結,三等
2020-03-23,7180,151,169,320,二結,三等
2020-03-24,7180,150,176,326,二結,三等
2020-03-25,7180,143,156,299,二結,三等
2020-03-26,7180,142,165,307,二結,三等
2020-03-27,7180,138,174,312,二結,三等
2020-03-28,7180,96,91,187,二結,三等
2020-03-29,7180,80,79,159,二結,三等
2020-03-30,7180,144,167,311,二結,三等
2020-03-31,7180,144,169,313,二結,三等
2020-04-01,7180,141,171,312,二結,三等
2020-04-02,7180,87,106,193,二結,三等
2020-04-03,7180,111,109,220,二結,三等
2020-04-04,7180,93,69,162,二結,三等
2020-04-05,7180,69,59,128,二結,三等
2020-04-06,7180,135,151,286,二結,三等
2020-04-07,7180,141,147,288,二結,三等
2020-04-08,7180,153,165,318,二結,三等
2020-04-09,7180,144,162,306,二結,三等
2020-04-10,7180,155,188,343,二結,三等
2020-04-11,7180,68,81,149,二結,三等
2020-04-12,7180,93,88,181,二結,三等
2020-04-13,7180,138,141,279,二結,三等
2020-04-14,7180,135,168,303,二結,三等
2020-04-15,7180,138,154,292,二結,三等
2020-04-16,7180,134,136,270,二結,三等
2020-04-17,7180,149,178,327,二結,三等
2020-04-18,7180,92,80,172,二結,三等
2020-04-19,7180,90,78,168,二結,三等
2020-04-20,7180,151,154,305,二結,三等
2020-04-21,7180,131,145,276,二結,三等
2020-04-22,7180,133,139,272,二結,三等
2020-04-23,7180,129,133,262,二結,三等
2020-04-24,7180,131,153,284,二結,三等
2020-04-25,7180,66,63,129,二結,三等
2020-04-26,7180,92,83,175,二結,三等
2020-04-27,7180,140,164,304,二結,三等
2020-04-28,7180,132,153,285,二結,三等
2020-04-29,7180,131,128,259,二結,三等
2020-04-30,7180,159,186,345,二結,三等
2020-05-01,7180,137,179,316,二結,三等
2020-05-02,7180,77,79,156,二結,三等
2020-05-03,7180,100,97,197,二結,三等
2020-05-04,7180,128,142,270,二結,三等
2020-05-05,7180,139,147,286,二結,三等
2020-05-06,7180,149,166,315,二結,三等
2020-05-07,7180,148,148,296,二結,三等
2020-05-08,7180,141,179,320,二結,三等
2020-05-09,7180,108,111,219,二結,三等
2020-05-10,7180,75,72,147,二結,三等
2020-05-11,7180,140,153,293,二結,三等
2020-05-12,7180,140,145,285,二結,三等
2020-05-13,7180,146,167,313,二結,三等
2020-05-14,7180,136,147,283,二結,三等
2020-05-15,7180,156,169,325,二結,三等
2020-05-16,7180,78,77,155,二結,三等
2020-05-17,7180,85,78,163,二結,三等
2020-05-18,7180,128,136,264,二結,三等
2020-05-19,7180,140,157,297,二結,三等
2020-05-20,7180,138,143,281,二結,三等
2020-05-21,7180,126,130,256,二結,三等
2020-05-22,7180,120,149,269,二結,三等
2020-05-23,7180,72,75,147,二結,三等
2020-05-24,7180,86,86,172,二結,三等
2020-05-25,7180,143,157,300,二結,三等
2020-05-26,7180,147,160,307,二結,三等
2020-05-27,7180,131,158,289,二結,三等
2020-05-28,7180,134,151,285,二結,三等
2020-05-29,7180,186,192,378,二結,三等
2020-05-30,7180,100,95,195,二結,三等
2020-05-31,7180,136,105,241,二結,三等
2020-06-01,7180,135,159,294,二結,三等
2020-06-02,7180,168,171,339,二結,三等
2020-06-03,7180,146,146,292,二結,三等
2020-06-04,7180,134,127,261,二結,三等
2020-06-05,7180,125,165,290,二結,三等
2020-06-06,7180,121,113,234,二結,三等
2020-06-07,7180,99,84,183,二結,三等
2020-06-08,7180,180,167,347,二結,三等
2020-06-09,7180,159,164,323,二結,三等
2020-06-10,7180,150,160,310,二結,三等
2020-06-11,7180,180,177,357,二結,三等
2020-06-12,7180,158,167,325,二結,三等
2020-06-13,7180,97,92,189,二結,三等
2020-06-14,7180,104,92,196,二結,三等
2020-06-15,7180,154,145,299,二結,三等
2020-06-16,7180,145,149,294,二結,三等
2020-06-17,7180,131,148,279,二結,三等
2020-06-18,7180,149,155,304,二結,三等
2020-06-19,7180,154,158,312,二結,三等
2020-06-20,7180,134,143,277,二結,三等
2020-06-21,7180,68,77,145,二結,三等
2020-06-22,7180,136,132,268,二結,三等
2020-06-23,7180,117,138,255,二結,三等
2020-06-24,7180,144,135,279,二結,三等
2020-06-25,7180,110,121,231,二結,三等
2020-06-26,7180,135,151,286,二結,三等
2020-06-27,7180,153,124,277,二結,三等
2020-06-28,7180,92,79,171,二結,三等
2020-06-29,7180,145,128,273,二結,三等
2020-06-30,7180,129,125,254,二結,三等
2020-07-01,7180,145,146,291,二結,三等
2020-07-02,7180,136,143,279,二結,三等
2020-07-03,7180,133,131,264,二結,三等
2020-07-04,7180,113,94,207,二結,三等
2020-07-05,7180,140,126,266,二結,三等
2020-07-06,7180,156,152,308,二結,三等
2020-07-07,7180,145,144,289,二結,三等
2020-07-08,7180,167,173,340,二結,三等
2020-07-09,7180,150,165,315,二結,三等
2020-07-10,7180,167,211,378,二結,三等
2020-07-11,7180,103,107,210,二結,三等
2020-07-12,7180,85,76,161,二結,三等
2020-07-13,7180,136,144,280,二結,三等
2020-07-14,7180,139,142,281,二結,三等
2020-07-15,7180,103,141,244,二結,三等
2020-07-16,7180,132,130,262,二結,三等
2020-07-17,7180,136,134,270,二結,三等
2020-07-18,7180,109,134,243,二結,三等
2020-07-19,7180,120,110,230,二結,三等
2020-07-20,7180,137,127,264,二結,三等
2020-07-21,7180,140,132,272,二結,三等
2020-07-22,7180,120,124,244,二結,三等
2020-07-23,7180,132,125,257,二結,三等
2020-07-24,7180,141,130,271,二結,三等
2020-07-25,7180,73,104,177,二結,三等
2020-07-26,7180,114,100,214,二結,三等
2020-07-27,7180,148,144,292,二結,三等
2020-07-28,7180,124,120,244,二結,三等
2020-07-29,7180,107,128,235,二結,三等
2020-07-30,7180,129,128,257,二結,三等
2020-07-31,7180,138,140,278,二結,三等
2020-08-01,7180,106,119,225,二結,三等
2020-08-02,7180,108,102,210,二結,三等
2020-08-03,7180,109,111,220,二結,三等
2020-08-04,7180,134,136,270,二結,三等
2020-08-05,7180,126,136,262,二結,三等
2020-08-06,7180,139,129,268,二結,三等
2020-08-07,7180,142,139,281,二結,三等
2020-08-08,7180,133,120,253,二結,三等
2020-08-09,7180,128,121,249,二結,三等
2020-08-10,7180,146,144,290,二結,三等
2020-08-11,7180,132,140,272,二結,三等
2020-08-12,7180,107,118,225,二結,三等
2020-08-13,7180,137,143,280,二結,三等
2020-08-14,7180,134,149,283,二結,三等
2020-08-15,7180,134,138,272,二結,三等
2020-08-16,7180,99,101,200,二結,三等
2020-08-17,7180,154,121,275,二結,三等
2020-08-18,7180,142,125,267,二結,三等
2020-08-19,7180,117,138,255,二結,三等
2020-08-20,7180,150,150,300,二結,三等
2020-08-21,7180,131,132,263,二結,三等
2020-08-22,7180,97,106,203,二結,三等
2020-08-23,7180,89,72,161,二結,三等
2020-08-24,7180,159,142,301,二結,三等
2020-08-25,7180,120,159,279,二結,三等
2020-08-26,7180,161,138,299,二結,三等
2020-08-27,7180,158,136,294,二結,三等
2020-08-28,7180,158,146,304,二結,三等
2020-08-29,7180,101,107,208,二結,三等
2020-08-30,7180,96,82,178,二結,三等
2020-08-31,7180,161,146,307,二結,三等
2020-09-01,7180,155,182,337,二結,三等
2020-09-02,7180,150,163,313,二結,三等
2020-09-03,7180,152,164,316,二結,三等
2020-09-04,7180,159,161,320,二結,三等
2020-09-05,7180,96,117,213,二結,三等
2020-09-06,7180,87,81,168,二結,三等
2020-09-07,7180,162,177,339,二結,三等
2020-09-08,7180,166,172,338,二結,三等
2020-09-09,7180,142,148,290,二結,三等
2020-09-10,7180,142,148,290,二結,三等
2020-09-11,7180,165,184,349,二結,三等
2020-09-12,7180,106,102,208,二結,三等
2020-09-13,7180,88,79,167,二結,三等
2020-09-14,7180,142,146,288,二結,三等
2020-09-15,7180,154,151,305,二結,三等
2020-09-16,7180,132,153,285,二結,三等
2020-09-17,7180,181,175,356,二結,三等
2020-09-18,7180,179,171,350,二結,三等
2020-09-19,7180,99,120,219,二結,三等
2020-09-20,7180,108,85,193,二結,三等
2020-09-21,7180,156,173,329,二結,三等
2020-09-22,7180,164,176,340,二結,三等
2020-09-23,7180,148,148,296,二結,三等
2020-09-24,7180,142,159,301,二結,三等
2020-09-25,7180,173,178,351,二結,三等
2020-09-26,7180,128,145,273,二結,三等
2020-09-27,7180,126,122,248,二結,三等
2020-09-28,7180,153,158,311,二結,三等
2020-09-29,7180,151,152,303,二結,三等
2020-09-30,7180,173,207,380,二結,三等
2020-10-01,7180,112,157,269,二結,三等
2020-10-02,7180,220,207,427,二結,三等
2020-10-03,7180,164,146,310,二結,三等
2020-10-04,7180,114,115,229,二結,三等
2020-10-05,7180,168,165,333,二結,三等
2020-10-06,7180,168,176,344,二結,三等
2020-10-07,7180,175,171,346,二結,三等
2020-10-08,7180,165,177,342,二結,三等
2020-10-09,7180,138,185,323,二結,三等
2020-10-10,7180,147,131,278,二結,三等
2020-10-11,7180,121,86,207,二結,三等
2020-10-12,7180,159,140,299,二結,三等
2020-10-13,7180,145,165,310,二結,三等
2020-10-14,7180,138,150,288,二結,三等
2020-10-15,7180,143,164,307,二結,三等
2020-10-16,7180,168,177,345,二結,三等
2020-10-17,7180,116,114,230,二結,三等
2020-10-18,7180,92,90,182,二結,三等
2020-10-19,7180,161,168,329,二結,三等
2020-10-20,7180,152,165,317,二結,三等
2020-10-21,7180,153,171,324,二結,三等
2020-10-22,7180,146,156,302,二結,三等
2020-10-23,7180,162,174,336,二結,三等
2020-10-24,7180,137,136,273,二結,三等
2020-10-25,7180,104,111,215,二結,三等
2020-10-26,7180,160,160,320,二結,三等
2020-10-27,7180,158,169,327,二結,三等
2020-10-28,7180,141,151,292,二結,三等
2020-10-29,7180,130,136,266,二結,三等
2020-10-30,7180,148,176,324,二結,三等
2020-10-31,7180,102,123,225,二結,三等
2020-11-01,7180,119,108,227,二結,三等
2020-11-02,7180,153,142,295,二結,三等
2020-11-03,7180,137,163,300,二結,三等
2020-11-04,7180,142,157,299,二結,三等
2020-11-05,7180,158,163,321,二結,三等
2020-11-06,7180,155,162,317,二結,三等
2020-11-07,7180,113,101,214,二結,三等
2020-11-08,7180,99,91,190,二結,三等
2020-11-09,7180,144,149,293,二結,三等
2020-11-10,7180,141,149,290,二結,三等
2020-11-11,7180,155,158,313,二結,三等
2020-11-12,7180,147,148,295,二結,三等
2020-11-13,7180,144,163,307,二結,三等
2020-11-14,7180,95,97,192,二結,三等
2020-11-15,7180,114,125,239,二結,三等
2020-11-16,7180,159,180,339,二結,三等
2020-11-17,7180,180,192,372,二結,三等
2020-11-18,7180,139,155,294,二結,三等
2020-11-19,7180,160,157,317,二結,三等
2020-11-20,7180,172,149,321,二結,三等
2020-11-21,7180,101,125,226,二結,三等
2020-11-22,7180,128,128,256,二結,三等
2020-11-23,7180,150,140,290,二結,三等
2020-11-24,7180,214,235,449,二結,三等
2020-11-25,7180,151,155,306,二結,三等
2020-11-26,7180,135,149,284,二結,三等
2020-11-27,7180,141,185,326,二結,三等
2020-11-28,7180,118,119,237,二結,三等
2020-11-29,7180,77,79,156,二結,三等
2020-11-30,7180,135,144,279,二結,三等
2020-12-01,7180,138,154,292,二結,三等
2020-12-02,7180,137,132,269,二結,三等
2020-12-03,7180,142,165,307,二結,三等
2020-12-04,7180,125,119,244,二結,三等
2020-12-05,7180,84,100,184,二結,三等
2020-12-06,7180,62,79,141,二結,三等
2020-12-07,7180,128,128,256,二結,三等
2020-12-08,7180,127,134,261,二結,三等
2020-12-09,7180,127,146,273,二結,三等
2020-12-10,7180,137,156,293,二結,三等
2020-12-11,7180,149,160,309,二結,三等
2020-12-12,7180,117,116,233,二結,三等
2020-12-13,7180,90,89,179,二結,三等
2020-12-14,7180,153,160,313,二結,三等
2020-12-15,7180,124,131,255,二結,三等
2020-12-16,7180,128,137,265,二結,三等
2020-12-17,7180,129,151,280,二結,三等
2020-12-18,7180,153,176,329,二結,三等
2020-12-19,7180,80,95,175,二結,三等
2020-12-20,7180,89,60,149,二結,三等
2020-12-21,7180,141,158,299,二結,三等
2020-12-22,7180,160,160,320,二結,三等
2020-12-23,7180,152,156,308,二結,三等
2020-12-24,7180,144,160,304,二結,三等
2020-12-25,7180,144,160,304,二結,三等
2020-12-26,7180,133,146,279,二結,三等
2020-12-27,7180,105,91,196,二結,三等
2020-12-28,7180,147,155,302,二結,三等
2020-12-29,7180,229,238,467,二結,三等
2020-12-30,7180,134,139,273,二結,三等
2020-12-31,7180,150,179,329,二結,三等
2020-01-01,7190,6035,5230,11265,宜蘭,一等
2020-01-02,7190,4587,4129,8716,宜蘭,一等
2020-01-03,7190,4768,4775,9543,宜蘭,一等
2020-01-04,7190,5041,4860,9901,宜蘭,一等
2020-01-05,7190,4432,4318,8750,宜蘭,一等
2020-01-06,7190,4208,3917,8125,宜蘭,一等
2020-01-07,7190,4004,3976,7980,宜蘭,一等
2020-01-08,7190,4096,3859,7955,宜蘭,一等
2020-01-09,7190,3889,3999,7888,宜蘭,一等
2020-01-10,7190,5224,5005,10229,宜蘭,一等
2020-01-11,7190,4059,4305,8364,宜蘭,一等
2020-01-12,7190,4450,4133,8583,宜蘭,一等
2020-01-13,7190,4205,3987,8192,宜蘭,一等
2020-01-14,7190,4360,4385,8745,宜蘭,一等
2020-01-15,7190,4242,4004,8246,宜蘭,一等
2020-01-16,7190,5521,5076,10597,宜蘭,一等
2020-01-17,7190,4416,4300,8716,宜蘭,一等
2020-01-18,7190,4597,4400,8997,宜蘭,一等
2020-01-19,7190,4271,4204,8475,宜蘭,一等
2020-01-20,7190,4299,4243,8542,宜蘭,一等
2020-01-21,7190,4301,4382,8683,宜蘭,一等
2020-01-22,7190,4774,4752,9526,宜蘭,一等
2020-01-23,7190,4239,4495,8734,宜蘭,一等
2020-01-24,7190,3232,3407,6639,宜蘭,一等
2020-01-25,7190,5886,5027,10913,宜蘭,一等
2020-01-26,7190,6059,5640,11699,宜蘭,一等
2020-01-27,7190,6289,6349,12638,宜蘭,一等
2020-01-28,7190,5768,5819,11587,宜蘭,一等
2020-01-29,7190,4900,4968,9868,宜蘭,一等
2020-01-30,7190,4262,4169,8431,宜蘭,一等
2020-01-31,7190,4198,4297,8495,宜蘭,一等
2020-02-01,7190,3897,3883,7780,宜蘭,一等
2020-02-02,7190,4029,3838,7867,宜蘭,一等
2020-02-03,7190,3481,4186,7667,宜蘭,一等
2020-02-04,7190,3519,3991,7510,宜蘭,一等
2020-02-05,7190,3082,3196,6278,宜蘭,一等
2020-02-06,7190,3410,3330,6740,宜蘭,一等
2020-02-07,7190,3849,3810,7659,宜蘭,一等
2020-02-08,7190,3199,3262,6461,宜蘭,一等
2020-02-09,7190,3393,3396,6789,宜蘭,一等
2020-02-10,7190,3332,3321,6653,宜蘭,一等
2020-02-11,7190,3074,3294,6368,宜蘭,一等
2020-02-12,7190,3441,3374,6815,宜蘭,一等
2020-02-13,7190,3188,3271,6459,宜蘭,一等
2020-02-14,7190,3331,3422,6753,宜蘭,一等
2020-02-15,7190,3498,3272,6770,宜蘭,一等
2020-02-16,7190,3366,3461,6827,宜蘭,一等
2020-02-17,7190,3245,3068,6313,宜蘭,一等
2020-02-18,7190,2954,2877,5831,宜蘭,一等
2020-02-19,7190,3119,3486,6605,宜蘭,一等
2020-02-20,7190,2956,3029,5985,宜蘭,一等
2020-02-21,7190,3693,3555,7248,宜蘭,一等
2020-02-22,7190,3120,3159,6279,宜蘭,一等
2020-02-23,7190,3155,3165,6320,宜蘭,一等
2020-02-24,7190,3201,3311,6512,宜蘭,一等
2020-02-25,7190,3559,3465,7024,宜蘭,一等
2020-02-26,7190,3474,3387,6861,宜蘭,一等
2020-02-27,7190,4226,4259,8485,宜蘭,一等
2020-02-28,7190,3870,4414,8284,宜蘭,一等
2020-02-29,7190,4078,3726,7804,宜蘭,一等
2020-03-01,7190,4236,3761,7997,宜蘭,一等
2020-03-02,7190,3368,3283,6651,宜蘭,一等
2020-03-03,7190,3165,2992,6157,宜蘭,一等
2020-03-04,7190,3251,3186,6437,宜蘭,一等
2020-03-05,7190,3112,3130,6242,宜蘭,一等
2020-03-06,7190,3999,3718,7717,宜蘭,一等
2020-03-07,7190,2877,3093,5970,宜蘭,一等
2020-03-08,7190,3226,3008,6234,宜蘭,一等
2020-03-09,7190,3352,3209,6561,宜蘭,一等
2020-03-10,7190,3061,2958,6019,宜蘭,一等
2020-03-11,7190,3210,3156,6366,宜蘭,一等
2020-03-12,7190,3156,3185,6341,宜蘭,一等
2020-03-13,7190,4167,4051,8218,宜蘭,一等
2020-03-14,7190,2787,3031,5818,宜蘭,一等
2020-03-15,7190,3736,3574,7310,宜蘭,一等
2020-03-16,7190,3313,3261,6574,宜蘭,一等
2020-03-17,7190,3188,3081,6269,宜蘭,一等
2020-03-18,7190,3201,3158,6359,宜蘭,一等
2020-03-19,7190,3106,3014,6120,宜蘭,一等
2020-03-20,7190,4021,3889,7910,宜蘭,一等
2020-03-21,7190,2808,2986,5794,宜蘭,一等
2020-03-22,7190,2956,2864,5820,宜蘭,一等
2020-03-23,7190,3207,3596,6803,宜蘭,一等
2020-03-24,7190,2977,3407,6384,宜蘭,一等
2020-03-25,7190,2899,2922,5821,宜蘭,一等
2020-03-26,7190,3000,2955,5955,宜蘭,一等
2020-03-27,7190,3846,3536,7382,宜蘭,一等
2020-03-28,7190,2319,2557,4876,宜蘭,一等
2020-03-29,7190,2843,2636,5479,宜蘭,一等
2020-03-30,7190,3150,2950,6100,宜蘭,一等
2020-03-31,7190,2929,2945,5874,宜蘭,一等
2020-04-01,7190,4049,4261,8310,宜蘭,一等
2020-04-02,7190,3198,3562,6760,宜蘭,一等
2020-04-03,7190,2946,3221,6167,宜蘭,一等
2020-04-04,7190,2787,2605,5392,宜蘭,一等
2020-04-05,7190,3361,3086,6447,宜蘭,一等
2020-04-06,7190,3188,2920,6108,宜蘭,一等
2020-04-07,7190,2779,2680,5459,宜蘭,一等
2020-04-08,7190,2660,2709,5369,宜蘭,一等
2020-04-09,7190,2728,2797,5525,宜蘭,一等
2020-04-10,7190,3642,3628,7270,宜蘭,一等
2020-04-11,7190,2314,2291,4605,宜蘭,一等
2020-04-12,7190,2562,2547,5109,宜蘭,一等
2020-04-13,7190,2919,2827,5746,宜蘭,一等
2020-04-14,7190,2791,2716,5507,宜蘭,一等
2020-04-15,7190,2931,2893,5824,宜蘭,一等
2020-04-16,7190,2792,2757,5549,宜蘭,一等
2020-04-17,7190,3691,3502,7193,宜蘭,一等
2020-04-18,7190,2570,2704,5274,宜蘭,一等
2020-04-19,7190,2603,2582,5185,宜蘭,一等
2020-04-20,7190,2910,2904,5814,宜蘭,一等
2020-04-21,7190,2817,2858,5675,宜蘭,一等
2020-04-22,7190,3249,3162,6411,宜蘭,一等
2020-04-23,7190,2757,2792,5549,宜蘭,一等
2020-04-24,7190,3458,3238,6696,宜蘭,一等
2020-04-25,7190,2102,2301,4403,宜蘭,一等
2020-04-26,7190,2383,2299,4682,宜蘭,一等
2020-04-27,7190,2899,2785,5684,宜蘭,一等
2020-04-28,7190,2791,2684,5475,宜蘭,一等
2020-04-29,7190,2836,2822,5658,宜蘭,一等
2020-04-30,7190,3128,3340,6468,宜蘭,一等
2020-05-01,7190,3916,3968,7884,宜蘭,一等
2020-05-02,7190,3036,2904,5940,宜蘭,一等
2020-05-03,7190,3537,3164,6701,宜蘭,一等
2020-05-04,7190,2987,2947,5934,宜蘭,一等
2020-05-05,7190,2926,3121,6047,宜蘭,一等
2020-05-06,7190,2961,2930,5891,宜蘭,一等
2020-05-07,7190,2911,2889,5800,宜蘭,一等
2020-05-08,7190,3958,4024,7982,宜蘭,一等
2020-05-09,7190,2674,2986,5660,宜蘭,一等
2020-05-10,7190,3446,3087,6533,宜蘭,一等
2020-05-11,7190,3178,3070,6248,宜蘭,一等
2020-05-12,7190,2911,2942,5853,宜蘭,一等
2020-05-13,7190,3157,3126,6283,宜蘭,一等
2020-05-14,7190,3048,3049,6097,宜蘭,一等
2020-05-15,7190,4540,4226,8766,宜蘭,一等
2020-05-16,7190,2644,2894,5538,宜蘭,一等
2020-05-17,7190,3347,3204,6551,宜蘭,一等
2020-05-18,7190,3116,3040,6156,宜蘭,一等
2020-05-19,7190,2833,2740,5573,宜蘭,一等
2020-05-20,7190,2874,3024,5898,宜蘭,一等
2020-05-21,7190,2837,3006,5843,宜蘭,一等
2020-05-22,7190,3726,3646,7372,宜蘭,一等
2020-05-23,7190,2665,2727,5392,宜蘭,一等
2020-05-24,7190,3443,3404,6847,宜蘭,一等
2020-05-25,7190,3285,3122,6407,宜蘭,一等
2020-05-26,7190,3088,3066,6154,宜蘭,一等
2020-05-27,7190,2984,2999,5983,宜蘭,一等
2020-05-28,7190,2958,2974,5932,宜蘭,一等
2020-05-29,7190,3778,4029,7807,宜蘭,一等
2020-05-30,7190,3876,3733,7609,宜蘭,一等
2020-05-31,7190,3873,3448,7321,宜蘭,一等
2020-06-01,7190,3275,3467,6742,宜蘭,一等
2020-06-02,7190,3161,3074,6235,宜蘭,一等
2020-06-03,7190,3222,3326,6548,宜蘭,一等
2020-06-04,7190,3179,3253,6432,宜蘭,一等
2020-06-05,7190,4222,4045,8267,宜蘭,一等
2020-06-06,7190,3786,4061,7847,宜蘭,一等
2020-06-07,7190,3826,3557,7383,宜蘭,一等
2020-06-08,7190,3311,3229,6540,宜蘭,一等
2020-06-09,7190,3775,3737,7512,宜蘭,一等
2020-06-10,7190,3369,3403,6772,宜蘭,一等
2020-06-11,7190,3612,3727,7339,宜蘭,一等
2020-06-12,7190,4407,4274,8681,宜蘭,一等
2020-06-13,7190,3965,4200,8165,宜蘭,一等
2020-06-14,7190,4354,4169,8523,宜蘭,一等
2020-06-15,7190,3526,3536,7062,宜蘭,一等
2020-06-16,7190,3537,3492,7029,宜蘭,一等
2020-06-17,7190,3315,3350,6665,宜蘭,一等
2020-06-18,7190,3212,3342,6554,宜蘭,一等
2020-06-19,7190,4347,4286,8633,宜蘭,一等
2020-06-20,7190,4047,4103,8150,宜蘭,一等
2020-06-21,7190,3932,4066,7998,宜蘭,一等
2020-06-22,7190,3577,3560,7137,宜蘭,一等
2020-06-23,7190,3608,3916,7524,宜蘭,一等
2020-06-24,7190,4746,4809,9555,宜蘭,一等
2020-06-25,7190,4894,5187,10081,宜蘭,一等
2020-06-26,7190,5426,5618,11044,宜蘭,一等
2020-06-27,7190,5405,5051,10456,宜蘭,一等
2020-06-28,7190,5054,4531,9585,宜蘭,一等
2020-06-29,7190,3816,3745,7561,宜蘭,一等
2020-06-30,7190,3674,3584,7258,宜蘭,一等
2020-07-01,7190,3297,3285,6582,宜蘭,一等
2020-07-02,7190,3261,3519,6780,宜蘭,一等
2020-07-03,7190,4353,4252,8605,宜蘭,一等
2020-07-04,7190,3651,3830,7481,宜蘭,一等
2020-07-05,7190,3860,3756,7616,宜蘭,一等
2020-07-06,7190,3674,3732,7406,宜蘭,一等
2020-07-07,7190,3403,3443,6846,宜蘭,一等
2020-07-08,7190,3532,3776,7308,宜蘭,一等
2020-07-09,7190,3607,3807,7414,宜蘭,一等
2020-07-10,7190,5023,4738,9761,宜蘭,一等
2020-07-11,7190,3853,4254,8107,宜蘭,一等
2020-07-12,7190,4366,3950,8316,宜蘭,一等
2020-07-13,7190,3841,3656,7497,宜蘭,一等
2020-07-14,7190,4449,4185,8634,宜蘭,一等
2020-07-15,7190,3990,3898,7888,宜蘭,一等
2020-07-16,7190,4081,4148,8229,宜蘭,一等
2020-07-17,7190,4498,4708,9206,宜蘭,一等
2020-07-18,7190,4233,4543,8776,宜蘭,一等
2020-07-19,7190,4514,4051,8565,宜蘭,一等
2020-07-20,7190,3782,3864,7646,宜蘭,一等
2020-07-21,7190,3802,3809,7611,宜蘭,一等
2020-07-22,7190,3728,5120,8848,宜蘭,一等
2020-07-23,7190,3920,4004,7924,宜蘭,一等
2020-07-24,7190,4225,4541,8766,宜蘭,一等
2020-07-25,7190,4304,4717,9021,宜蘭,一等
2020-07-26,7190,4625,4155,8780,宜蘭,一等
2020-07-27,7190,4071,4054,8125,宜蘭,一等
2020-07-28,7190,3978,4043,8021,宜蘭,一等
2020-07-29,7190,4202,3945,8147,宜蘭,一等
2020-07-30,7190,4215,4176,8391,宜蘭,一等
2020-07-31,7190,4427,4704,9131,宜蘭,一等
2020-08-01,7190,4477,4634,9111,宜蘭,一等
2020-08-02,7190,4807,4591,9398,宜蘭,一等
2020-08-03,7190,3854,3779,7633,宜蘭,一等
2020-08-04,7190,3584,3676,7260,宜蘭,一等
2020-08-05,7190,3809,3804,7613,宜蘭,一等
2020-08-06,7190,4086,4220,8306,宜蘭,一等
2020-08-07,7190,4960,4821,9781,宜蘭,一等
2020-08-08,7190,4363,4392,8755,宜蘭,一等
2020-08-09,7190,4677,4659,9336,宜蘭,一等
2020-08-10,7190,3931,3870,7801,宜蘭,一等
2020-08-11,7190,3830,4036,7866,宜蘭,一等
2020-08-12,7190,4027,4121,8148,宜蘭,一等
2020-08-13,7190,4137,4177,8314,宜蘭,一等
2020-08-14,7190,5336,4992,10328,宜蘭,一等
2020-08-15,7190,4899,4950,9849,宜蘭,一等
2020-08-16,7190,5273,5063,10336,宜蘭,一等
2020-08-17,7190,4094,4076,8170,宜蘭,一等
2020-08-18,7190,3935,4059,7994,宜蘭,一等
2020-08-19,7190,3948,4104,8052,宜蘭,一等
2020-08-20,7190,4097,4074,8171,宜蘭,一等
2020-08-21,7190,5010,4971,9981,宜蘭,一等
2020-08-22,7190,3863,4092,7955,宜蘭,一等
2020-08-23,7190,4388,4017,8405,宜蘭,一等
2020-08-24,7190,3853,4121,7974,宜蘭,一等
2020-08-25,7190,4090,4000,8090,宜蘭,一等
2020-08-26,7190,3768,3719,7487,宜蘭,一等
2020-08-27,7190,3525,3646,7171,宜蘭,一等
2020-08-28,7190,3962,4438,8400,宜蘭,一等
2020-08-29,7190,3949,4305,8254,宜蘭,一等
2020-08-30,7190,4542,4112,8654,宜蘭,一等
2020-08-31,7190,3795,3659,7454,宜蘭,一等
2020-09-01,7190,3613,3420,7033,宜蘭,一等
2020-09-02,7190,3645,3512,7157,宜蘭,一等
2020-09-03,7190,3972,4036,8008,宜蘭,一等
2020-09-04,7190,4803,4720,9523,宜蘭,一等
2020-09-05,7190,4046,4455,8501,宜蘭,一等
2020-09-06,7190,4578,4437,9015,宜蘭,一等
2020-09-07,7190,3885,4009,7894,宜蘭,一等
2020-09-08,7190,3722,3749,7471,宜蘭,一等
2020-09-09,7190,3867,3751,7618,宜蘭,一等
2020-09-10,7190,3803,3879,7682,宜蘭,一等
2020-09-11,7190,4994,4882,9876,宜蘭,一等
2020-09-12,7190,3857,4557,8414,宜蘭,一等
2020-09-13,7190,4714,4688,9402,宜蘭,一等
2020-09-14,7190,3725,3580,7305,宜蘭,一等
2020-09-15,7190,3582,3369,6951,宜蘭,一等
2020-09-16,7190,3602,3502,7104,宜蘭,一等
2020-09-17,7190,3792,3751,7543,宜蘭,一等
2020-09-18,7190,4947,4775,9722,宜蘭,一等
2020-09-19,7190,4960,5084,10044,宜蘭,一等
2020-09-20,7190,4748,4820,9568,宜蘭,一等
2020-09-21,7190,3743,3671,7414,宜蘭,一等
2020-09-22,7190,3690,3806,7496,宜蘭,一等
2020-09-23,7190,3946,3741,7687,宜蘭,一等
2020-09-24,7190,3686,3761,7447,宜蘭,一等
2020-09-25,7190,4139,4212,8351,宜蘭,一等
2020-09-26,7190,4808,4534,9342,宜蘭,一等
2020-09-27,7190,4048,4077,8125,宜蘭,一等
2020-09-28,7190,3675,3630,7305,宜蘭,一等
2020-09-29,7190,3716,3587,7303,宜蘭,一等
2020-09-30,7190,5730,5592,11322,宜蘭,一等
2020-10-01,7190,6052,6192,12244,宜蘭,一等
2020-10-02,7190,5895,5905,11800,宜蘭,一等
2020-10-03,7190,5709,5489,11198,宜蘭,一等
2020-10-04,7190,5770,5911,11681,宜蘭,一等
2020-10-05,7190,3851,3902,7753,宜蘭,一等
2020-10-06,7190,3773,3730,7503,宜蘭,一等
2020-10-07,7190,3663,3682,7345,宜蘭,一等
2020-10-08,7190,5302,5096,10398,宜蘭,一等
2020-10-09,7190,5805,6003,11808,宜蘭,一等
2020-10-10,7190,4813,4969,9782,宜蘭,一等
2020-10-11,7190,5090,4811,9901,宜蘭,一等
2020-10-12,7190,3559,3577,7136,宜蘭,一等
2020-10-13,7190,3279,3400,6679,宜蘭,一等
2020-10-14,7190,3467,3466,6933,宜蘭,一等
2020-10-15,7190,3705,3735,7440,宜蘭,一等
2020-10-16,7190,4853,4554,9407,宜蘭,一等
2020-10-17,7190,4826,4835,9661,宜蘭,一等
2020-10-18,7190,4598,4743,9341,宜蘭,一等
2020-10-19,7190,3943,3861,7804,宜蘭,一等
2020-10-20,7190,3591,3955,7546,宜蘭,一等
2020-10-21,7190,3512,3428,6940,宜蘭,一等
2020-10-22,7190,3466,3601,7067,宜蘭,一等
2020-10-23,7190,4763,4696,9459,宜蘭,一等
2020-10-24,7190,4789,4995,9784,宜蘭,一等
2020-10-25,7190,4756,4619,9375,宜蘭,一等
2020-10-26,7190,4029,3891,7920,宜蘭,一等
2020-10-27,7190,3656,3573,7229,宜蘭,一等
2020-10-28,7190,3411,3583,6994,宜蘭,一等
2020-10-29,7190,3575,4010,7585,宜蘭,一等
2020-10-30,7190,4904,4806,9710,宜蘭,一等
2020-10-31,7190,4841,4714,9555,宜蘭,一等
2020-11-01,7190,4930,4801,9731,宜蘭,一等
2020-11-02,7190,3728,3687,7415,宜蘭,一等
2020-11-03,7190,3388,3325,6713,宜蘭,一等
2020-11-04,7190,3592,3648,7240,宜蘭,一等
2020-11-05,7190,3574,3425,6999,宜蘭,一等
2020-11-06,7190,4641,4490,9131,宜蘭,一等
2020-11-07,7190,4276,4763,9039,宜蘭,一等
2020-11-08,7190,4465,4301,8766,宜蘭,一等
2020-11-09,7190,3943,3839,7782,宜蘭,一等
2020-11-10,7190,3441,3290,6731,宜蘭,一等
2020-11-11,7190,3749,3617,7366,宜蘭,一等
2020-11-12,7190,3494,3677,7171,宜蘭,一等
2020-11-13,7190,4600,4567,9167,宜蘭,一等
2020-11-14,7190,3991,4346,8337,宜蘭,一等
2020-11-15,7190,5043,5111,10154,宜蘭,一等
2020-11-16,7190,3857,3886,7743,宜蘭,一等
2020-11-17,7190,3711,4490,8201,宜蘭,一等
2020-11-18,7190,4011,3711,7722,宜蘭,一等
2020-11-19,7190,4234,4180,8414,宜蘭,一等
2020-11-20,7190,5057,4896,9953,宜蘭,一等
2020-11-21,7190,4105,4354,8459,宜蘭,一等
2020-11-22,7190,4825,4874,9699,宜蘭,一等
2020-11-23,7190,3854,3816,7670,宜蘭,一等
2020-11-24,7190,3422,3343,6765,宜蘭,一等
2020-11-25,7190,3716,3582,7298,宜蘭,一等
2020-11-26,7190,3942,4113,8055,宜蘭,一等
2020-11-27,7190,5010,4719,9729,宜蘭,一等
2020-11-28,7190,4051,4350,8401,宜蘭,一等
2020-11-29,7190,4300,3989,8289,宜蘭,一等
2020-11-30,7190,3842,3452,7294,宜蘭,一等
2020-12-01,7190,3244,3068,6312,宜蘭,一等
2020-12-02,7190,3252,3170,6422,宜蘭,一等
2020-12-03,7190,3421,3358,6779,宜蘭,一等
2020-12-04,7190,4732,4274,9006,宜蘭,一等
2020-12-05,7190,4389,4301,8690,宜蘭,一等
2020-12-06,7190,5001,4748,9749,宜蘭,一等
2020-12-07,7190,4021,3835,7856,宜蘭,一等
2020-12-08,7190,3473,3266,6739,宜蘭,一等
2020-12-09,7190,3347,3268,6615,宜蘭,一等
2020-12-10,7190,3397,3614,7011,宜蘭,一等
2020-12-11,7190,5261,4918,10179,宜蘭,一等
2020-12-12,7190,5362,5000,10362,宜蘭,一等
2020-12-13,7190,4916,4800,9716,宜蘭,一等
2020-12-14,7190,3752,3554,7306,宜蘭,一等
2020-12-15,7190,3496,3600,7096,宜蘭,一等
2020-12-16,7190,3102,3149,6251,宜蘭,一等
2020-12-17,7190,3252,3213,6465,宜蘭,一等
2020-12-18,7190,4704,4569,9273,宜蘭,一等
2020-12-19,7190,3904,4100,8004,宜蘭,一等
2020-12-20,7190,3997,3772,7769,宜蘭,一等
2020-12-21,7190,3426,3237,6663,宜蘭,一等
2020-12-22,7190,3101,3125,6226,宜蘭,一等
2020-12-23,7190,3324,3220,6544,宜蘭,一等
2020-12-24,7190,3286,3547,6833,宜蘭,一等
2020-12-25,7190,4531,4445,8976,宜蘭,一等
2020-12-26,7190,4079,4308,8387,宜蘭,一等
2020-12-27,7190,4161,3882,8043,宜蘭,一等
2020-12-28,7190,3623,3459,7082,宜蘭,一等
2020-12-29,7190,3649,3514,7163,宜蘭,一等
2020-12-30,7190,3471,3429,6900,宜蘭,一等
2020-12-31,7190,6226,6140,12366,宜蘭,一等
2020-01-01,7200,85,101,186,四城,甲簡
2020-01-02,7200,165,161,326,四城,甲簡
2020-01-03,7200,149,161,310,四城,甲簡
2020-01-04,7200,125,145,270,四城,甲簡
2020-01-05,7200,73,74,147,四城,甲簡
2020-01-06,7200,165,148,313,四城,甲簡
2020-01-07,7200,143,159,302,四城,甲簡
2020-01-08,7200,152,164,316,四城,甲簡
2020-01-09,7200,195,206,401,四城,甲簡
2020-01-10,7200,147,167,314,四城,甲簡
2020-01-11,7200,86,123,209,四城,甲簡
2020-01-12,7200,84,78,162,四城,甲簡
2020-01-13,7200,155,176,331,四城,甲簡
2020-01-14,7200,152,148,300,四城,甲簡
2020-01-15,7200,153,146,299,四城,甲簡
2020-01-16,7200,150,158,308,四城,甲簡
2020-01-17,7200,139,123,262,四城,甲簡
2020-01-18,7200,102,101,203,四城,甲簡
2020-01-19,7200,72,68,140,四城,甲簡
2020-01-20,7200,113,109,222,四城,甲簡
2020-01-21,7200,122,136,258,四城,甲簡
2020-01-22,7200,115,108,223,四城,甲簡
2020-01-23,7200,76,107,183,四城,甲簡
2020-01-24,7200,65,75,140,四城,甲簡
2020-01-25,7200,128,131,259,四城,甲簡
2020-01-26,7200,79,102,181,四城,甲簡
2020-01-27,7200,153,142,295,四城,甲簡
2020-01-28,7200,143,123,266,四城,甲簡
2020-01-29,7200,91,79,170,四城,甲簡
2020-01-30,7200,95,91,186,四城,甲簡
2020-01-31,7200,113,127,240,四城,甲簡
2020-02-01,7200,84,83,167,四城,甲簡
2020-02-02,7200,91,90,181,四城,甲簡
2020-02-03,7200,96,99,195,四城,甲簡
2020-02-04,7200,96,129,225,四城,甲簡
2020-02-05,7200,104,90,194,四城,甲簡
2020-02-06,7200,84,74,158,四城,甲簡
2020-02-07,7200,88,108,196,四城,甲簡
2020-02-08,7200,80,63,143,四城,甲簡
2020-02-09,7200,78,86,164,四城,甲簡
2020-02-10,7200,92,82,174,四城,甲簡
2020-02-11,7200,83,75,158,四城,甲簡
2020-02-12,7200,101,123,224,四城,甲簡
2020-02-13,7200,91,82,173,四城,甲簡
2020-02-14,7200,97,90,187,四城,甲簡
2020-02-15,7200,90,106,196,四城,甲簡
2020-02-16,7200,77,73,150,四城,甲簡
2020-02-17,7200,97,86,183,四城,甲簡
2020-02-18,7200,103,101,204,四城,甲簡
2020-02-19,7200,104,91,195,四城,甲簡
2020-02-20,7200,68,88,156,四城,甲簡
2020-02-21,7200,80,100,180,四城,甲簡
2020-02-22,7200,93,87,180,四城,甲簡
2020-02-23,7200,54,77,131,四城,甲簡
2020-02-24,7200,98,107,205,四城,甲簡
2020-02-25,7200,149,150,299,四城,甲簡
2020-02-26,7200,129,135,264,四城,甲簡
2020-02-27,7200,120,153,273,四城,甲簡
2020-02-28,7200,90,101,191,四城,甲簡
2020-02-29,7200,85,89,174,四城,甲簡
2020-03-01,7200,94,95,189,四城,甲簡
2020-03-02,7200,128,131,259,四城,甲簡
2020-03-03,7200,116,133,249,四城,甲簡
2020-03-04,7200,136,132,268,四城,甲簡
2020-03-05,7200,120,129,249,四城,甲簡
2020-03-06,7200,129,159,288,四城,甲簡
2020-03-07,7200,121,112,233,四城,甲簡
2020-03-08,7200,64,74,138,四城,甲簡
2020-03-09,7200,125,144,269,四城,甲簡
2020-03-10,7200,135,142,277,四城,甲簡
2020-03-11,7200,119,130,249,四城,甲簡
2020-03-12,7200,123,142,265,四城,甲簡
2020-03-13,7200,124,162,286,四城,甲簡
2020-03-14,7200,87,93,180,四城,甲簡
2020-03-15,7200,83,91,174,四城,甲簡
2020-03-16,7200,136,141,277,四城,甲簡
2020-03-17,7200,114,131,245,四城,甲簡
2020-03-18,7200,129,126,255,四城,甲簡
2020-03-19,7200,129,138,267,四城,甲簡
2020-03-20,7200,126,153,279,四城,甲簡
2020-03-21,7200,80,84,164,四城,甲簡
2020-03-22,7200,61,50,111,四城,甲簡
2020-03-23,7200,119,115,234,四城,甲簡
2020-03-24,7200,126,128,254,四城,甲簡
2020-03-25,7200,107,113,220,四城,甲簡
2020-03-26,7200,119,128,247,四城,甲簡
2020-03-27,7200,124,148,272,四城,甲簡
2020-03-28,7200,60,70,130,四城,甲簡
2020-03-29,7200,82,77,159,四城,甲簡
2020-03-30,7200,119,117,236,四城,甲簡
2020-03-31,7200,118,111,229,四城,甲簡
2020-04-01,7200,124,139,263,四城,甲簡
2020-04-02,7200,88,91,179,四城,甲簡
2020-04-03,7200,83,85,168,四城,甲簡
2020-04-04,7200,57,45,102,四城,甲簡
2020-04-05,7200,62,56,118,四城,甲簡
2020-04-06,7200,119,126,245,四城,甲簡
2020-04-07,7200,117,123,240,四城,甲簡
2020-04-08,7200,118,114,232,四城,甲簡
2020-04-09,7200,104,107,211,四城,甲簡
2020-04-10,7200,121,138,259,四城,甲簡
2020-04-11,7200,63,80,143,四城,甲簡
2020-04-12,7200,59,65,124,四城,甲簡
2020-04-13,7200,109,121,230,四城,甲簡
2020-04-14,7200,112,116,228,四城,甲簡
2020-04-15,7200,119,119,238,四城,甲簡
2020-04-16,7200,121,106,227,四城,甲簡
2020-04-17,7200,115,132,247,四城,甲簡
2020-04-18,7200,108,91,199,四城,甲簡
2020-04-19,7200,52,54,106,四城,甲簡
2020-04-20,7200,107,121,228,四城,甲簡
2020-04-21,7200,118,120,238,四城,甲簡
2020-04-22,7200,149,155,304,四城,甲簡
2020-04-23,7200,111,118,229,四城,甲簡
2020-04-24,7200,114,132,246,四城,甲簡
2020-04-25,7200,57,70,127,四城,甲簡
2020-04-26,7200,63,65,128,四城,甲簡
2020-04-27,7200,94,99,193,四城,甲簡
2020-04-28,7200,103,115,218,四城,甲簡
2020-04-29,7200,114,112,226,四城,甲簡
2020-04-30,7200,136,131,267,四城,甲簡
2020-05-01,7200,120,152,272,四城,甲簡
2020-05-02,7200,74,77,151,四城,甲簡
2020-05-03,7200,71,69,140,四城,甲簡
2020-05-04,7200,109,110,219,四城,甲簡
2020-05-05,7200,117,101,218,四城,甲簡
2020-05-06,7200,108,107,215,四城,甲簡
2020-05-07,7200,117,115,232,四城,甲簡
2020-05-08,7200,125,129,254,四城,甲簡
2020-05-09,7200,105,92,197,四城,甲簡
2020-05-10,7200,65,59,124,四城,甲簡
2020-05-11,7200,104,116,220,四城,甲簡
2020-05-12,7200,132,121,253,四城,甲簡
2020-05-13,7200,107,110,217,四城,甲簡
2020-05-14,7200,104,104,208,四城,甲簡
2020-05-15,7200,127,141,268,四城,甲簡
2020-05-16,7200,61,72,133,四城,甲簡
2020-05-17,7200,64,56,120,四城,甲簡
2020-05-18,7200,120,116,236,四城,甲簡
2020-05-19,7200,119,116,235,四城,甲簡
2020-05-20,7200,123,118,241,四城,甲簡
2020-05-21,7200,105,100,205,四城,甲簡
2020-05-22,7200,122,130,252,四城,甲簡
2020-05-23,7200,72,73,145,四城,甲簡
2020-05-24,7200,89,77,166,四城,甲簡
2020-05-25,7200,107,116,223,四城,甲簡
2020-05-26,7200,108,113,221,四城,甲簡
2020-05-27,7200,128,110,238,四城,甲簡
2020-05-28,7200,107,119,226,四城,甲簡
2020-05-29,7200,116,116,232,四城,甲簡
2020-05-30,7200,96,93,189,四城,甲簡
2020-05-31,7200,79,67,146,四城,甲簡
2020-06-01,7200,118,116,234,四城,甲簡
2020-06-02,7200,116,117,233,四城,甲簡
2020-06-03,7200,125,112,237,四城,甲簡
2020-06-04,7200,117,111,228,四城,甲簡
2020-06-05,7200,129,139,268,四城,甲簡
2020-06-06,7200,95,114,209,四城,甲簡
2020-06-07,7200,79,73,152,四城,甲簡
2020-06-08,7200,103,120,223,四城,甲簡
2020-06-09,7200,122,131,253,四城,甲簡
2020-06-10,7200,128,116,244,四城,甲簡
2020-06-11,7200,139,146,285,四城,甲簡
2020-06-12,7200,128,122,250,四城,甲簡
2020-06-13,7200,90,101,191,四城,甲簡
2020-06-14,7200,80,83,163,四城,甲簡
2020-06-15,7200,121,112,233,四城,甲簡
2020-06-16,7200,117,124,241,四城,甲簡
2020-06-17,7200,113,110,223,四城,甲簡
2020-06-18,7200,116,109,225,四城,甲簡
2020-06-19,7200,139,145,284,四城,甲簡
2020-06-20,7200,103,101,204,四城,甲簡
2020-06-21,7200,62,86,148,四城,甲簡
2020-06-22,7200,116,115,231,四城,甲簡
2020-06-23,7200,130,124,254,四城,甲簡
2020-06-24,7200,125,125,250,四城,甲簡
2020-06-25,7200,71,101,172,四城,甲簡
2020-06-26,7200,111,106,217,四城,甲簡
2020-06-27,7200,110,90,200,四城,甲簡
2020-06-28,7200,78,62,140,四城,甲簡
2020-06-29,7200,131,127,258,四城,甲簡
2020-06-30,7200,106,100,206,四城,甲簡
2020-07-01,7200,137,138,275,四城,甲簡
2020-07-02,7200,113,110,223,四城,甲簡
2020-07-03,7200,109,124,233,四城,甲簡
2020-07-04,7200,69,93,162,四城,甲簡
2020-07-05,7200,54,62,116,四城,甲簡
2020-07-06,7200,124,116,240,四城,甲簡
2020-07-07,7200,117,110,227,四城,甲簡
2020-07-08,7200,115,124,239,四城,甲簡
2020-07-09,7200,131,137,268,四城,甲簡
2020-07-10,7200,185,163,348,四城,甲簡
2020-07-11,7200,99,105,204,四城,甲簡
2020-07-12,7200,73,71,144,四城,甲簡
2020-07-13,7200,102,111,213,四城,甲簡
2020-07-14,7200,131,123,254,四城,甲簡
2020-07-15,7200,143,134,277,四城,甲簡
2020-07-16,7200,138,138,276,四城,甲簡
2020-07-17,7200,163,127,290,四城,甲簡
2020-07-18,7200,81,84,165,四城,甲簡
2020-07-19,7200,84,101,185,四城,甲簡
2020-07-20,7200,124,119,243,四城,甲簡
2020-07-21,7200,119,131,250,四城,甲簡
2020-07-22,7200,110,105,215,四城,甲簡
2020-07-23,7200,118,101,219,四城,甲簡
2020-07-24,7200,113,111,224,四城,甲簡
2020-07-25,7200,98,107,205,四城,甲簡
2020-07-26,7200,83,69,152,四城,甲簡
2020-07-27,7200,93,115,208,四城,甲簡
2020-07-28,7200,148,104,252,四城,甲簡
2020-07-29,7200,119,110,229,四城,甲簡
2020-07-30,7200,110,109,219,四城,甲簡
2020-07-31,7200,99,116,215,四城,甲簡
2020-08-01,7200,73,83,156,四城,甲簡
2020-08-02,7200,68,71,139,四城,甲簡
2020-08-03,7200,100,94,194,四城,甲簡
2020-08-04,7200,107,90,197,四城,甲簡
2020-08-05,7200,115,107,222,四城,甲簡
2020-08-06,7200,99,94,193,四城,甲簡
2020-08-07,7200,129,127,256,四城,甲簡
2020-08-08,7200,76,110,186,四城,甲簡
2020-08-09,7200,85,95,180,四城,甲簡
2020-08-10,7200,105,118,223,四城,甲簡
2020-08-11,7200,114,96,210,四城,甲簡
2020-08-12,7200,94,105,199,四城,甲簡
2020-08-13,7200,89,89,178,四城,甲簡
2020-08-14,7200,121,121,242,四城,甲簡
2020-08-15,7200,83,103,186,四城,甲簡
2020-08-16,7200,90,100,190,四城,甲簡
2020-08-17,7200,92,93,185,四城,甲簡
2020-08-18,7200,89,97,186,四城,甲簡
2020-08-19,7200,88,92,180,四城,甲簡
2020-08-20,7200,109,113,222,四城,甲簡
2020-08-21,7200,114,114,228,四城,甲簡
2020-08-22,7200,69,83,152,四城,甲簡
2020-08-23,7200,77,73,150,四城,甲簡
2020-08-24,7200,86,104,190,四城,甲簡
2020-08-25,7200,97,102,199,四城,甲簡
2020-08-26,7200,90,99,189,四城,甲簡
2020-08-27,7200,102,83,185,四城,甲簡
2020-08-28,7200,132,143,275,四城,甲簡
2020-08-29,7200,67,76,143,四城,甲簡
2020-08-30,7200,73,74,147,四城,甲簡
2020-08-31,7200,140,138,278,四城,甲簡
2020-09-01,7200,122,139,261,四城,甲簡
2020-09-02,7200,121,128,249,四城,甲簡
2020-09-03,7200,123,122,245,四城,甲簡
2020-09-04,7200,133,136,269,四城,甲簡
2020-09-05,7200,87,92,179,四城,甲簡
2020-09-06,7200,71,73,144,四城,甲簡
2020-09-07,7200,126,143,269,四城,甲簡
2020-09-08,7200,138,133,271,四城,甲簡
2020-09-09,7200,135,137,272,四城,甲簡
2020-09-10,7200,136,133,269,四城,甲簡
2020-09-11,7200,148,164,312,四城,甲簡
2020-09-12,7200,70,79,149,四城,甲簡
2020-09-13,7200,70,65,135,四城,甲簡
2020-09-14,7200,131,129,260,四城,甲簡
2020-09-15,7200,132,140,272,四城,甲簡
2020-09-16,7200,124,132,256,四城,甲簡
2020-09-17,7200,149,149,298,四城,甲簡
2020-09-18,7200,131,140,271,四城,甲簡
2020-09-19,7200,86,79,165,四城,甲簡
2020-09-20,7200,66,61,127,四城,甲簡
2020-09-21,7200,144,131,275,四城,甲簡
2020-09-22,7200,133,113,246,四城,甲簡
2020-09-23,7200,125,133,258,四城,甲簡
2020-09-24,7200,130,148,278,四城,甲簡
2020-09-25,7200,133,126,259,四城,甲簡
2020-09-26,7200,122,118,240,四城,甲簡
2020-09-27,7200,89,100,189,四城,甲簡
2020-09-28,7200,140,142,282,四城,甲簡
2020-09-29,7200,129,122,251,四城,甲簡
2020-09-30,7200,140,158,298,四城,甲簡
2020-10-01,7200,114,152,266,四城,甲簡
2020-10-02,7200,155,164,319,四城,甲簡
2020-10-03,7200,116,125,241,四城,甲簡
2020-10-04,7200,75,79,154,四城,甲簡
2020-10-05,7200,125,129,254,四城,甲簡
2020-10-06,7200,141,149,290,四城,甲簡
2020-10-07,7200,125,136,261,四城,甲簡
2020-10-08,7200,137,145,282,四城,甲簡
2020-10-09,7200,105,117,222,四城,甲簡
2020-10-10,7200,114,119,233,四城,甲簡
2020-10-11,7200,62,49,111,四城,甲簡
2020-10-12,7200,134,136,270,四城,甲簡
2020-10-13,7200,139,128,267,四城,甲簡
2020-10-14,7200,121,128,249,四城,甲簡
2020-10-15,7200,177,199,376,四城,甲簡
2020-10-16,7200,142,151,293,四城,甲簡
2020-10-17,7200,67,64,131,四城,甲簡
2020-10-18,7200,55,58,113,四城,甲簡
2020-10-19,7200,130,135,265,四城,甲簡
2020-10-20,7200,131,122,253,四城,甲簡
2020-10-21,7200,124,120,244,四城,甲簡
2020-10-22,7200,141,137,278,四城,甲簡
2020-10-23,7200,136,142,278,四城,甲簡
2020-10-24,7200,178,147,325,四城,甲簡
2020-10-25,7200,56,105,161,四城,甲簡
2020-10-26,7200,149,143,292,四城,甲簡
2020-10-27,7200,143,122,265,四城,甲簡
2020-10-28,7200,132,112,244,四城,甲簡
2020-10-29,7200,117,124,241,四城,甲簡
2020-10-30,7200,133,140,273,四城,甲簡
2020-10-31,7200,106,122,228,四城,甲簡
2020-11-01,7200,111,99,210,四城,甲簡
2020-11-02,7200,126,133,259,四城,甲簡
2020-11-03,7200,107,107,214,四城,甲簡
2020-11-04,7200,119,123,242,四城,甲簡
2020-11-05,7200,126,123,249,四城,甲簡
2020-11-06,7200,178,188,366,四城,甲簡
2020-11-07,7200,96,103,199,四城,甲簡
2020-11-08,7200,87,69,156,四城,甲簡
2020-11-09,7200,131,130,261,四城,甲簡
2020-11-10,7200,126,132,258,四城,甲簡
2020-11-11,7200,123,126,249,四城,甲簡
2020-11-12,7200,127,122,249,四城,甲簡
2020-11-13,7200,121,141,262,四城,甲簡
2020-11-14,7200,89,62,151,四城,甲簡
2020-11-15,7200,106,109,215,四城,甲簡
2020-11-16,7200,135,127,262,四城,甲簡
2020-11-17,7200,144,138,282,四城,甲簡
2020-11-18,7200,146,147,293,四城,甲簡
2020-11-19,7200,141,135,276,四城,甲簡
2020-11-20,7200,139,156,295,四城,甲簡
2020-11-21,7200,69,79,148,四城,甲簡
2020-11-22,7200,135,120,255,四城,甲簡
2020-11-23,7200,135,141,276,四城,甲簡
2020-11-24,7200,200,191,391,四城,甲簡
2020-11-25,7200,134,126,260,四城,甲簡
2020-11-26,7200,141,123,264,四城,甲簡
2020-11-27,7200,147,155,302,四城,甲簡
2020-11-28,7200,97,103,200,四城,甲簡
2020-11-29,7200,77,80,157,四城,甲簡
2020-11-30,7200,121,134,255,四城,甲簡
2020-12-01,7200,132,125,257,四城,甲簡
2020-12-02,7200,124,128,252,四城,甲簡
2020-12-03,7200,128,132,260,四城,甲簡
2020-12-04,7200,112,96,208,四城,甲簡
2020-12-05,7200,46,70,116,四城,甲簡
2020-12-06,7200,67,68,135,四城,甲簡
2020-12-07,7200,92,107,199,四城,甲簡
2020-12-08,7200,108,117,225,四城,甲簡
2020-12-09,7200,102,110,212,四城,甲簡
2020-12-10,7200,101,104,205,四城,甲簡
2020-12-11,7200,116,158,274,四城,甲簡
2020-12-12,7200,85,77,162,四城,甲簡
2020-12-13,7200,64,68,132,四城,甲簡
2020-12-14,7200,116,129,245,四城,甲簡
2020-12-15,7200,118,118,236,四城,甲簡
2020-12-16,7200,119,127,246,四城,甲簡
2020-12-17,7200,106,111,217,四城,甲簡
2020-12-18,7200,120,152,272,四城,甲簡
2020-12-19,7200,89,101,190,四城,甲簡
2020-12-20,7200,75,64,139,四城,甲簡
2020-12-21,7200,112,118,230,四城,甲簡
2020-12-22,7200,121,140,261,四城,甲簡
2020-12-23,7200,105,118,223,四城,甲簡
2020-12-24,7200,124,144,268,四城,甲簡
2020-12-25,7200,121,126,247,四城,甲簡
2020-12-26,7200,93,82,175,四城,甲簡
2020-12-27,7200,84,102,186,四城,甲簡
2020-12-28,7200,103,127,230,四城,甲簡
2020-12-29,7200,131,132,263,四城,甲簡
2020-12-30,7200,117,133,250,四城,甲簡
2020-12-31,7200,146,147,293,四城,甲簡
2020-01-01,7210,3371,2807,6178,礁溪,三等
2020-01-02,7210,2055,1896,3951,礁溪,三等
2020-01-03,7210,2061,2119,4180,礁溪,三等
2020-01-04,7210,2318,2582,4900,礁溪,三等
2020-01-05,7210,2292,2046,4338,礁溪,三等
2020-01-06,7210,1737,1603,3340,礁溪,三等
2020-01-07,7210,1604,1595,3199,礁溪,三等
2020-01-08,7210,1601,1704,3305,礁溪,三等
2020-01-09,7210,1547,1418,2965,礁溪,三等
2020-01-10,7210,1509,1665,3174,礁溪,三等
2020-01-11,7210,1606,1755,3361,礁溪,三等
2020-01-12,7210,1990,1927,3917,礁溪,三等
2020-01-13,7210,1963,1836,3799,礁溪,三等
2020-01-14,7210,1739,1863,3602,礁溪,三等
2020-01-15,7210,1638,1734,3372,礁溪,三等
2020-01-16,7210,1826,1940,3766,礁溪,三等
2020-01-17,7210,2236,2399,4635,礁溪,三等
2020-01-18,7210,2289,2428,4717,礁溪,三等
2020-01-19,7210,2452,2141,4593,礁溪,三等
2020-01-20,7210,2223,2280,4503,礁溪,三等
2020-01-21,7210,2020,2179,4199,礁溪,三等
2020-01-22,7210,2151,1939,4090,礁溪,三等
2020-01-23,7210,2022,1738,3760,礁溪,三等
2020-01-24,7210,1421,1514,2935,礁溪,三等
2020-01-25,7210,2832,2932,5764,礁溪,三等
2020-01-26,7210,2770,2783,5553,礁溪,三等
2020-01-27,7210,3548,3611,7159,礁溪,三等
2020-01-28,7210,3243,3169,6412,礁溪,三等
2020-01-29,7210,2325,2398,4723,礁溪,三等
2020-01-30,7210,2510,2711,5221,礁溪,三等
2020-01-31,7210,2595,2493,5088,礁溪,三等
2020-02-01,7210,2568,2542,5110,礁溪,三等
2020-02-02,7210,2491,2295,4786,礁溪,三等
2020-02-03,7210,2019,1810,3829,礁溪,三等
2020-02-04,7210,1826,1706,3532,礁溪,三等
2020-02-05,7210,1780,1772,3552,礁溪,三等
2020-02-06,7210,1719,1810,3529,礁溪,三等
2020-02-07,7210,1837,1862,3699,礁溪,三等
2020-02-08,7210,1722,1742,3464,礁溪,三等
2020-02-09,7210,1845,1749,3594,礁溪,三等
2020-02-10,7210,1783,1575,3358,礁溪,三等
2020-02-11,7210,1529,1548,3077,礁溪,三等
2020-02-12,7210,1619,1546,3165,礁溪,三等
2020-02-13,7210,1481,1481,2962,礁溪,三等
2020-02-14,7210,1560,1689,3249,礁溪,三等
2020-02-15,7210,1692,1913,3605,礁溪,三等
2020-02-16,7210,1862,1670,3532,礁溪,三等
2020-02-17,7210,1674,1664,3338,礁溪,三等
2020-02-18,7210,1524,1508,3032,礁溪,三等
2020-02-19,7210,1391,1400,2791,礁溪,三等
2020-02-20,7210,1313,1362,2675,礁溪,三等
2020-02-21,7210,1518,1654,3172,礁溪,三等
2020-02-22,7210,1526,1735,3261,礁溪,三等
2020-02-23,7210,1502,1335,2837,礁溪,三等
2020-02-24,7210,1401,1303,2704,礁溪,三等
2020-02-25,7210,1212,1160,2372,礁溪,三等
2020-02-26,7210,1102,1162,2264,礁溪,三等
2020-02-27,7210,1106,1381,2487,礁溪,三等
2020-02-28,7210,2033,2512,4545,礁溪,三等
2020-02-29,7210,2567,2338,4905,礁溪,三等
2020-03-01,7210,1980,1278,3258,礁溪,三等
2020-03-02,7210,1057,1090,2147,礁溪,三等
2020-03-03,7210,911,1080,1991,礁溪,三等
2020-03-04,7210,901,963,1864,礁溪,三等
2020-03-05,7210,924,1014,1938,礁溪,三等
2020-03-06,7210,1130,1266,2396,礁溪,三等
2020-03-07,7210,1399,1560,2959,礁溪,三等
2020-03-08,7210,1313,1168,2481,礁溪,三等
2020-03-09,7210,1000,1056,2056,礁溪,三等
2020-03-10,7210,838,903,1741,礁溪,三等
2020-03-11,7210,1025,1082,2107,礁溪,三等
2020-03-12,7210,889,1013,1902,礁溪,三等
2020-03-13,7210,1210,1394,2604,礁溪,三等
2020-03-14,7210,1315,1405,2720,礁溪,三等
2020-03-15,7210,1566,1469,3035,礁溪,三等
2020-03-16,7210,1164,1098,2262,礁溪,三等
2020-03-17,7210,1030,1047,2077,礁溪,三等
2020-03-18,7210,977,1038,2015,礁溪,三等
2020-03-19,7210,852,906,1758,礁溪,三等
2020-03-20,7210,1057,1175,2232,礁溪,三等
2020-03-21,7210,1365,1523,2888,礁溪,三等
2020-03-22,7210,1385,1182,2567,礁溪,三等
2020-03-23,7210,965,929,1894,礁溪,三等
2020-03-24,7210,765,831,1596,礁溪,三等
2020-03-25,7210,856,890,1746,礁溪,三等
2020-03-26,7210,824,872,1696,礁溪,三等
2020-03-27,7210,835,965,1800,礁溪,三等
2020-03-28,7210,818,1050,1868,礁溪,三等
2020-03-29,7210,1147,1045,2192,礁溪,三等
2020-03-30,7210,963,1009,1972,礁溪,三等
2020-03-31,7210,862,909,1771,礁溪,三等
2020-04-01,7210,937,1128,2065,礁溪,三等
2020-04-02,7210,1241,1629,2870,礁溪,三等
2020-04-03,7210,1728,1593,3321,礁溪,三等
2020-04-04,7210,1372,1146,2518,礁溪,三等
2020-04-05,7210,1162,904,2066,礁溪,三等
2020-04-06,7210,790,849,1639,礁溪,三等
2020-04-07,7210,742,769,1511,礁溪,三等
2020-04-08,7210,762,803,1565,礁溪,三等
2020-04-09,7210,789,882,1671,礁溪,三等
2020-04-10,7210,996,1108,2104,礁溪,三等
2020-04-11,7210,863,994,1857,礁溪,三等
2020-04-12,7210,1030,955,1985,礁溪,三等
2020-04-13,7210,854,886,1740,礁溪,三等
2020-04-14,7210,850,889,1739,礁溪,三等
2020-04-15,7210,826,907,1733,礁溪,三等
2020-04-16,7210,855,899,1754,礁溪,三等
2020-04-17,7210,995,1075,2070,礁溪,三等
2020-04-18,7210,1169,1234,2403,礁溪,三等
2020-04-19,7210,1133,1008,2141,礁溪,三等
2020-04-20,7210,822,864,1686,礁溪,三等
2020-04-21,7210,760,789,1549,礁溪,三等
2020-04-22,7210,768,805,1573,礁溪,三等
2020-04-23,7210,717,833,1550,礁溪,三等
2020-04-24,7210,898,1178,2076,礁溪,三等
2020-04-25,7210,999,1114,2113,礁溪,三等
2020-04-26,7210,916,811,1727,礁溪,三等
2020-04-27,7210,838,821,1659,礁溪,三等
2020-04-28,7210,789,861,1650,礁溪,三等
2020-04-29,7210,793,921,1714,礁溪,三等
2020-04-30,7210,932,1014,1946,礁溪,三等
2020-05-01,7210,1315,1634,2949,礁溪,三等
2020-05-02,7210,1499,1384,2883,礁溪,三等
2020-05-03,7210,1336,932,2268,礁溪,三等
2020-05-04,7210,813,850,1663,礁溪,三等
2020-05-05,7210,796,892,1688,礁溪,三等
2020-05-06,7210,813,889,1702,礁溪,三等
2020-05-07,7210,797,804,1601,礁溪,三等
2020-05-08,7210,1012,1090,2102,礁溪,三等
2020-05-09,7210,984,1233,2217,礁溪,三等
2020-05-10,7210,1111,906,2017,礁溪,三等
2020-05-11,7210,862,974,1836,礁溪,三等
2020-05-12,7210,816,898,1714,礁溪,三等
2020-05-13,7210,926,990,1916,礁溪,三等
2020-05-14,7210,949,1003,1952,礁溪,三等
2020-05-15,7210,1178,1421,2599,礁溪,三等
2020-05-16,7210,1304,1463,2767,礁溪,三等
2020-05-17,7210,1394,1109,2503,礁溪,三等
2020-05-18,7210,927,913,1840,礁溪,三等
2020-05-19,7210,802,866,1668,礁溪,三等
2020-05-20,7210,872,897,1769,礁溪,三等
2020-05-21,7210,814,858,1672,礁溪,三等
2020-05-22,7210,951,1148,2099,礁溪,三等
2020-05-23,7210,1095,1294,2389,礁溪,三等
2020-05-24,7210,1555,1304,2859,礁溪,三等
2020-05-25,7210,1057,1047,2104,礁溪,三等
2020-05-26,7210,983,1000,1983,礁溪,三等
2020-05-27,7210,909,959,1868,礁溪,三等
2020-05-28,7210,876,966,1842,礁溪,三等
2020-05-29,7210,1228,1375,2603,礁溪,三等
2020-05-30,7210,1598,1889,3487,礁溪,三等
2020-05-31,7210,1764,1411,3175,礁溪,三等
2020-06-01,7210,1035,964,1999,礁溪,三等
2020-06-02,7210,967,1046,2013,礁溪,三等
2020-06-03,7210,969,1030,1999,礁溪,三等
2020-06-04,7210,1016,1069,2085,礁溪,三等
2020-06-05,7210,1166,1346,2512,礁溪,三等
2020-06-06,7210,1615,1947,3562,礁溪,三等
2020-06-07,7210,1662,1377,3039,礁溪,三等
2020-06-08,7210,1211,1041,2252,礁溪,三等
2020-06-09,7210,1014,1041,2055,礁溪,三等
2020-06-10,7210,1081,1163,2244,礁溪,三等
2020-06-11,7210,1147,1133,2280,礁溪,三等
2020-06-12,7210,1223,1436,2659,礁溪,三等
2020-06-13,7210,1737,2184,3921,礁溪,三等
2020-06-14,7210,1959,1614,3573,礁溪,三等
2020-06-15,7210,1226,1145,2371,礁溪,三等
2020-06-16,7210,1214,1194,2408,礁溪,三等
2020-06-17,7210,1060,1243,2303,礁溪,三等
2020-06-18,7210,1208,1171,2379,礁溪,三等
2020-06-19,7210,1339,1508,2847,礁溪,三等
2020-06-20,7210,1494,1776,3270,礁溪,三等
2020-06-21,7210,1781,1578,3359,礁溪,三等
2020-06-22,7210,1399,1540,2939,礁溪,三等
2020-06-23,7210,1304,1243,2547,礁溪,三等
2020-06-24,7210,1304,1371,2675,礁溪,三等
2020-06-25,7210,1737,2212,3949,礁溪,三等
2020-06-26,7210,2961,2944,5905,礁溪,三等
2020-06-27,7210,2608,2754,5362,礁溪,三等
2020-06-28,7210,2069,1592,3661,礁溪,三等
2020-06-29,7210,1284,1363,2647,礁溪,三等
2020-06-30,7210,1272,1165,2437,礁溪,三等
2020-07-01,7210,1160,1238,2398,礁溪,三等
2020-07-02,7210,1161,1239,2400,礁溪,三等
2020-07-03,7210,1221,1369,2590,礁溪,三等
2020-07-04,7210,1554,1717,3271,礁溪,三等
2020-07-05,7210,1633,1509,3142,礁溪,三等
2020-07-06,7210,1279,1198,2477,礁溪,三等
2020-07-07,7210,1298,1257,2555,礁溪,三等
2020-07-08,7210,1134,1314,2448,礁溪,三等
2020-07-09,7210,1276,1443,2719,礁溪,三等
2020-07-10,7210,1501,1784,3285,礁溪,三等
2020-07-11,7210,1977,2255,4232,礁溪,三等
2020-07-12,7210,2209,1657,3866,礁溪,三等
2020-07-13,7210,1456,1330,2786,礁溪,三等
2020-07-14,7210,1294,1402,2696,礁溪,三等
2020-07-15,7210,1437,1684,3121,礁溪,三等
2020-07-16,7210,1716,1752,3468,礁溪,三等
2020-07-17,7210,1837,1919,3756,礁溪,三等
2020-07-18,7210,2012,2255,4267,礁溪,三等
2020-07-19,7210,2144,1721,3865,礁溪,三等
2020-07-20,7210,1646,1721,3367,礁溪,三等
2020-07-21,7210,1528,1591,3119,礁溪,三等
2020-07-22,7210,1593,1635,3228,礁溪,三等
2020-07-23,7210,1628,1734,3362,礁溪,三等
2020-07-24,7210,1842,1945,3787,礁溪,三等
2020-07-25,7210,2186,2161,4347,礁溪,三等
2020-07-26,7210,2002,1887,3889,礁溪,三等
2020-07-27,7210,1548,1506,3054,礁溪,三等
2020-07-28,7210,1610,1711,3321,礁溪,三等
2020-07-29,7210,1762,1854,3616,礁溪,三等
2020-07-30,7210,1756,1799,3555,礁溪,三等
2020-07-31,7210,1840,1832,3672,礁溪,三等
2020-08-01,7210,2031,2374,4405,礁溪,三等
2020-08-02,7210,2074,1707,3781,礁溪,三等
2020-08-03,7210,1352,1376,2728,礁溪,三等
2020-08-04,7210,1467,1445,2912,礁溪,三等
2020-08-05,7210,1542,1475,3017,礁溪,三等
2020-08-06,7210,1497,1507,3004,礁溪,三等
2020-08-07,7210,1582,1707,3289,礁溪,三等
2020-08-08,7210,1698,1976,3674,礁溪,三等
2020-08-09,7210,1868,1765,3633,礁溪,三等
2020-08-10,7210,1755,1597,3352,礁溪,三等
2020-08-11,7210,1640,1551,3191,礁溪,三等
2020-08-12,7210,1864,1854,3718,礁溪,三等
2020-08-13,7210,1878,1852,3730,礁溪,三等
2020-08-14,7210,1806,2078,3884,礁溪,三等
2020-08-15,7210,2320,2325,4645,礁溪,三等
2020-08-16,7210,2128,2080,4208,礁溪,三等
2020-08-17,7210,1849,1794,3643,礁溪,三等
2020-08-18,7210,1762,1682,3444,礁溪,三等
2020-08-19,7210,1689,1574,3263,礁溪,三等
2020-08-20,7210,1563,1695,3258,礁溪,三等
2020-08-21,7210,1687,1860,3547,礁溪,三等
2020-08-22,7210,1851,2145,3996,礁溪,三等
2020-08-23,7210,2012,1717,3729,礁溪,三等
2020-08-24,7210,1639,1788,3427,礁溪,三等
2020-08-25,7210,1667,1656,3323,礁溪,三等
2020-08-26,7210,1514,1616,3130,礁溪,三等
2020-08-27,7210,1540,1546,3086,礁溪,三等
2020-08-28,7210,1538,1797,3335,礁溪,三等
2020-08-29,7210,1873,2088,3961,礁溪,三等
2020-08-30,7210,1965,1474,3439,礁溪,三等
2020-08-31,7210,1356,1163,2519,礁溪,三等
2020-09-01,7210,1077,1053,2130,礁溪,三等
2020-09-02,7210,1038,1196,2234,礁溪,三等
2020-09-03,7210,1293,1436,2729,礁溪,三等
2020-09-04,7210,1283,1601,2884,礁溪,三等
2020-09-05,7210,1764,2157,3921,礁溪,三等
2020-09-06,7210,2153,1641,3794,礁溪,三等
2020-09-07,7210,1364,1385,2749,礁溪,三等
2020-09-08,7210,1333,1383,2716,礁溪,三等
2020-09-09,7210,1327,1323,2650,礁溪,三等
2020-09-10,7210,1377,1345,2722,礁溪,三等
2020-09-11,7210,1334,1615,2949,礁溪,三等
2020-09-12,7210,1702,2029,3731,礁溪,三等
2020-09-13,7210,2053,1667,3720,礁溪,三等
2020-09-14,7210,1217,1076,2293,礁溪,三等
2020-09-15,7210,1067,1050,2117,礁溪,三等
2020-09-16,7210,1043,1103,2146,礁溪,三等
2020-09-17,7210,1168,1445,2613,礁溪,三等
2020-09-18,7210,1602,1678,3280,礁溪,三等
2020-09-19,7210,2070,2459,4529,礁溪,三等
2020-09-20,7210,2137,1781,3918,礁溪,三等
2020-09-21,7210,1435,1289,2724,礁溪,三等
2020-09-22,7210,1303,1300,2603,礁溪,三等
2020-09-23,7210,1336,1311,2647,礁溪,三等
2020-09-24,7210,1268,1251,2519,礁溪,三等
2020-09-25,7210,1415,1447,2862,礁溪,三等
2020-09-26,7210,1699,2104,3803,礁溪,三等
2020-09-27,7210,1748,1641,3389,礁溪,三等
2020-09-28,7210,1337,1176,2513,礁溪,三等
2020-09-29,7210,1221,1184,2405,礁溪,三等
2020-09-30,7210,1509,1561,3070,礁溪,三等
2020-10-01,7210,2057,2687,4744,礁溪,三等
2020-10-02,7210,3159,3268,6427,礁溪,三等
2020-10-03,7210,2967,2802,5769,礁溪,三等
2020-10-04,7210,1869,1713,3582,礁溪,三等
2020-10-05,7210,1117,1165,2282,礁溪,三等
2020-10-06,7210,1107,1172,2279,礁溪,三等
2020-10-07,7210,1188,1280,2468,礁溪,三等
2020-10-08,7210,1447,1823,3270,礁溪,三等
2020-10-09,7210,2621,3189,5810,礁溪,三等
2020-10-10,7210,3134,3149,6283,礁溪,三等
2020-10-11,7210,2237,1841,4078,礁溪,三等
2020-10-12,7210,1279,1259,2538,礁溪,三等
2020-10-13,7210,1096,1097,2193,礁溪,三等
2020-10-14,7210,1152,1340,2492,礁溪,三等
2020-10-15,7210,1284,1289,2573,礁溪,三等
2020-10-16,7210,1425,1581,3006,礁溪,三等
2020-10-17,7210,1875,2075,3950,礁溪,三等
2020-10-18,7210,1994,1712,3706,礁溪,三等
2020-10-19,7210,1402,1421,2823,礁溪,三等
2020-10-20,7210,1371,1294,2665,礁溪,三等
2020-10-21,7210,1146,1182,2328,礁溪,三等
2020-10-22,7210,1217,1342,2559,礁溪,三等
2020-10-23,7210,1582,1747,3329,礁溪,三等
2020-10-24,7210,2248,2525,4773,礁溪,三等
2020-10-25,7210,2142,2105,4247,礁溪,三等
2020-10-26,7210,1754,1557,3311,礁溪,三等
2020-10-27,7210,1446,1520,2966,礁溪,三等
2020-10-28,7210,1482,1357,2839,礁溪,三等
2020-10-29,7210,1352,1416,2768,礁溪,三等
2020-10-30,7210,1679,1911,3590,礁溪,三等
2020-10-31,7210,2256,2721,4977,礁溪,三等
2020-11-01,7210,2305,1815,4120,礁溪,三等
2020-11-02,7210,1297,1271,2568,礁溪,三等
2020-11-03,7210,1197,1215,2412,礁溪,三等
2020-11-04,7210,1177,1268,2445,礁溪,三等
2020-11-05,7210,1132,1219,2351,礁溪,三等
2020-11-06,7210,1344,1668,3012,礁溪,三等
2020-11-07,7210,1899,2636,4535,礁溪,三等
2020-11-08,7210,2156,1906,4062,礁溪,三等
2020-11-09,7210,1504,1376,2880,礁溪,三等
2020-11-10,7210,1113,1171,2284,礁溪,三等
2020-11-11,7210,1286,1420,2706,礁溪,三等
2020-11-12,7210,1277,1383,2660,礁溪,三等
2020-11-13,7210,1514,1660,3174,礁溪,三等
2020-11-14,7210,1942,2656,4598,礁溪,三等
2020-11-15,7210,2435,2320,4755,礁溪,三等
2020-11-16,7210,1629,1431,3060,礁溪,三等
2020-11-17,7210,1385,1670,3055,礁溪,三等
2020-11-18,7210,1388,1538,2926,礁溪,三等
2020-11-19,7210,1552,1570,3122,礁溪,三等
2020-11-20,7210,1752,1911,3663,礁溪,三等
2020-11-21,7210,2187,2761,4948,礁溪,三等
2020-11-22,7210,2479,2432,4911,礁溪,三等
2020-11-23,7210,1645,1479,3124,礁溪,三等
2020-11-24,7210,1272,1352,2624,礁溪,三等
2020-11-25,7210,1418,1549,2967,礁溪,三等
2020-11-26,7210,1419,1557,2976,礁溪,三等
2020-11-27,7210,1751,1951,3702,礁溪,三等
2020-11-28,7210,1947,2467,4414,礁溪,三等
2020-11-29,7210,2207,2059,4266,礁溪,三等
2020-11-30,7210,1519,1322,2841,礁溪,三等
2020-12-01,7210,1079,1131,2210,礁溪,三等
2020-12-02,7210,1203,1203,2406,礁溪,三等
2020-12-03,7210,1191,1323,2514,礁溪,三等
2020-12-04,7210,800,1222,2022,礁溪,三等
2020-12-05,7210,1299,1645,2944,礁溪,三等
2020-12-06,7210,1422,1288,2710,礁溪,三等
2020-12-07,7210,1016,943,1959,礁溪,三等
2020-12-08,7210,771,822,1593,礁溪,三等
2020-12-09,7210,800,841,1641,礁溪,三等
2020-12-10,7210,797,888,1685,礁溪,三等
2020-12-11,7210,1016,1198,2214,礁溪,三等
2020-12-12,7210,1344,2094,3438,礁溪,三等
2020-12-13,7210,1569,1376,2945,礁溪,三等
2020-12-14,7210,1165,1140,2305,礁溪,三等
2020-12-15,7210,1082,1130,2212,礁溪,三等
2020-12-16,7210,1122,1147,2269,礁溪,三等
2020-12-17,7210,1111,1211,2322,礁溪,三等
2020-12-18,7210,1455,1656,3111,礁溪,三等
2020-12-19,7210,1801,2281,4082,礁溪,三等
2020-12-20,7210,2028,1601,3629,礁溪,三等
2020-12-21,7210,1328,1303,2631,礁溪,三等
2020-12-22,7210,1234,1164,2398,礁溪,三等
2020-12-23,7210,1208,1263,2471,礁溪,三等
2020-12-24,7210,1209,1364,2573,礁溪,三等
2020-12-25,7210,1572,1813,3385,礁溪,三等
2020-12-26,7210,2170,2542,4712,礁溪,三等
2020-12-27,7210,2466,2130,4596,礁溪,三等
2020-12-28,7210,1533,1381,2914,礁溪,三等
2020-12-29,7210,1219,1342,2561,礁溪,三等
2020-12-30,7210,1330,1399,2729,礁溪,三等
2020-12-31,7210,1945,2604,4549,礁溪,三等
2020-01-01,7220,72,60,132,頂埔,招呼
2020-01-02,7220,103,69,172,頂埔,招呼
2020-01-03,7220,122,76,198,頂埔,招呼
2020-01-04,7220,83,59,142,頂埔,招呼
2020-01-05,7220,60,40,100,頂埔,招呼
2020-01-06,7220,113,78,191,頂埔,招呼
2020-01-07,7220,76,81,157,頂埔,招呼
2020-01-08,7220,125,82,207,頂埔,招呼
2020-01-09,7220,112,68,180,頂埔,招呼
2020-01-10,7220,113,74,187,頂埔,招呼
2020-01-11,7220,79,53,132,頂埔,招呼
2020-01-12,7220,36,38,74,頂埔,招呼
2020-01-13,7220,121,75,196,頂埔,招呼
2020-01-14,7220,112,71,183,頂埔,招呼
2020-01-15,7220,105,72,177,頂埔,招呼
2020-01-16,7220,146,101,247,頂埔,招呼
2020-01-17,7220,98,78,176,頂埔,招呼
2020-01-18,7220,87,44,131,頂埔,招呼
2020-01-19,7220,67,46,113,頂埔,招呼
2020-01-20,7220,95,63,158,頂埔,招呼
2020-01-21,7220,101,78,179,頂埔,招呼
2020-01-22,7220,94,69,163,頂埔,招呼
2020-01-23,7220,83,60,143,頂埔,招呼
2020-01-24,7220,35,46,81,頂埔,招呼
2020-01-25,7220,91,62,153,頂埔,招呼
2020-01-26,7220,56,50,106,頂埔,招呼
2020-01-27,7220,84,58,142,頂埔,招呼
2020-01-28,7220,73,59,132,頂埔,招呼
2020-01-29,7220,84,61,145,頂埔,招呼
2020-01-30,7220,92,57,149,頂埔,招呼
2020-01-31,7220,72,50,122,頂埔,招呼
2020-02-01,7220,79,61,140,頂埔,招呼
2020-02-02,7220,67,54,121,頂埔,招呼
2020-02-03,7220,102,52,154,頂埔,招呼
2020-02-04,7220,94,60,154,頂埔,招呼
2020-02-05,7220,77,60,137,頂埔,招呼
2020-02-06,7220,85,52,137,頂埔,招呼
2020-02-07,7220,88,63,151,頂埔,招呼
2020-02-08,7220,54,51,105,頂埔,招呼
2020-02-09,7220,49,27,76,頂埔,招呼
2020-02-10,7220,76,55,131,頂埔,招呼
2020-02-11,7220,87,60,147,頂埔,招呼
2020-02-12,7220,77,54,131,頂埔,招呼
2020-02-13,7220,67,54,121,頂埔,招呼
2020-02-14,7220,81,58,139,頂埔,招呼
2020-02-15,7220,77,68,145,頂埔,招呼
2020-02-16,7220,47,36,83,頂埔,招呼
2020-02-17,7220,82,51,133,頂埔,招呼
2020-02-18,7220,74,46,120,頂埔,招呼
2020-02-19,7220,78,47,125,頂埔,招呼
2020-02-20,7220,70,62,132,頂埔,招呼
2020-02-21,7220,63,42,105,頂埔,招呼
2020-02-22,7220,59,41,100,頂埔,招呼
2020-02-23,7220,55,38,93,頂埔,招呼
2020-02-24,7220,76,64,140,頂埔,招呼
2020-02-25,7220,125,85,210,頂埔,招呼
2020-02-26,7220,131,71,202,頂埔,招呼
2020-02-27,7220,128,78,206,頂埔,招呼
2020-02-28,7220,54,37,91,頂埔,招呼
2020-02-29,7220,66,44,110,頂埔,招呼
2020-03-01,7220,47,30,77,頂埔,招呼
2020-03-02,7220,109,63,172,頂埔,招呼
2020-03-03,7220,107,79,186,頂埔,招呼
2020-03-04,7220,107,64,171,頂埔,招呼
2020-03-05,7220,106,63,169,頂埔,招呼
2020-03-06,7220,99,79,178,頂埔,招呼
2020-03-07,7220,64,52,116,頂埔,招呼
2020-03-08,7220,30,26,56,頂埔,招呼
2020-03-09,7220,116,72,188,頂埔,招呼
2020-03-10,7220,116,78,194,頂埔,招呼
2020-03-11,7220,114,72,186,頂埔,招呼
2020-03-12,7220,121,80,201,頂埔,招呼
2020-03-13,7220,113,80,193,頂埔,招呼
2020-03-14,7220,58,53,111,頂埔,招呼
2020-03-15,7220,40,36,76,頂埔,招呼
2020-03-16,7220,134,78,212,頂埔,招呼
2020-03-17,7220,115,87,202,頂埔,招呼
2020-03-18,7220,115,74,189,頂埔,招呼
2020-03-19,7220,113,72,185,頂埔,招呼
2020-03-20,7220,113,89,202,頂埔,招呼
2020-03-21,7220,53,52,105,頂埔,招呼
2020-03-22,7220,49,46,95,頂埔,招呼
2020-03-23,7220,103,71,174,頂埔,招呼
2020-03-24,7220,109,75,184,頂埔,招呼
2020-03-25,7220,108,64,172,頂埔,招呼
2020-03-26,7220,105,67,172,頂埔,招呼
2020-03-27,7220,114,77,191,頂埔,招呼
2020-03-28,7220,34,31,65,頂埔,招呼
2020-03-29,7220,54,40,94,頂埔,招呼
2020-03-30,7220,117,69,186,頂埔,招呼
2020-03-31,7220,104,61,165,頂埔,招呼
2020-04-01,7220,101,81,182,頂埔,招呼
2020-04-02,7220,60,61,121,頂埔,招呼
2020-04-03,7220,76,53,129,頂埔,招呼
2020-04-04,7220,50,46,96,頂埔,招呼
2020-04-05,7220,46,29,75,頂埔,招呼
2020-04-06,7220,97,74,171,頂埔,招呼
2020-04-07,7220,96,74,170,頂埔,招呼
2020-04-08,7220,102,69,171,頂埔,招呼
2020-04-09,7220,112,66,178,頂埔,招呼
2020-04-10,7220,107,66,173,頂埔,招呼
2020-04-11,7220,55,33,88,頂埔,招呼
2020-04-12,7220,46,34,80,頂埔,招呼
2020-04-13,7220,102,59,161,頂埔,招呼
2020-04-14,7220,106,80,186,頂埔,招呼
2020-04-15,7220,113,74,187,頂埔,招呼
2020-04-16,7220,115,70,185,頂埔,招呼
2020-04-17,7220,120,79,199,頂埔,招呼
2020-04-18,7220,53,38,91,頂埔,招呼
2020-04-19,7220,46,32,78,頂埔,招呼
2020-04-20,7220,100,71,171,頂埔,招呼
2020-04-21,7220,118,78,196,頂埔,招呼
2020-04-22,7220,120,80,200,頂埔,招呼
2020-04-23,7220,114,73,187,頂埔,招呼
2020-04-24,7220,101,95,196,頂埔,招呼
2020-04-25,7220,48,42,90,頂埔,招呼
2020-04-26,7220,58,36,94,頂埔,招呼
2020-04-27,7220,104,67,171,頂埔,招呼
2020-04-28,7220,104,75,179,頂埔,招呼
2020-04-29,7220,113,84,197,頂埔,招呼
2020-04-30,7220,100,75,175,頂埔,招呼
2020-05-01,7220,116,95,211,頂埔,招呼
2020-05-02,7220,54,50,104,頂埔,招呼
2020-05-03,7220,68,32,100,頂埔,招呼
2020-05-04,7220,106,57,163,頂埔,招呼
2020-05-05,7220,105,70,175,頂埔,招呼
2020-05-06,7220,108,102,210,頂埔,招呼
2020-05-07,7220,103,95,198,頂埔,招呼
2020-05-08,7220,111,89,200,頂埔,招呼
2020-05-09,7220,53,45,98,頂埔,招呼
2020-05-10,7220,52,30,82,頂埔,招呼
2020-05-11,7220,105,74,179,頂埔,招呼
2020-05-12,7220,109,69,178,頂埔,招呼
2020-05-13,7220,110,94,204,頂埔,招呼
2020-05-14,7220,112,99,211,頂埔,招呼
2020-05-15,7220,104,76,180,頂埔,招呼
2020-05-16,7220,62,48,110,頂埔,招呼
2020-05-17,7220,49,52,101,頂埔,招呼
2020-05-18,7220,114,71,185,頂埔,招呼
2020-05-19,7220,96,68,164,頂埔,招呼
2020-05-20,7220,104,72,176,頂埔,招呼
2020-05-21,7220,100,66,166,頂埔,招呼
2020-05-22,7220,106,78,184,頂埔,招呼
2020-05-23,7220,61,41,102,頂埔,招呼
2020-05-24,7220,63,42,105,頂埔,招呼
2020-05-25,7220,91,68,159,頂埔,招呼
2020-05-26,7220,105,82,187,頂埔,招呼
2020-05-27,7220,114,76,190,頂埔,招呼
2020-05-28,7220,96,69,165,頂埔,招呼
2020-05-29,7220,87,75,162,頂埔,招呼
2020-05-30,7220,67,55,122,頂埔,招呼
2020-05-31,7220,55,36,91,頂埔,招呼
2020-06-01,7220,112,69,181,頂埔,招呼
2020-06-02,7220,115,69,184,頂埔,招呼
2020-06-03,7220,123,79,202,頂埔,招呼
2020-06-04,7220,109,74,183,頂埔,招呼
2020-06-05,7220,118,85,203,頂埔,招呼
2020-06-06,7220,68,47,115,頂埔,招呼
2020-06-07,7220,49,23,72,頂埔,招呼
2020-06-08,7220,120,81,201,頂埔,招呼
2020-06-09,7220,95,68,163,頂埔,招呼
2020-06-10,7220,110,83,193,頂埔,招呼
2020-06-11,7220,104,87,191,頂埔,招呼
2020-06-12,7220,100,73,173,頂埔,招呼
2020-06-13,7220,90,55,145,頂埔,招呼
2020-06-14,7220,44,34,78,頂埔,招呼
2020-06-15,7220,99,80,179,頂埔,招呼
2020-06-16,7220,105,71,176,頂埔,招呼
2020-06-17,7220,84,65,149,頂埔,招呼
2020-06-18,7220,99,72,171,頂埔,招呼
2020-06-19,7220,117,78,195,頂埔,招呼
2020-06-20,7220,80,53,133,頂埔,招呼
2020-06-21,7220,50,43,93,頂埔,招呼
2020-06-22,7220,107,81,188,頂埔,招呼
2020-06-23,7220,108,76,184,頂埔,招呼
2020-06-24,7220,108,83,191,頂埔,招呼
2020-06-25,7220,71,70,141,頂埔,招呼
2020-06-26,7220,120,81,201,頂埔,招呼
2020-06-27,7220,69,27,96,頂埔,招呼
2020-06-28,7220,67,32,99,頂埔,招呼
2020-06-29,7220,103,81,184,頂埔,招呼
2020-06-30,7220,101,64,165,頂埔,招呼
2020-07-01,7220,102,78,180,頂埔,招呼
2020-07-02,7220,91,55,146,頂埔,招呼
2020-07-03,7220,96,63,159,頂埔,招呼
2020-07-04,7220,80,43,123,頂埔,招呼
2020-07-05,7220,47,39,86,頂埔,招呼
2020-07-06,7220,114,95,209,頂埔,招呼
2020-07-07,7220,89,58,147,頂埔,招呼
2020-07-08,7220,86,74,160,頂埔,招呼
2020-07-09,7220,106,56,162,頂埔,招呼
2020-07-10,7220,110,58,168,頂埔,招呼
2020-07-11,7220,77,58,135,頂埔,招呼
2020-07-12,7220,54,25,79,頂埔,招呼
2020-07-13,7220,106,76,182,頂埔,招呼
2020-07-14,7220,102,65,167,頂埔,招呼
2020-07-15,7220,89,74,163,頂埔,招呼
2020-07-16,7220,83,50,133,頂埔,招呼
2020-07-17,7220,94,70,164,頂埔,招呼
2020-07-18,7220,65,43,108,頂埔,招呼
2020-07-19,7220,58,30,88,頂埔,招呼
2020-07-20,7220,91,62,153,頂埔,招呼
2020-07-21,7220,105,63,168,頂埔,招呼
2020-07-22,7220,100,55,155,頂埔,招呼
2020-07-23,7220,88,58,146,頂埔,招呼
2020-07-24,7220,84,51,135,頂埔,招呼
2020-07-25,7220,72,43,115,頂埔,招呼
2020-07-26,7220,46,34,80,頂埔,招呼
2020-07-27,7220,92,66,158,頂埔,招呼
2020-07-28,7220,87,53,140,頂埔,招呼
2020-07-29,7220,90,61,151,頂埔,招呼
2020-07-30,7220,99,50,149,頂埔,招呼
2020-07-31,7220,82,56,138,頂埔,招呼
2020-08-01,7220,63,58,121,頂埔,招呼
2020-08-02,7220,61,46,107,頂埔,招呼
2020-08-03,7220,86,63,149,頂埔,招呼
2020-08-04,7220,82,51,133,頂埔,招呼
2020-08-05,7220,89,73,162,頂埔,招呼
2020-08-06,7220,102,52,154,頂埔,招呼
2020-08-07,7220,97,59,156,頂埔,招呼
2020-08-08,7220,66,47,113,頂埔,招呼
2020-08-09,7220,57,39,96,頂埔,招呼
2020-08-10,7220,84,58,142,頂埔,招呼
2020-08-11,7220,105,54,159,頂埔,招呼
2020-08-12,7220,107,75,182,頂埔,招呼
2020-08-13,7220,91,56,147,頂埔,招呼
2020-08-14,7220,83,51,134,頂埔,招呼
2020-08-15,7220,69,46,115,頂埔,招呼
2020-08-16,7220,53,41,94,頂埔,招呼
2020-08-17,7220,94,76,170,頂埔,招呼
2020-08-18,7220,92,62,154,頂埔,招呼
2020-08-19,7220,97,55,152,頂埔,招呼
2020-08-20,7220,112,64,176,頂埔,招呼
2020-08-21,7220,104,69,173,頂埔,招呼
2020-08-22,7220,65,48,113,頂埔,招呼
2020-08-23,7220,61,40,101,頂埔,招呼
2020-08-24,7220,85,54,139,頂埔,招呼
2020-08-25,7220,83,53,136,頂埔,招呼
2020-08-26,7220,93,56,149,頂埔,招呼
2020-08-27,7220,79,45,124,頂埔,招呼
2020-08-28,7220,82,98,180,頂埔,招呼
2020-08-29,7220,64,79,143,頂埔,招呼
2020-08-30,7220,61,58,119,頂埔,招呼
2020-08-31,7220,126,142,268,頂埔,招呼
2020-09-01,7220,125,136,261,頂埔,招呼
2020-09-02,7220,110,144,254,頂埔,招呼
2020-09-03,7220,122,135,257,頂埔,招呼
2020-09-04,7220,145,156,301,頂埔,招呼
2020-09-05,7220,57,115,172,頂埔,招呼
2020-09-06,7220,62,79,141,頂埔,招呼
2020-09-07,7220,133,149,282,頂埔,招呼
2020-09-08,7220,118,142,260,頂埔,招呼
2020-09-09,7220,135,132,267,頂埔,招呼
2020-09-10,7220,113,129,242,頂埔,招呼
2020-09-11,7220,116,148,264,頂埔,招呼
2020-09-12,7220,65,96,161,頂埔,招呼
2020-09-13,7220,57,56,113,頂埔,招呼
2020-09-14,7220,128,141,269,頂埔,招呼
2020-09-15,7220,125,153,278,頂埔,招呼
2020-09-16,7220,141,153,294,頂埔,招呼
2020-09-17,7220,135,138,273,頂埔,招呼
2020-09-18,7220,124,155,279,頂埔,招呼
2020-09-19,7220,83,112,195,頂埔,招呼
2020-09-20,7220,57,52,109,頂埔,招呼
2020-09-21,7220,122,132,254,頂埔,招呼
2020-09-22,7220,119,137,256,頂埔,招呼
2020-09-23,7220,117,137,254,頂埔,招呼
2020-09-24,7220,113,122,235,頂埔,招呼
2020-09-25,7220,125,127,252,頂埔,招呼
2020-09-26,7220,95,134,229,頂埔,招呼
2020-09-27,7220,55,48,103,頂埔,招呼
2020-09-28,7220,120,140,260,頂埔,招呼
2020-09-29,7220,122,138,260,頂埔,招呼
2020-09-30,7220,120,152,272,頂埔,招呼
2020-10-01,7220,72,117,189,頂埔,招呼
2020-10-02,7220,119,110,229,頂埔,招呼
2020-10-03,7220,95,94,189,頂埔,招呼
2020-10-04,7220,78,56,134,頂埔,招呼
2020-10-05,7220,123,134,257,頂埔,招呼
2020-10-06,7220,119,136,255,頂埔,招呼
2020-10-07,7220,118,135,253,頂埔,招呼
2020-10-08,7220,110,141,251,頂埔,招呼
2020-10-09,7220,89,115,204,頂埔,招呼
2020-10-10,7220,65,74,139,頂埔,招呼
2020-10-11,7220,69,59,128,頂埔,招呼
2020-10-12,7220,119,136,255,頂埔,招呼
2020-10-13,7220,105,120,225,頂埔,招呼
2020-10-14,7220,110,125,235,頂埔,招呼
2020-10-15,7220,120,116,236,頂埔,招呼
2020-10-16,7220,110,136,246,頂埔,招呼
2020-10-17,7220,93,95,188,頂埔,招呼
2020-10-18,7220,59,59,118,頂埔,招呼
2020-10-19,7220,126,141,267,頂埔,招呼
2020-10-20,7220,123,135,258,頂埔,招呼
2020-10-21,7220,103,128,231,頂埔,招呼
2020-10-22,7220,116,132,248,頂埔,招呼
2020-10-23,7220,112,151,263,頂埔,招呼
2020-10-24,7220,104,117,221,頂埔,招呼
2020-10-25,7220,74,72,146,頂埔,招呼
2020-10-26,7220,128,139,267,頂埔,招呼
2020-10-27,7220,114,149,263,頂埔,招呼
2020-10-28,7220,128,144,272,頂埔,招呼
2020-10-29,7220,117,136,253,頂埔,招呼
2020-10-30,7220,135,157,292,頂埔,招呼
2020-10-31,7220,74,111,185,頂埔,招呼
2020-11-01,7220,77,77,154,頂埔,招呼
2020-11-02,7220,124,138,262,頂埔,招呼
2020-11-03,7220,112,131,243,頂埔,招呼
2020-11-04,7220,115,147,262,頂埔,招呼
2020-11-05,7220,117,144,261,頂埔,招呼
2020-11-06,7220,110,152,262,頂埔,招呼
2020-11-07,7220,68,88,156,頂埔,招呼
2020-11-08,7220,71,71,142,頂埔,招呼
2020-11-09,7220,132,148,280,頂埔,招呼
2020-11-10,7220,119,132,251,頂埔,招呼
2020-11-11,7220,128,144,272,頂埔,招呼
2020-11-12,7220,110,127,237,頂埔,招呼
2020-11-13,7220,108,140,248,頂埔,招呼
2020-11-14,7220,59,86,145,頂埔,招呼
2020-11-15,7220,75,84,159,頂埔,招呼
2020-11-16,7220,120,147,267,頂埔,招呼
2020-11-17,7220,107,127,234,頂埔,招呼
2020-11-18,7220,111,153,264,頂埔,招呼
2020-11-19,7220,128,154,282,頂埔,招呼
2020-11-20,7220,113,149,262,頂埔,招呼
2020-11-21,7220,83,105,188,頂埔,招呼
2020-11-22,7220,59,55,114,頂埔,招呼
2020-11-23,7220,136,147,283,頂埔,招呼
2020-11-24,7220,112,118,230,頂埔,招呼
2020-11-25,7220,146,178,324,頂埔,招呼
2020-11-26,7220,115,139,254,頂埔,招呼
2020-11-27,7220,120,165,285,頂埔,招呼
2020-11-28,7220,81,100,181,頂埔,招呼
2020-11-29,7220,59,55,114,頂埔,招呼
2020-11-30,7220,125,137,262,頂埔,招呼
2020-12-01,7220,106,134,240,頂埔,招呼
2020-12-02,7220,146,160,306,頂埔,招呼
2020-12-03,7220,158,190,348,頂埔,招呼
2020-12-04,7220,94,86,180,頂埔,招呼
2020-12-05,7220,37,54,91,頂埔,招呼
2020-12-06,7220,56,41,97,頂埔,招呼
2020-12-07,7220,87,118,205,頂埔,招呼
2020-12-08,7220,65,102,167,頂埔,招呼
2020-12-09,7220,72,102,174,頂埔,招呼
2020-12-10,7220,76,106,182,頂埔,招呼
2020-12-11,7220,91,143,234,頂埔,招呼
2020-12-12,7220,74,104,178,頂埔,招呼
2020-12-13,7220,62,82,144,頂埔,招呼
2020-12-14,7220,88,136,224,頂埔,招呼
2020-12-15,7220,98,126,224,頂埔,招呼
2020-12-16,7220,100,112,212,頂埔,招呼
2020-12-17,7220,99,110,209,頂埔,招呼
2020-12-18,7220,110,138,248,頂埔,招呼
2020-12-19,7220,71,88,159,頂埔,招呼
2020-12-20,7220,55,61,116,頂埔,招呼
2020-12-21,7220,99,129,228,頂埔,招呼
2020-12-22,7220,103,122,225,頂埔,招呼
2020-12-23,7220,88,122,210,頂埔,招呼
2020-12-24,7220,92,122,214,頂埔,招呼
2020-12-25,7220,108,128,236,頂埔,招呼
2020-12-26,7220,82,111,193,頂埔,招呼
2020-12-27,7220,50,66,116,頂埔,招呼
2020-12-28,7220,96,139,235,頂埔,招呼
2020-12-29,7220,107,134,241,頂埔,招呼
2020-12-30,7220,97,141,238,頂埔,招呼
2020-12-31,7220,112,146,258,頂埔,招呼
2020-01-01,7230,1198,1222,2420,頭城,二等
2020-01-02,7230,1474,1413,2887,頭城,二等
2020-01-03,7230,1485,1397,2882,頭城,二等
2020-01-04,7230,1282,1303,2585,頭城,二等
2020-01-05,7230,943,838,1781,頭城,二等
2020-01-06,7230,1452,1367,2819,頭城,二等
2020-01-07,7230,1330,1281,2611,頭城,二等
2020-01-08,7230,1480,1379,2859,頭城,二等
2020-01-09,7230,1317,1278,2595,頭城,二等
2020-01-10,7230,1435,1500,2935,頭城,二等
2020-01-11,7230,957,1085,2042,頭城,二等
2020-01-12,7230,932,823,1755,頭城,二等
2020-01-13,7230,1351,1238,2589,頭城,二等
2020-01-14,7230,1351,1346,2697,頭城,二等
2020-01-15,7230,1348,1304,2652,頭城,二等
2020-01-16,7230,1605,1471,3076,頭城,二等
2020-01-17,7230,1127,1272,2399,頭城,二等
2020-01-18,7230,868,935,1803,頭城,二等
2020-01-19,7230,994,852,1846,頭城,二等
2020-01-20,7230,1096,1049,2145,頭城,二等
2020-01-21,7230,1131,1083,2214,頭城,二等
2020-01-22,7230,1101,1155,2256,頭城,二等
2020-01-23,7230,931,1100,2031,頭城,二等
2020-01-24,7230,755,913,1668,頭城,二等
2020-01-25,7230,1251,1250,2501,頭城,二等
2020-01-26,7230,1251,1266,2517,頭城,二等
2020-01-27,7230,1489,1395,2884,頭城,二等
2020-01-28,7230,1377,1264,2641,頭城,二等
2020-01-29,7230,981,868,1849,頭城,二等
2020-01-30,7230,1004,927,1931,頭城,二等
2020-01-31,7230,891,893,1784,頭城,二等
2020-02-01,7230,821,852,1673,頭城,二等
2020-02-02,7230,946,846,1792,頭城,二等
2020-02-03,7230,883,880,1763,頭城,二等
2020-02-04,7230,956,912,1868,頭城,二等
2020-02-05,7230,829,817,1646,頭城,二等
2020-02-06,7230,842,859,1701,頭城,二等
2020-02-07,7230,923,920,1843,頭城,二等
2020-02-08,7230,748,815,1563,頭城,二等
2020-02-09,7230,797,785,1582,頭城,二等
2020-02-10,7230,905,834,1739,頭城,二等
2020-02-11,7230,886,885,1771,頭城,二等
2020-02-12,7230,945,896,1841,頭城,二等
2020-02-13,7230,804,816,1620,頭城,二等
2020-02-14,7230,891,861,1752,頭城,二等
2020-02-15,7230,807,868,1675,頭城,二等
2020-02-16,7230,808,687,1495,頭城,二等
2020-02-17,7230,892,857,1749,頭城,二等
2020-02-18,7230,797,777,1574,頭城,二等
2020-02-19,7230,792,727,1519,頭城,二等
2020-02-20,7230,771,771,1542,頭城,二等
2020-02-21,7230,827,901,1728,頭城,二等
2020-02-22,7230,796,858,1654,頭城,二等
2020-02-23,7230,779,690,1469,頭城,二等
2020-02-24,7230,873,801,1674,頭城,二等
2020-02-25,7230,1319,1262,2581,頭城,二等
2020-02-26,7230,1293,1222,2515,頭城,二等
2020-02-27,7230,1406,1422,2828,頭城,二等
2020-02-28,7230,880,1065,1945,頭城,二等
2020-02-29,7230,1101,1022,2123,頭城,二等
2020-03-01,7230,902,687,1589,頭城,二等
2020-03-02,7230,1328,1255,2583,頭城,二等
2020-03-03,7230,1318,1241,2559,頭城,二等
2020-03-04,7230,1357,1264,2621,頭城,二等
2020-03-05,7230,1339,1265,2604,頭城,二等
2020-03-06,7230,1242,1224,2466,頭城,二等
2020-03-07,7230,798,896,1694,頭城,二等
2020-03-08,7230,728,623,1351,頭城,二等
2020-03-09,7230,1277,1168,2445,頭城,二等
2020-03-10,7230,1247,1172,2419,頭城,二等
2020-03-11,7230,1281,1241,2522,頭城,二等
2020-03-12,7230,1302,1193,2495,頭城,二等
2020-03-13,7230,1314,1257,2571,頭城,二等
2020-03-14,7230,750,811,1561,頭城,二等
2020-03-15,7230,783,702,1485,頭城,二等
2020-03-16,7230,1253,1195,2448,頭城,二等
2020-03-17,7230,1247,1146,2393,頭城,二等
2020-03-18,7230,1246,1135,2381,頭城,二等
2020-03-19,7230,1237,1135,2372,頭城,二等
2020-03-20,7230,1264,1257,2521,頭城,二等
2020-03-21,7230,726,773,1499,頭城,二等
2020-03-22,7230,725,631,1356,頭城,二等
2020-03-23,7230,1214,1179,2393,頭城,二等
2020-03-24,7230,1200,1169,2369,頭城,二等
2020-03-25,7230,1174,1086,2260,頭城,二等
2020-03-26,7230,1200,1175,2375,頭城,二等
2020-03-27,7230,1210,1209,2419,頭城,二等
2020-03-28,7230,679,686,1365,頭城,二等
2020-03-29,7230,798,735,1533,頭城,二等
2020-03-30,7230,1212,1159,2371,頭城,二等
2020-03-31,7230,1154,1048,2202,頭城,二等
2020-04-01,7230,1250,1294,2544,頭城,二等
2020-04-02,7230,852,944,1796,頭城,二等
2020-04-03,7230,906,927,1833,頭城,二等
2020-04-04,7230,799,658,1457,頭城,二等
2020-04-05,7230,659,558,1217,頭城,二等
2020-04-06,7230,1251,1146,2397,頭城,二等
2020-04-07,7230,1160,1070,2230,頭城,二等
2020-04-08,7230,1163,1094,2257,頭城,二等
2020-04-09,7230,1159,1048,2207,頭城,二等
2020-04-10,7230,1179,1170,2349,頭城,二等
2020-04-11,7230,660,705,1365,頭城,二等
2020-04-12,7230,860,712,1572,頭城,二等
2020-04-13,7230,1238,1187,2425,頭城,二等
2020-04-14,7230,1183,1126,2309,頭城,二等
2020-04-15,7230,1208,1167,2375,頭城,二等
2020-04-16,7230,1182,1116,2298,頭城,二等
2020-04-17,7230,1251,1229,2480,頭城,二等
2020-04-18,7230,827,811,1638,頭城,二等
2020-04-19,7230,700,585,1285,頭城,二等
2020-04-20,7230,1194,1136,2330,頭城,二等
2020-04-21,7230,1145,1123,2268,頭城,二等
2020-04-22,7230,1185,1122,2307,頭城,二等
2020-04-23,7230,1091,1015,2106,頭城,二等
2020-04-24,7230,1142,1042,2184,頭城,二等
2020-04-25,7230,641,660,1301,頭城,二等
2020-04-26,7230,609,491,1100,頭城,二等
2020-04-27,7230,1157,1071,2228,頭城,二等
2020-04-28,7230,1167,1103,2270,頭城,二等
2020-04-29,7230,1171,1130,2301,頭城,二等
2020-04-30,7230,1186,1137,2323,頭城,二等
2020-05-01,7230,1331,1391,2722,頭城,二等
2020-05-02,7230,874,862,1736,頭城,二等
2020-05-03,7230,795,669,1464,頭城,二等
2020-05-04,7230,1227,1156,2383,頭城,二等
2020-05-05,7230,1136,1084,2220,頭城,二等
2020-05-06,7230,1238,1166,2404,頭城,二等
2020-05-07,7230,1126,1060,2186,頭城,二等
2020-05-08,7230,1264,1240,2504,頭城,二等
2020-05-09,7230,847,920,1767,頭城,二等
2020-05-10,7230,818,640,1458,頭城,二等
2020-05-11,7230,1207,1118,2325,頭城,二等
2020-05-12,7230,1257,1139,2396,頭城,二等
2020-05-13,7230,1300,1167,2467,頭城,二等
2020-05-14,7230,1186,1083,2269,頭城,二等
2020-05-15,7230,1311,1272,2583,頭城,二等
2020-05-16,7230,725,819,1544,頭城,二等
2020-05-17,7230,858,674,1532,頭城,二等
2020-05-18,7230,1201,1157,2358,頭城,二等
2020-05-19,7230,1108,1099,2207,頭城,二等
2020-05-20,7230,1241,1144,2385,頭城,二等
2020-05-21,7230,1138,1031,2169,頭城,二等
2020-05-22,7230,1206,1237,2443,頭城,二等
2020-05-23,7230,728,814,1542,頭城,二等
2020-05-24,7230,1015,853,1868,頭城,二等
2020-05-25,7230,1217,1145,2362,頭城,二等
2020-05-26,7230,1205,1114,2319,頭城,二等
2020-05-27,7230,1163,1100,2263,頭城,二等
2020-05-28,7230,1156,1043,2199,頭城,二等
2020-05-29,7230,1303,1222,2525,頭城,二等
2020-05-30,7230,997,1020,2017,頭城,二等
2020-05-31,7230,969,797,1766,頭城,二等
2020-06-01,7230,1208,1149,2357,頭城,二等
2020-06-02,7230,1245,1156,2401,頭城,二等
2020-06-03,7230,1225,1171,2396,頭城,二等
2020-06-04,7230,1249,1136,2385,頭城,二等
2020-06-05,7230,1296,1340,2636,頭城,二等
2020-06-06,7230,1079,1144,2223,頭城,二等
2020-06-07,7230,1008,774,1782,頭城,二等
2020-06-08,7230,1287,1148,2435,頭城,二等
2020-06-09,7230,1304,1189,2493,頭城,二等
2020-06-10,7230,1220,1170,2390,頭城,二等
2020-06-11,7230,1359,1266,2625,頭城,二等
2020-06-12,7230,1335,1374,2709,頭城,二等
2020-06-13,7230,1199,1202,2401,頭城,二等
2020-06-14,7230,1117,955,2072,頭城,二等
2020-06-15,7230,1291,1256,2547,頭城,二等
2020-06-16,7230,1254,1196,2450,頭城,二等
2020-06-17,7230,1181,1128,2309,頭城,二等
2020-06-18,7230,1204,1087,2291,頭城,二等
2020-06-19,7230,1443,1322,2765,頭城,二等
2020-06-20,7230,1236,1247,2483,頭城,二等
2020-06-21,7230,1060,1023,2083,頭城,二等
2020-06-22,7230,1384,1341,2725,頭城,二等
2020-06-23,7230,1231,1186,2417,頭城,二等
2020-06-24,7230,1407,1429,2836,頭城,二等
2020-06-25,7230,1265,1548,2813,頭城,二等
2020-06-26,7230,1839,1668,3507,頭城,二等
2020-06-27,7230,1524,1423,2947,頭城,二等
2020-06-28,7230,1171,922,2093,頭城,二等
2020-06-29,7230,1382,1272,2654,頭城,二等
2020-06-30,7230,1185,1151,2336,頭城,二等
2020-07-01,7230,1265,1162,2427,頭城,二等
2020-07-02,7230,1158,1087,2245,頭城,二等
2020-07-03,7230,1323,1262,2585,頭城,二等
2020-07-04,7230,1249,1367,2616,頭城,二等
2020-07-05,7230,1129,878,2007,頭城,二等
2020-07-06,7230,1304,1214,2518,頭城,二等
2020-07-07,7230,1205,1174,2379,頭城,二等
2020-07-08,7230,1212,1138,2350,頭城,二等
2020-07-09,7230,1331,1252,2583,頭城,二等
2020-07-10,7230,1450,1471,2921,頭城,二等
2020-07-11,7230,1178,1231,2409,頭城,二等
2020-07-12,7230,1172,995,2167,頭城,二等
2020-07-13,7230,1331,1283,2614,頭城,二等
2020-07-14,7230,1398,1282,2680,頭城,二等
2020-07-15,7230,1044,1065,2109,頭城,二等
2020-07-16,7230,1188,1169,2357,頭城,二等
2020-07-17,7230,1297,1275,2572,頭城,二等
2020-07-18,7230,1249,1372,2621,頭城,二等
2020-07-19,7230,1281,1016,2297,頭城,二等
2020-07-20,7230,1116,1075,2191,頭城,二等
2020-07-21,7230,1061,1057,2118,頭城,二等
2020-07-22,7230,1260,1252,2512,頭城,二等
2020-07-23,7230,1052,1075,2127,頭城,二等
2020-07-24,7230,1108,1173,2281,頭城,二等
2020-07-25,7230,1181,1382,2563,頭城,二等
2020-07-26,7230,1435,1110,2545,頭城,二等
2020-07-27,7230,1154,1114,2268,頭城,二等
2020-07-28,7230,1089,1032,2121,頭城,二等
2020-07-29,7230,1106,1037,2143,頭城,二等
2020-07-30,7230,1262,1223,2485,頭城,二等
2020-07-31,7230,1189,1298,2487,頭城,二等
2020-08-01,7230,1300,1392,2692,頭城,二等
2020-08-02,7230,1358,1244,2602,頭城,二等
2020-08-03,7230,1248,1186,2434,頭城,二等
2020-08-04,7230,973,951,1924,頭城,二等
2020-08-05,7230,1046,1123,2169,頭城,二等
2020-08-06,7230,1160,1131,2291,頭城,二等
2020-08-07,7230,1320,1385,2705,頭城,二等
2020-08-08,7230,1153,1162,2315,頭城,二等
2020-08-09,7230,1220,960,2180,頭城,二等
2020-08-10,7230,1199,1110,2309,頭城,二等
2020-08-11,7230,1143,1137,2280,頭城,二等
2020-08-12,7230,1142,1153,2295,頭城,二等
2020-08-13,7230,1112,1111,2223,頭城,二等
2020-08-14,7230,1245,1275,2520,頭城,二等
2020-08-15,7230,1283,1393,2676,頭城,二等
2020-08-16,7230,1360,1126,2486,頭城,二等
2020-08-17,7230,1218,1167,2385,頭城,二等
2020-08-18,7230,1074,1119,2193,頭城,二等
2020-08-19,7230,1082,1026,2108,頭城,二等
2020-08-20,7230,1325,1279,2604,頭城,二等
2020-08-21,7230,1321,1366,2687,頭城,二等
2020-08-22,7230,1090,1161,2251,頭城,二等
2020-08-23,7230,1192,1029,2221,頭城,二等
2020-08-24,7230,1100,1010,2110,頭城,二等
2020-08-25,7230,1060,1055,2115,頭城,二等
2020-08-26,7230,1070,1020,2090,頭城,二等
2020-08-27,7230,1040,1038,2078,頭城,二等
2020-08-28,7230,1217,1287,2504,頭城,二等
2020-08-29,7230,1087,1206,2293,頭城,二等
2020-08-30,7230,1258,1143,2401,頭城,二等
2020-08-31,7230,1441,1401,2842,頭城,二等
2020-09-01,7230,1237,1249,2486,頭城,二等
2020-09-02,7230,1239,1228,2467,頭城,二等
2020-09-03,7230,1217,1203,2420,頭城,二等
2020-09-04,7230,1306,1388,2694,頭城,二等
2020-09-05,7230,1227,1244,2471,頭城,二等
2020-09-06,7230,1259,1040,2299,頭城,二等
2020-09-07,7230,1488,1453,2941,頭城,二等
2020-09-08,7230,1391,1321,2712,頭城,二等
2020-09-09,7230,1403,1291,2694,頭城,二等
2020-09-10,7230,1354,1279,2633,頭城,二等
2020-09-11,7230,1546,1590,3136,頭城,二等
2020-09-12,7230,1048,1122,2170,頭城,二等
2020-09-13,7230,1202,960,2162,頭城,二等
2020-09-14,7230,1415,1307,2722,頭城,二等
2020-09-15,7230,1393,1261,2654,頭城,二等
2020-09-16,7230,1337,1272,2609,頭城,二等
2020-09-17,7230,1398,1295,2693,頭城,二等
2020-09-18,7230,1524,1574,3098,頭城,二等
2020-09-19,7230,1147,1153,2300,頭城,二等
2020-09-20,7230,1095,932,2027,頭城,二等
2020-09-21,7230,1422,1308,2730,頭城,二等
2020-09-22,7230,1365,1338,2703,頭城,二等
2020-09-23,7230,1443,1351,2794,頭城,二等
2020-09-24,7230,1305,1256,2561,頭城,二等
2020-09-25,7230,1431,1450,2881,頭城,二等
2020-09-26,7230,1345,1420,2765,頭城,二等
2020-09-27,7230,1044,862,1906,頭城,二等
2020-09-28,7230,1283,1232,2515,頭城,二等
2020-09-29,7230,1250,1221,2471,頭城,二等
2020-09-30,7230,1445,1564,3009,頭城,二等
2020-10-01,7230,1378,1667,3045,頭城,二等
2020-10-02,7230,1862,1695,3557,頭城,二等
2020-10-03,7230,1550,1414,2964,頭城,二等
2020-10-04,7230,1104,873,1977,頭城,二等
2020-10-05,7230,1387,1257,2644,頭城,二等
2020-10-06,7230,1364,1296,2660,頭城,二等
2020-10-07,7230,1368,1263,2631,頭城,二等
2020-10-08,7230,1438,1490,2928,頭城,二等
2020-10-09,7230,1329,1517,2846,頭城,二等
2020-10-10,7230,1268,1201,2469,頭城,二等
2020-10-11,7230,1068,862,1930,頭城,二等
2020-10-12,7230,1351,1269,2620,頭城,二等
2020-10-13,7230,1273,1204,2477,頭城,二等
2020-10-14,7230,1344,1238,2582,頭城,二等
2020-10-15,7230,1260,1243,2503,頭城,二等
2020-10-16,7230,1402,2463,3865,頭城,二等
2020-10-17,7230,992,1107,2099,頭城,二等
2020-10-18,7230,1130,808,1938,頭城,二等
2020-10-19,7230,1314,1276,2590,頭城,二等
2020-10-20,7230,1270,1250,2520,頭城,二等
2020-10-21,7230,1241,1196,2437,頭城,二等
2020-10-22,7230,1320,1268,2588,頭城,二等
2020-10-23,7230,1335,1399,2734,頭城,二等
2020-10-24,7230,2038,2188,4226,頭城,二等
2020-10-25,7230,1093,799,1892,頭城,二等
2020-10-26,7230,1369,1330,2699,頭城,二等
2020-10-27,7230,1292,1228,2520,頭城,二等
2020-10-28,7230,1255,1178,2433,頭城,二等
2020-10-29,7230,1191,1203,2394,頭城,二等
2020-10-30,7230,1380,1398,2778,頭城,二等
2020-10-31,7230,993,1146,2139,頭城,二等
2020-11-01,7230,1119,938,2057,頭城,二等
2020-11-02,7230,1328,1223,2551,頭城,二等
2020-11-03,7230,1268,1175,2443,頭城,二等
2020-11-04,7230,1283,1230,2513,頭城,二等
2020-11-05,7230,1321,1204,2525,頭城,二等
2020-11-06,7230,1317,1299,2616,頭城,二等
2020-11-07,7230,942,1073,2015,頭城,二等
2020-11-08,7230,863,773,1636,頭城,二等
2020-11-09,7230,1329,1262,2591,頭城,二等
2020-11-10,7230,1240,1202,2442,頭城,二等
2020-11-11,7230,1242,1241,2483,頭城,二等
2020-11-12,7230,1232,1193,2425,頭城,二等
2020-11-13,7230,1273,1314,2587,頭城,二等
2020-11-14,7230,908,1046,1954,頭城,二等
2020-11-15,7230,1193,1045,2238,頭城,二等
2020-11-16,7230,1371,1293,2664,頭城,二等
2020-11-17,7230,1423,1322,2745,頭城,二等
2020-11-18,7230,1341,1250,2591,頭城,二等
2020-11-19,7230,1351,1285,2636,頭城,二等
2020-11-20,7230,1494,1590,3084,頭城,二等
2020-11-21,7230,1123,1092,2215,頭城,二等
2020-11-22,7230,1147,947,2094,頭城,二等
2020-11-23,7230,1349,1256,2605,頭城,二等
2020-11-24,7230,1482,1441,2923,頭城,二等
2020-11-25,7230,1329,1238,2567,頭城,二等
2020-11-26,7230,1309,1240,2549,頭城,二等
2020-11-27,7230,1387,1429,2816,頭城,二等
2020-11-28,7230,841,956,1797,頭城,二等
2020-11-29,7230,1042,789,1831,頭城,二等
2020-11-30,7230,1330,1206,2536,頭城,二等
2020-12-01,7230,1211,1139,2350,頭城,二等
2020-12-02,7230,1246,1186,2432,頭城,二等
2020-12-03,7230,1296,1269,2565,頭城,二等
2020-12-04,7230,996,1011,2007,頭城,二等
2020-12-05,7230,507,579,1086,頭城,二等
2020-12-06,7230,479,428,907,頭城,二等
2020-12-07,7230,966,937,1903,頭城,二等
2020-12-08,7230,1004,954,1958,頭城,二等
2020-12-09,7230,944,906,1850,頭城,二等
2020-12-10,7230,1000,918,1918,頭城,二等
2020-12-11,7230,1143,1045,2188,頭城,二等
2020-12-12,7230,615,688,1303,頭城,二等
2020-12-13,7230,659,525,1184,頭城,二等
2020-12-14,7230,1155,1133,2288,頭城,二等
2020-12-15,7230,1166,1055,2221,頭城,二等
2020-12-16,7230,1153,1145,2298,頭城,二等
2020-12-17,7230,1206,1186,2392,頭城,二等
2020-12-18,7230,1385,1301,2686,頭城,二等
2020-12-19,7230,852,801,1653,頭城,二等
2020-12-20,7230,797,648,1445,頭城,二等
2020-12-21,7230,1196,1065,2261,頭城,二等
2020-12-22,7230,1158,1101,2259,頭城,二等
2020-12-23,7230,1172,1095,2267,頭城,二等
2020-12-24,7230,1251,1238,2489,頭城,二等
2020-12-25,7230,1300,1273,2573,頭城,二等
2020-12-26,7230,939,1055,1994,頭城,二等
2020-12-27,7230,923,774,1697,頭城,二等
2020-12-28,7230,1236,1191,2427,頭城,二等
2020-12-29,7230,1279,1176,2455,頭城,二等
2020-12-30,7230,1154,1105,2259,頭城,二等
2020-12-31,7230,1403,1429,2832,頭城,二等
2020-01-01,7240,200,118,318,外澳,招呼
2020-01-02,7240,67,73,140,外澳,招呼
2020-01-03,7240,101,115,216,外澳,招呼
2020-01-04,7240,113,131,244,外澳,招呼
2020-01-05,7240,120,83,203,外澳,招呼
2020-01-06,7240,42,51,93,外澳,招呼
2020-01-07,7240,76,86,162,外澳,招呼
2020-01-08,7240,39,51,90,外澳,招呼
2020-01-09,7240,34,44,78,外澳,招呼
2020-01-10,7240,73,42,115,外澳,招呼
2020-01-11,7240,95,114,209,外澳,招呼
2020-01-12,7240,58,96,154,外澳,招呼
2020-01-13,7240,57,57,114,外澳,招呼
2020-01-14,7240,59,79,138,外澳,招呼
2020-01-15,7240,41,50,91,外澳,招呼
2020-01-16,7240,90,89,179,外澳,招呼
2020-01-17,7240,43,52,95,外澳,招呼
2020-01-18,7240,46,73,119,外澳,招呼
2020-01-19,7240,89,64,153,外澳,招呼
2020-01-20,7240,56,75,131,外澳,招呼
2020-01-21,7240,62,74,136,外澳,招呼
2020-01-22,7240,74,111,185,外澳,招呼
2020-01-23,7240,46,74,120,外澳,招呼
2020-01-24,7240,57,64,121,外澳,招呼
2020-01-25,7240,111,128,239,外澳,招呼
2020-01-26,7240,70,75,145,外澳,招呼
2020-01-27,7240,72,98,170,外澳,招呼
2020-01-28,7240,80,65,145,外澳,招呼
2020-01-29,7240,33,58,91,外澳,招呼
2020-01-30,7240,65,69,134,外澳,招呼
2020-01-31,7240,52,48,100,外澳,招呼
2020-02-01,7240,119,98,217,外澳,招呼
2020-02-02,7240,121,111,232,外澳,招呼
2020-02-03,7240,124,124,248,外澳,招呼
2020-02-04,7240,51,62,113,外澳,招呼
2020-02-05,7240,43,51,94,外澳,招呼
2020-02-06,7240,36,45,81,外澳,招呼
2020-02-07,7240,72,92,164,外澳,招呼
2020-02-08,7240,55,56,111,外澳,招呼
2020-02-09,7240,80,60,140,外澳,招呼
2020-02-10,7240,46,58,104,外澳,招呼
2020-02-11,7240,57,67,124,外澳,招呼
2020-02-12,7240,129,148,277,外澳,招呼
2020-02-13,7240,79,91,170,外澳,招呼
2020-02-14,7240,72,116,188,外澳,招呼
2020-02-15,7240,105,115,220,外澳,招呼
2020-02-16,7240,36,31,67,外澳,招呼
2020-02-17,7240,54,71,125,外澳,招呼
2020-02-18,7240,43,47,90,外澳,招呼
2020-02-19,7240,102,106,208,外澳,招呼
2020-02-20,7240,49,63,112,外澳,招呼
2020-02-21,7240,68,84,152,外澳,招呼
2020-02-22,7240,88,107,195,外澳,招呼
2020-02-23,7240,55,45,100,外澳,招呼
2020-02-24,7240,85,106,191,外澳,招呼
2020-02-25,7240,89,86,175,外澳,招呼
2020-02-26,7240,57,57,114,外澳,招呼
2020-02-27,7240,37,64,101,外澳,招呼
2020-02-28,7240,152,151,303,外澳,招呼
2020-02-29,7240,207,188,395,外澳,招呼
2020-03-01,7240,115,146,261,外澳,招呼
2020-03-02,7240,30,27,57,外澳,招呼
2020-03-03,7240,46,40,86,外澳,招呼
2020-03-04,7240,33,31,64,外澳,招呼
2020-03-05,7240,26,29,55,外澳,招呼
2020-03-06,7240,29,36,65,外澳,招呼
2020-03-07,7240,158,126,284,外澳,招呼
2020-03-08,7240,89,68,157,外澳,招呼
2020-03-09,7240,61,39,100,外澳,招呼
2020-03-10,7240,26,34,60,外澳,招呼
2020-03-11,7240,26,29,55,外澳,招呼
2020-03-12,7240,34,42,76,外澳,招呼
2020-03-13,7240,41,63,104,外澳,招呼
2020-03-14,7240,40,63,103,外澳,招呼
2020-03-15,7240,139,126,265,外澳,招呼
2020-03-16,7240,49,56,105,外澳,招呼
2020-03-17,7240,43,48,91,外澳,招呼
2020-03-18,7240,34,40,74,外澳,招呼
2020-03-19,7240,21,26,47,外澳,招呼
2020-03-20,7240,39,47,86,外澳,招呼
2020-03-21,7240,167,145,312,外澳,招呼
2020-03-22,7240,87,85,172,外澳,招呼
2020-03-23,7240,31,28,59,外澳,招呼
2020-03-24,7240,30,38,68,外澳,招呼
2020-03-25,7240,28,35,63,外澳,招呼
2020-03-26,7240,53,50,103,外澳,招呼
2020-03-27,7240,34,35,69,外澳,招呼
2020-03-28,7240,19,29,48,外澳,招呼
2020-03-29,7240,73,96,169,外澳,招呼
2020-03-30,7240,54,56,110,外澳,招呼
2020-03-31,7240,40,64,104,外澳,招呼
2020-04-01,7240,39,31,70,外澳,招呼
2020-04-02,7240,66,92,158,外澳,招呼
2020-04-03,7240,109,130,239,外澳,招呼
2020-04-04,7240,72,69,141,外澳,招呼
2020-04-05,7240,57,42,99,外澳,招呼
2020-04-06,7240,27,28,55,外澳,招呼
2020-04-07,7240,33,37,70,外澳,招呼
2020-04-08,7240,34,38,72,外澳,招呼
2020-04-09,7240,34,40,74,外澳,招呼
2020-04-10,7240,42,48,90,外澳,招呼
2020-04-11,7240,61,68,129,外澳,招呼
2020-04-12,7240,66,74,140,外澳,招呼
2020-04-13,7240,42,43,85,外澳,招呼
2020-04-14,7240,39,45,84,外澳,招呼
2020-04-15,7240,36,38,74,外澳,招呼
2020-04-16,7240,30,47,77,外澳,招呼
2020-04-17,7240,96,102,198,外澳,招呼
2020-04-18,7240,143,180,323,外澳,招呼
2020-04-19,7240,156,107,263,外澳,招呼
2020-04-20,7240,28,45,73,外澳,招呼
2020-04-21,7240,22,34,56,外澳,招呼
2020-04-22,7240,26,29,55,外澳,招呼
2020-04-23,7240,16,19,35,外澳,招呼
2020-04-24,7240,24,40,64,外澳,招呼
2020-04-25,7240,73,74,147,外澳,招呼
2020-04-26,7240,134,171,305,外澳,招呼
2020-04-27,7240,32,31,63,外澳,招呼
2020-04-28,7240,23,37,60,外澳,招呼
2020-04-29,7240,40,50,90,外澳,招呼
2020-04-30,7240,41,73,114,外澳,招呼
2020-05-01,7240,165,177,342,外澳,招呼
2020-05-02,7240,234,290,524,外澳,招呼
2020-05-03,7240,266,197,463,外澳,招呼
2020-05-04,7240,40,49,89,外澳,招呼
2020-05-05,7240,51,62,113,外澳,招呼
2020-05-06,7240,44,55,99,外澳,招呼
2020-05-07,7240,38,42,80,外澳,招呼
2020-05-08,7240,61,63,124,外澳,招呼
2020-05-09,7240,223,210,433,外澳,招呼
2020-05-10,7240,109,75,184,外澳,招呼
2020-05-11,7240,23,37,60,外澳,招呼
2020-05-12,7240,30,30,60,外澳,招呼
2020-05-13,7240,49,54,103,外澳,招呼
2020-05-14,7240,56,63,119,外澳,招呼
2020-05-15,7240,101,141,242,外澳,招呼
2020-05-16,7240,161,101,262,外澳,招呼
2020-05-17,7240,182,160,342,外澳,招呼
2020-05-18,7240,35,43,78,外澳,招呼
2020-05-19,7240,40,40,80,外澳,招呼
2020-05-20,7240,34,46,80,外澳,招呼
2020-05-21,7240,30,38,68,外澳,招呼
2020-05-22,7240,33,44,77,外澳,招呼
2020-05-23,7240,81,101,182,外澳,招呼
2020-05-24,7240,199,188,387,外澳,招呼
2020-05-25,7240,53,45,98,外澳,招呼
2020-05-26,7240,47,44,91,外澳,招呼
2020-05-27,7240,35,35,70,外澳,招呼
2020-05-28,7240,33,35,68,外澳,招呼
2020-05-29,7240,46,63,109,外澳,招呼
2020-05-30,7240,189,206,395,外澳,招呼
2020-05-31,7240,276,191,467,外澳,招呼
2020-06-01,7240,39,48,87,外澳,招呼
2020-06-02,7240,90,97,187,外澳,招呼
2020-06-03,7240,71,77,148,外澳,招呼
2020-06-04,7240,77,74,151,外澳,招呼
2020-06-05,7240,77,85,162,外澳,招呼
2020-06-06,7240,280,295,575,外澳,招呼
2020-06-07,7240,269,193,462,外澳,招呼
2020-06-08,7240,45,50,95,外澳,招呼
2020-06-09,7240,73,77,150,外澳,招呼
2020-06-10,7240,79,72,151,外澳,招呼
2020-06-11,7240,90,91,181,外澳,招呼
2020-06-12,7240,90,113,203,外澳,招呼
2020-06-13,7240,515,356,871,外澳,招呼
2020-06-14,7240,232,179,411,外澳,招呼
2020-06-15,7240,98,83,181,外澳,招呼
2020-06-16,7240,95,106,201,外澳,招呼
2020-06-17,7240,94,79,173,外澳,招呼
2020-06-18,7240,116,86,202,外澳,招呼
2020-06-19,7240,138,172,310,外澳,招呼
2020-06-20,7240,198,216,414,外澳,招呼
2020-06-21,7240,251,226,477,外澳,招呼
2020-06-22,7240,105,118,223,外澳,招呼
2020-06-23,7240,112,108,220,外澳,招呼
2020-06-24,7240,147,154,301,外澳,招呼
2020-06-25,7240,303,396,699,外澳,招呼
2020-06-26,7240,476,488,964,外澳,招呼
2020-06-27,7240,473,386,859,外澳,招呼
2020-06-28,7240,322,254,576,外澳,招呼
2020-06-29,7240,128,119,247,外澳,招呼
2020-06-30,7240,127,120,247,外澳,招呼
2020-07-01,7240,123,126,249,外澳,招呼
2020-07-02,7240,110,139,249,外澳,招呼
2020-07-03,7240,117,134,251,外澳,招呼
2020-07-04,7240,218,274,492,外澳,招呼
2020-07-05,7240,192,179,371,外澳,招呼
2020-07-06,7240,143,162,305,外澳,招呼
2020-07-07,7240,125,124,249,外澳,招呼
2020-07-08,7240,116,99,215,外澳,招呼
2020-07-09,7240,182,175,357,外澳,招呼
2020-07-10,7240,251,231,482,外澳,招呼
2020-07-11,7240,435,364,799,外澳,招呼
2020-07-12,7240,354,385,739,外澳,招呼
2020-07-13,7240,135,140,275,外澳,招呼
2020-07-14,7240,168,173,341,外澳,招呼
2020-07-15,7240,259,159,418,外澳,招呼
2020-07-16,7240,236,240,476,外澳,招呼
2020-07-17,7240,267,277,544,外澳,招呼
2020-07-18,7240,389,432,821,外澳,招呼
2020-07-19,7240,301,271,572,外澳,招呼
2020-07-20,7240,149,176,325,外澳,招呼
2020-07-21,7240,146,147,293,外澳,招呼
2020-07-22,7240,188,138,326,外澳,招呼
2020-07-23,7240,252,224,476,外澳,招呼
2020-07-24,7240,295,292,587,外澳,招呼
2020-07-25,7240,469,468,937,外澳,招呼
2020-07-26,7240,387,375,762,外澳,招呼
2020-07-27,7240,211,189,400,外澳,招呼
2020-07-28,7240,137,138,275,外澳,招呼
2020-07-29,7240,184,194,378,外澳,招呼
2020-07-30,7240,169,182,351,外澳,招呼
2020-07-31,7240,275,278,553,外澳,招呼
2020-08-01,7240,536,532,1068,外澳,招呼
2020-08-02,7240,369,303,672,外澳,招呼
2020-08-03,7240,63,44,107,外澳,招呼
2020-08-04,7240,151,160,311,外澳,招呼
2020-08-05,7240,169,171,340,外澳,招呼
2020-08-06,7240,215,224,439,外澳,招呼
2020-08-07,7240,192,212,404,外澳,招呼
2020-08-08,7240,300,301,601,外澳,招呼
2020-08-09,7240,321,316,637,外澳,招呼
2020-08-10,7240,207,178,385,外澳,招呼
2020-08-11,7240,193,184,377,外澳,招呼
2020-08-12,7240,220,223,443,外澳,招呼
2020-08-13,7240,168,116,284,外澳,招呼
2020-08-14,7240,229,219,448,外澳,招呼
2020-08-15,7240,363,398,761,外澳,招呼
2020-08-16,7240,400,340,740,外澳,招呼
2020-08-17,7240,238,218,456,外澳,招呼
2020-08-18,7240,258,225,483,外澳,招呼
2020-08-19,7240,201,173,374,外澳,招呼
2020-08-20,7240,169,181,350,外澳,招呼
2020-08-21,7240,237,222,459,外澳,招呼
2020-08-22,7240,225,220,445,外澳,招呼
2020-08-23,7240,275,251,526,外澳,招呼
2020-08-24,7240,161,137,298,外澳,招呼
2020-08-25,7240,186,188,374,外澳,招呼
2020-08-26,7240,152,134,286,外澳,招呼
2020-08-27,7240,110,148,258,外澳,招呼
2020-08-28,7240,206,204,410,外澳,招呼
2020-08-29,7240,289,238,527,外澳,招呼
2020-08-30,7240,251,220,471,外澳,招呼
2020-08-31,7240,95,86,181,外澳,招呼
2020-09-01,7240,94,93,187,外澳,招呼
2020-09-02,7240,120,108,228,外澳,招呼
2020-09-03,7240,112,127,239,外澳,招呼
2020-09-04,7240,100,134,234,外澳,招呼
2020-09-05,7240,265,233,498,外澳,招呼
2020-09-06,7240,191,130,321,外澳,招呼
2020-09-07,7240,117,147,264,外澳,招呼
2020-09-08,7240,114,114,228,外澳,招呼
2020-09-09,7240,143,134,277,外澳,招呼
2020-09-10,7240,71,93,164,外澳,招呼
2020-09-11,7240,119,104,223,外澳,招呼
2020-09-12,7240,142,163,305,外澳,招呼
2020-09-13,7240,159,167,326,外澳,招呼
2020-09-14,7240,64,66,130,外澳,招呼
2020-09-15,7240,67,61,128,外澳,招呼
2020-09-16,7240,56,65,121,外澳,招呼
2020-09-17,7240,67,77,144,外澳,招呼
2020-09-18,7240,124,103,227,外澳,招呼
2020-09-19,7240,235,267,502,外澳,招呼
2020-09-20,7240,158,157,315,外澳,招呼
2020-09-21,7240,80,85,165,外澳,招呼
2020-09-22,7240,87,72,159,外澳,招呼
2020-09-23,7240,77,81,158,外澳,招呼
2020-09-24,7240,55,47,102,外澳,招呼
2020-09-25,7240,66,90,156,外澳,招呼
2020-09-26,7240,124,159,283,外澳,招呼
2020-09-27,7240,130,154,284,外澳,招呼
2020-09-28,7240,66,65,131,外澳,招呼
2020-09-29,7240,62,54,116,外澳,招呼
2020-09-30,7240,59,76,135,外澳,招呼
2020-10-01,7240,241,322,563,外澳,招呼
2020-10-02,7240,390,416,806,外澳,招呼
2020-10-03,7240,391,314,705,外澳,招呼
2020-10-04,7240,208,140,348,外澳,招呼
2020-10-05,7240,49,79,128,外澳,招呼
2020-10-06,7240,91,90,181,外澳,招呼
2020-10-07,7240,70,80,150,外澳,招呼
2020-10-08,7240,69,83,152,外澳,招呼
2020-10-09,7240,179,199,378,外澳,招呼
2020-10-10,7240,164,180,344,外澳,招呼
2020-10-11,7240,128,123,251,外澳,招呼
2020-10-12,7240,52,57,109,外澳,招呼
2020-10-13,7240,50,47,97,外澳,招呼
2020-10-14,7240,62,71,133,外澳,招呼
2020-10-15,7240,53,61,114,外澳,招呼
2020-10-16,7240,73,66,139,外澳,招呼
2020-10-17,7240,271,309,580,外澳,招呼
2020-10-18,7240,92,55,147,外澳,招呼
2020-10-19,7240,38,41,79,外澳,招呼
2020-10-20,7240,51,53,104,外澳,招呼
2020-10-21,7240,34,45,79,外澳,招呼
2020-10-22,7240,30,31,61,外澳,招呼
2020-10-23,7240,34,36,70,外澳,招呼
2020-10-24,7240,178,202,380,外澳,招呼
2020-10-25,7240,167,126,293,外澳,招呼
2020-10-26,7240,102,100,202,外澳,招呼
2020-10-27,7240,52,49,101,外澳,招呼
2020-10-28,7240,39,40,79,外澳,招呼
2020-10-29,7240,49,48,97,外澳,招呼
2020-10-30,7240,54,64,118,外澳,招呼
2020-10-31,7240,162,229,391,外澳,招呼
2020-11-01,7240,187,108,295,外澳,招呼
2020-11-02,7240,55,54,109,外澳,招呼
2020-11-03,7240,45,46,91,外澳,招呼
2020-11-04,7240,48,43,91,外澳,招呼
2020-11-05,7240,46,34,80,外澳,招呼
2020-11-06,7240,46,60,106,外澳,招呼
2020-11-07,7240,90,114,204,外澳,招呼
2020-11-08,7240,48,49,97,外澳,招呼
2020-11-09,7240,47,35,82,外澳,招呼
2020-11-10,7240,37,48,85,外澳,招呼
2020-11-11,7240,48,38,86,外澳,招呼
2020-11-12,7240,28,34,62,外澳,招呼
2020-11-13,7240,31,43,74,外澳,招呼
2020-11-14,7240,73,90,163,外澳,招呼
2020-11-15,7240,122,78,200,外澳,招呼
2020-11-16,7240,49,47,96,外澳,招呼
2020-11-17,7240,49,52,101,外澳,招呼
2020-11-18,7240,78,91,169,外澳,招呼
2020-11-19,7240,72,86,158,外澳,招呼
2020-11-20,7240,55,62,117,外澳,招呼
2020-11-21,7240,52,83,135,外澳,招呼
2020-11-22,7240,148,168,316,外澳,招呼
2020-11-23,7240,33,64,97,外澳,招呼
2020-11-24,7240,39,50,89,外澳,招呼
2020-11-25,7240,50,57,107,外澳,招呼
2020-11-26,7240,75,52,127,外澳,招呼
2020-11-27,7240,40,52,92,外澳,招呼
2020-11-28,7240,67,98,165,外澳,招呼
2020-11-29,7240,68,54,122,外澳,招呼
2020-11-30,7240,23,31,54,外澳,招呼
2020-12-01,7240,28,28,56,外澳,招呼
2020-12-02,7240,35,30,65,外澳,招呼
2020-12-03,7240,37,40,77,外澳,招呼
2020-12-04,7240,16,20,36,外澳,招呼
2020-12-05,7240,19,22,41,外澳,招呼
2020-12-06,7240,14,15,29,外澳,招呼
2020-12-07,7240,22,20,42,外澳,招呼
2020-12-08,7240,17,19,36,外澳,招呼
2020-12-09,7240,15,24,39,外澳,招呼
2020-12-10,7240,12,23,35,外澳,招呼
2020-12-11,7240,23,39,62,外澳,招呼
2020-12-12,7240,32,34,66,外澳,招呼
2020-12-13,7240,53,29,82,外澳,招呼
2020-12-14,7240,19,29,48,外澳,招呼
2020-12-15,7240,22,29,51,外澳,招呼
2020-12-16,7240,31,29,60,外澳,招呼
2020-12-17,7240,19,23,42,外澳,招呼
2020-12-18,7240,34,50,84,外澳,招呼
2020-12-19,7240,30,39,69,外澳,招呼
2020-12-20,7240,35,39,74,外澳,招呼
2020-12-21,7240,24,22,46,外澳,招呼
2020-12-22,7240,18,26,44,外澳,招呼
2020-12-23,7240,18,26,44,外澳,招呼
2020-12-24,7240,43,51,94,外澳,招呼
2020-12-25,7240,27,39,66,外澳,招呼
2020-12-26,7240,116,119,235,外澳,招呼
2020-12-27,7240,97,83,180,外澳,招呼
2020-12-28,7240,30,30,60,外澳,招呼
2020-12-29,7240,57,48,105,外澳,招呼
2020-12-30,7240,17,21,38,外澳,招呼
2020-12-31,7240,28,79,107,外澳,招呼
2020-01-01,7250,77,73,150,龜山,甲簡
2020-01-02,7250,99,103,202,龜山,甲簡
2020-01-03,7250,98,114,212,龜山,甲簡
2020-01-04,7250,88,103,191,龜山,甲簡
2020-01-05,7250,99,86,185,龜山,甲簡
2020-01-06,7250,77,90,167,龜山,甲簡
2020-01-07,7250,95,101,196,龜山,甲簡
2020-01-08,7250,177,165,342,龜山,甲簡
2020-01-09,7250,90,99,189,龜山,甲簡
2020-01-10,7250,93,106,199,龜山,甲簡
2020-01-11,7250,87,105,192,龜山,甲簡
2020-01-12,7250,174,125,299,龜山,甲簡
2020-01-13,7250,98,206,304,龜山,甲簡
2020-01-14,7250,155,138,293,龜山,甲簡
2020-01-15,7250,87,88,175,龜山,甲簡
2020-01-16,7250,102,104,206,龜山,甲簡
2020-01-17,7250,136,123,259,龜山,甲簡
2020-01-18,7250,79,91,170,龜山,甲簡
2020-01-19,7250,97,88,185,龜山,甲簡
2020-01-20,7250,116,106,222,龜山,甲簡
2020-01-21,7250,116,130,246,龜山,甲簡
2020-01-22,7250,147,132,279,龜山,甲簡
2020-01-23,7250,157,168,325,龜山,甲簡
2020-01-24,7250,149,163,312,龜山,甲簡
2020-01-25,7250,209,140,349,龜山,甲簡
2020-01-26,7250,140,163,303,龜山,甲簡
2020-01-27,7250,133,157,290,龜山,甲簡
2020-01-28,7250,135,108,243,龜山,甲簡
2020-01-29,7250,104,115,219,龜山,甲簡
2020-01-30,7250,119,105,224,龜山,甲簡
2020-01-31,7250,101,82,183,龜山,甲簡
2020-02-01,7250,99,103,202,龜山,甲簡
2020-02-02,7250,97,79,176,龜山,甲簡
2020-02-03,7250,95,80,175,龜山,甲簡
2020-02-04,7250,64,62,126,龜山,甲簡
2020-02-05,7250,103,86,189,龜山,甲簡
2020-02-06,7250,111,104,215,龜山,甲簡
2020-02-07,7250,101,108,209,龜山,甲簡
2020-02-08,7250,100,98,198,龜山,甲簡
2020-02-09,7250,87,76,163,龜山,甲簡
2020-02-10,7250,66,61,127,龜山,甲簡
2020-02-11,7250,83,80,163,龜山,甲簡
2020-02-12,7250,101,83,184,龜山,甲簡
2020-02-13,7250,78,80,158,龜山,甲簡
2020-02-14,7250,90,80,170,龜山,甲簡
2020-02-15,7250,53,64,117,龜山,甲簡
2020-02-16,7250,113,82,195,龜山,甲簡
2020-02-17,7250,90,99,189,龜山,甲簡
2020-02-18,7250,67,60,127,龜山,甲簡
2020-02-19,7250,58,67,125,龜山,甲簡
2020-02-20,7250,63,54,117,龜山,甲簡
2020-02-21,7250,61,62,123,龜山,甲簡
2020-02-22,7250,79,93,172,龜山,甲簡
2020-02-23,7250,85,79,164,龜山,甲簡
2020-02-24,7250,92,78,170,龜山,甲簡
2020-02-25,7250,79,72,151,龜山,甲簡
2020-02-26,7250,78,87,165,龜山,甲簡
2020-02-27,7250,110,126,236,龜山,甲簡
2020-02-28,7250,54,67,121,龜山,甲簡
2020-02-29,7250,84,88,172,龜山,甲簡
2020-03-01,7250,84,66,150,龜山,甲簡
2020-03-02,7250,104,84,188,龜山,甲簡
2020-03-03,7250,86,88,174,龜山,甲簡
2020-03-04,7250,162,140,302,龜山,甲簡
2020-03-05,7250,122,111,233,龜山,甲簡
2020-03-06,7250,83,86,169,龜山,甲簡
2020-03-07,7250,62,64,126,龜山,甲簡
2020-03-08,7250,59,50,109,龜山,甲簡
2020-03-09,7250,91,89,180,龜山,甲簡
2020-03-10,7250,130,116,246,龜山,甲簡
2020-03-11,7250,126,115,241,龜山,甲簡
2020-03-12,7250,100,93,193,龜山,甲簡
2020-03-13,7250,93,111,204,龜山,甲簡
2020-03-14,7250,94,89,183,龜山,甲簡
2020-03-15,7250,106,86,192,龜山,甲簡
2020-03-16,7250,94,99,193,龜山,甲簡
2020-03-17,7250,97,97,194,龜山,甲簡
2020-03-18,7250,101,95,196,龜山,甲簡
2020-03-19,7250,92,90,182,龜山,甲簡
2020-03-20,7250,100,121,221,龜山,甲簡
2020-03-21,7250,102,87,189,龜山,甲簡
2020-03-22,7250,112,96,208,龜山,甲簡
2020-03-23,7250,109,94,203,龜山,甲簡
2020-03-24,7250,89,89,178,龜山,甲簡
2020-03-25,7250,79,96,175,龜山,甲簡
2020-03-26,7250,80,71,151,龜山,甲簡
2020-03-27,7250,81,103,184,龜山,甲簡
2020-03-28,7250,88,80,168,龜山,甲簡
2020-03-29,7250,65,58,123,龜山,甲簡
2020-03-30,7250,99,99,198,龜山,甲簡
2020-03-31,7250,99,79,178,龜山,甲簡
2020-04-01,7250,116,114,230,龜山,甲簡
2020-04-02,7250,71,99,170,龜山,甲簡
2020-04-03,7250,75,88,163,龜山,甲簡
2020-04-04,7250,104,91,195,龜山,甲簡
2020-04-05,7250,101,54,155,龜山,甲簡
2020-04-06,7250,84,75,159,龜山,甲簡
2020-04-07,7250,93,89,182,龜山,甲簡
2020-04-08,7250,80,79,159,龜山,甲簡
2020-04-09,7250,99,94,193,龜山,甲簡
2020-04-10,7250,85,97,182,龜山,甲簡
2020-04-11,7250,65,56,121,龜山,甲簡
2020-04-12,7250,103,85,188,龜山,甲簡
2020-04-13,7250,104,93,197,龜山,甲簡
2020-04-14,7250,69,73,142,龜山,甲簡
2020-04-15,7250,89,91,180,龜山,甲簡
2020-04-16,7250,74,72,146,龜山,甲簡
2020-04-17,7250,75,79,154,龜山,甲簡
2020-04-18,7250,69,78,147,龜山,甲簡
2020-04-19,7250,96,81,177,龜山,甲簡
2020-04-20,7250,97,78,175,龜山,甲簡
2020-04-21,7250,76,69,145,龜山,甲簡
2020-04-22,7250,97,90,187,龜山,甲簡
2020-04-23,7250,71,71,142,龜山,甲簡
2020-04-24,7250,63,82,145,龜山,甲簡
2020-04-25,7250,44,70,114,龜山,甲簡
2020-04-26,7250,59,30,89,龜山,甲簡
2020-04-27,7250,76,70,146,龜山,甲簡
2020-04-28,7250,89,88,177,龜山,甲簡
2020-04-29,7250,79,73,152,龜山,甲簡
2020-04-30,7250,80,89,169,龜山,甲簡
2020-05-01,7250,92,109,201,龜山,甲簡
2020-05-02,7250,120,132,252,龜山,甲簡
2020-05-03,7250,110,71,181,龜山,甲簡
2020-05-04,7250,90,85,175,龜山,甲簡
2020-05-05,7250,95,78,173,龜山,甲簡
2020-05-06,7250,93,92,185,龜山,甲簡
2020-05-07,7250,69,75,144,龜山,甲簡
2020-05-08,7250,73,79,152,龜山,甲簡
2020-05-09,7250,76,84,160,龜山,甲簡
2020-05-10,7250,103,78,181,龜山,甲簡
2020-05-11,7250,96,87,183,龜山,甲簡
2020-05-12,7250,97,91,188,龜山,甲簡
2020-05-13,7250,88,87,175,龜山,甲簡
2020-05-14,7250,82,82,164,龜山,甲簡
2020-05-15,7250,91,104,195,龜山,甲簡
2020-05-16,7250,75,110,185,龜山,甲簡
2020-05-17,7250,135,127,262,龜山,甲簡
2020-05-18,7250,126,91,217,龜山,甲簡
2020-05-19,7250,98,86,184,龜山,甲簡
2020-05-20,7250,85,86,171,龜山,甲簡
2020-05-21,7250,79,84,163,龜山,甲簡
2020-05-22,7250,94,91,185,龜山,甲簡
2020-05-23,7250,80,87,167,龜山,甲簡
2020-05-24,7250,126,112,238,龜山,甲簡
2020-05-25,7250,94,97,191,龜山,甲簡
2020-05-26,7250,113,90,203,龜山,甲簡
2020-05-27,7250,83,89,172,龜山,甲簡
2020-05-28,7250,76,98,174,龜山,甲簡
2020-05-29,7250,110,97,207,龜山,甲簡
2020-05-30,7250,108,140,248,龜山,甲簡
2020-05-31,7250,104,158,262,龜山,甲簡
2020-06-01,7250,149,77,226,龜山,甲簡
2020-06-02,7250,109,105,214,龜山,甲簡
2020-06-03,7250,98,105,203,龜山,甲簡
2020-06-04,7250,109,83,192,龜山,甲簡
2020-06-05,7250,106,107,213,龜山,甲簡
2020-06-06,7250,106,110,216,龜山,甲簡
2020-06-07,7250,77,50,127,龜山,甲簡
2020-06-08,7250,73,72,145,龜山,甲簡
2020-06-09,7250,76,74,150,龜山,甲簡
2020-06-10,7250,111,98,209,龜山,甲簡
2020-06-11,7250,92,85,177,龜山,甲簡
2020-06-12,7250,93,92,185,龜山,甲簡
2020-06-13,7250,127,203,330,龜山,甲簡
2020-06-14,7250,86,110,196,龜山,甲簡
2020-06-15,7250,117,84,201,龜山,甲簡
2020-06-16,7250,96,99,195,龜山,甲簡
2020-06-17,7250,76,74,150,龜山,甲簡
2020-06-18,7250,77,98,175,龜山,甲簡
2020-06-19,7250,87,114,201,龜山,甲簡
2020-06-20,7250,108,102,210,龜山,甲簡
2020-06-21,7250,101,58,159,龜山,甲簡
2020-06-22,7250,102,73,175,龜山,甲簡
2020-06-23,7250,72,72,144,龜山,甲簡
2020-06-24,7250,78,86,164,龜山,甲簡
2020-06-25,7250,98,126,224,龜山,甲簡
2020-06-26,7250,77,91,168,龜山,甲簡
2020-06-27,7250,134,91,225,龜山,甲簡
2020-06-28,7250,92,50,142,龜山,甲簡
2020-06-29,7250,102,72,174,龜山,甲簡
2020-06-30,7250,90,89,179,龜山,甲簡
2020-07-01,7250,84,85,169,龜山,甲簡
2020-07-02,7250,72,77,149,龜山,甲簡
2020-07-03,7250,70,95,165,龜山,甲簡
2020-07-04,7250,95,100,195,龜山,甲簡
2020-07-05,7250,104,78,182,龜山,甲簡
2020-07-06,7250,112,96,208,龜山,甲簡
2020-07-07,7250,77,80,157,龜山,甲簡
2020-07-08,7250,83,71,154,龜山,甲簡
2020-07-09,7250,86,97,183,龜山,甲簡
2020-07-10,7250,87,86,173,龜山,甲簡
2020-07-11,7250,93,140,233,龜山,甲簡
2020-07-12,7250,136,137,273,龜山,甲簡
2020-07-13,7250,129,88,217,龜山,甲簡
2020-07-14,7250,80,92,172,龜山,甲簡
2020-07-15,7250,109,116,225,龜山,甲簡
2020-07-16,7250,71,75,146,龜山,甲簡
2020-07-17,7250,86,78,164,龜山,甲簡
2020-07-18,7250,67,79,146,龜山,甲簡
2020-07-19,7250,108,79,187,龜山,甲簡
2020-07-20,7250,90,83,173,龜山,甲簡
2020-07-21,7250,96,81,177,龜山,甲簡
2020-07-22,7250,71,70,141,龜山,甲簡
2020-07-23,7250,83,80,163,龜山,甲簡
2020-07-24,7250,67,66,133,龜山,甲簡
2020-07-25,7250,77,79,156,龜山,甲簡
2020-07-26,7250,86,80,166,龜山,甲簡
2020-07-27,7250,77,97,174,龜山,甲簡
2020-07-28,7250,93,97,190,龜山,甲簡
2020-07-29,7250,95,73,168,龜山,甲簡
2020-07-30,7250,90,108,198,龜山,甲簡
2020-07-31,7250,113,128,241,龜山,甲簡
2020-08-01,7250,105,81,186,龜山,甲簡
2020-08-02,7250,166,140,306,龜山,甲簡
2020-08-03,7250,99,100,199,龜山,甲簡
2020-08-04,7250,120,153,273,龜山,甲簡
2020-08-05,7250,143,86,229,龜山,甲簡
2020-08-06,7250,73,69,142,龜山,甲簡
2020-08-07,7250,77,99,176,龜山,甲簡
2020-08-08,7250,81,86,167,龜山,甲簡
2020-08-09,7250,126,78,204,龜山,甲簡
2020-08-10,7250,123,113,236,龜山,甲簡
2020-08-11,7250,106,113,219,龜山,甲簡
2020-08-12,7250,91,75,166,龜山,甲簡
2020-08-13,7250,74,102,176,龜山,甲簡
2020-08-14,7250,100,100,200,龜山,甲簡
2020-08-15,7250,81,76,157,龜山,甲簡
2020-08-16,7250,114,89,203,龜山,甲簡
2020-08-17,7250,109,94,203,龜山,甲簡
2020-08-18,7250,84,90,174,龜山,甲簡
2020-08-19,7250,74,65,139,龜山,甲簡
2020-08-20,7250,89,69,158,龜山,甲簡
2020-08-21,7250,80,85,165,龜山,甲簡
2020-08-22,7250,115,91,206,龜山,甲簡
2020-08-23,7250,88,157,245,龜山,甲簡
2020-08-24,7250,156,75,231,龜山,甲簡
2020-08-25,7250,76,94,170,龜山,甲簡
2020-08-26,7250,98,56,154,龜山,甲簡
2020-08-27,7250,84,79,163,龜山,甲簡
2020-08-28,7250,87,88,175,龜山,甲簡
2020-08-29,7250,94,91,185,龜山,甲簡
2020-08-30,7250,153,141,294,龜山,甲簡
2020-08-31,7250,118,99,217,龜山,甲簡
2020-09-01,7250,103,102,205,龜山,甲簡
2020-09-02,7250,84,81,165,龜山,甲簡
2020-09-03,7250,84,76,160,龜山,甲簡
2020-09-04,7250,93,101,194,龜山,甲簡
2020-09-05,7250,104,108,212,龜山,甲簡
2020-09-06,7250,91,67,158,龜山,甲簡
2020-09-07,7250,82,75,157,龜山,甲簡
2020-09-08,7250,70,57,127,龜山,甲簡
2020-09-09,7250,58,71,129,龜山,甲簡
2020-09-10,7250,64,61,125,龜山,甲簡
2020-09-11,7250,64,80,144,龜山,甲簡
2020-09-12,7250,74,62,136,龜山,甲簡
2020-09-13,7250,111,80,191,龜山,甲簡
2020-09-14,7250,89,73,162,龜山,甲簡
2020-09-15,7250,74,73,147,龜山,甲簡
2020-09-16,7250,66,62,128,龜山,甲簡
2020-09-17,7250,72,70,142,龜山,甲簡
2020-09-18,7250,84,79,163,龜山,甲簡
2020-09-19,7250,67,75,142,龜山,甲簡
2020-09-20,7250,99,68,167,龜山,甲簡
2020-09-21,7250,88,62,150,龜山,甲簡
2020-09-22,7250,76,108,184,龜山,甲簡
2020-09-23,7250,126,75,201,龜山,甲簡
2020-09-24,7250,64,50,114,龜山,甲簡
2020-09-25,7250,79,72,151,龜山,甲簡
2020-09-26,7250,76,90,166,龜山,甲簡
2020-09-27,7250,110,105,215,龜山,甲簡
2020-09-28,7250,121,86,207,龜山,甲簡
2020-09-29,7250,85,78,163,龜山,甲簡
2020-09-30,7250,80,99,179,龜山,甲簡
2020-10-01,7250,148,192,340,龜山,甲簡
2020-10-02,7250,103,78,181,龜山,甲簡
2020-10-03,7250,92,68,160,龜山,甲簡
2020-10-04,7250,95,57,152,龜山,甲簡
2020-10-05,7250,93,71,164,龜山,甲簡
2020-10-06,7250,98,100,198,龜山,甲簡
2020-10-07,7250,82,83,165,龜山,甲簡
2020-10-08,7250,101,103,204,龜山,甲簡
2020-10-09,7250,107,104,211,龜山,甲簡
2020-10-10,7250,83,78,161,龜山,甲簡
2020-10-11,7250,94,52,146,龜山,甲簡
2020-10-12,7250,75,61,136,龜山,甲簡
2020-10-13,7250,77,66,143,龜山,甲簡
2020-10-14,7250,71,72,143,龜山,甲簡
2020-10-15,7250,76,68,144,龜山,甲簡
2020-10-16,7250,86,82,168,龜山,甲簡
2020-10-17,7250,77,91,168,龜山,甲簡
2020-10-18,7250,81,49,130,龜山,甲簡
2020-10-19,7250,92,67,159,龜山,甲簡
2020-10-20,7250,74,64,138,龜山,甲簡
2020-10-21,7250,69,103,172,龜山,甲簡
2020-10-22,7250,70,82,152,龜山,甲簡
2020-10-23,7250,83,101,184,龜山,甲簡
2020-10-24,7250,92,93,185,龜山,甲簡
2020-10-25,7250,87,105,192,龜山,甲簡
2020-10-26,7250,128,115,243,龜山,甲簡
2020-10-27,7250,75,67,142,龜山,甲簡
2020-10-28,7250,82,81,163,龜山,甲簡
2020-10-29,7250,75,71,146,龜山,甲簡
2020-10-30,7250,75,84,159,龜山,甲簡
2020-10-31,7250,85,71,156,龜山,甲簡
2020-11-01,7250,82,66,148,龜山,甲簡
2020-11-02,7250,91,85,176,龜山,甲簡
2020-11-03,7250,110,86,196,龜山,甲簡
2020-11-04,7250,94,100,194,龜山,甲簡
2020-11-05,7250,60,85,145,龜山,甲簡
2020-11-06,7250,150,128,278,龜山,甲簡
2020-11-07,7250,60,62,122,龜山,甲簡
2020-11-08,7250,95,62,157,龜山,甲簡
2020-11-09,7250,84,77,161,龜山,甲簡
2020-11-10,7250,77,117,194,龜山,甲簡
2020-11-11,7250,117,60,177,龜山,甲簡
2020-11-12,7250,65,67,132,龜山,甲簡
2020-11-13,7250,68,97,165,龜山,甲簡
2020-11-14,7250,100,98,198,龜山,甲簡
2020-11-15,7250,129,105,234,龜山,甲簡
2020-11-16,7250,103,78,181,龜山,甲簡
2020-11-17,7250,96,91,187,龜山,甲簡
2020-11-18,7250,63,66,129,龜山,甲簡
2020-11-19,7250,71,73,144,龜山,甲簡
2020-11-20,7250,74,85,159,龜山,甲簡
2020-11-21,7250,84,57,141,龜山,甲簡
2020-11-22,7250,97,76,173,龜山,甲簡
2020-11-23,7250,158,133,291,龜山,甲簡
2020-11-24,7250,75,81,156,龜山,甲簡
2020-11-25,7250,90,86,176,龜山,甲簡
2020-11-26,7250,67,55,122,龜山,甲簡
2020-11-27,7250,76,78,154,龜山,甲簡
2020-11-28,7250,97,86,183,龜山,甲簡
2020-11-29,7250,112,82,194,龜山,甲簡
2020-11-30,7250,91,80,171,龜山,甲簡
2020-12-01,7250,84,80,164,龜山,甲簡
2020-12-02,7250,103,97,200,龜山,甲簡
2020-12-03,7250,100,93,193,龜山,甲簡
2020-12-04,7250,115,92,207,龜山,甲簡
2020-12-05,7250,70,61,131,龜山,甲簡
2020-12-06,7250,60,54,114,龜山,甲簡
2020-12-07,7250,61,67,128,龜山,甲簡
2020-12-08,7250,66,61,127,龜山,甲簡
2020-12-09,7250,43,42,85,龜山,甲簡
2020-12-10,7250,43,42,85,龜山,甲簡
2020-12-11,7250,55,65,120,龜山,甲簡
2020-12-12,7250,47,55,102,龜山,甲簡
2020-12-13,7250,56,40,96,龜山,甲簡
2020-12-14,7250,89,77,166,龜山,甲簡
2020-12-15,7250,72,60,132,龜山,甲簡
2020-12-16,7250,68,66,134,龜山,甲簡
2020-12-17,7250,56,61,117,龜山,甲簡
2020-12-18,7250,83,91,174,龜山,甲簡
2020-12-19,7250,65,66,131,龜山,甲簡
2020-12-20,7250,103,78,181,龜山,甲簡
2020-12-21,7250,63,50,113,龜山,甲簡
2020-12-22,7250,53,103,156,龜山,甲簡
2020-12-23,7250,111,66,177,龜山,甲簡
2020-12-24,7250,89,66,155,龜山,甲簡
2020-12-25,7250,62,73,135,龜山,甲簡
2020-12-26,7250,46,46,92,龜山,甲簡
2020-12-27,7250,74,85,159,龜山,甲簡
2020-12-28,7250,70,69,139,龜山,甲簡
2020-12-29,7250,82,73,155,龜山,甲簡
2020-12-30,7250,73,66,139,龜山,甲簡
2020-12-31,7250,105,127,232,龜山,甲簡
2020-01-01,7260,196,222,418,大溪,簡易
2020-01-02,7260,219,234,453,大溪,簡易
2020-01-03,7260,196,247,443,大溪,簡易
2020-01-04,7260,301,285,586,大溪,簡易
2020-01-05,7260,231,225,456,大溪,簡易
2020-01-06,7260,239,234,473,大溪,簡易
2020-01-07,7260,215,239,454,大溪,簡易
2020-01-08,7260,216,255,471,大溪,簡易
2020-01-09,7260,192,213,405,大溪,簡易
2020-01-10,7260,196,235,431,大溪,簡易
2020-01-11,7260,225,289,514,大溪,簡易
2020-01-12,7260,241,197,438,大溪,簡易
2020-01-13,7260,202,209,411,大溪,簡易
2020-01-14,7260,185,204,389,大溪,簡易
2020-01-15,7260,190,210,400,大溪,簡易
2020-01-16,7260,204,239,443,大溪,簡易
2020-01-17,7260,157,207,364,大溪,簡易
2020-01-18,7260,174,202,376,大溪,簡易
2020-01-19,7260,169,182,351,大溪,簡易
2020-01-20,7260,207,230,437,大溪,簡易
2020-01-21,7260,210,200,410,大溪,簡易
2020-01-22,7260,205,216,421,大溪,簡易
2020-01-23,7260,214,305,519,大溪,簡易
2020-01-24,7260,188,232,420,大溪,簡易
2020-01-25,7260,312,281,593,大溪,簡易
2020-01-26,7260,230,296,526,大溪,簡易
2020-01-27,7260,280,315,595,大溪,簡易
2020-01-28,7260,224,234,458,大溪,簡易
2020-01-29,7260,201,177,378,大溪,簡易
2020-01-30,7260,159,175,334,大溪,簡易
2020-01-31,7260,140,172,312,大溪,簡易
2020-02-01,7260,139,210,349,大溪,簡易
2020-02-02,7260,249,293,542,大溪,簡易
2020-02-03,7260,206,173,379,大溪,簡易
2020-02-04,7260,169,159,328,大溪,簡易
2020-02-05,7260,162,149,311,大溪,簡易
2020-02-06,7260,167,179,346,大溪,簡易
2020-02-07,7260,185,219,404,大溪,簡易
2020-02-08,7260,223,226,449,大溪,簡易
2020-02-09,7260,185,126,311,大溪,簡易
2020-02-10,7260,197,187,384,大溪,簡易
2020-02-11,7260,192,195,387,大溪,簡易
2020-02-12,7260,204,204,408,大溪,簡易
2020-02-13,7260,200,188,388,大溪,簡易
2020-02-14,7260,181,206,387,大溪,簡易
2020-02-15,7260,168,164,332,大溪,簡易
2020-02-16,7260,174,140,314,大溪,簡易
2020-02-17,7260,208,244,452,大溪,簡易
2020-02-18,7260,149,149,298,大溪,簡易
2020-02-19,7260,176,162,338,大溪,簡易
2020-02-20,7260,159,158,317,大溪,簡易
2020-02-21,7260,128,137,265,大溪,簡易
2020-02-22,7260,192,189,381,大溪,簡易
2020-02-23,7260,205,177,382,大溪,簡易
2020-02-24,7260,168,164,332,大溪,簡易
2020-02-25,7260,178,214,392,大溪,簡易
2020-02-26,7260,163,179,342,大溪,簡易
2020-02-27,7260,237,238,475,大溪,簡易
2020-02-28,7260,180,259,439,大溪,簡易
2020-02-29,7260,315,302,617,大溪,簡易
2020-03-01,7260,220,125,345,大溪,簡易
2020-03-02,7260,254,258,512,大溪,簡易
2020-03-03,7260,159,179,338,大溪,簡易
2020-03-04,7260,201,203,404,大溪,簡易
2020-03-05,7260,229,262,491,大溪,簡易
2020-03-06,7260,155,192,347,大溪,簡易
2020-03-07,7260,222,262,484,大溪,簡易
2020-03-08,7260,172,152,324,大溪,簡易
2020-03-09,7260,184,201,385,大溪,簡易
2020-03-10,7260,219,208,427,大溪,簡易
2020-03-11,7260,188,199,387,大溪,簡易
2020-03-12,7260,144,161,305,大溪,簡易
2020-03-13,7260,158,193,351,大溪,簡易
2020-03-14,7260,188,235,423,大溪,簡易
2020-03-15,7260,185,180,365,大溪,簡易
2020-03-16,7260,172,177,349,大溪,簡易
2020-03-17,7260,176,208,384,大溪,簡易
2020-03-18,7260,162,184,346,大溪,簡易
2020-03-19,7260,146,163,309,大溪,簡易
2020-03-20,7260,174,218,392,大溪,簡易
2020-03-21,7260,265,270,535,大溪,簡易
2020-03-22,7260,213,205,418,大溪,簡易
2020-03-23,7260,176,173,349,大溪,簡易
2020-03-24,7260,161,174,335,大溪,簡易
2020-03-25,7260,174,188,362,大溪,簡易
2020-03-26,7260,179,198,377,大溪,簡易
2020-03-27,7260,155,191,346,大溪,簡易
2020-03-28,7260,131,144,275,大溪,簡易
2020-03-29,7260,239,204,443,大溪,簡易
2020-03-30,7260,194,200,394,大溪,簡易
2020-03-31,7260,153,169,322,大溪,簡易
2020-04-01,7260,229,263,492,大溪,簡易
2020-04-02,7260,122,174,296,大溪,簡易
2020-04-03,7260,163,205,368,大溪,簡易
2020-04-04,7260,203,182,385,大溪,簡易
2020-04-05,7260,165,178,343,大溪,簡易
2020-04-06,7260,174,172,346,大溪,簡易
2020-04-07,7260,155,183,338,大溪,簡易
2020-04-08,7260,165,182,347,大溪,簡易
2020-04-09,7260,170,185,355,大溪,簡易
2020-04-10,7260,166,205,371,大溪,簡易
2020-04-11,7260,144,211,355,大溪,簡易
2020-04-12,7260,161,166,327,大溪,簡易
2020-04-13,7260,190,218,408,大溪,簡易
2020-04-14,7260,181,187,368,大溪,簡易
2020-04-15,7260,250,258,508,大溪,簡易
2020-04-16,7260,151,191,342,大溪,簡易
2020-04-17,7260,201,213,414,大溪,簡易
2020-04-18,7260,259,394,653,大溪,簡易
2020-04-19,7260,237,286,523,大溪,簡易
2020-04-20,7260,174,180,354,大溪,簡易
2020-04-21,7260,141,128,269,大溪,簡易
2020-04-22,7260,202,204,406,大溪,簡易
2020-04-23,7260,140,180,320,大溪,簡易
2020-04-24,7260,139,195,334,大溪,簡易
2020-04-25,7260,99,142,241,大溪,簡易
2020-04-26,7260,144,134,278,大溪,簡易
2020-04-27,7260,150,163,313,大溪,簡易
2020-04-28,7260,161,178,339,大溪,簡易
2020-04-29,7260,177,187,364,大溪,簡易
2020-04-30,7260,185,233,418,大溪,簡易
2020-05-01,7260,293,362,655,大溪,簡易
2020-05-02,7260,345,449,794,大溪,簡易
2020-05-03,7260,320,275,595,大溪,簡易
2020-05-04,7260,233,236,469,大溪,簡易
2020-05-05,7260,169,190,359,大溪,簡易
2020-05-06,7260,180,201,381,大溪,簡易
2020-05-07,7260,175,179,354,大溪,簡易
2020-05-08,7260,184,236,420,大溪,簡易
2020-05-09,7260,227,280,507,大溪,簡易
2020-05-10,7260,218,198,416,大溪,簡易
2020-05-11,7260,156,165,321,大溪,簡易
2020-05-12,7260,191,227,418,大溪,簡易
2020-05-13,7260,192,209,401,大溪,簡易
2020-05-14,7260,194,217,411,大溪,簡易
2020-05-15,7260,173,268,441,大溪,簡易
2020-05-16,7260,188,253,441,大溪,簡易
2020-05-17,7260,251,234,485,大溪,簡易
2020-05-18,7260,182,205,387,大溪,簡易
2020-05-19,7260,144,166,310,大溪,簡易
2020-05-20,7260,157,175,332,大溪,簡易
2020-05-21,7260,145,148,293,大溪,簡易
2020-05-22,7260,176,242,418,大溪,簡易
2020-05-23,7260,173,174,347,大溪,簡易
2020-05-24,7260,262,261,523,大溪,簡易
2020-05-25,7260,164,187,351,大溪,簡易
2020-05-26,7260,169,188,357,大溪,簡易
2020-05-27,7260,154,179,333,大溪,簡易
2020-05-28,7260,136,142,278,大溪,簡易
2020-05-29,7260,163,210,373,大溪,簡易
2020-05-30,7260,196,239,435,大溪,簡易
2020-05-31,7260,234,220,454,大溪,簡易
2020-06-01,7260,186,187,373,大溪,簡易
2020-06-02,7260,189,215,404,大溪,簡易
2020-06-03,7260,186,210,396,大溪,簡易
2020-06-04,7260,195,215,410,大溪,簡易
2020-06-05,7260,177,202,379,大溪,簡易
2020-06-06,7260,260,277,537,大溪,簡易
2020-06-07,7260,207,170,377,大溪,簡易
2020-06-08,7260,179,181,360,大溪,簡易
2020-06-09,7260,179,194,373,大溪,簡易
2020-06-10,7260,185,204,389,大溪,簡易
2020-06-11,7260,206,231,437,大溪,簡易
2020-06-12,7260,219,242,461,大溪,簡易
2020-06-13,7260,288,367,655,大溪,簡易
2020-06-14,7260,286,263,549,大溪,簡易
2020-06-15,7260,174,173,347,大溪,簡易
2020-06-16,7260,180,213,393,大溪,簡易
2020-06-17,7260,175,196,371,大溪,簡易
2020-06-18,7260,192,234,426,大溪,簡易
2020-06-19,7260,218,238,456,大溪,簡易
2020-06-20,7260,242,246,488,大溪,簡易
2020-06-21,7260,228,257,485,大溪,簡易
2020-06-22,7260,206,227,433,大溪,簡易
2020-06-23,7260,172,189,361,大溪,簡易
2020-06-24,7260,193,233,426,大溪,簡易
2020-06-25,7260,227,361,588,大溪,簡易
2020-06-26,7260,286,345,631,大溪,簡易
2020-06-27,7260,341,312,653,大溪,簡易
2020-06-28,7260,247,187,434,大溪,簡易
2020-06-29,7260,183,190,373,大溪,簡易
2020-06-30,7260,151,174,325,大溪,簡易
2020-07-01,7260,167,205,372,大溪,簡易
2020-07-02,7260,195,179,374,大溪,簡易
2020-07-03,7260,192,219,411,大溪,簡易
2020-07-04,7260,244,288,532,大溪,簡易
2020-07-05,7260,228,205,433,大溪,簡易
2020-07-06,7260,179,185,364,大溪,簡易
2020-07-07,7260,175,182,357,大溪,簡易
2020-07-08,7260,174,185,359,大溪,簡易
2020-07-09,7260,222,220,442,大溪,簡易
2020-07-10,7260,189,231,420,大溪,簡易
2020-07-11,7260,227,238,465,大溪,簡易
2020-07-12,7260,231,212,443,大溪,簡易
2020-07-13,7260,205,213,418,大溪,簡易
2020-07-14,7260,188,213,401,大溪,簡易
2020-07-15,7260,212,238,450,大溪,簡易
2020-07-16,7260,191,200,391,大溪,簡易
2020-07-17,7260,149,192,341,大溪,簡易
2020-07-18,7260,291,297,588,大溪,簡易
2020-07-19,7260,253,230,483,大溪,簡易
2020-07-20,7260,202,216,418,大溪,簡易
2020-07-21,7260,145,154,299,大溪,簡易
2020-07-22,7260,140,181,321,大溪,簡易
2020-07-23,7260,166,169,335,大溪,簡易
2020-07-24,7260,157,174,331,大溪,簡易
2020-07-25,7260,226,258,484,大溪,簡易
2020-07-26,7260,246,210,456,大溪,簡易
2020-07-27,7260,181,186,367,大溪,簡易
2020-07-28,7260,170,172,342,大溪,簡易
2020-07-29,7260,194,186,380,大溪,簡易
2020-07-30,7260,180,191,371,大溪,簡易
2020-07-31,7260,187,224,411,大溪,簡易
2020-08-01,7260,251,300,551,大溪,簡易
2020-08-02,7260,275,231,506,大溪,簡易
2020-08-03,7260,207,219,426,大溪,簡易
2020-08-04,7260,196,227,423,大溪,簡易
2020-08-05,7260,200,233,433,大溪,簡易
2020-08-06,7260,169,183,352,大溪,簡易
2020-08-07,7260,222,259,481,大溪,簡易
2020-08-08,7260,247,299,546,大溪,簡易
2020-08-09,7260,270,233,503,大溪,簡易
2020-08-10,7260,157,176,333,大溪,簡易
2020-08-11,7260,197,217,414,大溪,簡易
2020-08-12,7260,157,170,327,大溪,簡易
2020-08-13,7260,156,190,346,大溪,簡易
2020-08-14,7260,157,203,360,大溪,簡易
2020-08-15,7260,254,275,529,大溪,簡易
2020-08-16,7260,286,295,581,大溪,簡易
2020-08-17,7260,174,227,401,大溪,簡易
2020-08-18,7260,170,168,338,大溪,簡易
2020-08-19,7260,173,186,359,大溪,簡易
2020-08-20,7260,171,182,353,大溪,簡易
2020-08-21,7260,197,246,443,大溪,簡易
2020-08-22,7260,257,248,505,大溪,簡易
2020-08-23,7260,246,269,515,大溪,簡易
2020-08-24,7260,163,176,339,大溪,簡易
2020-08-25,7260,184,168,352,大溪,簡易
2020-08-26,7260,215,216,431,大溪,簡易
2020-08-27,7260,126,165,291,大溪,簡易
2020-08-28,7260,162,196,358,大溪,簡易
2020-08-29,7260,222,227,449,大溪,簡易
2020-08-30,7260,267,261,528,大溪,簡易
2020-08-31,7260,229,249,478,大溪,簡易
2020-09-01,7260,240,289,529,大溪,簡易
2020-09-02,7260,232,258,490,大溪,簡易
2020-09-03,7260,171,166,337,大溪,簡易
2020-09-04,7260,220,226,446,大溪,簡易
2020-09-05,7260,239,300,539,大溪,簡易
2020-09-06,7260,304,282,586,大溪,簡易
2020-09-07,7260,225,218,443,大溪,簡易
2020-09-08,7260,195,200,395,大溪,簡易
2020-09-09,7260,168,185,353,大溪,簡易
2020-09-10,7260,167,189,356,大溪,簡易
2020-09-11,7260,187,219,406,大溪,簡易
2020-09-12,7260,214,234,448,大溪,簡易
2020-09-13,7260,279,303,582,大溪,簡易
2020-09-14,7260,187,186,373,大溪,簡易
2020-09-15,7260,207,210,417,大溪,簡易
2020-09-16,7260,183,198,381,大溪,簡易
2020-09-17,7260,202,220,422,大溪,簡易
2020-09-18,7260,224,267,491,大溪,簡易
2020-09-19,7260,220,364,584,大溪,簡易
2020-09-20,7260,289,220,509,大溪,簡易
2020-09-21,7260,187,197,384,大溪,簡易
2020-09-22,7260,223,199,422,大溪,簡易
2020-09-23,7260,175,202,377,大溪,簡易
2020-09-24,7260,183,193,376,大溪,簡易
2020-09-25,7260,193,214,407,大溪,簡易
2020-09-26,7260,295,288,583,大溪,簡易
2020-09-27,7260,169,171,340,大溪,簡易
2020-09-28,7260,175,157,332,大溪,簡易
2020-09-29,7260,171,181,352,大溪,簡易
2020-09-30,7260,189,267,456,大溪,簡易
2020-10-01,7260,304,420,724,大溪,簡易
2020-10-02,7260,463,511,974,大溪,簡易
2020-10-03,7260,435,426,861,大溪,簡易
2020-10-04,7260,352,267,619,大溪,簡易
2020-10-05,7260,231,225,456,大溪,簡易
2020-10-06,7260,266,267,533,大溪,簡易
2020-10-07,7260,226,259,485,大溪,簡易
2020-10-08,7260,226,272,498,大溪,簡易
2020-10-09,7260,367,416,783,大溪,簡易
2020-10-10,7260,297,279,576,大溪,簡易
2020-10-11,7260,239,174,413,大溪,簡易
2020-10-12,7260,202,217,419,大溪,簡易
2020-10-13,7260,191,189,380,大溪,簡易
2020-10-14,7260,236,212,448,大溪,簡易
2020-10-15,7260,189,209,398,大溪,簡易
2020-10-16,7260,239,266,505,大溪,簡易
2020-10-17,7260,200,235,435,大溪,簡易
2020-10-18,7260,217,250,467,大溪,簡易
2020-10-19,7260,193,199,392,大溪,簡易
2020-10-20,7260,206,200,406,大溪,簡易
2020-10-21,7260,195,191,386,大溪,簡易
2020-10-22,7260,203,192,395,大溪,簡易
2020-10-23,7260,271,333,604,大溪,簡易
2020-10-24,7260,316,402,718,大溪,簡易
2020-10-25,7260,346,276,622,大溪,簡易
2020-10-26,7260,254,223,477,大溪,簡易
2020-10-27,7260,252,225,477,大溪,簡易
2020-10-28,7260,222,216,438,大溪,簡易
2020-10-29,7260,202,177,379,大溪,簡易
2020-10-30,7260,243,279,522,大溪,簡易
2020-10-31,7260,577,468,1045,大溪,簡易
2020-11-01,7260,382,375,757,大溪,簡易
2020-11-02,7260,257,266,523,大溪,簡易
2020-11-03,7260,268,253,521,大溪,簡易
2020-11-04,7260,273,255,528,大溪,簡易
2020-11-05,7260,258,222,480,大溪,簡易
2020-11-06,7260,205,251,456,大溪,簡易
2020-11-07,7260,334,404,738,大溪,簡易
2020-11-08,7260,253,229,482,大溪,簡易
2020-11-09,7260,217,213,430,大溪,簡易
2020-11-10,7260,239,236,475,大溪,簡易
2020-11-11,7260,202,202,404,大溪,簡易
2020-11-12,7260,207,182,389,大溪,簡易
2020-11-13,7260,158,225,383,大溪,簡易
2020-11-14,7260,250,270,520,大溪,簡易
2020-11-15,7260,519,604,1123,大溪,簡易
2020-11-16,7260,238,222,460,大溪,簡易
2020-11-17,7260,208,243,451,大溪,簡易
2020-11-18,7260,291,278,569,大溪,簡易
2020-11-19,7260,346,374,720,大溪,簡易
2020-11-20,7260,271,344,615,大溪,簡易
2020-11-21,7260,391,362,753,大溪,簡易
2020-11-22,7260,510,539,1049,大溪,簡易
2020-11-23,7260,216,236,452,大溪,簡易
2020-11-24,7260,197,219,416,大溪,簡易
2020-11-25,7260,223,232,455,大溪,簡易
2020-11-26,7260,269,247,516,大溪,簡易
2020-11-27,7260,191,234,425,大溪,簡易
2020-11-28,7260,204,246,450,大溪,簡易
2020-11-29,7260,214,147,361,大溪,簡易
2020-11-30,7260,172,200,372,大溪,簡易
2020-12-01,7260,225,230,455,大溪,簡易
2020-12-02,7260,239,211,450,大溪,簡易
2020-12-03,7260,166,213,379,大溪,簡易
2020-12-04,7260,140,129,269,大溪,簡易
2020-12-05,7260,83,143,226,大溪,簡易
2020-12-06,7260,98,84,182,大溪,簡易
2020-12-07,7260,131,168,299,大溪,簡易
2020-12-08,7260,141,141,282,大溪,簡易
2020-12-09,7260,112,150,262,大溪,簡易
2020-12-10,7260,103,152,255,大溪,簡易
2020-12-11,7260,141,170,311,大溪,簡易
2020-12-12,7260,108,153,261,大溪,簡易
2020-12-13,7260,144,139,283,大溪,簡易
2020-12-14,7260,159,176,335,大溪,簡易
2020-12-15,7260,193,210,403,大溪,簡易
2020-12-16,7260,171,152,323,大溪,簡易
2020-12-17,7260,179,182,361,大溪,簡易
2020-12-18,7260,162,199,361,大溪,簡易
2020-12-19,7260,178,217,395,大溪,簡易
2020-12-20,7260,198,185,383,大溪,簡易
2020-12-21,7260,153,168,321,大溪,簡易
2020-12-22,7260,149,140,289,大溪,簡易
2020-12-23,7260,157,168,325,大溪,簡易
2020-12-24,7260,192,236,428,大溪,簡易
2020-12-25,7260,172,197,369,大溪,簡易
2020-12-26,7260,170,205,375,大溪,簡易
2020-12-27,7260,248,190,438,大溪,簡易
2020-12-28,7260,172,195,367,大溪,簡易
2020-12-29,7260,202,224,426,大溪,簡易
2020-12-30,7260,174,181,355,大溪,簡易
2020-12-31,7260,237,259,496,大溪,簡易
2020-01-01,7270,237,152,389,大里,甲簡
2020-01-02,7270,112,100,212,大里,甲簡
2020-01-03,7270,144,109,253,大里,甲簡
2020-01-04,7270,439,216,655,大里,甲簡
2020-01-05,7270,482,222,704,大里,甲簡
2020-01-06,7270,129,120,249,大里,甲簡
2020-01-07,7270,186,121,307,大里,甲簡
2020-01-08,7270,112,103,215,大里,甲簡
2020-01-09,7270,113,111,224,大里,甲簡
2020-01-10,7270,120,92,212,大里,甲簡
2020-01-11,7270,191,142,333,大里,甲簡
2020-01-12,7270,133,116,249,大里,甲簡
2020-01-13,7270,104,101,205,大里,甲簡
2020-01-14,7270,90,89,179,大里,甲簡
2020-01-15,7270,91,90,181,大里,甲簡
2020-01-16,7270,136,100,236,大里,甲簡
2020-01-17,7270,156,127,283,大里,甲簡
2020-01-18,7270,150,89,239,大里,甲簡
2020-01-19,7270,134,109,243,大里,甲簡
2020-01-20,7270,116,104,220,大里,甲簡
2020-01-21,7270,182,106,288,大里,甲簡
2020-01-22,7270,156,105,261,大里,甲簡
2020-01-23,7270,158,121,279,大里,甲簡
2020-01-24,7270,121,126,247,大里,甲簡
2020-01-25,7270,1872,1753,3625,大里,甲簡
2020-01-26,7270,499,443,942,大里,甲簡
2020-01-27,7270,921,846,1767,大里,甲簡
2020-01-28,7270,829,760,1589,大里,甲簡
2020-01-29,7270,437,396,833,大里,甲簡
2020-01-30,7270,419,374,793,大里,甲簡
2020-01-31,7270,365,338,703,大里,甲簡
2020-02-01,7270,826,793,1619,大里,甲簡
2020-02-02,7270,2464,2162,4626,大里,甲簡
2020-02-03,7270,240,219,459,大里,甲簡
2020-02-04,7270,117,92,209,大里,甲簡
2020-02-05,7270,107,93,200,大里,甲簡
2020-02-06,7270,92,89,181,大里,甲簡
2020-02-07,7270,99,101,200,大里,甲簡
2020-02-08,7270,108,124,232,大里,甲簡
2020-02-09,7270,184,116,300,大里,甲簡
2020-02-10,7270,113,92,205,大里,甲簡
2020-02-11,7270,147,86,233,大里,甲簡
2020-02-12,7270,219,160,379,大里,甲簡
2020-02-13,7270,116,99,215,大里,甲簡
2020-02-14,7270,94,86,180,大里,甲簡
2020-02-15,7270,202,150,352,大里,甲簡
2020-02-16,7270,105,80,185,大里,甲簡
2020-02-17,7270,83,68,151,大里,甲簡
2020-02-18,7270,131,80,211,大里,甲簡
2020-02-19,7270,119,89,208,大里,甲簡
2020-02-20,7270,122,105,227,大里,甲簡
2020-02-21,7270,119,135,254,大里,甲簡
2020-02-22,7270,248,120,368,大里,甲簡
2020-02-23,7270,248,126,374,大里,甲簡
2020-02-24,7270,104,107,211,大里,甲簡
2020-02-25,7270,169,100,269,大里,甲簡
2020-02-26,7270,102,89,191,大里,甲簡
2020-02-27,7270,71,79,150,大里,甲簡
2020-02-28,7270,431,188,619,大里,甲簡
2020-02-29,7270,624,252,876,大里,甲簡
2020-03-01,7270,187,85,272,大里,甲簡
2020-03-02,7270,71,75,146,大里,甲簡
2020-03-03,7270,80,75,155,大里,甲簡
2020-03-04,7270,85,92,177,大里,甲簡
2020-03-05,7270,68,64,132,大里,甲簡
2020-03-06,7270,86,95,181,大里,甲簡
2020-03-07,7270,436,242,678,大里,甲簡
2020-03-08,7270,245,151,396,大里,甲簡
2020-03-09,7270,129,95,224,大里,甲簡
2020-03-10,7270,50,62,112,大里,甲簡
2020-03-11,7270,81,82,163,大里,甲簡
2020-03-12,7270,78,66,144,大里,甲簡
2020-03-13,7270,73,82,155,大里,甲簡
2020-03-14,7270,102,107,209,大里,甲簡
2020-03-15,7270,431,236,667,大里,甲簡
2020-03-16,7270,119,93,212,大里,甲簡
2020-03-17,7270,105,94,199,大里,甲簡
2020-03-18,7270,81,85,166,大里,甲簡
2020-03-19,7270,55,72,127,大里,甲簡
2020-03-20,7270,87,87,174,大里,甲簡
2020-03-21,7270,422,190,612,大里,甲簡
2020-03-22,7270,371,166,537,大里,甲簡
2020-03-23,7270,81,62,143,大里,甲簡
2020-03-24,7270,71,65,136,大里,甲簡
2020-03-25,7270,60,60,120,大里,甲簡
2020-03-26,7270,128,70,198,大里,甲簡
2020-03-27,7270,87,101,188,大里,甲簡
2020-03-28,7270,76,87,163,大里,甲簡
2020-03-29,7270,228,146,374,大里,甲簡
2020-03-30,7270,89,85,174,大里,甲簡
2020-03-31,7270,59,62,121,大里,甲簡
2020-04-01,7270,79,87,166,大里,甲簡
2020-04-02,7270,88,98,186,大里,甲簡
2020-04-03,7270,194,123,317,大里,甲簡
2020-04-04,7270,124,86,210,大里,甲簡
2020-04-05,7270,228,74,302,大里,甲簡
2020-04-06,7270,76,57,133,大里,甲簡
2020-04-07,7270,58,60,118,大里,甲簡
2020-04-08,7270,68,62,130,大里,甲簡
2020-04-09,7270,67,84,151,大里,甲簡
2020-04-10,7270,117,80,197,大里,甲簡
2020-04-11,7270,305,173,478,大里,甲簡
2020-04-12,7270,84,57,141,大里,甲簡
2020-04-13,7270,106,91,197,大里,甲簡
2020-04-14,7270,102,66,168,大里,甲簡
2020-04-15,7270,183,106,289,大里,甲簡
2020-04-16,7270,178,101,279,大里,甲簡
2020-04-17,7270,172,117,289,大里,甲簡
2020-04-18,7270,662,247,909,大里,甲簡
2020-04-19,7270,479,194,673,大里,甲簡
2020-04-20,7270,102,104,206,大里,甲簡
2020-04-21,7270,89,72,161,大里,甲簡
2020-04-22,7270,66,63,129,大里,甲簡
2020-04-23,7270,53,61,114,大里,甲簡
2020-04-24,7270,52,70,122,大里,甲簡
2020-04-25,7270,105,80,185,大里,甲簡
2020-04-26,7270,141,60,201,大里,甲簡
2020-04-27,7270,69,58,127,大里,甲簡
2020-04-28,7270,94,75,169,大里,甲簡
2020-04-29,7270,202,116,318,大里,甲簡
2020-04-30,7270,183,116,299,大里,甲簡
2020-05-01,7270,711,226,937,大里,甲簡
2020-05-02,7270,617,263,880,大里,甲簡
2020-05-03,7270,340,182,522,大里,甲簡
2020-05-04,7270,120,112,232,大里,甲簡
2020-05-05,7270,102,73,175,大里,甲簡
2020-05-06,7270,93,88,181,大里,甲簡
2020-05-07,7270,99,71,170,大里,甲簡
2020-05-08,7270,132,110,242,大里,甲簡
2020-05-09,7270,338,177,515,大里,甲簡
2020-05-10,7270,197,115,312,大里,甲簡
2020-05-11,7270,77,71,148,大里,甲簡
2020-05-12,7270,93,91,184,大里,甲簡
2020-05-13,7270,133,111,244,大里,甲簡
2020-05-14,7270,122,83,205,大里,甲簡
2020-05-15,7270,141,90,231,大里,甲簡
2020-05-16,7270,409,175,584,大里,甲簡
2020-05-17,7270,145,108,253,大里,甲簡
2020-05-18,7270,76,69,145,大里,甲簡
2020-05-19,7270,46,58,104,大里,甲簡
2020-05-20,7270,85,85,170,大里,甲簡
2020-05-21,7270,62,70,132,大里,甲簡
2020-05-22,7270,70,65,135,大里,甲簡
2020-05-23,7270,105,92,197,大里,甲簡
2020-05-24,7270,169,143,312,大里,甲簡
2020-05-25,7270,75,69,144,大里,甲簡
2020-05-26,7270,109,69,178,大里,甲簡
2020-05-27,7270,65,77,142,大里,甲簡
2020-05-28,7270,53,62,115,大里,甲簡
2020-05-29,7270,77,73,150,大里,甲簡
2020-05-30,7270,252,150,402,大里,甲簡
2020-05-31,7270,241,174,415,大里,甲簡
2020-06-01,7270,82,79,161,大里,甲簡
2020-06-02,7270,83,90,173,大里,甲簡
2020-06-03,7270,116,121,237,大里,甲簡
2020-06-04,7270,133,112,245,大里,甲簡
2020-06-05,7270,101,88,189,大里,甲簡
2020-06-06,7270,296,243,539,大里,甲簡
2020-06-07,7270,228,187,415,大里,甲簡
2020-06-08,7270,76,85,161,大里,甲簡
2020-06-09,7270,132,86,218,大里,甲簡
2020-06-10,7270,87,86,173,大里,甲簡
2020-06-11,7270,110,66,176,大里,甲簡
2020-06-12,7270,127,113,240,大里,甲簡
2020-06-13,7270,375,206,581,大里,甲簡
2020-06-14,7270,231,159,390,大里,甲簡
2020-06-15,7270,75,71,146,大里,甲簡
2020-06-16,7270,95,79,174,大里,甲簡
2020-06-17,7270,87,74,161,大里,甲簡
2020-06-18,7270,92,84,176,大里,甲簡
2020-06-19,7270,95,81,176,大里,甲簡
2020-06-20,7270,194,129,323,大里,甲簡
2020-06-21,7270,275,130,405,大里,甲簡
2020-06-22,7270,98,84,182,大里,甲簡
2020-06-23,7270,95,93,188,大里,甲簡
2020-06-24,7270,127,88,215,大里,甲簡
2020-06-25,7270,274,188,462,大里,甲簡
2020-06-26,7270,427,291,718,大里,甲簡
2020-06-27,7270,413,239,652,大里,甲簡
2020-06-28,7270,174,115,289,大里,甲簡
2020-06-29,7270,95,102,197,大里,甲簡
2020-06-30,7270,101,95,196,大里,甲簡
2020-07-01,7270,90,75,165,大里,甲簡
2020-07-02,7270,84,81,165,大里,甲簡
2020-07-03,7270,85,85,170,大里,甲簡
2020-07-04,7270,239,179,418,大里,甲簡
2020-07-05,7270,198,142,340,大里,甲簡
2020-07-06,7270,117,108,225,大里,甲簡
2020-07-07,7270,94,88,182,大里,甲簡
2020-07-08,7270,94,94,188,大里,甲簡
2020-07-09,7270,104,86,190,大里,甲簡
2020-07-10,7270,121,131,252,大里,甲簡
2020-07-11,7270,287,173,460,大里,甲簡
2020-07-12,7270,290,130,420,大里,甲簡
2020-07-13,7270,113,97,210,大里,甲簡
2020-07-14,7270,100,102,202,大里,甲簡
2020-07-15,7270,124,151,275,大里,甲簡
2020-07-16,7270,155,102,257,大里,甲簡
2020-07-17,7270,181,121,302,大里,甲簡
2020-07-18,7270,244,149,393,大里,甲簡
2020-07-19,7270,309,162,471,大里,甲簡
2020-07-20,7270,115,99,214,大里,甲簡
2020-07-21,7270,136,93,229,大里,甲簡
2020-07-22,7270,103,96,199,大里,甲簡
2020-07-23,7270,121,109,230,大里,甲簡
2020-07-24,7270,127,94,221,大里,甲簡
2020-07-25,7270,405,137,542,大里,甲簡
2020-07-26,7270,226,171,397,大里,甲簡
2020-07-27,7270,628,162,790,大里,甲簡
2020-07-28,7270,99,81,180,大里,甲簡
2020-07-29,7270,118,129,247,大里,甲簡
2020-07-30,7270,102,104,206,大里,甲簡
2020-07-31,7270,145,144,289,大里,甲簡
2020-08-01,7270,287,214,501,大里,甲簡
2020-08-02,7270,193,132,325,大里,甲簡
2020-08-03,7270,87,81,168,大里,甲簡
2020-08-04,7270,99,113,212,大里,甲簡
2020-08-05,7270,121,111,232,大里,甲簡
2020-08-06,7270,157,107,264,大里,甲簡
2020-08-07,7270,92,69,161,大里,甲簡
2020-08-08,7270,255,196,451,大里,甲簡
2020-08-09,7270,190,157,347,大里,甲簡
2020-08-10,7270,134,111,245,大里,甲簡
2020-08-11,7270,107,66,173,大里,甲簡
2020-08-12,7270,151,100,251,大里,甲簡
2020-08-13,7270,150,96,246,大里,甲簡
2020-08-14,7270,128,110,238,大里,甲簡
2020-08-15,7270,1149,157,1306,大里,甲簡
2020-08-16,7270,290,199,489,大里,甲簡
2020-08-17,7270,131,92,223,大里,甲簡
2020-08-18,7270,105,94,199,大里,甲簡
2020-08-19,7270,104,87,191,大里,甲簡
2020-08-20,7270,118,74,192,大里,甲簡
2020-08-21,7270,92,80,172,大里,甲簡
2020-08-22,7270,153,104,257,大里,甲簡
2020-08-23,7270,174,88,262,大里,甲簡
2020-08-24,7270,115,116,231,大里,甲簡
2020-08-25,7270,115,82,197,大里,甲簡
2020-08-26,7270,110,81,191,大里,甲簡
2020-08-27,7270,91,72,163,大里,甲簡
2020-08-28,7270,104,90,194,大里,甲簡
2020-08-29,7270,229,120,349,大里,甲簡
2020-08-30,7270,181,183,364,大里,甲簡
2020-08-31,7270,95,79,174,大里,甲簡
2020-09-01,7270,85,78,163,大里,甲簡
2020-09-02,7270,104,79,183,大里,甲簡
2020-09-03,7270,107,74,181,大里,甲簡
2020-09-04,7270,102,87,189,大里,甲簡
2020-09-05,7270,263,140,403,大里,甲簡
2020-09-06,7270,269,129,398,大里,甲簡
2020-09-07,7270,104,74,178,大里,甲簡
2020-09-08,7270,127,109,236,大里,甲簡
2020-09-09,7270,101,69,170,大里,甲簡
2020-09-10,7270,93,73,166,大里,甲簡
2020-09-11,7270,132,70,202,大里,甲簡
2020-09-12,7270,204,109,313,大里,甲簡
2020-09-13,7270,198,139,337,大里,甲簡
2020-09-14,7270,104,62,166,大里,甲簡
2020-09-15,7270,118,96,214,大里,甲簡
2020-09-16,7270,96,76,172,大里,甲簡
2020-09-17,7270,112,113,225,大里,甲簡
2020-09-18,7270,128,101,229,大里,甲簡
2020-09-19,7270,276,148,424,大里,甲簡
2020-09-20,7270,105,97,202,大里,甲簡
2020-09-21,7270,105,84,189,大里,甲簡
2020-09-22,7270,114,84,198,大里,甲簡
2020-09-23,7270,218,139,357,大里,甲簡
2020-09-24,7270,126,84,210,大里,甲簡
2020-09-25,7270,80,83,163,大里,甲簡
2020-09-26,7270,255,116,371,大里,甲簡
2020-09-27,7270,141,97,238,大里,甲簡
2020-09-28,7270,166,159,325,大里,甲簡
2020-09-29,7270,85,75,160,大里,甲簡
2020-09-30,7270,77,92,169,大里,甲簡
2020-10-01,7270,474,275,749,大里,甲簡
2020-10-02,7270,1116,493,1609,大里,甲簡
2020-10-03,7270,844,395,1239,大里,甲簡
2020-10-04,7270,443,216,659,大里,甲簡
2020-10-05,7270,81,74,155,大里,甲簡
2020-10-06,7270,108,91,199,大里,甲簡
2020-10-07,7270,112,79,191,大里,甲簡
2020-10-08,7270,152,93,245,大里,甲簡
2020-10-09,7270,594,287,881,大里,甲簡
2020-10-10,7270,482,177,659,大里,甲簡
2020-10-11,7270,231,143,374,大里,甲簡
2020-10-12,7270,111,96,207,大里,甲簡
2020-10-13,7270,100,102,202,大里,甲簡
2020-10-14,7270,88,69,157,大里,甲簡
2020-10-15,7270,181,76,257,大里,甲簡
2020-10-16,7270,249,65,314,大里,甲簡
2020-10-17,7270,228,141,369,大里,甲簡
2020-10-18,7270,256,90,346,大里,甲簡
2020-10-19,7270,73,69,142,大里,甲簡
2020-10-20,7270,116,84,200,大里,甲簡
2020-10-21,7270,69,58,127,大里,甲簡
2020-10-22,7270,54,53,107,大里,甲簡
2020-10-23,7270,87,71,158,大里,甲簡
2020-10-24,7270,712,279,991,大里,甲簡
2020-10-25,7270,720,229,949,大里,甲簡
2020-10-26,7270,388,92,480,大里,甲簡
2020-10-27,7270,342,154,496,大里,甲簡
2020-10-28,7270,175,102,277,大里,甲簡
2020-10-29,7270,122,97,219,大里,甲簡
2020-10-30,7270,176,89,265,大里,甲簡
2020-10-31,7270,1544,469,2013,大里,甲簡
2020-11-01,7270,1180,391,1571,大里,甲簡
2020-11-02,7270,276,131,407,大里,甲簡
2020-11-03,7270,204,155,359,大里,甲簡
2020-11-04,7270,250,120,370,大里,甲簡
2020-11-05,7270,364,286,650,大里,甲簡
2020-11-06,7270,288,169,457,大里,甲簡
2020-11-07,7270,1933,546,2479,大里,甲簡
2020-11-08,7270,701,303,1004,大里,甲簡
2020-11-09,7270,269,84,353,大里,甲簡
2020-11-10,7270,189,82,271,大里,甲簡
2020-11-11,7270,367,114,481,大里,甲簡
2020-11-12,7270,293,106,399,大里,甲簡
2020-11-13,7270,154,73,227,大里,甲簡
2020-11-14,7270,1130,228,1358,大里,甲簡
2020-11-15,7270,3239,770,4009,大里,甲簡
2020-11-16,7270,640,171,811,大里,甲簡
2020-11-17,7270,738,230,968,大里,甲簡
2020-11-18,7270,1044,266,1310,大里,甲簡
2020-11-19,7270,1342,659,2001,大里,甲簡
2020-11-20,7270,931,236,1167,大里,甲簡
2020-11-21,7270,1973,586,2559,大里,甲簡
2020-11-22,7270,3765,1021,4786,大里,甲簡
2020-11-23,7270,174,97,271,大里,甲簡
2020-11-24,7270,411,110,521,大里,甲簡
2020-11-25,7270,551,158,709,大里,甲簡
2020-11-26,7270,781,254,1035,大里,甲簡
2020-11-27,7270,414,268,682,大里,甲簡
2020-11-28,7270,745,318,1063,大里,甲簡
2020-11-29,7270,636,246,882,大里,甲簡
2020-11-30,7270,154,103,257,大里,甲簡
2020-12-01,7270,105,72,177,大里,甲簡
2020-12-02,7270,74,61,135,大里,甲簡
2020-12-03,7270,81,83,164,大里,甲簡
2020-12-04,7270,36,44,80,大里,甲簡
2020-12-05,7270,77,42,119,大里,甲簡
2020-12-06,7270,50,33,83,大里,甲簡
2020-12-07,7270,38,41,79,大里,甲簡
2020-12-08,7270,48,53,101,大里,甲簡
2020-12-09,7270,39,41,80,大里,甲簡
2020-12-10,7270,60,56,116,大里,甲簡
2020-12-11,7270,43,49,92,大里,甲簡
2020-12-12,7270,82,58,140,大里,甲簡
2020-12-13,7270,136,75,211,大里,甲簡
2020-12-14,7270,61,57,118,大里,甲簡
2020-12-15,7270,77,78,155,大里,甲簡
2020-12-16,7270,54,59,113,大里,甲簡
2020-12-17,7270,56,122,178,大里,甲簡
2020-12-18,7270,71,77,148,大里,甲簡
2020-12-19,7270,90,74,164,大里,甲簡
2020-12-20,7270,106,74,180,大里,甲簡
2020-12-21,7270,45,46,91,大里,甲簡
2020-12-22,7270,63,78,141,大里,甲簡
2020-12-23,7270,81,82,163,大里,甲簡
2020-12-24,7270,101,60,161,大里,甲簡
2020-12-25,7270,87,73,160,大里,甲簡
2020-12-26,7270,262,140,402,大里,甲簡
2020-12-27,7270,344,169,513,大里,甲簡
2020-12-28,7270,323,78,401,大里,甲簡
2020-12-29,7270,145,103,248,大里,甲簡
2020-12-30,7270,68,55,123,大里,甲簡
2020-12-31,7270,80,115,195,大里,甲簡
2020-01-01,7280,24,35,59,石城,招呼
2020-01-02,7280,23,18,41,石城,招呼
2020-01-03,7280,19,25,44,石城,招呼
2020-01-04,7280,46,45,91,石城,招呼
2020-01-05,7280,53,32,85,石城,招呼
2020-01-06,7280,33,26,59,石城,招呼
2020-01-07,7280,23,26,49,石城,招呼
2020-01-08,7280,19,24,43,石城,招呼
2020-01-09,7280,14,10,24,石城,招呼
2020-01-10,7280,26,39,65,石城,招呼
2020-01-11,7280,22,42,64,石城,招呼
2020-01-12,7280,54,22,76,石城,招呼
2020-01-13,7280,17,22,39,石城,招呼
2020-01-14,7280,15,19,34,石城,招呼
2020-01-15,7280,21,21,42,石城,招呼
2020-01-16,7280,27,25,52,石城,招呼
2020-01-17,7280,16,28,44,石城,招呼
2020-01-18,7280,28,28,56,石城,招呼
2020-01-19,7280,49,28,77,石城,招呼
2020-01-20,7280,26,19,45,石城,招呼
2020-01-21,7280,25,28,53,石城,招呼
2020-01-22,7280,26,26,52,石城,招呼
2020-01-23,7280,38,35,73,石城,招呼
2020-01-24,7280,22,49,71,石城,招呼
2020-01-25,7280,50,45,95,石城,招呼
2020-01-26,7280,43,36,79,石城,招呼
2020-01-27,7280,42,35,77,石城,招呼
2020-01-28,7280,49,38,87,石城,招呼
2020-01-29,7280,32,17,49,石城,招呼
2020-01-30,7280,19,21,40,石城,招呼
2020-01-31,7280,21,40,61,石城,招呼
2020-02-01,7280,65,37,102,石城,招呼
2020-02-02,7280,84,60,144,石城,招呼
2020-02-03,7280,17,14,31,石城,招呼
2020-02-04,7280,12,17,29,石城,招呼
2020-02-05,7280,16,14,30,石城,招呼
2020-02-06,7280,16,20,36,石城,招呼
2020-02-07,7280,20,25,45,石城,招呼
2020-02-08,7280,21,16,37,石城,招呼
2020-02-09,7280,38,26,64,石城,招呼
2020-02-10,7280,11,20,31,石城,招呼
2020-02-11,7280,24,24,48,石城,招呼
2020-02-12,7280,27,31,58,石城,招呼
2020-02-13,7280,19,23,42,石城,招呼
2020-02-14,7280,20,19,39,石城,招呼
2020-02-15,7280,30,34,64,石城,招呼
2020-02-16,7280,25,15,40,石城,招呼
2020-02-17,7280,8,8,16,石城,招呼
2020-02-18,7280,21,27,48,石城,招呼
2020-02-19,7280,31,27,58,石城,招呼
2020-02-20,7280,21,23,44,石城,招呼
2020-02-21,7280,23,25,48,石城,招呼
2020-02-22,7280,26,44,70,石城,招呼
2020-02-23,7280,26,18,44,石城,招呼
2020-02-24,7280,36,17,53,石城,招呼
2020-02-25,7280,26,24,50,石城,招呼
2020-02-26,7280,30,26,56,石城,招呼
2020-02-27,7280,16,39,55,石城,招呼
2020-02-28,7280,52,51,103,石城,招呼
2020-02-29,7280,71,61,132,石城,招呼
2020-03-01,7280,45,22,67,石城,招呼
2020-03-02,7280,20,24,44,石城,招呼
2020-03-03,7280,32,22,54,石城,招呼
2020-03-04,7280,28,29,57,石城,招呼
2020-03-05,7280,15,25,40,石城,招呼
2020-03-06,7280,18,30,48,石城,招呼
2020-03-07,7280,64,30,94,石城,招呼
2020-03-08,7280,42,34,76,石城,招呼
2020-03-09,7280,27,16,43,石城,招呼
2020-03-10,7280,16,18,34,石城,招呼
2020-03-11,7280,17,31,48,石城,招呼
2020-03-12,7280,24,24,48,石城,招呼
2020-03-13,7280,15,14,29,石城,招呼
2020-03-14,7280,16,34,50,石城,招呼
2020-03-15,7280,99,44,143,石城,招呼
2020-03-16,7280,40,24,64,石城,招呼
2020-03-17,7280,21,35,56,石城,招呼
2020-03-18,7280,34,29,63,石城,招呼
2020-03-19,7280,20,18,38,石城,招呼
2020-03-20,7280,22,30,52,石城,招呼
2020-03-21,7280,46,32,78,石城,招呼
2020-03-22,7280,65,36,101,石城,招呼
2020-03-23,7280,14,16,30,石城,招呼
2020-03-24,7280,21,17,38,石城,招呼
2020-03-25,7280,22,26,48,石城,招呼
2020-03-26,7280,16,23,39,石城,招呼
2020-03-27,7280,22,33,55,石城,招呼
2020-03-28,7280,8,17,25,石城,招呼
2020-03-29,7280,39,30,69,石城,招呼
2020-03-30,7280,25,25,50,石城,招呼
2020-03-31,7280,10,20,30,石城,招呼
2020-04-01,7280,25,30,55,石城,招呼
2020-04-02,7280,10,32,42,石城,招呼
2020-04-03,7280,36,42,78,石城,招呼
2020-04-04,7280,31,29,60,石城,招呼
2020-04-05,7280,46,20,66,石城,招呼
2020-04-06,7280,19,25,44,石城,招呼
2020-04-07,7280,12,16,28,石城,招呼
2020-04-08,7280,23,26,49,石城,招呼
2020-04-09,7280,14,15,29,石城,招呼
2020-04-10,7280,19,31,50,石城,招呼
2020-04-11,7280,28,21,49,石城,招呼
2020-04-12,7280,36,21,57,石城,招呼
2020-04-13,7280,29,15,44,石城,招呼
2020-04-14,7280,25,21,46,石城,招呼
2020-04-15,7280,21,25,46,石城,招呼
2020-04-16,7280,30,21,51,石城,招呼
2020-04-17,7280,29,31,60,石城,招呼
2020-04-18,7280,97,33,130,石城,招呼
2020-04-19,7280,48,44,92,石城,招呼
2020-04-20,7280,26,26,52,石城,招呼
2020-04-21,7280,15,19,34,石城,招呼
2020-04-22,7280,19,17,36,石城,招呼
2020-04-23,7280,16,19,35,石城,招呼
2020-04-24,7280,12,21,33,石城,招呼
2020-04-25,7280,29,49,78,石城,招呼
2020-04-26,7280,53,19,72,石城,招呼
2020-04-27,7280,15,19,34,石城,招呼
2020-04-28,7280,28,17,45,石城,招呼
2020-04-29,7280,36,39,75,石城,招呼
2020-04-30,7280,20,27,47,石城,招呼
2020-05-01,7280,56,52,108,石城,招呼
2020-05-02,7280,67,46,113,石城,招呼
2020-05-03,7280,82,46,128,石城,招呼
2020-05-04,7280,16,17,33,石城,招呼
2020-05-05,7280,17,19,36,石城,招呼
2020-05-06,7280,34,19,53,石城,招呼
2020-05-07,7280,19,24,43,石城,招呼
2020-05-08,7280,24,34,58,石城,招呼
2020-05-09,7280,40,50,90,石城,招呼
2020-05-10,7280,50,29,79,石城,招呼
2020-05-11,7280,17,14,31,石城,招呼
2020-05-12,7280,31,18,49,石城,招呼
2020-05-13,7280,32,32,64,石城,招呼
2020-05-14,7280,19,20,39,石城,招呼
2020-05-15,7280,32,31,63,石城,招呼
2020-05-16,7280,52,42,94,石城,招呼
2020-05-17,7280,41,39,80,石城,招呼
2020-05-18,7280,18,15,33,石城,招呼
2020-05-19,7280,23,12,35,石城,招呼
2020-05-20,7280,53,75,128,石城,招呼
2020-05-21,7280,15,12,27,石城,招呼
2020-05-22,7280,21,27,48,石城,招呼
2020-05-23,7280,14,29,43,石城,招呼
2020-05-24,7280,51,29,80,石城,招呼
2020-05-25,7280,20,24,44,石城,招呼
2020-05-26,7280,19,17,36,石城,招呼
2020-05-27,7280,19,20,39,石城,招呼
2020-05-28,7280,16,12,28,石城,招呼
2020-05-29,7280,17,26,43,石城,招呼
2020-05-30,7280,35,78,113,石城,招呼
2020-05-31,7280,59,48,107,石城,招呼
2020-06-01,7280,34,18,52,石城,招呼
2020-06-02,7280,17,24,41,石城,招呼
2020-06-03,7280,26,23,49,石城,招呼
2020-06-04,7280,30,22,52,石城,招呼
2020-06-05,7280,24,31,55,石城,招呼
2020-06-06,7280,38,40,78,石城,招呼
2020-06-07,7280,38,23,61,石城,招呼
2020-06-08,7280,24,22,46,石城,招呼
2020-06-09,7280,14,15,29,石城,招呼
2020-06-10,7280,27,27,54,石城,招呼
2020-06-11,7280,23,22,45,石城,招呼
2020-06-12,7280,31,30,61,石城,招呼
2020-06-13,7280,40,32,72,石城,招呼
2020-06-14,7280,42,30,72,石城,招呼
2020-06-15,7280,13,15,28,石城,招呼
2020-06-16,7280,65,86,151,石城,招呼
2020-06-17,7280,30,32,62,石城,招呼
2020-06-18,7280,14,27,41,石城,招呼
2020-06-19,7280,16,25,41,石城,招呼
2020-06-20,7280,25,32,57,石城,招呼
2020-06-21,7280,46,27,73,石城,招呼
2020-06-22,7280,16,18,34,石城,招呼
2020-06-23,7280,23,24,47,石城,招呼
2020-06-24,7280,29,39,68,石城,招呼
2020-06-25,7280,47,55,102,石城,招呼
2020-06-26,7280,57,59,116,石城,招呼
2020-06-27,7280,50,36,86,石城,招呼
2020-06-28,7280,56,41,97,石城,招呼
2020-06-29,7280,21,18,39,石城,招呼
2020-06-30,7280,23,26,49,石城,招呼
2020-07-01,7280,23,26,49,石城,招呼
2020-07-02,7280,31,24,55,石城,招呼
2020-07-03,7280,21,27,48,石城,招呼
2020-07-04,7280,29,48,77,石城,招呼
2020-07-05,7280,59,52,111,石城,招呼
2020-07-06,7280,27,29,56,石城,招呼
2020-07-07,7280,15,17,32,石城,招呼
2020-07-08,7280,39,26,65,石城,招呼
2020-07-09,7280,24,21,45,石城,招呼
2020-07-10,7280,22,27,49,石城,招呼
2020-07-11,7280,30,25,55,石城,招呼
2020-07-12,7280,50,29,79,石城,招呼
2020-07-13,7280,17,21,38,石城,招呼
2020-07-14,7280,22,28,50,石城,招呼
2020-07-15,7280,51,23,74,石城,招呼
2020-07-16,7280,22,27,49,石城,招呼
2020-07-17,7280,18,25,43,石城,招呼
2020-07-18,7280,34,47,81,石城,招呼
2020-07-19,7280,70,28,98,石城,招呼
2020-07-20,7280,30,28,58,石城,招呼
2020-07-21,7280,17,24,41,石城,招呼
2020-07-22,7280,31,35,66,石城,招呼
2020-07-23,7280,23,35,58,石城,招呼
2020-07-24,7280,56,57,113,石城,招呼
2020-07-25,7280,32,92,124,石城,招呼
2020-07-26,7280,54,39,93,石城,招呼
2020-07-27,7280,27,30,57,石城,招呼
2020-07-28,7280,43,23,66,石城,招呼
2020-07-29,7280,29,28,57,石城,招呼
2020-07-30,7280,24,18,42,石城,招呼
2020-07-31,7280,24,32,56,石城,招呼
2020-08-01,7280,24,24,48,石城,招呼
2020-08-02,7280,45,37,82,石城,招呼
2020-08-03,7280,12,15,27,石城,招呼
2020-08-04,7280,21,27,48,石城,招呼
2020-08-05,7280,39,28,67,石城,招呼
2020-08-06,7280,23,17,40,石城,招呼
2020-08-07,7280,22,30,52,石城,招呼
2020-08-08,7280,26,53,79,石城,招呼
2020-08-09,7280,68,63,131,石城,招呼
2020-08-10,7280,15,20,35,石城,招呼
2020-08-11,7280,20,20,40,石城,招呼
2020-08-12,7280,56,45,101,石城,招呼
2020-08-13,7280,19,29,48,石城,招呼
2020-08-14,7280,22,21,43,石城,招呼
2020-08-15,7280,41,32,73,石城,招呼
2020-08-16,7280,57,41,98,石城,招呼
2020-08-17,7280,29,32,61,石城,招呼
2020-08-18,7280,24,19,43,石城,招呼
2020-08-19,7280,38,26,64,石城,招呼
2020-08-20,7280,14,17,31,石城,招呼
2020-08-21,7280,29,43,72,石城,招呼
2020-08-22,7280,33,31,64,石城,招呼
2020-08-23,7280,43,35,78,石城,招呼
2020-08-24,7280,27,25,52,石城,招呼
2020-08-25,7280,15,21,36,石城,招呼
2020-08-26,7280,19,22,41,石城,招呼
2020-08-27,7280,31,16,47,石城,招呼
2020-08-28,7280,13,26,39,石城,招呼
2020-08-29,7280,137,133,270,石城,招呼
2020-08-30,7280,51,37,88,石城,招呼
2020-08-31,7280,15,19,34,石城,招呼
2020-09-01,7280,26,26,52,石城,招呼
2020-09-02,7280,25,27,52,石城,招呼
2020-09-03,7280,38,17,55,石城,招呼
2020-09-04,7280,24,27,51,石城,招呼
2020-09-05,7280,24,43,67,石城,招呼
2020-09-06,7280,59,38,97,石城,招呼
2020-09-07,7280,17,25,42,石城,招呼
2020-09-08,7280,40,23,63,石城,招呼
2020-09-09,7280,27,35,62,石城,招呼
2020-09-10,7280,22,23,45,石城,招呼
2020-09-11,7280,14,16,30,石城,招呼
2020-09-12,7280,34,40,74,石城,招呼
2020-09-13,7280,28,22,50,石城,招呼
2020-09-14,7280,31,25,56,石城,招呼
2020-09-15,7280,21,20,41,石城,招呼
2020-09-16,7280,23,24,47,石城,招呼
2020-09-17,7280,30,37,67,石城,招呼
2020-09-18,7280,53,31,84,石城,招呼
2020-09-19,7280,47,37,84,石城,招呼
2020-09-20,7280,52,15,67,石城,招呼
2020-09-21,7280,33,24,57,石城,招呼
2020-09-22,7280,16,23,39,石城,招呼
2020-09-23,7280,17,23,40,石城,招呼
2020-09-24,7280,15,16,31,石城,招呼
2020-09-25,7280,17,24,41,石城,招呼
2020-09-26,7280,29,27,56,石城,招呼
2020-09-27,7280,82,56,138,石城,招呼
2020-09-28,7280,21,22,43,石城,招呼
2020-09-29,7280,14,20,34,石城,招呼
2020-09-30,7280,22,24,46,石城,招呼
2020-10-01,7280,59,78,137,石城,招呼
2020-10-02,7280,62,84,146,石城,招呼
2020-10-03,7280,72,56,128,石城,招呼
2020-10-04,7280,42,31,73,石城,招呼
2020-10-05,7280,16,18,34,石城,招呼
2020-10-06,7280,23,27,50,石城,招呼
2020-10-07,7280,30,24,54,石城,招呼
2020-10-08,7280,27,35,62,石城,招呼
2020-10-09,7280,35,43,78,石城,招呼
2020-10-10,7280,30,34,64,石城,招呼
2020-10-11,7280,32,39,71,石城,招呼
2020-10-12,7280,25,24,49,石城,招呼
2020-10-13,7280,27,23,50,石城,招呼
2020-10-14,7280,26,34,60,石城,招呼
2020-10-15,7280,21,37,58,石城,招呼
2020-10-16,7280,18,22,40,石城,招呼
2020-10-17,7280,29,32,61,石城,招呼
2020-10-18,7280,35,40,75,石城,招呼
2020-10-19,7280,28,17,45,石城,招呼
2020-10-20,7280,28,22,50,石城,招呼
2020-10-21,7280,20,19,39,石城,招呼
2020-10-22,7280,14,14,28,石城,招呼
2020-10-23,7280,15,25,40,石城,招呼
2020-10-24,7280,46,54,100,石城,招呼
2020-10-25,7280,59,21,80,石城,招呼
2020-10-26,7280,32,30,62,石城,招呼
2020-10-27,7280,70,19,89,石城,招呼
2020-10-28,7280,61,27,88,石城,招呼
2020-10-29,7280,19,16,35,石城,招呼
2020-10-30,7280,30,28,58,石城,招呼
2020-10-31,7280,39,131,170,石城,招呼
2020-11-01,7280,66,32,98,石城,招呼
2020-11-02,7280,29,20,49,石城,招呼
2020-11-03,7280,16,17,33,石城,招呼
2020-11-04,7280,23,25,48,石城,招呼
2020-11-05,7280,18,23,41,石城,招呼
2020-11-06,7280,22,25,47,石城,招呼
2020-11-07,7280,23,40,63,石城,招呼
2020-11-08,7280,44,31,75,石城,招呼
2020-11-09,7280,26,14,40,石城,招呼
2020-11-10,7280,26,20,46,石城,招呼
2020-11-11,7280,24,34,58,石城,招呼
2020-11-12,7280,21,15,36,石城,招呼
2020-11-13,7280,21,27,48,石城,招呼
2020-11-14,7280,25,30,55,石城,招呼
2020-11-15,7280,70,49,119,石城,招呼
2020-11-16,7280,64,26,90,石城,招呼
2020-11-17,7280,47,34,81,石城,招呼
2020-11-18,7280,25,20,45,石城,招呼
2020-11-19,7280,37,29,66,石城,招呼
2020-11-20,7280,32,39,71,石城,招呼
2020-11-21,7280,54,60,114,石城,招呼
2020-11-22,7280,59,47,106,石城,招呼
2020-11-23,7280,16,17,33,石城,招呼
2020-11-24,7280,23,25,48,石城,招呼
2020-11-25,7280,24,29,53,石城,招呼
2020-11-26,7280,32,24,56,石城,招呼
2020-11-27,7280,21,25,46,石城,招呼
2020-11-28,7280,38,45,83,石城,招呼
2020-11-29,7280,46,26,72,石城,招呼
2020-11-30,7280,36,14,50,石城,招呼
2020-12-01,7280,13,23,36,石城,招呼
2020-12-02,7280,19,24,43,石城,招呼
2020-12-03,7280,15,14,29,石城,招呼
2020-12-04,7280,8,8,16,石城,招呼
2020-12-05,7280,6,8,14,石城,招呼
2020-12-06,7280,356,227,583,石城,招呼
2020-12-07,7280,7,12,19,石城,招呼
2020-12-08,7280,10,11,21,石城,招呼
2020-12-09,7280,14,12,26,石城,招呼
2020-12-10,7280,10,13,23,石城,招呼
2020-12-11,7280,9,13,22,石城,招呼
2020-12-12,7280,13,15,28,石城,招呼
2020-12-13,7280,21,13,34,石城,招呼
2020-12-14,7280,7,15,22,石城,招呼
2020-12-15,7280,15,13,28,石城,招呼
2020-12-16,7280,8,12,20,石城,招呼
2020-12-17,7280,14,12,26,石城,招呼
2020-12-18,7280,25,28,53,石城,招呼
2020-12-19,7280,10,30,40,石城,招呼
2020-12-20,7280,34,19,53,石城,招呼
2020-12-21,7280,12,11,23,石城,招呼
2020-12-22,7280,14,16,30,石城,招呼
2020-12-23,7280,13,18,31,石城,招呼
2020-12-24,7280,14,41,55,石城,招呼
2020-12-25,7280,19,27,46,石城,招呼
2020-12-26,7280,26,31,57,石城,招呼
2020-12-27,7280,38,31,69,石城,招呼
2020-12-28,7280,21,18,39,石城,招呼
2020-12-29,7280,19,30,49,石城,招呼
2020-12-30,7280,14,23,37,石城,招呼
2020-12-31,7280,21,18,39,石城,招呼
2020-01-01,7290,1234,1099,2333,福隆,三等
2020-01-02,7290,614,635,1249,福隆,三等
2020-01-03,7290,640,756,1396,福隆,三等
2020-01-04,7290,908,1138,2046,福隆,三等
2020-01-05,7290,1008,1115,2123,福隆,三等
2020-01-06,7290,671,626,1297,福隆,三等
2020-01-07,7290,541,584,1125,福隆,三等
2020-01-08,7290,499,513,1012,福隆,三等
2020-01-09,7290,460,479,939,福隆,三等
2020-01-10,7290,515,679,1194,福隆,三等
2020-01-11,7290,775,960,1735,福隆,三等
2020-01-12,7290,576,495,1071,福隆,三等
2020-01-13,7290,454,460,914,福隆,三等
2020-01-14,7290,501,506,1007,福隆,三等
2020-01-15,7290,430,458,888,福隆,三等
2020-01-16,7290,622,688,1310,福隆,三等
2020-01-17,7290,541,621,1162,福隆,三等
2020-01-18,7290,496,679,1175,福隆,三等
2020-01-19,7290,629,561,1190,福隆,三等
2020-01-20,7290,833,838,1671,福隆,三等
2020-01-21,7290,739,762,1501,福隆,三等
2020-01-22,7290,693,790,1483,福隆,三等
2020-01-23,7290,587,823,1410,福隆,三等
2020-01-24,7290,399,675,1074,福隆,三等
2020-01-25,7290,1171,1129,2300,福隆,三等
2020-01-26,7290,748,784,1532,福隆,三等
2020-01-27,7290,1193,1056,2249,福隆,三等
2020-01-28,7290,1029,943,1972,福隆,三等
2020-01-29,7290,774,683,1457,福隆,三等
2020-01-30,7290,566,635,1201,福隆,三等
2020-01-31,7290,607,610,1217,福隆,三等
2020-02-01,7290,629,853,1482,福隆,三等
2020-02-02,7290,958,1008,1966,福隆,三等
2020-02-03,7290,609,533,1142,福隆,三等
2020-02-04,7290,390,405,795,福隆,三等
2020-02-05,7290,397,424,821,福隆,三等
2020-02-06,7290,438,452,890,福隆,三等
2020-02-07,7290,502,494,996,福隆,三等
2020-02-08,7290,438,514,952,福隆,三等
2020-02-09,7290,440,472,912,福隆,三等
2020-02-10,7290,554,564,1118,福隆,三等
2020-02-11,7290,514,543,1057,福隆,三等
2020-02-12,7290,695,719,1414,福隆,三等
2020-02-13,7290,486,494,980,福隆,三等
2020-02-14,7290,491,457,948,福隆,三等
2020-02-15,7290,553,661,1214,福隆,三等
2020-02-16,7290,416,388,804,福隆,三等
2020-02-17,7290,470,477,947,福隆,三等
2020-02-18,7290,447,488,935,福隆,三等
2020-02-19,7290,545,609,1154,福隆,三等
2020-02-20,7290,564,622,1186,福隆,三等
2020-02-21,7290,692,698,1390,福隆,三等
2020-02-22,7290,576,699,1275,福隆,三等
2020-02-23,7290,570,570,1140,福隆,三等
2020-02-24,7290,589,587,1176,福隆,三等
2020-02-25,7290,542,610,1152,福隆,三等
2020-02-26,7290,440,471,911,福隆,三等
2020-02-27,7290,440,490,930,福隆,三等
2020-02-28,7290,1011,1366,2377,福隆,三等
2020-02-29,7290,1384,1612,2996,福隆,三等
2020-03-01,7290,752,580,1332,福隆,三等
2020-03-02,7290,406,392,798,福隆,三等
2020-03-03,7290,373,401,774,福隆,三等
2020-03-04,7290,348,365,713,福隆,三等
2020-03-05,7290,320,344,664,福隆,三等
2020-03-06,7290,428,511,939,福隆,三等
2020-03-07,7290,880,1036,1916,福隆,三等
2020-03-08,7290,727,665,1392,福隆,三等
2020-03-09,7290,528,560,1088,福隆,三等
2020-03-10,7290,348,349,697,福隆,三等
2020-03-11,7290,444,460,904,福隆,三等
2020-03-12,7290,352,364,716,福隆,三等
2020-03-13,7290,424,488,912,福隆,三等
2020-03-14,7290,355,469,824,福隆,三等
2020-03-15,7290,1108,986,2094,福隆,三等
2020-03-16,7290,480,502,982,福隆,三等
2020-03-17,7290,520,522,1042,福隆,三等
2020-03-18,7290,414,437,851,福隆,三等
2020-03-19,7290,343,346,689,福隆,三等
2020-03-20,7290,435,532,967,福隆,三等
2020-03-21,7290,913,1139,2052,福隆,三等
2020-03-22,7290,983,969,1952,福隆,三等
2020-03-23,7290,386,386,772,福隆,三等
2020-03-24,7290,371,383,754,福隆,三等
2020-03-25,7290,390,415,805,福隆,三等
2020-03-26,7290,507,534,1041,福隆,三等
2020-03-27,7290,468,513,981,福隆,三等
2020-03-28,7290,360,434,794,福隆,三等
2020-03-29,7290,655,690,1345,福隆,三等
2020-03-30,7290,436,415,851,福隆,三等
2020-03-31,7290,383,404,787,福隆,三等
2020-04-01,7290,356,414,770,福隆,三等
2020-04-02,7290,351,447,798,福隆,三等
2020-04-03,7290,509,618,1127,福隆,三等
2020-04-04,7290,481,442,923,福隆,三等
2020-04-05,7290,473,394,867,福隆,三等
2020-04-06,7290,327,325,652,福隆,三等
2020-04-07,7290,291,314,605,福隆,三等
2020-04-08,7290,316,326,642,福隆,三等
2020-04-09,7290,347,341,688,福隆,三等
2020-04-10,7290,458,542,1000,福隆,三等
2020-04-11,7290,511,601,1112,福隆,三等
2020-04-12,7290,349,313,662,福隆,三等
2020-04-13,7290,356,392,748,福隆,三等
2020-04-14,7290,391,458,849,福隆,三等
2020-04-15,7290,442,522,964,福隆,三等
2020-04-16,7290,437,468,905,福隆,三等
2020-04-17,7290,551,738,1289,福隆,三等
2020-04-18,7290,979,1415,2394,福隆,三等
2020-04-19,7290,1002,995,1997,福隆,三等
2020-04-20,7290,404,369,773,福隆,三等
2020-04-21,7290,316,318,634,福隆,三等
2020-04-22,7290,284,308,592,福隆,三等
2020-04-23,7290,291,298,589,福隆,三等
2020-04-24,7290,347,370,717,福隆,三等
2020-04-25,7290,329,413,742,福隆,三等
2020-04-26,7290,411,390,801,福隆,三等
2020-04-27,7290,347,354,701,福隆,三等
2020-04-28,7290,430,447,877,福隆,三等
2020-04-29,7290,510,523,1033,福隆,三等
2020-04-30,7290,510,581,1091,福隆,三等
2020-05-01,7290,1181,1617,2798,福隆,三等
2020-05-02,7290,1371,1602,2973,福隆,三等
2020-05-03,7290,1242,1155,2397,福隆,三等
2020-05-04,7290,583,546,1129,福隆,三等
2020-05-05,7290,604,460,1064,福隆,三等
2020-05-06,7290,442,432,874,福隆,三等
2020-05-07,7290,386,413,799,福隆,三等
2020-05-08,7290,438,587,1025,福隆,三等
2020-05-09,7290,1079,1365,2444,福隆,三等
2020-05-10,7290,832,704,1536,福隆,三等
2020-05-11,7290,375,359,734,福隆,三等
2020-05-12,7290,434,489,923,福隆,三等
2020-05-13,7290,492,506,998,福隆,三等
2020-05-14,7290,507,560,1067,福隆,三等
2020-05-15,7290,643,760,1403,福隆,三等
2020-05-16,7290,1044,1367,2411,福隆,三等
2020-05-17,7290,1065,927,1992,福隆,三等
2020-05-18,7290,450,431,881,福隆,三等
2020-05-19,7290,346,379,725,福隆,三等
2020-05-20,7290,377,413,790,福隆,三等
2020-05-21,7290,391,407,798,福隆,三等
2020-05-22,7290,394,420,814,福隆,三等
2020-05-23,7290,318,484,802,福隆,三等
2020-05-24,7290,1540,1450,2990,福隆,三等
2020-05-25,7290,519,503,1022,福隆,三等
2020-05-26,7290,489,508,997,福隆,三等
2020-05-27,7290,402,395,797,福隆,三等
2020-05-28,7290,479,464,943,福隆,三等
2020-05-29,7290,656,810,1466,福隆,三等
2020-05-30,7290,1714,1903,3617,福隆,三等
2020-05-31,7290,2619,2440,5059,福隆,三等
2020-06-01,7290,743,718,1461,福隆,三等
2020-06-02,7290,872,913,1785,福隆,三等
2020-06-03,7290,1005,1058,2063,福隆,三等
2020-06-04,7290,885,1043,1928,福隆,三等
2020-06-05,7290,778,848,1626,福隆,三等
2020-06-06,7290,2386,2580,4966,福隆,三等
2020-06-07,7290,1962,1745,3707,福隆,三等
2020-06-08,7290,582,576,1158,福隆,三等
2020-06-09,7290,972,1022,1994,福隆,三等
2020-06-10,7290,954,978,1932,福隆,三等
2020-06-11,7290,846,1105,1951,福隆,三等
2020-06-12,7290,1373,1230,2603,福隆,三等
2020-06-13,7290,2644,2937,5581,福隆,三等
2020-06-14,7290,2693,2473,5166,福隆,三等
2020-06-15,7290,793,781,1574,福隆,三等
2020-06-16,7290,953,945,1898,福隆,三等
2020-06-17,7290,785,812,1597,福隆,三等
2020-06-18,7290,732,787,1519,福隆,三等
2020-06-19,7290,965,1104,2069,福隆,三等
2020-06-20,7290,1454,1645,3099,福隆,三等
2020-06-21,7290,2284,2206,4490,福隆,三等
2020-06-22,7290,832,781,1613,福隆,三等
2020-06-23,7290,839,814,1653,福隆,三等
2020-06-24,7290,875,963,1838,福隆,三等
2020-06-25,7290,2273,2547,4820,福隆,三等
2020-06-26,7290,4032,3974,8006,福隆,三等
2020-06-27,7290,3836,4035,7871,福隆,三等
2020-06-28,7290,2597,2238,4835,福隆,三等
2020-06-29,7290,890,854,1744,福隆,三等
2020-06-30,7290,858,802,1660,福隆,三等
2020-07-01,7290,712,748,1460,福隆,三等
2020-07-02,7290,743,813,1556,福隆,三等
2020-07-03,7290,778,896,1674,福隆,三等
2020-07-04,7290,1744,2022,3766,福隆,三等
2020-07-05,7290,2092,2001,4093,福隆,三等
2020-07-06,7290,860,846,1706,福隆,三等
2020-07-07,7290,810,831,1641,福隆,三等
2020-07-08,7290,822,790,1612,福隆,三等
2020-07-09,7290,841,829,1670,福隆,三等
2020-07-10,7290,957,988,1945,福隆,三等
2020-07-11,7290,1841,2120,3961,福隆,三等
2020-07-12,7290,2454,2356,4810,福隆,三等
2020-07-13,7290,1075,1074,2149,福隆,三等
2020-07-14,7290,1048,1069,2117,福隆,三等
2020-07-15,7290,1015,1152,2167,福隆,三等
2020-07-16,7290,1147,1230,2377,福隆,三等
2020-07-17,7290,1160,1371,2531,福隆,三等
2020-07-18,7290,1992,2204,4196,福隆,三等
2020-07-19,7290,2600,2424,5024,福隆,三等
2020-07-20,7290,1081,1137,2218,福隆,三等
2020-07-21,7290,1019,1027,2046,福隆,三等
2020-07-22,7290,1056,1077,2133,福隆,三等
2020-07-23,7290,1056,1106,2162,福隆,三等
2020-07-24,7290,1248,1260,2508,福隆,三等
2020-07-25,7290,1914,2518,4432,福隆,三等
2020-07-26,7290,1892,1770,3662,福隆,三等
2020-07-27,7290,970,1019,1989,福隆,三等
2020-07-28,7290,975,983,1958,福隆,三等
2020-07-29,7290,1061,1048,2109,福隆,三等
2020-07-30,7290,982,969,1951,福隆,三等
2020-07-31,7290,981,1091,2072,福隆,三等
2020-08-01,7290,1984,2179,4163,福隆,三等
2020-08-02,7290,1788,1623,3411,福隆,三等
2020-08-03,7290,544,452,996,福隆,三等
2020-08-04,7290,568,620,1188,福隆,三等
2020-08-05,7290,762,655,1417,福隆,三等
2020-08-06,7290,1038,1209,2247,福隆,三等
2020-08-07,7290,986,1004,1990,福隆,三等
2020-08-08,7290,1617,1852,3469,福隆,三等
2020-08-09,7290,1952,1682,3634,福隆,三等
2020-08-10,7290,987,1013,2000,福隆,三等
2020-08-11,7290,711,659,1370,福隆,三等
2020-08-12,7290,815,848,1663,福隆,三等
2020-08-13,7290,1016,1045,2061,福隆,三等
2020-08-14,7290,1021,1089,2110,福隆,三等
2020-08-15,7290,1976,3124,5100,福隆,三等
2020-08-16,7290,2406,2248,4654,福隆,三等
2020-08-17,7290,1155,1140,2295,福隆,三等
2020-08-18,7290,1180,1165,2345,福隆,三等
2020-08-19,7290,856,840,1696,福隆,三等
2020-08-20,7290,872,888,1760,福隆,三等
2020-08-21,7290,996,1102,2098,福隆,三等
2020-08-22,7290,1309,1480,2789,福隆,三等
2020-08-23,7290,1274,1253,2527,福隆,三等
2020-08-24,7290,969,956,1925,福隆,三等
2020-08-25,7290,859,867,1726,福隆,三等
2020-08-26,7290,857,921,1778,福隆,三等
2020-08-27,7290,843,806,1649,福隆,三等
2020-08-28,7290,811,835,1646,福隆,三等
2020-08-29,7290,1110,1348,2458,福隆,三等
2020-08-30,7290,1415,1217,2632,福隆,三等
2020-08-31,7290,541,519,1060,福隆,三等
2020-09-01,7290,571,566,1137,福隆,三等
2020-09-02,7290,591,548,1139,福隆,三等
2020-09-03,7290,566,591,1157,福隆,三等
2020-09-04,7290,620,723,1343,福隆,三等
2020-09-05,7290,1255,1408,2663,福隆,三等
2020-09-06,7290,1581,1743,3324,福隆,三等
2020-09-07,7290,786,647,1433,福隆,三等
2020-09-08,7290,693,693,1386,福隆,三等
2020-09-09,7290,650,638,1288,福隆,三等
2020-09-10,7290,529,561,1090,福隆,三等
2020-09-11,7290,658,776,1434,福隆,三等
2020-09-12,7290,1073,1362,2435,福隆,三等
2020-09-13,7290,1102,910,2012,福隆,三等
2020-09-14,7290,553,528,1081,福隆,三等
2020-09-15,7290,517,556,1073,福隆,三等
2020-09-16,7290,571,597,1168,福隆,三等
2020-09-17,7290,688,695,1383,福隆,三等
2020-09-18,7290,653,896,1549,福隆,三等
2020-09-19,7290,1393,1623,3016,福隆,三等
2020-09-20,7290,1131,991,2122,福隆,三等
2020-09-21,7290,602,424,1026,福隆,三等
2020-09-22,7290,652,739,1391,福隆,三等
2020-09-23,7290,729,731,1460,福隆,三等
2020-09-24,7290,582,619,1201,福隆,三等
2020-09-25,7290,528,647,1175,福隆,三等
2020-09-26,7290,876,1098,1974,福隆,三等
2020-09-27,7290,803,770,1573,福隆,三等
2020-09-28,7290,407,394,801,福隆,三等
2020-09-29,7290,608,624,1232,福隆,三等
2020-09-30,7290,528,693,1221,福隆,三等
2020-10-01,7290,1375,1723,3098,福隆,三等
2020-10-02,7290,2325,2806,5131,福隆,三等
2020-10-03,7290,2242,2435,4677,福隆,三等
2020-10-04,7290,1544,1476,3020,福隆,三等
2020-10-05,7290,522,411,933,福隆,三等
2020-10-06,7290,461,488,949,福隆,三等
2020-10-07,7290,512,556,1068,福隆,三等
2020-10-08,7290,638,827,1465,福隆,三等
2020-10-09,7290,1391,1753,3144,福隆,三等
2020-10-10,7290,1559,1758,3317,福隆,三等
2020-10-11,7290,1143,1109,2252,福隆,三等
2020-10-12,7290,504,440,944,福隆,三等
2020-10-13,7290,381,388,769,福隆,三等
2020-10-14,7290,494,531,1025,福隆,三等
2020-10-15,7290,534,501,1035,福隆,三等
2020-10-16,7290,588,762,1350,福隆,三等
2020-10-17,7290,651,943,1594,福隆,三等
2020-10-18,7290,917,735,1652,福隆,三等
2020-10-19,7290,432,447,879,福隆,三等
2020-10-20,7290,437,500,937,福隆,三等
2020-10-21,7290,459,471,930,福隆,三等
2020-10-22,7290,392,396,788,福隆,三等
2020-10-23,7290,406,533,939,福隆,三等
2020-10-24,7290,1070,1496,2566,福隆,三等
2020-10-25,7290,1091,1318,2409,福隆,三等
2020-10-26,7290,602,728,1330,福隆,三等
2020-10-27,7290,604,783,1387,福隆,三等
2020-10-28,7290,524,664,1188,福隆,三等
2020-10-29,7290,466,486,952,福隆,三等
2020-10-30,7290,656,812,1468,福隆,三等
2020-10-31,7290,1319,2439,3758,福隆,三等
2020-11-01,7290,1498,1840,3338,福隆,三等
2020-11-02,7290,569,627,1196,福隆,三等
2020-11-03,7290,474,560,1034,福隆,三等
2020-11-04,7290,585,711,1296,福隆,三等
2020-11-05,7290,747,549,1296,福隆,三等
2020-11-06,7290,696,806,1502,福隆,三等
2020-11-07,7290,1180,2554,3734,福隆,三等
2020-11-08,7290,819,1172,1991,福隆,三等
2020-11-09,7290,505,665,1170,福隆,三等
2020-11-10,7290,450,591,1041,福隆,三等
2020-11-11,7290,500,715,1215,福隆,三等
2020-11-12,7290,453,678,1131,福隆,三等
2020-11-13,7290,454,645,1099,福隆,三等
2020-11-14,7290,867,1958,2825,福隆,三等
2020-11-15,7290,1967,2656,4623,福隆,三等
2020-11-16,7290,640,1009,1649,福隆,三等
2020-11-17,7290,748,1127,1875,福隆,三等
2020-11-18,7290,881,1323,2204,福隆,三等
2020-11-19,7290,1067,1462,2529,福隆,三等
2020-11-20,7290,698,1345,2043,福隆,三等
2020-11-21,7290,1280,2989,4269,福隆,三等
2020-11-22,7290,2362,4322,6684,福隆,三等
2020-11-23,7290,553,540,1093,福隆,三等
2020-11-24,7290,495,714,1209,福隆,三等
2020-11-25,7290,503,817,1320,福隆,三等
2020-11-26,7290,713,1070,1783,福隆,三等
2020-11-27,7290,618,823,1441,福隆,三等
2020-11-28,7290,915,1511,2426,福隆,三等
2020-11-29,7290,838,1094,1932,福隆,三等
2020-11-30,7290,387,397,784,福隆,三等
2020-12-01,7290,341,384,725,福隆,三等
2020-12-02,7290,378,382,760,福隆,三等
2020-12-03,7290,390,401,791,福隆,三等
2020-12-04,7290,228,215,443,福隆,三等
2020-12-05,7290,189,381,570,福隆,三等
2020-12-06,7290,1091,897,1988,福隆,三等
2020-12-07,7290,172,189,361,福隆,三等
2020-12-08,7290,180,169,349,福隆,三等
2020-12-09,7290,157,174,331,福隆,三等
2020-12-10,7290,190,207,397,福隆,三等
2020-12-11,7290,191,209,400,福隆,三等
2020-12-12,7290,162,257,419,福隆,三等
2020-12-13,7290,327,378,705,福隆,三等
2020-12-14,7290,338,277,615,福隆,三等
2020-12-15,7290,277,299,576,福隆,三等
2020-12-16,7290,264,287,551,福隆,三等
2020-12-17,7290,391,323,714,福隆,三等
2020-12-18,7290,436,486,922,福隆,三等
2020-12-19,7290,376,509,885,福隆,三等
2020-12-20,7290,448,378,826,福隆,三等
2020-12-21,7290,352,492,844,福隆,三等
2020-12-22,7290,471,330,801,福隆,三等
2020-12-23,7290,351,377,728,福隆,三等
2020-12-24,7290,383,372,755,福隆,三等
2020-12-25,7290,352,446,798,福隆,三等
2020-12-26,7290,720,850,1570,福隆,三等
2020-12-27,7290,845,828,1673,福隆,三等
2020-12-28,7290,491,473,964,福隆,三等
2020-12-29,7290,480,498,978,福隆,三等
2020-12-30,7290,316,348,664,福隆,三等
2020-12-31,7290,380,521,901,福隆,三等
2020-01-01,7300,137,160,297,貢寮,甲簡
2020-01-02,7300,192,210,402,貢寮,甲簡
2020-01-03,7300,202,234,436,貢寮,甲簡
2020-01-04,7300,194,351,545,貢寮,甲簡
2020-01-05,7300,161,194,355,貢寮,甲簡
2020-01-06,7300,187,193,380,貢寮,甲簡
2020-01-07,7300,192,210,402,貢寮,甲簡
2020-01-08,7300,184,190,374,貢寮,甲簡
2020-01-09,7300,176,184,360,貢寮,甲簡
2020-01-10,7300,205,285,490,貢寮,甲簡
2020-01-11,7300,197,249,446,貢寮,甲簡
2020-01-12,7300,132,121,253,貢寮,甲簡
2020-01-13,7300,173,155,328,貢寮,甲簡
2020-01-14,7300,175,184,359,貢寮,甲簡
2020-01-15,7300,166,175,341,貢寮,甲簡
2020-01-16,7300,196,231,427,貢寮,甲簡
2020-01-17,7300,209,211,420,貢寮,甲簡
2020-01-18,7300,170,201,371,貢寮,甲簡
2020-01-19,7300,125,171,296,貢寮,甲簡
2020-01-20,7300,222,211,433,貢寮,甲簡
2020-01-21,7300,206,193,399,貢寮,甲簡
2020-01-22,7300,190,221,411,貢寮,甲簡
2020-01-23,7300,129,222,351,貢寮,甲簡
2020-01-24,7300,101,230,331,貢寮,甲簡
2020-01-25,7300,185,210,395,貢寮,甲簡
2020-01-26,7300,226,243,469,貢寮,甲簡
2020-01-27,7300,191,147,338,貢寮,甲簡
2020-01-28,7300,149,155,304,貢寮,甲簡
2020-01-29,7300,128,128,256,貢寮,甲簡
2020-01-30,7300,171,183,354,貢寮,甲簡
2020-01-31,7300,167,181,348,貢寮,甲簡
2020-02-01,7300,137,198,335,貢寮,甲簡
2020-02-02,7300,179,280,459,貢寮,甲簡
2020-02-03,7300,184,174,358,貢寮,甲簡
2020-02-04,7300,142,143,285,貢寮,甲簡
2020-02-05,7300,145,146,291,貢寮,甲簡
2020-02-06,7300,137,146,283,貢寮,甲簡
2020-02-07,7300,172,188,360,貢寮,甲簡
2020-02-08,7300,109,140,249,貢寮,甲簡
2020-02-09,7300,159,217,376,貢寮,甲簡
2020-02-10,7300,145,190,335,貢寮,甲簡
2020-02-11,7300,174,201,375,貢寮,甲簡
2020-02-12,7300,186,219,405,貢寮,甲簡
2020-02-13,7300,128,134,262,貢寮,甲簡
2020-02-14,7300,154,162,316,貢寮,甲簡
2020-02-15,7300,159,221,380,貢寮,甲簡
2020-02-16,7300,273,276,549,貢寮,甲簡
2020-02-17,7300,152,164,316,貢寮,甲簡
2020-02-18,7300,154,176,330,貢寮,甲簡
2020-02-19,7300,166,200,366,貢寮,甲簡
2020-02-20,7300,176,188,364,貢寮,甲簡
2020-02-21,7300,183,211,394,貢寮,甲簡
2020-02-22,7300,111,196,307,貢寮,甲簡
2020-02-23,7300,133,140,273,貢寮,甲簡
2020-02-24,7300,162,164,326,貢寮,甲簡
2020-02-25,7300,165,200,365,貢寮,甲簡
2020-02-26,7300,192,203,395,貢寮,甲簡
2020-02-27,7300,160,218,378,貢寮,甲簡
2020-02-28,7300,128,224,352,貢寮,甲簡
2020-02-29,7300,160,300,460,貢寮,甲簡
2020-03-01,7300,150,207,357,貢寮,甲簡
2020-03-02,7300,165,159,324,貢寮,甲簡
2020-03-03,7300,154,179,333,貢寮,甲簡
2020-03-04,7300,189,202,391,貢寮,甲簡
2020-03-05,7300,129,135,264,貢寮,甲簡
2020-03-06,7300,211,231,442,貢寮,甲簡
2020-03-07,7300,140,288,428,貢寮,甲簡
2020-03-08,7300,190,193,383,貢寮,甲簡
2020-03-09,7300,195,183,378,貢寮,甲簡
2020-03-10,7300,172,164,336,貢寮,甲簡
2020-03-11,7300,164,178,342,貢寮,甲簡
2020-03-12,7300,169,186,355,貢寮,甲簡
2020-03-13,7300,184,206,390,貢寮,甲簡
2020-03-14,7300,90,128,218,貢寮,甲簡
2020-03-15,7300,126,256,382,貢寮,甲簡
2020-03-16,7300,189,181,370,貢寮,甲簡
2020-03-17,7300,175,187,362,貢寮,甲簡
2020-03-18,7300,159,162,321,貢寮,甲簡
2020-03-19,7300,152,158,310,貢寮,甲簡
2020-03-20,7300,206,243,449,貢寮,甲簡
2020-03-21,7300,104,246,350,貢寮,甲簡
2020-03-22,7300,129,172,301,貢寮,甲簡
2020-03-23,7300,178,157,335,貢寮,甲簡
2020-03-24,7300,164,169,333,貢寮,甲簡
2020-03-25,7300,167,163,330,貢寮,甲簡
2020-03-26,7300,174,197,371,貢寮,甲簡
2020-03-27,7300,170,209,379,貢寮,甲簡
2020-03-28,7300,83,102,185,貢寮,甲簡
2020-03-29,7300,138,221,359,貢寮,甲簡
2020-03-30,7300,177,178,355,貢寮,甲簡
2020-03-31,7300,153,146,299,貢寮,甲簡
2020-04-01,7300,161,202,363,貢寮,甲簡
2020-04-02,7300,107,160,267,貢寮,甲簡
2020-04-03,7300,109,193,302,貢寮,甲簡
2020-04-04,7300,89,120,209,貢寮,甲簡
2020-04-05,7300,134,109,243,貢寮,甲簡
2020-04-06,7300,163,139,302,貢寮,甲簡
2020-04-07,7300,151,154,305,貢寮,甲簡
2020-04-08,7300,151,154,305,貢寮,甲簡
2020-04-09,7300,171,153,324,貢寮,甲簡
2020-04-10,7300,193,223,416,貢寮,甲簡
2020-04-11,7300,69,171,240,貢寮,甲簡
2020-04-12,7300,104,100,204,貢寮,甲簡
2020-04-13,7300,169,162,331,貢寮,甲簡
2020-04-14,7300,177,194,371,貢寮,甲簡
2020-04-15,7300,190,211,401,貢寮,甲簡
2020-04-16,7300,169,203,372,貢寮,甲簡
2020-04-17,7300,179,222,401,貢寮,甲簡
2020-04-18,7300,123,244,367,貢寮,甲簡
2020-04-19,7300,137,176,313,貢寮,甲簡
2020-04-20,7300,189,171,360,貢寮,甲簡
2020-04-21,7300,150,160,310,貢寮,甲簡
2020-04-22,7300,144,146,290,貢寮,甲簡
2020-04-23,7300,152,169,321,貢寮,甲簡
2020-04-24,7300,156,168,324,貢寮,甲簡
2020-04-25,7300,100,118,218,貢寮,甲簡
2020-04-26,7300,107,139,246,貢寮,甲簡
2020-04-27,7300,154,165,319,貢寮,甲簡
2020-04-28,7300,163,183,346,貢寮,甲簡
2020-04-29,7300,178,254,432,貢寮,甲簡
2020-04-30,7300,195,225,420,貢寮,甲簡
2020-05-01,7300,207,400,607,貢寮,甲簡
2020-05-02,7300,148,232,380,貢寮,甲簡
2020-05-03,7300,163,159,322,貢寮,甲簡
2020-05-04,7300,185,185,370,貢寮,甲簡
2020-05-05,7300,157,196,353,貢寮,甲簡
2020-05-06,7300,168,175,343,貢寮,甲簡
2020-05-07,7300,171,217,388,貢寮,甲簡
2020-05-08,7300,184,252,436,貢寮,甲簡
2020-05-09,7300,145,266,411,貢寮,甲簡
2020-05-10,7300,166,158,324,貢寮,甲簡
2020-05-11,7300,205,176,381,貢寮,甲簡
2020-05-12,7300,186,196,382,貢寮,甲簡
2020-05-13,7300,183,204,387,貢寮,甲簡
2020-05-14,7300,180,208,388,貢寮,甲簡
2020-05-15,7300,201,228,429,貢寮,甲簡
2020-05-16,7300,171,239,410,貢寮,甲簡
2020-05-17,7300,151,149,300,貢寮,甲簡
2020-05-18,7300,173,155,328,貢寮,甲簡
2020-05-19,7300,170,163,333,貢寮,甲簡
2020-05-20,7300,193,189,382,貢寮,甲簡
2020-05-21,7300,167,173,340,貢寮,甲簡
2020-05-22,7300,152,201,353,貢寮,甲簡
2020-05-23,7300,83,133,216,貢寮,甲簡
2020-05-24,7300,148,160,308,貢寮,甲簡
2020-05-25,7300,200,210,410,貢寮,甲簡
2020-05-26,7300,179,185,364,貢寮,甲簡
2020-05-27,7300,184,203,387,貢寮,甲簡
2020-05-28,7300,152,143,295,貢寮,甲簡
2020-05-29,7300,186,225,411,貢寮,甲簡
2020-05-30,7300,148,166,314,貢寮,甲簡
2020-05-31,7300,172,178,350,貢寮,甲簡
2020-06-01,7300,203,190,393,貢寮,甲簡
2020-06-02,7300,179,167,346,貢寮,甲簡
2020-06-03,7300,196,205,401,貢寮,甲簡
2020-06-04,7300,260,195,455,貢寮,甲簡
2020-06-05,7300,202,256,458,貢寮,甲簡
2020-06-06,7300,149,212,361,貢寮,甲簡
2020-06-07,7300,175,204,379,貢寮,甲簡
2020-06-08,7300,210,184,394,貢寮,甲簡
2020-06-09,7300,167,183,350,貢寮,甲簡
2020-06-10,7300,201,198,399,貢寮,甲簡
2020-06-11,7300,207,246,453,貢寮,甲簡
2020-06-12,7300,199,250,449,貢寮,甲簡
2020-06-13,7300,178,210,388,貢寮,甲簡
2020-06-14,7300,164,171,335,貢寮,甲簡
2020-06-15,7300,183,170,353,貢寮,甲簡
2020-06-16,7300,174,192,366,貢寮,甲簡
2020-06-17,7300,173,170,343,貢寮,甲簡
2020-06-18,7300,195,175,370,貢寮,甲簡
2020-06-19,7300,208,227,435,貢寮,甲簡
2020-06-20,7300,145,197,342,貢寮,甲簡
2020-06-21,7300,155,185,340,貢寮,甲簡
2020-06-22,7300,200,212,412,貢寮,甲簡
2020-06-23,7300,183,192,375,貢寮,甲簡
2020-06-24,7300,218,291,509,貢寮,甲簡
2020-06-25,7300,163,274,437,貢寮,甲簡
2020-06-26,7300,245,270,515,貢寮,甲簡
2020-06-27,7300,203,260,463,貢寮,甲簡
2020-06-28,7300,150,113,263,貢寮,甲簡
2020-06-29,7300,181,175,356,貢寮,甲簡
2020-06-30,7300,206,217,423,貢寮,甲簡
2020-07-01,7300,169,150,319,貢寮,甲簡
2020-07-02,7300,206,207,413,貢寮,甲簡
2020-07-03,7300,187,213,400,貢寮,甲簡
2020-07-04,7300,151,208,359,貢寮,甲簡
2020-07-05,7300,158,180,338,貢寮,甲簡
2020-07-06,7300,199,171,370,貢寮,甲簡
2020-07-07,7300,203,192,395,貢寮,甲簡
2020-07-08,7300,204,216,420,貢寮,甲簡
2020-07-09,7300,181,197,378,貢寮,甲簡
2020-07-10,7300,192,225,417,貢寮,甲簡
2020-07-11,7300,135,205,340,貢寮,甲簡
2020-07-12,7300,138,146,284,貢寮,甲簡
2020-07-13,7300,187,185,372,貢寮,甲簡
2020-07-14,7300,197,196,393,貢寮,甲簡
2020-07-15,7300,187,228,415,貢寮,甲簡
2020-07-16,7300,197,171,368,貢寮,甲簡
2020-07-17,7300,177,214,391,貢寮,甲簡
2020-07-18,7300,141,247,388,貢寮,甲簡
2020-07-19,7300,199,186,385,貢寮,甲簡
2020-07-20,7300,199,164,363,貢寮,甲簡
2020-07-21,7300,167,186,353,貢寮,甲簡
2020-07-22,7300,181,190,371,貢寮,甲簡
2020-07-23,7300,191,183,374,貢寮,甲簡
2020-07-24,7300,193,226,419,貢寮,甲簡
2020-07-25,7300,139,242,381,貢寮,甲簡
2020-07-26,7300,157,152,309,貢寮,甲簡
2020-07-27,7300,182,166,348,貢寮,甲簡
2020-07-28,7300,169,179,348,貢寮,甲簡
2020-07-29,7300,170,185,355,貢寮,甲簡
2020-07-30,7300,209,192,401,貢寮,甲簡
2020-07-31,7300,183,238,421,貢寮,甲簡
2020-08-01,7300,140,196,336,貢寮,甲簡
2020-08-02,7300,147,183,330,貢寮,甲簡
2020-08-03,7300,159,152,311,貢寮,甲簡
2020-08-04,7300,172,185,357,貢寮,甲簡
2020-08-05,7300,183,214,397,貢寮,甲簡
2020-08-06,7300,178,231,409,貢寮,甲簡
2020-08-07,7300,197,215,412,貢寮,甲簡
2020-08-08,7300,125,169,294,貢寮,甲簡
2020-08-09,7300,153,132,285,貢寮,甲簡
2020-08-10,7300,214,231,445,貢寮,甲簡
2020-08-11,7300,193,193,386,貢寮,甲簡
2020-08-12,7300,171,212,383,貢寮,甲簡
2020-08-13,7300,195,211,406,貢寮,甲簡
2020-08-14,7300,206,247,453,貢寮,甲簡
2020-08-15,7300,209,277,486,貢寮,甲簡
2020-08-16,7300,138,147,285,貢寮,甲簡
2020-08-17,7300,220,207,427,貢寮,甲簡
2020-08-18,7300,163,183,346,貢寮,甲簡
2020-08-19,7300,175,183,358,貢寮,甲簡
2020-08-20,7300,157,211,368,貢寮,甲簡
2020-08-21,7300,172,209,381,貢寮,甲簡
2020-08-22,7300,143,171,314,貢寮,甲簡
2020-08-23,7300,138,163,301,貢寮,甲簡
2020-08-24,7300,187,201,388,貢寮,甲簡
2020-08-25,7300,199,197,396,貢寮,甲簡
2020-08-26,7300,177,188,365,貢寮,甲簡
2020-08-27,7300,157,155,312,貢寮,甲簡
2020-08-28,7300,173,231,404,貢寮,甲簡
2020-08-29,7300,121,175,296,貢寮,甲簡
2020-08-30,7300,181,153,334,貢寮,甲簡
2020-08-31,7300,144,152,296,貢寮,甲簡
2020-09-01,7300,153,151,304,貢寮,甲簡
2020-09-02,7300,178,189,367,貢寮,甲簡
2020-09-03,7300,165,169,334,貢寮,甲簡
2020-09-04,7300,183,216,399,貢寮,甲簡
2020-09-05,7300,142,222,364,貢寮,甲簡
2020-09-06,7300,134,171,305,貢寮,甲簡
2020-09-07,7300,177,172,349,貢寮,甲簡
2020-09-08,7300,189,186,375,貢寮,甲簡
2020-09-09,7300,201,207,408,貢寮,甲簡
2020-09-10,7300,170,167,337,貢寮,甲簡
2020-09-11,7300,176,206,382,貢寮,甲簡
2020-09-12,7300,147,200,347,貢寮,甲簡
2020-09-13,7300,149,115,264,貢寮,甲簡
2020-09-14,7300,167,185,352,貢寮,甲簡
2020-09-15,7300,195,202,397,貢寮,甲簡
2020-09-16,7300,174,169,343,貢寮,甲簡
2020-09-17,7300,184,180,364,貢寮,甲簡
2020-09-18,7300,191,240,431,貢寮,甲簡
2020-09-19,7300,130,218,348,貢寮,甲簡
2020-09-20,7300,147,113,260,貢寮,甲簡
2020-09-21,7300,175,164,339,貢寮,甲簡
2020-09-22,7300,170,174,344,貢寮,甲簡
2020-09-23,7300,239,222,461,貢寮,甲簡
2020-09-24,7300,147,172,319,貢寮,甲簡
2020-09-25,7300,184,203,387,貢寮,甲簡
2020-09-26,7300,121,190,311,貢寮,甲簡
2020-09-27,7300,104,110,214,貢寮,甲簡
2020-09-28,7300,168,161,329,貢寮,甲簡
2020-09-29,7300,194,191,385,貢寮,甲簡
2020-09-30,7300,200,251,451,貢寮,甲簡
2020-10-01,7300,201,427,628,貢寮,甲簡
2020-10-02,7300,294,394,688,貢寮,甲簡
2020-10-03,7300,241,312,553,貢寮,甲簡
2020-10-04,7300,236,259,495,貢寮,甲簡
2020-10-05,7300,171,141,312,貢寮,甲簡
2020-10-06,7300,161,158,319,貢寮,甲簡
2020-10-07,7300,199,232,431,貢寮,甲簡
2020-10-08,7300,171,208,379,貢寮,甲簡
2020-10-09,7300,144,317,461,貢寮,甲簡
2020-10-10,7300,156,249,405,貢寮,甲簡
2020-10-11,7300,153,115,268,貢寮,甲簡
2020-10-12,7300,182,176,358,貢寮,甲簡
2020-10-13,7300,157,161,318,貢寮,甲簡
2020-10-14,7300,157,217,374,貢寮,甲簡
2020-10-15,7300,176,274,450,貢寮,甲簡
2020-10-16,7300,152,197,349,貢寮,甲簡
2020-10-17,7300,171,207,378,貢寮,甲簡
2020-10-18,7300,152,221,373,貢寮,甲簡
2020-10-19,7300,182,184,366,貢寮,甲簡
2020-10-20,7300,159,179,338,貢寮,甲簡
2020-10-21,7300,145,161,306,貢寮,甲簡
2020-10-22,7300,156,156,312,貢寮,甲簡
2020-10-23,7300,160,190,350,貢寮,甲簡
2020-10-24,7300,131,356,487,貢寮,甲簡
2020-10-25,7300,244,343,587,貢寮,甲簡
2020-10-26,7300,259,321,580,貢寮,甲簡
2020-10-27,7300,202,286,488,貢寮,甲簡
2020-10-28,7300,213,206,419,貢寮,甲簡
2020-10-29,7300,164,172,336,貢寮,甲簡
2020-10-30,7300,186,247,433,貢寮,甲簡
2020-10-31,7300,242,517,759,貢寮,甲簡
2020-11-01,7300,207,400,607,貢寮,甲簡
2020-11-02,7300,185,254,439,貢寮,甲簡
2020-11-03,7300,170,188,358,貢寮,甲簡
2020-11-04,7300,177,231,408,貢寮,甲簡
2020-11-05,7300,179,227,406,貢寮,甲簡
2020-11-06,7300,218,260,478,貢寮,甲簡
2020-11-07,7300,172,436,608,貢寮,甲簡
2020-11-08,7300,150,223,373,貢寮,甲簡
2020-11-09,7300,162,199,361,貢寮,甲簡
2020-11-10,7300,204,195,399,貢寮,甲簡
2020-11-11,7300,186,263,449,貢寮,甲簡
2020-11-12,7300,180,214,394,貢寮,甲簡
2020-11-13,7300,141,204,345,貢寮,甲簡
2020-11-14,7300,178,286,464,貢寮,甲簡
2020-11-15,7300,222,514,736,貢寮,甲簡
2020-11-16,7300,225,316,541,貢寮,甲簡
2020-11-17,7300,262,402,664,貢寮,甲簡
2020-11-18,7300,273,650,923,貢寮,甲簡
2020-11-19,7300,248,576,824,貢寮,甲簡
2020-11-20,7300,247,424,671,貢寮,甲簡
2020-11-21,7300,173,464,637,貢寮,甲簡
2020-11-22,7300,258,564,822,貢寮,甲簡
2020-11-23,7300,202,178,380,貢寮,甲簡
2020-11-24,7300,196,342,538,貢寮,甲簡
2020-11-25,7300,196,323,519,貢寮,甲簡
2020-11-26,7300,245,410,655,貢寮,甲簡
2020-11-27,7300,234,300,534,貢寮,甲簡
2020-11-28,7300,194,325,519,貢寮,甲簡
2020-11-29,7300,172,196,368,貢寮,甲簡
2020-11-30,7300,179,191,370,貢寮,甲簡
2020-12-01,7300,151,147,298,貢寮,甲簡
2020-12-02,7300,179,178,357,貢寮,甲簡
2020-12-03,7300,180,171,351,貢寮,甲簡
2020-12-04,7300,84,81,165,貢寮,甲簡
2020-12-05,7300,29,66,95,貢寮,甲簡
2020-12-06,7300,405,333,738,貢寮,甲簡
2020-12-07,7300,64,80,144,貢寮,甲簡
2020-12-08,7300,85,74,159,貢寮,甲簡
2020-12-09,7300,70,73,143,貢寮,甲簡
2020-12-10,7300,82,89,171,貢寮,甲簡
2020-12-11,7300,100,103,203,貢寮,甲簡
2020-12-12,7300,51,91,142,貢寮,甲簡
2020-12-13,7300,75,92,167,貢寮,甲簡
2020-12-14,7300,119,114,233,貢寮,甲簡
2020-12-15,7300,136,132,268,貢寮,甲簡
2020-12-16,7300,144,158,302,貢寮,甲簡
2020-12-17,7300,133,135,268,貢寮,甲簡
2020-12-18,7300,151,179,330,貢寮,甲簡
2020-12-19,7300,100,243,343,貢寮,甲簡
2020-12-20,7300,211,93,304,貢寮,甲簡
2020-12-21,7300,155,149,304,貢寮,甲簡
2020-12-22,7300,155,161,316,貢寮,甲簡
2020-12-23,7300,155,163,318,貢寮,甲簡
2020-12-24,7300,142,168,310,貢寮,甲簡
2020-12-25,7300,152,205,357,貢寮,甲簡
2020-12-26,7300,129,211,340,貢寮,甲簡
2020-12-27,7300,159,205,364,貢寮,甲簡
2020-12-28,7300,171,178,349,貢寮,甲簡
2020-12-29,7300,187,190,377,貢寮,甲簡
2020-12-30,7300,151,145,296,貢寮,甲簡
2020-12-31,7300,156,166,322,貢寮,甲簡
2020-01-01,7310,614,700,1314,雙溪,二等
2020-01-02,7310,751,781,1532,雙溪,二等
2020-01-03,7310,802,840,1642,雙溪,二等
2020-01-04,7310,890,862,1752,雙溪,二等
2020-01-05,7310,729,749,1478,雙溪,二等
2020-01-06,7310,774,779,1553,雙溪,二等
2020-01-07,7310,817,795,1612,雙溪,二等
2020-01-08,7310,754,746,1500,雙溪,二等
2020-01-09,7310,767,780,1547,雙溪,二等
2020-01-10,7310,874,897,1771,雙溪,二等
2020-01-11,7310,923,1004,1927,雙溪,二等
2020-01-12,7310,711,587,1298,雙溪,二等
2020-01-13,7310,735,769,1504,雙溪,二等
2020-01-14,7310,802,783,1585,雙溪,二等
2020-01-15,7310,702,656,1358,雙溪,二等
2020-01-16,7310,946,831,1777,雙溪,二等
2020-01-17,7310,834,884,1718,雙溪,二等
2020-01-18,7310,591,689,1280,雙溪,二等
2020-01-19,7310,678,668,1346,雙溪,二等
2020-01-20,7310,808,762,1570,雙溪,二等
2020-01-21,7310,807,858,1665,雙溪,二等
2020-01-22,7310,753,840,1593,雙溪,二等
2020-01-23,7310,569,902,1471,雙溪,二等
2020-01-24,7310,557,1046,1603,雙溪,二等
2020-01-25,7310,984,761,1745,雙溪,二等
2020-01-26,7310,887,808,1695,雙溪,二等
2020-01-27,7310,854,680,1534,雙溪,二等
2020-01-28,7310,717,570,1287,雙溪,二等
2020-01-29,7310,606,549,1155,雙溪,二等
2020-01-30,7310,729,710,1439,雙溪,二等
2020-01-31,7310,699,712,1411,雙溪,二等
2020-02-01,7310,576,658,1234,雙溪,二等
2020-02-02,7310,678,633,1311,雙溪,二等
2020-02-03,7310,647,645,1292,雙溪,二等
2020-02-04,7310,618,653,1271,雙溪,二等
2020-02-05,7310,588,608,1196,雙溪,二等
2020-02-06,7310,581,600,1181,雙溪,二等
2020-02-07,7310,596,653,1249,雙溪,二等
2020-02-08,7310,507,722,1229,雙溪,二等
2020-02-09,7310,636,511,1147,雙溪,二等
2020-02-10,7310,634,637,1271,雙溪,二等
2020-02-11,7310,663,657,1320,雙溪,二等
2020-02-12,7310,665,692,1357,雙溪,二等
2020-02-13,7310,624,592,1216,雙溪,二等
2020-02-14,7310,613,605,1218,雙溪,二等
2020-02-15,7310,570,652,1222,雙溪,二等
2020-02-16,7310,506,447,953,雙溪,二等
2020-02-17,7310,584,541,1125,雙溪,二等
2020-02-18,7310,604,595,1199,雙溪,二等
2020-02-19,7310,621,633,1254,雙溪,二等
2020-02-20,7310,629,653,1282,雙溪,二等
2020-02-21,7310,703,706,1409,雙溪,二等
2020-02-22,7310,597,702,1299,雙溪,二等
2020-02-23,7310,616,584,1200,雙溪,二等
2020-02-24,7310,707,674,1381,雙溪,二等
2020-02-25,7310,703,699,1402,雙溪,二等
2020-02-26,7310,716,662,1378,雙溪,二等
2020-02-27,7310,828,775,1603,雙溪,二等
2020-02-28,7310,632,771,1403,雙溪,二等
2020-02-29,7310,607,633,1240,雙溪,二等
2020-03-01,7310,631,577,1208,雙溪,二等
2020-03-02,7310,678,653,1331,雙溪,二等
2020-03-03,7310,680,690,1370,雙溪,二等
2020-03-04,7310,656,657,1313,雙溪,二等
2020-03-05,7310,634,639,1273,雙溪,二等
2020-03-06,7310,845,771,1616,雙溪,二等
2020-03-07,7310,619,777,1396,雙溪,二等
2020-03-08,7310,653,809,1462,雙溪,二等
2020-03-09,7310,665,736,1401,雙溪,二等
2020-03-10,7310,665,621,1286,雙溪,二等
2020-03-11,7310,700,708,1408,雙溪,二等
2020-03-12,7310,652,656,1308,雙溪,二等
2020-03-13,7310,839,778,1617,雙溪,二等
2020-03-14,7310,442,569,1011,雙溪,二等
2020-03-15,7310,765,785,1550,雙溪,二等
2020-03-16,7310,716,755,1471,雙溪,二等
2020-03-17,7310,709,709,1418,雙溪,二等
2020-03-18,7310,674,636,1310,雙溪,二等
2020-03-19,7310,656,640,1296,雙溪,二等
2020-03-20,7310,847,785,1632,雙溪,二等
2020-03-21,7310,576,743,1319,雙溪,二等
2020-03-22,7310,646,606,1252,雙溪,二等
2020-03-23,7310,669,704,1373,雙溪,二等
2020-03-24,7310,664,640,1304,雙溪,二等
2020-03-25,7310,646,630,1276,雙溪,二等
2020-03-26,7310,744,779,1523,雙溪,二等
2020-03-27,7310,820,758,1578,雙溪,二等
2020-03-28,7310,434,573,1007,雙溪,二等
2020-03-29,7310,653,624,1277,雙溪,二等
2020-03-30,7310,700,688,1388,雙溪,二等
2020-03-31,7310,627,622,1249,雙溪,二等
2020-04-01,7310,752,702,1454,雙溪,二等
2020-04-02,7310,418,600,1018,雙溪,二等
2020-04-03,7310,517,675,1192,雙溪,二等
2020-04-04,7310,647,567,1214,雙溪,二等
2020-04-05,7310,561,456,1017,雙溪,二等
2020-04-06,7310,655,623,1278,雙溪,二等
2020-04-07,7310,580,555,1135,雙溪,二等
2020-04-08,7310,601,604,1205,雙溪,二等
2020-04-09,7310,566,616,1182,雙溪,二等
2020-04-10,7310,822,777,1599,雙溪,二等
2020-04-11,7310,473,608,1081,雙溪,二等
2020-04-12,7310,434,425,859,雙溪,二等
2020-04-13,7310,621,628,1249,雙溪,二等
2020-04-14,7310,642,672,1314,雙溪,二等
2020-04-15,7310,610,638,1248,雙溪,二等
2020-04-16,7310,642,644,1286,雙溪,二等
2020-04-17,7310,806,772,1578,雙溪,二等
2020-04-18,7310,550,675,1225,雙溪,二等
2020-04-19,7310,661,678,1339,雙溪,二等
2020-04-20,7310,691,679,1370,雙溪,二等
2020-04-21,7310,579,564,1143,雙溪,二等
2020-04-22,7310,572,582,1154,雙溪,二等
2020-04-23,7310,566,558,1124,雙溪,二等
2020-04-24,7310,710,671,1381,雙溪,二等
2020-04-25,7310,434,380,814,雙溪,二等
2020-04-26,7310,552,525,1077,雙溪,二等
2020-04-27,7310,632,624,1256,雙溪,二等
2020-04-28,7310,654,649,1303,雙溪,二等
2020-04-29,7310,668,688,1356,雙溪,二等
2020-04-30,7310,694,725,1419,雙溪,二等
2020-05-01,7310,945,980,1925,雙溪,二等
2020-05-02,7310,676,812,1488,雙溪,二等
2020-05-03,7310,765,636,1401,雙溪,二等
2020-05-04,7310,704,707,1411,雙溪,二等
2020-05-05,7310,680,659,1339,雙溪,二等
2020-05-06,7310,720,731,1451,雙溪,二等
2020-05-07,7310,647,622,1269,雙溪,二等
2020-05-08,7310,886,849,1735,雙溪,二等
2020-05-09,7310,675,919,1594,雙溪,二等
2020-05-10,7310,780,659,1439,雙溪,二等
2020-05-11,7310,688,660,1348,雙溪,二等
2020-05-12,7310,654,629,1283,雙溪,二等
2020-05-13,7310,687,726,1413,雙溪,二等
2020-05-14,7310,696,697,1393,雙溪,二等
2020-05-15,7310,853,858,1711,雙溪,二等
2020-05-16,7310,720,863,1583,雙溪,二等
2020-05-17,7310,667,642,1309,雙溪,二等
2020-05-18,7310,710,692,1402,雙溪,二等
2020-05-19,7310,675,640,1315,雙溪,二等
2020-05-20,7310,675,673,1348,雙溪,二等
2020-05-21,7310,642,629,1271,雙溪,二等
2020-05-22,7310,778,751,1529,雙溪,二等
2020-05-23,7310,465,565,1030,雙溪,二等
2020-05-24,7310,670,681,1351,雙溪,二等
2020-05-25,7310,735,758,1493,雙溪,二等
2020-05-26,7310,694,703,1397,雙溪,二等
2020-05-27,7310,660,659,1319,雙溪,二等
2020-05-28,7310,598,635,1233,雙溪,二等
2020-05-29,7310,845,796,1641,雙溪,二等
2020-05-30,7310,698,847,1545,雙溪,二等
2020-05-31,7310,733,680,1413,雙溪,二等
2020-06-01,7310,689,761,1450,雙溪,二等
2020-06-02,7310,734,741,1475,雙溪,二等
2020-06-03,7310,722,713,1435,雙溪,二等
2020-06-04,7310,732,739,1471,雙溪,二等
2020-06-05,7310,946,956,1902,雙溪,二等
2020-06-06,7310,770,967,1737,雙溪,二等
2020-06-07,7310,759,753,1512,雙溪,二等
2020-06-08,7310,720,734,1454,雙溪,二等
2020-06-09,7310,725,756,1481,雙溪,二等
2020-06-10,7310,775,771,1546,雙溪,二等
2020-06-11,7310,786,809,1595,雙溪,二等
2020-06-12,7310,921,849,1770,雙溪,二等
2020-06-13,7310,808,1025,1833,雙溪,二等
2020-06-14,7310,946,967,1913,雙溪,二等
2020-06-15,7310,836,811,1647,雙溪,二等
2020-06-16,7310,697,729,1426,雙溪,二等
2020-06-17,7310,731,787,1518,雙溪,二等
2020-06-18,7310,739,806,1545,雙溪,二等
2020-06-19,7310,736,809,1545,雙溪,二等
2020-06-20,7310,829,849,1678,雙溪,二等
2020-06-21,7310,784,726,1510,雙溪,二等
2020-06-22,7310,776,815,1591,雙溪,二等
2020-06-23,7310,841,856,1697,雙溪,二等
2020-06-24,7310,861,969,1830,雙溪,二等
2020-06-25,7310,762,1069,1831,雙溪,二等
2020-06-26,7310,879,994,1873,雙溪,二等
2020-06-27,7310,853,800,1653,雙溪,二等
2020-06-28,7310,744,671,1415,雙溪,二等
2020-06-29,7310,749,795,1544,雙溪,二等
2020-06-30,7310,734,741,1475,雙溪,二等
2020-07-01,7310,685,721,1406,雙溪,二等
2020-07-02,7310,704,703,1407,雙溪,二等
2020-07-03,7310,836,840,1676,雙溪,二等
2020-07-04,7310,770,893,1663,雙溪,二等
2020-07-05,7310,706,684,1390,雙溪,二等
2020-07-06,7310,713,736,1449,雙溪,二等
2020-07-07,7310,740,706,1446,雙溪,二等
2020-07-08,7310,758,835,1593,雙溪,二等
2020-07-09,7310,783,812,1595,雙溪,二等
2020-07-10,7310,955,940,1895,雙溪,二等
2020-07-11,7310,914,1121,2035,雙溪,二等
2020-07-12,7310,896,834,1730,雙溪,二等
2020-07-13,7310,766,777,1543,雙溪,二等
2020-07-14,7310,899,853,1752,雙溪,二等
2020-07-15,7310,693,744,1437,雙溪,二等
2020-07-16,7310,716,720,1436,雙溪,二等
2020-07-17,7310,795,892,1687,雙溪,二等
2020-07-18,7310,724,997,1721,雙溪,二等
2020-07-19,7310,846,760,1606,雙溪,二等
2020-07-20,7310,790,748,1538,雙溪,二等
2020-07-21,7310,723,740,1463,雙溪,二等
2020-07-22,7310,765,801,1566,雙溪,二等
2020-07-23,7310,756,782,1538,雙溪,二等
2020-07-24,7310,785,779,1564,雙溪,二等
2020-07-25,7310,653,860,1513,雙溪,二等
2020-07-26,7310,759,730,1489,雙溪,二等
2020-07-27,7310,754,788,1542,雙溪,二等
2020-07-28,7310,729,768,1497,雙溪,二等
2020-07-29,7310,814,778,1592,雙溪,二等
2020-07-30,7310,793,828,1621,雙溪,二等
2020-07-31,7310,848,845,1693,雙溪,二等
2020-08-01,7310,833,972,1805,雙溪,二等
2020-08-02,7310,743,754,1497,雙溪,二等
2020-08-03,7310,590,591,1181,雙溪,二等
2020-08-04,7310,643,633,1276,雙溪,二等
2020-08-05,7310,677,734,1411,雙溪,二等
2020-08-06,7310,744,734,1478,雙溪,二等
2020-08-07,7310,777,800,1577,雙溪,二等
2020-08-08,7310,764,927,1691,雙溪,二等
2020-08-09,7310,870,763,1633,雙溪,二等
2020-08-10,7310,867,892,1759,雙溪,二等
2020-08-11,7310,760,780,1540,雙溪,二等
2020-08-12,7310,786,774,1560,雙溪,二等
2020-08-13,7310,865,886,1751,雙溪,二等
2020-08-14,7310,828,862,1690,雙溪,二等
2020-08-15,7310,734,937,1671,雙溪,二等
2020-08-16,7310,845,820,1665,雙溪,二等
2020-08-17,7310,765,743,1508,雙溪,二等
2020-08-18,7310,834,830,1664,雙溪,二等
2020-08-19,7310,700,776,1476,雙溪,二等
2020-08-20,7310,912,789,1701,雙溪,二等
2020-08-21,7310,854,905,1759,雙溪,二等
2020-08-22,7310,704,1039,1743,雙溪,二等
2020-08-23,7310,725,564,1289,雙溪,二等
2020-08-24,7310,754,751,1505,雙溪,二等
2020-08-25,7310,756,794,1550,雙溪,二等
2020-08-26,7310,839,947,1786,雙溪,二等
2020-08-27,7310,744,965,1709,雙溪,二等
2020-08-28,7310,761,780,1541,雙溪,二等
2020-08-29,7310,685,785,1470,雙溪,二等
2020-08-30,7310,818,869,1687,雙溪,二等
2020-08-31,7310,711,716,1427,雙溪,二等
2020-09-01,7310,710,776,1486,雙溪,二等
2020-09-02,7310,785,834,1619,雙溪,二等
2020-09-03,7310,719,706,1425,雙溪,二等
2020-09-04,7310,918,826,1744,雙溪,二等
2020-09-05,7310,819,963,1782,雙溪,二等
2020-09-06,7310,790,774,1564,雙溪,二等
2020-09-07,7310,794,852,1646,雙溪,二等
2020-09-08,7310,753,778,1531,雙溪,二等
2020-09-09,7310,803,804,1607,雙溪,二等
2020-09-10,7310,723,725,1448,雙溪,二等
2020-09-11,7310,976,931,1907,雙溪,二等
2020-09-12,7310,717,857,1574,雙溪,二等
2020-09-13,7310,723,759,1482,雙溪,二等
2020-09-14,7310,737,737,1474,雙溪,二等
2020-09-15,7310,749,753,1502,雙溪,二等
2020-09-16,7310,791,795,1586,雙溪,二等
2020-09-17,7310,775,782,1557,雙溪,二等
2020-09-18,7310,743,884,1627,雙溪,二等
2020-09-19,7310,928,969,1897,雙溪,二等
2020-09-20,7310,772,660,1432,雙溪,二等
2020-09-21,7310,730,820,1550,雙溪,二等
2020-09-22,7310,718,850,1568,雙溪,二等
2020-09-23,7310,827,857,1684,雙溪,二等
2020-09-24,7310,750,715,1465,雙溪,二等
2020-09-25,7310,679,771,1450,雙溪,二等
2020-09-26,7310,892,821,1713,雙溪,二等
2020-09-27,7310,554,600,1154,雙溪,二等
2020-09-28,7310,632,676,1308,雙溪,二等
2020-09-29,7310,788,786,1574,雙溪,二等
2020-09-30,7310,1095,1084,2179,雙溪,二等
2020-10-01,7310,755,1218,1973,雙溪,二等
2020-10-02,7310,1029,987,2016,雙溪,二等
2020-10-03,7310,1019,866,1885,雙溪,二等
2020-10-04,7310,792,703,1495,雙溪,二等
2020-10-05,7310,682,697,1379,雙溪,二等
2020-10-06,7310,711,694,1405,雙溪,二等
2020-10-07,7310,772,769,1541,雙溪,二等
2020-10-08,7310,910,804,1714,雙溪,二等
2020-10-09,7310,687,830,1517,雙溪,二等
2020-10-10,7310,718,779,1497,雙溪,二等
2020-10-11,7310,743,670,1413,雙溪,二等
2020-10-12,7310,656,681,1337,雙溪,二等
2020-10-13,7310,595,588,1183,雙溪,二等
2020-10-14,7310,733,692,1425,雙溪,二等
2020-10-15,7310,702,680,1382,雙溪,二等
2020-10-16,7310,882,853,1735,雙溪,二等
2020-10-17,7310,634,749,1383,雙溪,二等
2020-10-18,7310,641,683,1324,雙溪,二等
2020-10-19,7310,663,690,1353,雙溪,二等
2020-10-20,7310,757,758,1515,雙溪,二等
2020-10-21,7310,715,692,1407,雙溪,二等
2020-10-22,7310,693,682,1375,雙溪,二等
2020-10-23,7310,930,927,1857,雙溪,二等
2020-10-24,7310,844,986,1830,雙溪,二等
2020-10-25,7310,904,817,1721,雙溪,二等
2020-10-26,7310,847,859,1706,雙溪,二等
2020-10-27,7310,767,757,1524,雙溪,二等
2020-10-28,7310,776,784,1560,雙溪,二等
2020-10-29,7310,696,685,1381,雙溪,二等
2020-10-30,7310,949,879,1828,雙溪,二等
2020-10-31,7310,674,806,1480,雙溪,二等
2020-11-01,7310,796,793,1589,雙溪,二等
2020-11-02,7310,815,844,1659,雙溪,二等
2020-11-03,7310,710,716,1426,雙溪,二等
2020-11-04,7310,813,815,1628,雙溪,二等
2020-11-05,7310,762,739,1501,雙溪,二等
2020-11-06,7310,788,848,1636,雙溪,二等
2020-11-07,7310,981,962,1943,雙溪,二等
2020-11-08,7310,655,561,1216,雙溪,二等
2020-11-09,7310,828,923,1751,雙溪,二等
2020-11-10,7310,734,755,1489,雙溪,二等
2020-11-11,7310,777,766,1543,雙溪,二等
2020-11-12,7310,752,763,1515,雙溪,二等
2020-11-13,7310,841,802,1643,雙溪,二等
2020-11-14,7310,675,797,1472,雙溪,二等
2020-11-15,7310,737,760,1497,雙溪,二等
2020-11-16,7310,749,742,1491,雙溪,二等
2020-11-17,7310,812,805,1617,雙溪,二等
2020-11-18,7310,789,785,1574,雙溪,二等
2020-11-19,7310,819,813,1632,雙溪,二等
2020-11-20,7310,948,898,1846,雙溪,二等
2020-11-21,7310,674,800,1474,雙溪,二等
2020-11-22,7310,764,785,1549,雙溪,二等
2020-11-23,7310,705,716,1421,雙溪,二等
2020-11-24,7310,712,703,1415,雙溪,二等
2020-11-25,7310,781,791,1572,雙溪,二等
2020-11-26,7310,728,821,1549,雙溪,二等
2020-11-27,7310,920,828,1748,雙溪,二等
2020-11-28,7310,581,756,1337,雙溪,二等
2020-11-29,7310,698,642,1340,雙溪,二等
2020-11-30,7310,729,688,1417,雙溪,二等
2020-12-01,7310,644,634,1278,雙溪,二等
2020-12-02,7310,702,699,1401,雙溪,二等
2020-12-03,7310,674,671,1345,雙溪,二等
2020-12-04,7310,385,374,759,雙溪,二等
2020-12-05,7310,136,214,350,雙溪,二等
2020-12-06,7310,923,1421,2344,雙溪,二等
2020-12-07,7310,245,259,504,雙溪,二等
2020-12-08,7310,258,262,520,雙溪,二等
2020-12-09,7310,246,259,505,雙溪,二等
2020-12-10,7310,260,267,527,雙溪,二等
2020-12-11,7310,353,308,661,雙溪,二等
2020-12-12,7310,245,300,545,雙溪,二等
2020-12-13,7310,236,254,490,雙溪,二等
2020-12-14,7310,472,523,995,雙溪,二等
2020-12-15,7310,521,540,1061,雙溪,二等
2020-12-16,7310,573,559,1132,雙溪,二等
2020-12-17,7310,528,539,1067,雙溪,二等
2020-12-18,7310,834,724,1558,雙溪,二等
2020-12-19,7310,518,654,1172,雙溪,二等
2020-12-20,7310,618,586,1204,雙溪,二等
2020-12-21,7310,785,632,1417,雙溪,二等
2020-12-22,7310,583,747,1330,雙溪,二等
2020-12-23,7310,588,593,1181,雙溪,二等
2020-12-24,7310,594,605,1199,雙溪,二等
2020-12-25,7310,804,731,1535,雙溪,二等
2020-12-26,7310,545,650,1195,雙溪,二等
2020-12-27,7310,669,699,1368,雙溪,二等
2020-12-28,7310,638,709,1347,雙溪,二等
2020-12-29,7310,683,681,1364,雙溪,二等
2020-12-30,7310,605,580,1185,雙溪,二等
2020-12-31,7310,777,647,1424,雙溪,二等
2020-01-01,7320,90,120,210,牡丹,簡易
2020-01-02,7320,116,127,243,牡丹,簡易
2020-01-03,7320,124,147,271,牡丹,簡易
2020-01-04,7320,145,197,342,牡丹,簡易
2020-01-05,7320,155,179,334,牡丹,簡易
2020-01-06,7320,117,127,244,牡丹,簡易
2020-01-07,7320,133,127,260,牡丹,簡易
2020-01-08,7320,109,139,248,牡丹,簡易
2020-01-09,7320,119,114,233,牡丹,簡易
2020-01-10,7320,121,136,257,牡丹,簡易
2020-01-11,7320,117,162,279,牡丹,簡易
2020-01-12,7320,90,134,224,牡丹,簡易
2020-01-13,7320,116,112,228,牡丹,簡易
2020-01-14,7320,104,114,218,牡丹,簡易
2020-01-15,7320,102,101,203,牡丹,簡易
2020-01-16,7320,127,133,260,牡丹,簡易
2020-01-17,7320,138,133,271,牡丹,簡易
2020-01-18,7320,95,105,200,牡丹,簡易
2020-01-19,7320,116,136,252,牡丹,簡易
2020-01-20,7320,113,132,245,牡丹,簡易
2020-01-21,7320,150,141,291,牡丹,簡易
2020-01-22,7320,117,124,241,牡丹,簡易
2020-01-23,7320,115,204,319,牡丹,簡易
2020-01-24,7320,103,154,257,牡丹,簡易
2020-01-25,7320,134,102,236,牡丹,簡易
2020-01-26,7320,130,119,249,牡丹,簡易
2020-01-27,7320,137,126,263,牡丹,簡易
2020-01-28,7320,97,116,213,牡丹,簡易
2020-01-29,7320,114,91,205,牡丹,簡易
2020-01-30,7320,124,110,234,牡丹,簡易
2020-01-31,7320,118,147,265,牡丹,簡易
2020-02-01,7320,138,213,351,牡丹,簡易
2020-02-02,7320,164,165,329,牡丹,簡易
2020-02-03,7320,117,119,236,牡丹,簡易
2020-02-04,7320,97,108,205,牡丹,簡易
2020-02-05,7320,100,126,226,牡丹,簡易
2020-02-06,7320,112,110,222,牡丹,簡易
2020-02-07,7320,111,117,228,牡丹,簡易
2020-02-08,7320,102,215,317,牡丹,簡易
2020-02-09,7320,111,130,241,牡丹,簡易
2020-02-10,7320,102,121,223,牡丹,簡易
2020-02-11,7320,113,115,228,牡丹,簡易
2020-02-12,7320,126,131,257,牡丹,簡易
2020-02-13,7320,113,124,237,牡丹,簡易
2020-02-14,7320,122,129,251,牡丹,簡易
2020-02-15,7320,110,133,243,牡丹,簡易
2020-02-16,7320,83,104,187,牡丹,簡易
2020-02-17,7320,109,113,222,牡丹,簡易
2020-02-18,7320,116,133,249,牡丹,簡易
2020-02-19,7320,116,107,223,牡丹,簡易
2020-02-20,7320,114,105,219,牡丹,簡易
2020-02-21,7320,109,116,225,牡丹,簡易
2020-02-22,7320,160,154,314,牡丹,簡易
2020-02-23,7320,146,166,312,牡丹,簡易
2020-02-24,7320,94,92,186,牡丹,簡易
2020-02-25,7320,95,107,202,牡丹,簡易
2020-02-26,7320,96,129,225,牡丹,簡易
2020-02-27,7320,96,120,216,牡丹,簡易
2020-02-28,7320,123,139,262,牡丹,簡易
2020-02-29,7320,141,154,295,牡丹,簡易
2020-03-01,7320,163,88,251,牡丹,簡易
2020-03-02,7320,98,115,213,牡丹,簡易
2020-03-03,7320,96,116,212,牡丹,簡易
2020-03-04,7320,88,93,181,牡丹,簡易
2020-03-05,7320,101,95,196,牡丹,簡易
2020-03-06,7320,101,119,220,牡丹,簡易
2020-03-07,7320,115,236,351,牡丹,簡易
2020-03-08,7320,122,154,276,牡丹,簡易
2020-03-09,7320,121,120,241,牡丹,簡易
2020-03-10,7320,83,90,173,牡丹,簡易
2020-03-11,7320,140,144,284,牡丹,簡易
2020-03-12,7320,100,118,218,牡丹,簡易
2020-03-13,7320,96,120,216,牡丹,簡易
2020-03-14,7320,88,135,223,牡丹,簡易
2020-03-15,7320,225,185,410,牡丹,簡易
2020-03-16,7320,119,115,234,牡丹,簡易
2020-03-17,7320,132,127,259,牡丹,簡易
2020-03-18,7320,88,121,209,牡丹,簡易
2020-03-19,7320,94,95,189,牡丹,簡易
2020-03-20,7320,112,143,255,牡丹,簡易
2020-03-21,7320,139,129,268,牡丹,簡易
2020-03-22,7320,146,168,314,牡丹,簡易
2020-03-23,7320,92,96,188,牡丹,簡易
2020-03-24,7320,99,108,207,牡丹,簡易
2020-03-25,7320,116,107,223,牡丹,簡易
2020-03-26,7320,106,114,220,牡丹,簡易
2020-03-27,7320,110,142,252,牡丹,簡易
2020-03-28,7320,109,71,180,牡丹,簡易
2020-03-29,7320,150,110,260,牡丹,簡易
2020-03-30,7320,101,110,211,牡丹,簡易
2020-03-31,7320,112,114,226,牡丹,簡易
2020-04-01,7320,83,127,210,牡丹,簡易
2020-04-02,7320,62,101,163,牡丹,簡易
2020-04-03,7320,116,123,239,牡丹,簡易
2020-04-04,7320,87,92,179,牡丹,簡易
2020-04-05,7320,88,80,168,牡丹,簡易
2020-04-06,7320,97,108,205,牡丹,簡易
2020-04-07,7320,92,94,186,牡丹,簡易
2020-04-08,7320,81,93,174,牡丹,簡易
2020-04-09,7320,76,103,179,牡丹,簡易
2020-04-10,7320,124,146,270,牡丹,簡易
2020-04-11,7320,109,108,217,牡丹,簡易
2020-04-12,7320,113,98,211,牡丹,簡易
2020-04-13,7320,95,96,191,牡丹,簡易
2020-04-14,7320,107,103,210,牡丹,簡易
2020-04-15,7320,103,99,202,牡丹,簡易
2020-04-16,7320,94,113,207,牡丹,簡易
2020-04-17,7320,102,147,249,牡丹,簡易
2020-04-18,7320,168,212,380,牡丹,簡易
2020-04-19,7320,154,186,340,牡丹,簡易
2020-04-20,7320,93,95,188,牡丹,簡易
2020-04-21,7320,93,96,189,牡丹,簡易
2020-04-22,7320,96,102,198,牡丹,簡易
2020-04-23,7320,94,102,196,牡丹,簡易
2020-04-24,7320,97,121,218,牡丹,簡易
2020-04-25,7320,85,55,140,牡丹,簡易
2020-04-26,7320,100,109,209,牡丹,簡易
2020-04-27,7320,111,106,217,牡丹,簡易
2020-04-28,7320,109,129,238,牡丹,簡易
2020-04-29,7320,129,135,264,牡丹,簡易
2020-04-30,7320,103,113,216,牡丹,簡易
2020-05-01,7320,157,217,374,牡丹,簡易
2020-05-02,7320,129,183,312,牡丹,簡易
2020-05-03,7320,119,164,283,牡丹,簡易
2020-05-04,7320,107,110,217,牡丹,簡易
2020-05-05,7320,100,115,215,牡丹,簡易
2020-05-06,7320,133,133,266,牡丹,簡易
2020-05-07,7320,109,124,233,牡丹,簡易
2020-05-08,7320,116,128,244,牡丹,簡易
2020-05-09,7320,163,175,338,牡丹,簡易
2020-05-10,7320,257,254,511,牡丹,簡易
2020-05-11,7320,91,104,195,牡丹,簡易
2020-05-12,7320,103,105,208,牡丹,簡易
2020-05-13,7320,137,124,261,牡丹,簡易
2020-05-14,7320,122,110,232,牡丹,簡易
2020-05-15,7320,107,141,248,牡丹,簡易
2020-05-16,7320,138,137,275,牡丹,簡易
2020-05-17,7320,104,167,271,牡丹,簡易
2020-05-18,7320,103,109,212,牡丹,簡易
2020-05-19,7320,105,117,222,牡丹,簡易
2020-05-20,7320,107,108,215,牡丹,簡易
2020-05-21,7320,96,100,196,牡丹,簡易
2020-05-22,7320,97,126,223,牡丹,簡易
2020-05-23,7320,94,104,198,牡丹,簡易
2020-05-24,7320,148,142,290,牡丹,簡易
2020-05-25,7320,91,133,224,牡丹,簡易
2020-05-26,7320,117,135,252,牡丹,簡易
2020-05-27,7320,106,115,221,牡丹,簡易
2020-05-28,7320,103,111,214,牡丹,簡易
2020-05-29,7320,95,124,219,牡丹,簡易
2020-05-30,7320,132,162,294,牡丹,簡易
2020-05-31,7320,126,131,257,牡丹,簡易
2020-06-01,7320,130,124,254,牡丹,簡易
2020-06-02,7320,107,127,234,牡丹,簡易
2020-06-03,7320,114,122,236,牡丹,簡易
2020-06-04,7320,109,133,242,牡丹,簡易
2020-06-05,7320,129,169,298,牡丹,簡易
2020-06-06,7320,149,180,329,牡丹,簡易
2020-06-07,7320,102,122,224,牡丹,簡易
2020-06-08,7320,109,129,238,牡丹,簡易
2020-06-09,7320,127,122,249,牡丹,簡易
2020-06-10,7320,109,128,237,牡丹,簡易
2020-06-11,7320,143,148,291,牡丹,簡易
2020-06-12,7320,118,150,268,牡丹,簡易
2020-06-13,7320,168,150,318,牡丹,簡易
2020-06-14,7320,186,160,346,牡丹,簡易
2020-06-15,7320,109,133,242,牡丹,簡易
2020-06-16,7320,118,117,235,牡丹,簡易
2020-06-17,7320,110,121,231,牡丹,簡易
2020-06-18,7320,96,117,213,牡丹,簡易
2020-06-19,7320,123,136,259,牡丹,簡易
2020-06-20,7320,122,158,280,牡丹,簡易
2020-06-21,7320,151,223,374,牡丹,簡易
2020-06-22,7320,127,159,286,牡丹,簡易
2020-06-23,7320,173,145,318,牡丹,簡易
2020-06-24,7320,165,202,367,牡丹,簡易
2020-06-25,7320,134,152,286,牡丹,簡易
2020-06-26,7320,202,188,390,牡丹,簡易
2020-06-27,7320,112,129,241,牡丹,簡易
2020-06-28,7320,116,95,211,牡丹,簡易
2020-06-29,7320,101,119,220,牡丹,簡易
2020-06-30,7320,112,124,236,牡丹,簡易
2020-07-01,7320,163,158,321,牡丹,簡易
2020-07-02,7320,121,122,243,牡丹,簡易
2020-07-03,7320,110,125,235,牡丹,簡易
2020-07-04,7320,131,139,270,牡丹,簡易
2020-07-05,7320,160,227,387,牡丹,簡易
2020-07-06,7320,96,104,200,牡丹,簡易
2020-07-07,7320,105,127,232,牡丹,簡易
2020-07-08,7320,137,128,265,牡丹,簡易
2020-07-09,7320,107,112,219,牡丹,簡易
2020-07-10,7320,160,162,322,牡丹,簡易
2020-07-11,7320,219,312,531,牡丹,簡易
2020-07-12,7320,167,146,313,牡丹,簡易
2020-07-13,7320,96,110,206,牡丹,簡易
2020-07-14,7320,110,107,217,牡丹,簡易
2020-07-15,7320,123,114,237,牡丹,簡易
2020-07-16,7320,115,124,239,牡丹,簡易
2020-07-17,7320,119,129,248,牡丹,簡易
2020-07-18,7320,178,209,387,牡丹,簡易
2020-07-19,7320,148,151,299,牡丹,簡易
2020-07-20,7320,144,151,295,牡丹,簡易
2020-07-21,7320,106,113,219,牡丹,簡易
2020-07-22,7320,108,123,231,牡丹,簡易
2020-07-23,7320,124,124,248,牡丹,簡易
2020-07-24,7320,113,146,259,牡丹,簡易
2020-07-25,7320,135,128,263,牡丹,簡易
2020-07-26,7320,120,105,225,牡丹,簡易
2020-07-27,7320,118,125,243,牡丹,簡易
2020-07-28,7320,121,124,245,牡丹,簡易
2020-07-29,7320,126,128,254,牡丹,簡易
2020-07-30,7320,130,133,263,牡丹,簡易
2020-07-31,7320,118,128,246,牡丹,簡易
2020-08-01,7320,171,177,348,牡丹,簡易
2020-08-02,7320,128,135,263,牡丹,簡易
2020-08-03,7320,117,110,227,牡丹,簡易
2020-08-04,7320,110,111,221,牡丹,簡易
2020-08-05,7320,126,133,259,牡丹,簡易
2020-08-06,7320,136,143,279,牡丹,簡易
2020-08-07,7320,132,155,287,牡丹,簡易
2020-08-08,7320,168,187,355,牡丹,簡易
2020-08-09,7320,152,104,256,牡丹,簡易
2020-08-10,7320,121,157,278,牡丹,簡易
2020-08-11,7320,103,125,228,牡丹,簡易
2020-08-12,7320,133,180,313,牡丹,簡易
2020-08-13,7320,115,121,236,牡丹,簡易
2020-08-14,7320,120,134,254,牡丹,簡易
2020-08-15,7320,125,148,273,牡丹,簡易
2020-08-16,7320,145,142,287,牡丹,簡易
2020-08-17,7320,125,134,259,牡丹,簡易
2020-08-18,7320,129,134,263,牡丹,簡易
2020-08-19,7320,143,140,283,牡丹,簡易
2020-08-20,7320,119,246,365,牡丹,簡易
2020-08-21,7320,119,136,255,牡丹,簡易
2020-08-22,7320,157,144,301,牡丹,簡易
2020-08-23,7320,90,86,176,牡丹,簡易
2020-08-24,7320,109,124,233,牡丹,簡易
2020-08-25,7320,121,123,244,牡丹,簡易
2020-08-26,7320,160,165,325,牡丹,簡易
2020-08-27,7320,115,116,231,牡丹,簡易
2020-08-28,7320,143,138,281,牡丹,簡易
2020-08-29,7320,93,132,225,牡丹,簡易
2020-08-30,7320,135,122,257,牡丹,簡易
2020-08-31,7320,116,125,241,牡丹,簡易
2020-09-01,7320,121,118,239,牡丹,簡易
2020-09-02,7320,135,132,267,牡丹,簡易
2020-09-03,7320,105,116,221,牡丹,簡易
2020-09-04,7320,128,154,282,牡丹,簡易
2020-09-05,7320,128,236,364,牡丹,簡易
2020-09-06,7320,143,117,260,牡丹,簡易
2020-09-07,7320,119,105,224,牡丹,簡易
2020-09-08,7320,107,126,233,牡丹,簡易
2020-09-09,7320,120,113,233,牡丹,簡易
2020-09-10,7320,122,127,249,牡丹,簡易
2020-09-11,7320,116,159,275,牡丹,簡易
2020-09-12,7320,132,182,314,牡丹,簡易
2020-09-13,7320,132,180,312,牡丹,簡易
2020-09-14,7320,110,123,233,牡丹,簡易
2020-09-15,7320,124,139,263,牡丹,簡易
2020-09-16,7320,138,138,276,牡丹,簡易
2020-09-17,7320,114,113,227,牡丹,簡易
2020-09-18,7320,114,164,278,牡丹,簡易
2020-09-19,7320,121,145,266,牡丹,簡易
2020-09-20,7320,118,120,238,牡丹,簡易
2020-09-21,7320,119,110,229,牡丹,簡易
2020-09-22,7320,118,138,256,牡丹,簡易
2020-09-23,7320,146,121,267,牡丹,簡易
2020-09-24,7320,102,122,224,牡丹,簡易
2020-09-25,7320,125,144,269,牡丹,簡易
2020-09-26,7320,105,134,239,牡丹,簡易
2020-09-27,7320,160,140,300,牡丹,簡易
2020-09-28,7320,115,123,238,牡丹,簡易
2020-09-29,7320,107,129,236,牡丹,簡易
2020-09-30,7320,138,164,302,牡丹,簡易
2020-10-01,7320,155,186,341,牡丹,簡易
2020-10-02,7320,223,288,511,牡丹,簡易
2020-10-03,7320,192,209,401,牡丹,簡易
2020-10-04,7320,156,170,326,牡丹,簡易
2020-10-05,7320,118,138,256,牡丹,簡易
2020-10-06,7320,131,121,252,牡丹,簡易
2020-10-07,7320,120,193,313,牡丹,簡易
2020-10-08,7320,149,154,303,牡丹,簡易
2020-10-09,7320,131,211,342,牡丹,簡易
2020-10-10,7320,114,182,296,牡丹,簡易
2020-10-11,7320,95,84,179,牡丹,簡易
2020-10-12,7320,111,110,221,牡丹,簡易
2020-10-13,7320,101,109,210,牡丹,簡易
2020-10-14,7320,136,141,277,牡丹,簡易
2020-10-15,7320,118,133,251,牡丹,簡易
2020-10-16,7320,130,138,268,牡丹,簡易
2020-10-17,7320,108,136,244,牡丹,簡易
2020-10-18,7320,131,99,230,牡丹,簡易
2020-10-19,7320,109,116,225,牡丹,簡易
2020-10-20,7320,108,117,225,牡丹,簡易
2020-10-21,7320,151,167,318,牡丹,簡易
2020-10-22,7320,101,107,208,牡丹,簡易
2020-10-23,7320,102,129,231,牡丹,簡易
2020-10-24,7320,192,203,395,牡丹,簡易
2020-10-25,7320,206,140,346,牡丹,簡易
2020-10-26,7320,145,145,290,牡丹,簡易
2020-10-27,7320,116,154,270,牡丹,簡易
2020-10-28,7320,144,161,305,牡丹,簡易
2020-10-29,7320,126,122,248,牡丹,簡易
2020-10-30,7320,155,152,307,牡丹,簡易
2020-10-31,7320,139,196,335,牡丹,簡易
2020-11-01,7320,174,274,448,牡丹,簡易
2020-11-02,7320,165,138,303,牡丹,簡易
2020-11-03,7320,152,174,326,牡丹,簡易
2020-11-04,7320,226,291,517,牡丹,簡易
2020-11-05,7320,134,146,280,牡丹,簡易
2020-11-06,7320,111,151,262,牡丹,簡易
2020-11-07,7320,98,184,282,牡丹,簡易
2020-11-08,7320,111,92,203,牡丹,簡易
2020-11-09,7320,131,120,251,牡丹,簡易
2020-11-10,7320,114,127,241,牡丹,簡易
2020-11-11,7320,137,139,276,牡丹,簡易
2020-11-12,7320,111,124,235,牡丹,簡易
2020-11-13,7320,119,127,246,牡丹,簡易
2020-11-14,7320,115,152,267,牡丹,簡易
2020-11-15,7320,147,150,297,牡丹,簡易
2020-11-16,7320,151,142,293,牡丹,簡易
2020-11-17,7320,164,163,327,牡丹,簡易
2020-11-18,7320,147,206,353,牡丹,簡易
2020-11-19,7320,140,168,308,牡丹,簡易
2020-11-20,7320,180,168,348,牡丹,簡易
2020-11-21,7320,118,179,297,牡丹,簡易
2020-11-22,7320,181,163,344,牡丹,簡易
2020-11-23,7320,129,111,240,牡丹,簡易
2020-11-24,7320,158,154,312,牡丹,簡易
2020-11-25,7320,195,238,433,牡丹,簡易
2020-11-26,7320,152,156,308,牡丹,簡易
2020-11-27,7320,143,155,298,牡丹,簡易
2020-11-28,7320,107,142,249,牡丹,簡易
2020-11-29,7320,120,127,247,牡丹,簡易
2020-11-30,7320,119,118,237,牡丹,簡易
2020-12-01,7320,120,124,244,牡丹,簡易
2020-12-02,7320,133,130,263,牡丹,簡易
2020-12-03,7320,125,122,247,牡丹,簡易
2020-12-04,7320,54,35,89,牡丹,簡易
2020-12-05,7320,12,20,32,牡丹,簡易
2020-12-06,7320,282,315,597,牡丹,簡易
2020-12-07,7320,36,42,78,牡丹,簡易
2020-12-08,7320,35,54,89,牡丹,簡易
2020-12-09,7320,38,45,83,牡丹,簡易
2020-12-10,7320,43,39,82,牡丹,簡易
2020-12-11,7320,43,57,100,牡丹,簡易
2020-12-12,7320,48,59,107,牡丹,簡易
2020-12-13,7320,45,38,83,牡丹,簡易
2020-12-14,7320,76,91,167,牡丹,簡易
2020-12-15,7320,82,97,179,牡丹,簡易
2020-12-16,7320,101,103,204,牡丹,簡易
2020-12-17,7320,88,125,213,牡丹,簡易
2020-12-18,7320,114,137,251,牡丹,簡易
2020-12-19,7320,80,97,177,牡丹,簡易
2020-12-20,7320,75,79,154,牡丹,簡易
2020-12-21,7320,102,96,198,牡丹,簡易
2020-12-22,7320,114,111,225,牡丹,簡易
2020-12-23,7320,119,147,266,牡丹,簡易
2020-12-24,7320,136,152,288,牡丹,簡易
2020-12-25,7320,114,127,241,牡丹,簡易
2020-12-26,7320,84,166,250,牡丹,簡易
2020-12-27,7320,104,99,203,牡丹,簡易
2020-12-28,7320,109,100,209,牡丹,簡易
2020-12-29,7320,110,139,249,牡丹,簡易
2020-12-30,7320,96,115,211,牡丹,簡易
2020-12-31,7320,101,148,249,牡丹,簡易
2020-01-01,7330,97,126,223,三貂嶺,三等
2020-01-02,7330,38,96,134,三貂嶺,三等
2020-01-03,7330,88,105,193,三貂嶺,三等
2020-01-04,7330,112,209,321,三貂嶺,三等
2020-01-05,7330,151,279,430,三貂嶺,三等
2020-01-06,7330,29,78,107,三貂嶺,三等
2020-01-07,7330,113,156,269,三貂嶺,三等
2020-01-08,7330,35,45,80,三貂嶺,三等
2020-01-09,7330,40,73,113,三貂嶺,三等
2020-01-10,7330,56,58,114,三貂嶺,三等
2020-01-11,7330,71,117,188,三貂嶺,三等
2020-01-12,7330,119,93,212,三貂嶺,三等
2020-01-13,7330,25,15,40,三貂嶺,三等
2020-01-14,7330,15,33,48,三貂嶺,三等
2020-01-15,7330,29,34,63,三貂嶺,三等
2020-01-16,7330,81,79,160,三貂嶺,三等
2020-01-17,7330,30,33,63,三貂嶺,三等
2020-01-18,7330,41,47,88,三貂嶺,三等
2020-01-19,7330,68,161,229,三貂嶺,三等
2020-01-20,7330,31,43,74,三貂嶺,三等
2020-01-21,7330,82,84,166,三貂嶺,三等
2020-01-22,7330,31,38,69,三貂嶺,三等
2020-01-23,7330,76,136,212,三貂嶺,三等
2020-01-24,7330,20,18,38,三貂嶺,三等
2020-01-25,7330,81,104,185,三貂嶺,三等
2020-01-26,7330,50,49,99,三貂嶺,三等
2020-01-27,7330,51,66,117,三貂嶺,三等
2020-01-28,7330,102,106,208,三貂嶺,三等
2020-01-29,7330,56,82,138,三貂嶺,三等
2020-01-30,7330,48,53,101,三貂嶺,三等
2020-01-31,7330,80,88,168,三貂嶺,三等
2020-02-01,7330,97,111,208,三貂嶺,三等
2020-02-02,7330,114,146,260,三貂嶺,三等
2020-02-03,7330,16,46,62,三貂嶺,三等
2020-02-04,7330,25,26,51,三貂嶺,三等
2020-02-05,7330,16,18,34,三貂嶺,三等
2020-02-06,7330,40,42,82,三貂嶺,三等
2020-02-07,7330,51,53,104,三貂嶺,三等
2020-02-08,7330,74,100,174,三貂嶺,三等
2020-02-09,7330,77,104,181,三貂嶺,三等
2020-02-10,7330,46,58,104,三貂嶺,三等
2020-02-11,7330,20,49,69,三貂嶺,三等
2020-02-12,7330,62,91,153,三貂嶺,三等
2020-02-13,7330,35,40,75,三貂嶺,三等
2020-02-14,7330,45,43,88,三貂嶺,三等
2020-02-15,7330,59,78,137,三貂嶺,三等
2020-02-16,7330,115,248,363,三貂嶺,三等
2020-02-17,7330,22,34,56,三貂嶺,三等
2020-02-18,7330,32,51,83,三貂嶺,三等
2020-02-19,7330,74,89,163,三貂嶺,三等
2020-02-20,7330,58,75,133,三貂嶺,三等
2020-02-21,7330,56,94,150,三貂嶺,三等
2020-02-22,7330,134,172,306,三貂嶺,三等
2020-02-23,7330,98,157,255,三貂嶺,三等
2020-02-24,7330,76,81,157,三貂嶺,三等
2020-02-25,7330,55,83,138,三貂嶺,三等
2020-02-26,7330,35,54,89,三貂嶺,三等
2020-02-27,7330,44,37,81,三貂嶺,三等
2020-02-28,7330,179,234,413,三貂嶺,三等
2020-02-29,7330,269,377,646,三貂嶺,三等
2020-03-01,7330,88,141,229,三貂嶺,三等
2020-03-02,7330,31,36,67,三貂嶺,三等
2020-03-03,7330,51,68,119,三貂嶺,三等
2020-03-04,7330,21,17,38,三貂嶺,三等
2020-03-05,7330,9,10,19,三貂嶺,三等
2020-03-06,7330,48,62,110,三貂嶺,三等
2020-03-07,7330,135,231,366,三貂嶺,三等
2020-03-08,7330,116,139,255,三貂嶺,三等
2020-03-09,7330,35,52,87,三貂嶺,三等
2020-03-10,7330,8,10,18,三貂嶺,三等
2020-03-11,7330,38,46,84,三貂嶺,三等
2020-03-12,7330,20,16,36,三貂嶺,三等
2020-03-13,7330,17,13,30,三貂嶺,三等
2020-03-14,7330,37,33,70,三貂嶺,三等
2020-03-15,7330,226,332,558,三貂嶺,三等
2020-03-16,7330,39,67,106,三貂嶺,三等
2020-03-17,7330,69,77,146,三貂嶺,三等
2020-03-18,7330,32,33,65,三貂嶺,三等
2020-03-19,7330,7,11,18,三貂嶺,三等
2020-03-20,7330,23,36,59,三貂嶺,三等
2020-03-21,7330,177,219,396,三貂嶺,三等
2020-03-22,7330,164,276,440,三貂嶺,三等
2020-03-23,7330,49,52,101,三貂嶺,三等
2020-03-24,7330,30,21,51,三貂嶺,三等
2020-03-25,7330,28,33,61,三貂嶺,三等
2020-03-26,7330,81,108,189,三貂嶺,三等
2020-03-27,7330,64,82,146,三貂嶺,三等
2020-03-28,7330,49,67,116,三貂嶺,三等
2020-03-29,7330,189,246,435,三貂嶺,三等
2020-03-30,7330,36,52,88,三貂嶺,三等
2020-03-31,7330,24,29,53,三貂嶺,三等
2020-04-01,7330,29,28,57,三貂嶺,三等
2020-04-02,7330,38,59,97,三貂嶺,三等
2020-04-03,7330,77,100,177,三貂嶺,三等
2020-04-04,7330,40,68,108,三貂嶺,三等
2020-04-05,7330,28,45,73,三貂嶺,三等
2020-04-06,7330,13,16,29,三貂嶺,三等
2020-04-07,7330,14,15,29,三貂嶺,三等
2020-04-08,7330,27,27,54,三貂嶺,三等
2020-04-09,7330,18,28,46,三貂嶺,三等
2020-04-10,7330,67,89,156,三貂嶺,三等
2020-04-11,7330,80,163,243,三貂嶺,三等
2020-04-12,7330,48,65,113,三貂嶺,三等
2020-04-13,7330,53,98,151,三貂嶺,三等
2020-04-14,7330,32,72,104,三貂嶺,三等
2020-04-15,7330,44,78,122,三貂嶺,三等
2020-04-16,7330,80,123,203,三貂嶺,三等
2020-04-17,7330,88,103,191,三貂嶺,三等
2020-04-18,7330,184,382,566,三貂嶺,三等
2020-04-19,7330,194,308,502,三貂嶺,三等
2020-04-20,7330,41,60,101,三貂嶺,三等
2020-04-21,7330,13,23,36,三貂嶺,三等
2020-04-22,7330,16,38,54,三貂嶺,三等
2020-04-23,7330,12,15,27,三貂嶺,三等
2020-04-24,7330,16,16,32,三貂嶺,三等
2020-04-25,7330,75,101,176,三貂嶺,三等
2020-04-26,7330,111,125,236,三貂嶺,三等
2020-04-27,7330,20,48,68,三貂嶺,三等
2020-04-28,7330,44,78,122,三貂嶺,三等
2020-04-29,7330,65,99,164,三貂嶺,三等
2020-04-30,7330,74,93,167,三貂嶺,三等
2020-05-01,7330,205,492,697,三貂嶺,三等
2020-05-02,7330,221,250,471,三貂嶺,三等
2020-05-03,7330,196,314,510,三貂嶺,三等
2020-05-04,7330,73,104,177,三貂嶺,三等
2020-05-05,7330,84,116,200,三貂嶺,三等
2020-05-06,7330,65,93,158,三貂嶺,三等
2020-05-07,7330,43,63,106,三貂嶺,三等
2020-05-08,7330,40,84,124,三貂嶺,三等
2020-05-09,7330,198,324,522,三貂嶺,三等
2020-05-10,7330,196,246,442,三貂嶺,三等
2020-05-11,7330,27,36,63,三貂嶺,三等
2020-05-12,7330,27,34,61,三貂嶺,三等
2020-05-13,7330,52,74,126,三貂嶺,三等
2020-05-14,7330,98,138,236,三貂嶺,三等
2020-05-15,7330,84,114,198,三貂嶺,三等
2020-05-16,7330,305,466,771,三貂嶺,三等
2020-05-17,7330,196,269,465,三貂嶺,三等
2020-05-18,7330,38,65,103,三貂嶺,三等
2020-05-19,7330,16,18,34,三貂嶺,三等
2020-05-20,7330,49,54,103,三貂嶺,三等
2020-05-21,7330,25,26,51,三貂嶺,三等
2020-05-22,7330,9,12,21,三貂嶺,三等
2020-05-23,7330,54,64,118,三貂嶺,三等
2020-05-24,7330,131,196,327,三貂嶺,三等
2020-05-25,7330,102,126,228,三貂嶺,三等
2020-05-26,7330,22,61,83,三貂嶺,三等
2020-05-27,7330,21,33,54,三貂嶺,三等
2020-05-28,7330,9,18,27,三貂嶺,三等
2020-05-29,7330,29,27,56,三貂嶺,三等
2020-05-30,7330,163,303,466,三貂嶺,三等
2020-05-31,7330,260,434,694,三貂嶺,三等
2020-06-01,7330,39,90,129,三貂嶺,三等
2020-06-02,7330,59,88,147,三貂嶺,三等
2020-06-03,7330,104,124,228,三貂嶺,三等
2020-06-04,7330,123,119,242,三貂嶺,三等
2020-06-05,7330,81,135,216,三貂嶺,三等
2020-06-06,7330,302,590,892,三貂嶺,三等
2020-06-07,7330,258,434,692,三貂嶺,三等
2020-06-08,7330,51,34,85,三貂嶺,三等
2020-06-09,7330,37,64,101,三貂嶺,三等
2020-06-10,7330,87,142,229,三貂嶺,三等
2020-06-11,7330,89,161,250,三貂嶺,三等
2020-06-12,7330,86,176,262,三貂嶺,三等
2020-06-13,7330,365,647,1012,三貂嶺,三等
2020-06-14,7330,380,510,890,三貂嶺,三等
2020-06-15,7330,75,116,191,三貂嶺,三等
2020-06-16,7330,77,128,205,三貂嶺,三等
2020-06-17,7330,109,152,261,三貂嶺,三等
2020-06-18,7330,101,142,243,三貂嶺,三等
2020-06-19,7330,85,117,202,三貂嶺,三等
2020-06-20,7330,373,481,854,三貂嶺,三等
2020-06-21,7330,361,596,957,三貂嶺,三等
2020-06-22,7330,85,102,187,三貂嶺,三等
2020-06-23,7330,76,108,184,三貂嶺,三等
2020-06-24,7330,51,64,115,三貂嶺,三等
2020-06-25,7330,201,305,506,三貂嶺,三等
2020-06-26,7330,593,859,1452,三貂嶺,三等
2020-06-27,7330,412,655,1067,三貂嶺,三等
2020-06-28,7330,310,515,825,三貂嶺,三等
2020-06-29,7330,84,141,225,三貂嶺,三等
2020-06-30,7330,144,132,276,三貂嶺,三等
2020-07-01,7330,56,87,143,三貂嶺,三等
2020-07-02,7330,58,78,136,三貂嶺,三等
2020-07-03,7330,105,132,237,三貂嶺,三等
2020-07-04,7330,286,535,821,三貂嶺,三等
2020-07-05,7330,242,483,725,三貂嶺,三等
2020-07-06,7330,51,69,120,三貂嶺,三等
2020-07-07,7330,107,165,272,三貂嶺,三等
2020-07-08,7330,96,103,199,三貂嶺,三等
2020-07-09,7330,85,94,179,三貂嶺,三等
2020-07-10,7330,124,169,293,三貂嶺,三等
2020-07-11,7330,313,508,821,三貂嶺,三等
2020-07-12,7330,358,759,1117,三貂嶺,三等
2020-07-13,7330,203,254,457,三貂嶺,三等
2020-07-14,7330,80,92,172,三貂嶺,三等
2020-07-15,7330,108,179,287,三貂嶺,三等
2020-07-16,7330,124,126,250,三貂嶺,三等
2020-07-17,7330,114,170,284,三貂嶺,三等
2020-07-18,7330,347,619,966,三貂嶺,三等
2020-07-19,7330,295,682,977,三貂嶺,三等
2020-07-20,7330,93,126,219,三貂嶺,三等
2020-07-21,7330,127,163,290,三貂嶺,三等
2020-07-22,7330,77,117,194,三貂嶺,三等
2020-07-23,7330,95,97,192,三貂嶺,三等
2020-07-24,7330,121,153,274,三貂嶺,三等
2020-07-25,7330,246,415,661,三貂嶺,三等
2020-07-26,7330,284,511,795,三貂嶺,三等
2020-07-27,7330,92,103,195,三貂嶺,三等
2020-07-28,7330,181,220,401,三貂嶺,三等
2020-07-29,7330,95,260,355,三貂嶺,三等
2020-07-30,7330,145,171,316,三貂嶺,三等
2020-07-31,7330,125,159,284,三貂嶺,三等
2020-08-01,7330,293,547,840,三貂嶺,三等
2020-08-02,7330,219,424,643,三貂嶺,三等
2020-08-03,7330,7,11,18,三貂嶺,三等
2020-08-04,7330,46,62,108,三貂嶺,三等
2020-08-05,7330,64,78,142,三貂嶺,三等
2020-08-06,7330,96,121,217,三貂嶺,三等
2020-08-07,7330,88,128,216,三貂嶺,三等
2020-08-08,7330,193,303,496,三貂嶺,三等
2020-08-09,7330,372,504,876,三貂嶺,三等
2020-08-10,7330,131,165,296,三貂嶺,三等
2020-08-11,7330,29,29,58,三貂嶺,三等
2020-08-12,7330,45,90,135,三貂嶺,三等
2020-08-13,7330,71,106,177,三貂嶺,三等
2020-08-14,7330,76,137,213,三貂嶺,三等
2020-08-15,7330,312,825,1137,三貂嶺,三等
2020-08-16,7330,303,526,829,三貂嶺,三等
2020-08-17,7330,76,152,228,三貂嶺,三等
2020-08-18,7330,55,94,149,三貂嶺,三等
2020-08-19,7330,132,169,301,三貂嶺,三等
2020-08-20,7330,86,136,222,三貂嶺,三等
2020-08-21,7330,123,169,292,三貂嶺,三等
2020-08-22,7330,204,324,528,三貂嶺,三等
2020-08-23,7330,119,180,299,三貂嶺,三等
2020-08-24,7330,60,129,189,三貂嶺,三等
2020-08-25,7330,98,134,232,三貂嶺,三等
2020-08-26,7330,66,104,170,三貂嶺,三等
2020-08-27,7330,38,133,171,三貂嶺,三等
2020-08-28,7330,79,73,152,三貂嶺,三等
2020-08-29,7330,191,344,535,三貂嶺,三等
2020-08-30,7330,138,265,403,三貂嶺,三等
2020-08-31,7330,55,73,128,三貂嶺,三等
2020-09-01,7330,20,37,57,三貂嶺,三等
2020-09-02,7330,65,71,136,三貂嶺,三等
2020-09-03,7330,51,80,131,三貂嶺,三等
2020-09-04,7330,49,58,107,三貂嶺,三等
2020-09-05,7330,214,447,661,三貂嶺,三等
2020-09-06,7330,274,546,820,三貂嶺,三等
2020-09-07,7330,92,148,240,三貂嶺,三等
2020-09-08,7330,56,83,139,三貂嶺,三等
2020-09-09,7330,41,73,114,三貂嶺,三等
2020-09-10,7330,41,172,213,三貂嶺,三等
2020-09-11,7330,21,53,74,三貂嶺,三等
2020-09-12,7330,155,212,367,三貂嶺,三等
2020-09-13,7330,121,137,258,三貂嶺,三等
2020-09-14,7330,79,69,148,三貂嶺,三等
2020-09-15,7330,66,98,164,三貂嶺,三等
2020-09-16,7330,104,170,274,三貂嶺,三等
2020-09-17,7330,96,166,262,三貂嶺,三等
2020-09-18,7330,88,115,203,三貂嶺,三等
2020-09-19,7330,236,357,593,三貂嶺,三等
2020-09-20,7330,91,83,174,三貂嶺,三等
2020-09-21,7330,46,60,106,三貂嶺,三等
2020-09-22,7330,51,67,118,三貂嶺,三等
2020-09-23,7330,143,159,302,三貂嶺,三等
2020-09-24,7330,140,98,238,三貂嶺,三等
2020-09-25,7330,23,72,95,三貂嶺,三等
2020-09-26,7330,83,139,222,三貂嶺,三等
2020-09-27,7330,71,86,157,三貂嶺,三等
2020-09-28,7330,24,22,46,三貂嶺,三等
2020-09-29,7330,40,78,118,三貂嶺,三等
2020-09-30,7330,29,39,68,三貂嶺,三等
2020-10-01,7330,222,303,525,三貂嶺,三等
2020-10-02,7330,432,511,943,三貂嶺,三等
2020-10-03,7330,385,570,955,三貂嶺,三等
2020-10-04,7330,310,373,683,三貂嶺,三等
2020-10-05,7330,25,28,53,三貂嶺,三等
2020-10-06,7330,24,32,56,三貂嶺,三等
2020-10-07,7330,58,95,153,三貂嶺,三等
2020-10-08,7330,80,111,191,三貂嶺,三等
2020-10-09,7330,231,308,539,三貂嶺,三等
2020-10-10,7330,186,193,379,三貂嶺,三等
2020-10-11,7330,183,244,427,三貂嶺,三等
2020-10-12,7330,43,66,109,三貂嶺,三等
2020-10-13,7330,36,49,85,三貂嶺,三等
2020-10-14,7330,18,34,52,三貂嶺,三等
2020-10-15,7330,32,40,72,三貂嶺,三等
2020-10-16,7330,60,65,125,三貂嶺,三等
2020-10-17,7330,122,116,238,三貂嶺,三等
2020-10-18,7330,109,116,225,三貂嶺,三等
2020-10-19,7330,43,47,90,三貂嶺,三等
2020-10-20,7330,33,43,76,三貂嶺,三等
2020-10-21,7330,25,51,76,三貂嶺,三等
2020-10-22,7330,17,20,37,三貂嶺,三等
2020-10-23,7330,24,19,43,三貂嶺,三等
2020-10-24,7330,221,340,561,三貂嶺,三等
2020-10-25,7330,262,336,598,三貂嶺,三等
2020-10-26,7330,69,104,173,三貂嶺,三等
2020-10-27,7330,82,144,226,三貂嶺,三等
2020-10-28,7330,122,122,244,三貂嶺,三等
2020-10-29,7330,47,56,103,三貂嶺,三等
2020-10-30,7330,39,52,91,三貂嶺,三等
2020-10-31,7330,139,245,384,三貂嶺,三等
2020-11-01,7330,325,447,772,三貂嶺,三等
2020-11-02,7330,50,63,113,三貂嶺,三等
2020-11-03,7330,57,53,110,三貂嶺,三等
2020-11-04,7330,36,100,136,三貂嶺,三等
2020-11-05,7330,39,45,84,三貂嶺,三等
2020-11-06,7330,36,43,79,三貂嶺,三等
2020-11-07,7330,131,155,286,三貂嶺,三等
2020-11-08,7330,56,70,126,三貂嶺,三等
2020-11-09,7330,26,29,55,三貂嶺,三等
2020-11-10,7330,34,40,74,三貂嶺,三等
2020-11-11,7330,59,77,136,三貂嶺,三等
2020-11-12,7330,20,33,53,三貂嶺,三等
2020-11-13,7330,62,91,153,三貂嶺,三等
2020-11-14,7330,103,101,204,三貂嶺,三等
2020-11-15,7330,237,343,580,三貂嶺,三等
2020-11-16,7330,43,69,112,三貂嶺,三等
2020-11-17,7330,62,76,138,三貂嶺,三等
2020-11-18,7330,58,86,144,三貂嶺,三等
2020-11-19,7330,109,85,194,三貂嶺,三等
2020-11-20,7330,50,55,105,三貂嶺,三等
2020-11-21,7330,76,87,163,三貂嶺,三等
2020-11-22,7330,210,314,524,三貂嶺,三等
2020-11-23,7330,35,36,71,三貂嶺,三等
2020-11-24,7330,49,45,94,三貂嶺,三等
2020-11-25,7330,70,96,166,三貂嶺,三等
2020-11-26,7330,73,81,154,三貂嶺,三等
2020-11-27,7330,32,37,69,三貂嶺,三等
2020-11-28,7330,86,96,182,三貂嶺,三等
2020-11-29,7330,62,58,120,三貂嶺,三等
2020-11-30,7330,12,13,25,三貂嶺,三等
2020-12-01,7330,12,11,23,三貂嶺,三等
2020-12-02,7330,23,9,32,三貂嶺,三等
2020-12-03,7330,14,20,34,三貂嶺,三等
2020-12-04,7330,0,3,3,三貂嶺,三等
2020-12-05,7330,2,2,4,三貂嶺,三等
2020-12-06,7330,2,1,3,三貂嶺,三等
2020-12-07,7330,2,0,2,三貂嶺,三等
2020-12-08,7330,0,1,1,三貂嶺,三等
2020-12-09,7330,1,3,4,三貂嶺,三等
2020-12-10,7330,1,2,3,三貂嶺,三等
2020-12-11,7330,1,2,3,三貂嶺,三等
2020-12-12,7330,23,23,46,三貂嶺,三等
2020-12-13,7330,11,11,22,三貂嶺,三等
2020-12-14,7330,2,5,7,三貂嶺,三等
2020-12-15,7330,4,6,10,三貂嶺,三等
2020-12-16,7330,19,19,38,三貂嶺,三等
2020-12-17,7330,10,10,20,三貂嶺,三等
2020-12-18,7330,20,21,41,三貂嶺,三等
2020-12-19,7330,13,12,25,三貂嶺,三等
2020-12-20,7330,66,45,111,三貂嶺,三等
2020-12-21,7330,16,15,31,三貂嶺,三等
2020-12-22,7330,27,29,56,三貂嶺,三等
2020-12-23,7330,12,9,21,三貂嶺,三等
2020-12-24,7330,6,12,18,三貂嶺,三等
2020-12-25,7330,13,15,28,三貂嶺,三等
2020-12-26,7330,81,57,138,三貂嶺,三等
2020-12-27,7330,178,117,295,三貂嶺,三等
2020-12-28,7330,15,20,35,三貂嶺,三等
2020-12-29,7330,29,50,79,三貂嶺,三等
2020-12-30,7330,5,7,12,三貂嶺,三等
2020-12-31,7330,24,15,39,三貂嶺,三等
2020-01-01,7331,17,18,35,大華,招呼
2020-01-02,7331,9,4,13,大華,招呼
2020-01-03,7331,7,2,9,大華,招呼
2020-01-04,7331,32,16,48,大華,招呼
2020-01-05,7331,70,17,87,大華,招呼
2020-01-06,7331,34,13,47,大華,招呼
2020-01-07,7331,15,9,24,大華,招呼
2020-01-08,7331,11,12,23,大華,招呼
2020-01-09,7331,40,10,50,大華,招呼
2020-01-10,7331,7,3,10,大華,招呼
2020-01-11,7331,39,8,47,大華,招呼
2020-01-12,7331,33,36,69,大華,招呼
2020-01-13,7331,7,5,12,大華,招呼
2020-01-14,7331,14,24,38,大華,招呼
2020-01-15,7331,3,8,11,大華,招呼
2020-01-16,7331,32,31,63,大華,招呼
2020-01-17,7331,3,2,5,大華,招呼
2020-01-18,7331,11,9,20,大華,招呼
2020-01-19,7331,59,12,71,大華,招呼
2020-01-20,7331,7,5,12,大華,招呼
2020-01-21,7331,22,27,49,大華,招呼
2020-01-22,7331,13,9,22,大華,招呼
2020-01-23,7331,7,8,15,大華,招呼
2020-01-24,7331,6,7,13,大華,招呼
2020-01-25,7331,12,7,19,大華,招呼
2020-01-26,7331,17,20,37,大華,招呼
2020-01-27,7331,13,10,23,大華,招呼
2020-01-28,7331,25,21,46,大華,招呼
2020-01-29,7331,23,20,43,大華,招呼
2020-01-30,7331,6,14,20,大華,招呼
2020-01-31,7331,4,6,10,大華,招呼
2020-02-01,7331,27,20,47,大華,招呼
2020-02-02,7331,24,17,41,大華,招呼
2020-02-03,7331,24,21,45,大華,招呼
2020-02-04,7331,6,13,19,大華,招呼
2020-02-05,7331,7,7,14,大華,招呼
2020-02-06,7331,5,5,10,大華,招呼
2020-02-07,7331,3,2,5,大華,招呼
2020-02-08,7331,0,1,1,大華,招呼
2020-02-09,7331,15,8,23,大華,招呼
2020-02-10,7331,11,9,20,大華,招呼
2020-02-11,7331,24,8,32,大華,招呼
2020-02-12,7331,21,20,41,大華,招呼
2020-02-13,7331,4,6,10,大華,招呼
2020-02-14,7331,5,8,13,大華,招呼
2020-02-15,7331,22,15,37,大華,招呼
2020-02-16,7331,6,4,10,大華,招呼
2020-02-17,7331,6,5,11,大華,招呼
2020-02-18,7331,7,6,13,大華,招呼
2020-02-19,7331,19,14,33,大華,招呼
2020-02-20,7331,6,8,14,大華,招呼
2020-02-21,7331,5,4,9,大華,招呼
2020-02-22,7331,28,30,58,大華,招呼
2020-02-23,7331,45,35,80,大華,招呼
2020-02-24,7331,7,13,20,大華,招呼
2020-02-25,7331,14,8,22,大華,招呼
2020-02-26,7331,21,19,40,大華,招呼
2020-02-27,7331,3,14,17,大華,招呼
2020-02-28,7331,30,23,53,大華,招呼
2020-02-29,7331,75,75,150,大華,招呼
2020-03-01,7331,31,19,50,大華,招呼
2020-03-02,7331,26,28,54,大華,招呼
2020-03-03,7331,17,14,31,大華,招呼
2020-03-04,7331,11,28,39,大華,招呼
2020-03-05,7331,5,3,8,大華,招呼
2020-03-06,7331,14,7,21,大華,招呼
2020-03-07,7331,56,26,82,大華,招呼
2020-03-08,7331,38,39,77,大華,招呼
2020-03-09,7331,19,9,28,大華,招呼
2020-03-10,7331,6,8,14,大華,招呼
2020-03-11,7331,8,11,19,大華,招呼
2020-03-12,7331,3,6,9,大華,招呼
2020-03-13,7331,0,0,0,大華,招呼
2020-03-14,7331,9,17,26,大華,招呼
2020-03-15,7331,58,64,122,大華,招呼
2020-03-16,7331,10,10,20,大華,招呼
2020-03-17,7331,13,12,25,大華,招呼
2020-03-18,7331,12,10,22,大華,招呼
2020-03-19,7331,5,11,16,大華,招呼
2020-03-20,7331,4,5,9,大華,招呼
2020-03-21,7331,23,49,72,大華,招呼
2020-03-22,7331,60,31,91,大華,招呼
2020-03-23,7331,10,9,19,大華,招呼
2020-03-24,7331,14,10,24,大華,招呼
2020-03-25,7331,22,24,46,大華,招呼
2020-03-26,7331,18,4,22,大華,招呼
2020-03-27,7331,7,7,14,大華,招呼
2020-03-28,7331,4,8,12,大華,招呼
2020-03-29,7331,52,50,102,大華,招呼
2020-03-30,7331,30,22,52,大華,招呼
2020-03-31,7331,6,7,13,大華,招呼
2020-04-01,7331,19,19,38,大華,招呼
2020-04-02,7331,11,9,20,大華,招呼
2020-04-03,7331,38,34,72,大華,招呼
2020-04-04,7331,16,6,22,大華,招呼
2020-04-05,7331,22,15,37,大華,招呼
2020-04-06,7331,7,6,13,大華,招呼
2020-04-07,7331,6,8,14,大華,招呼
2020-04-08,7331,7,7,14,大華,招呼
2020-04-09,7331,8,4,12,大華,招呼
2020-04-10,7331,12,7,19,大華,招呼
2020-04-11,7331,46,5,51,大華,招呼
2020-04-12,7331,9,4,13,大華,招呼
2020-04-13,7331,28,25,53,大華,招呼
2020-04-14,7331,34,18,52,大華,招呼
2020-04-15,7331,17,7,24,大華,招呼
2020-04-16,7331,18,6,24,大華,招呼
2020-04-17,7331,11,11,22,大華,招呼
2020-04-18,7331,84,19,103,大華,招呼
2020-04-19,7331,85,19,104,大華,招呼
2020-04-20,7331,30,10,40,大華,招呼
2020-04-21,7331,7,4,11,大華,招呼
2020-04-22,7331,21,5,26,大華,招呼
2020-04-23,7331,5,2,7,大華,招呼
2020-04-24,7331,3,2,5,大華,招呼
2020-04-25,7331,13,15,28,大華,招呼
2020-04-26,7331,34,50,84,大華,招呼
2020-04-27,7331,13,14,27,大華,招呼
2020-04-28,7331,20,14,34,大華,招呼
2020-04-29,7331,27,24,51,大華,招呼
2020-04-30,7331,8,7,15,大華,招呼
2020-05-01,7331,172,26,198,大華,招呼
2020-05-02,7331,89,39,128,大華,招呼
2020-05-03,7331,99,21,120,大華,招呼
2020-05-04,7331,18,6,24,大華,招呼
2020-05-05,7331,26,19,45,大華,招呼
2020-05-06,7331,18,16,34,大華,招呼
2020-05-07,7331,8,5,13,大華,招呼
2020-05-08,7331,10,10,20,大華,招呼
2020-05-09,7331,84,21,105,大華,招呼
2020-05-10,7331,55,26,81,大華,招呼
2020-05-11,7331,12,8,20,大華,招呼
2020-05-12,7331,11,8,19,大華,招呼
2020-05-13,7331,34,16,50,大華,招呼
2020-05-14,7331,29,10,39,大華,招呼
2020-05-15,7331,17,9,26,大華,招呼
2020-05-16,7331,74,16,90,大華,招呼
2020-05-17,7331,61,17,78,大華,招呼
2020-05-18,7331,26,14,40,大華,招呼
2020-05-19,7331,9,9,18,大華,招呼
2020-05-20,7331,7,9,16,大華,招呼
2020-05-21,7331,7,5,12,大華,招呼
2020-05-22,7331,7,5,12,大華,招呼
2020-05-23,7331,10,9,19,大華,招呼
2020-05-24,7331,46,24,70,大華,招呼
2020-05-25,7331,15,11,26,大華,招呼
2020-05-26,7331,28,17,45,大華,招呼
2020-05-27,7331,11,8,19,大華,招呼
2020-05-28,7331,9,6,15,大華,招呼
2020-05-29,7331,5,6,11,大華,招呼
2020-05-30,7331,87,35,122,大華,招呼
2020-05-31,7331,126,39,165,大華,招呼
2020-06-01,7331,17,16,33,大華,招呼
2020-06-02,7331,13,3,16,大華,招呼
2020-06-03,7331,22,13,35,大華,招呼
2020-06-04,7331,16,9,25,大華,招呼
2020-06-05,7331,45,4,49,大華,招呼
2020-06-06,7331,162,73,235,大華,招呼
2020-06-07,7331,119,27,146,大華,招呼
2020-06-08,7331,18,15,33,大華,招呼
2020-06-09,7331,15,13,28,大華,招呼
2020-06-10,7331,48,30,78,大華,招呼
2020-06-11,7331,16,6,22,大華,招呼
2020-06-12,7331,45,3,48,大華,招呼
2020-06-13,7331,159,40,199,大華,招呼
2020-06-14,7331,68,42,110,大華,招呼
2020-06-15,7331,14,13,27,大華,招呼
2020-06-16,7331,35,13,48,大華,招呼
2020-06-17,7331,40,18,58,大華,招呼
2020-06-18,7331,28,10,38,大華,招呼
2020-06-19,7331,27,19,46,大華,招呼
2020-06-20,7331,39,16,55,大華,招呼
2020-06-21,7331,109,29,138,大華,招呼
2020-06-22,7331,24,12,36,大華,招呼
2020-06-23,7331,26,12,38,大華,招呼
2020-06-24,7331,19,12,31,大華,招呼
2020-06-25,7331,80,34,114,大華,招呼
2020-06-26,7331,146,42,188,大華,招呼
2020-06-27,7331,102,65,167,大華,招呼
2020-06-28,7331,85,25,110,大華,招呼
2020-06-29,7331,30,17,47,大華,招呼
2020-06-30,7331,24,15,39,大華,招呼
2020-07-01,7331,21,7,28,大華,招呼
2020-07-02,7331,10,7,17,大華,招呼
2020-07-03,7331,11,27,38,大華,招呼
2020-07-04,7331,125,16,141,大華,招呼
2020-07-05,7331,77,15,92,大華,招呼
2020-07-06,7331,23,30,53,大華,招呼
2020-07-07,7331,57,6,63,大華,招呼
2020-07-08,7331,25,10,35,大華,招呼
2020-07-09,7331,13,4,17,大華,招呼
2020-07-10,7331,10,30,40,大華,招呼
2020-07-11,7331,124,40,164,大華,招呼
2020-07-12,7331,79,28,107,大華,招呼
2020-07-13,7331,18,35,53,大華,招呼
2020-07-14,7331,21,15,36,大華,招呼
2020-07-15,7331,29,28,57,大華,招呼
2020-07-16,7331,8,47,55,大華,招呼
2020-07-17,7331,4,6,10,大華,招呼
2020-07-18,7331,88,45,133,大華,招呼
2020-07-19,7331,96,27,123,大華,招呼
2020-07-20,7331,40,18,58,大華,招呼
2020-07-21,7331,19,8,27,大華,招呼
2020-07-22,7331,48,31,79,大華,招呼
2020-07-23,7331,16,4,20,大華,招呼
2020-07-24,7331,13,5,18,大華,招呼
2020-07-25,7331,46,13,59,大華,招呼
2020-07-26,7331,36,46,82,大華,招呼
2020-07-27,7331,21,17,38,大華,招呼
2020-07-28,7331,22,11,33,大華,招呼
2020-07-29,7331,56,36,92,大華,招呼
2020-07-30,7331,13,9,22,大華,招呼
2020-07-31,7331,34,16,50,大華,招呼
2020-08-01,7331,70,38,108,大華,招呼
2020-08-02,7331,110,19,129,大華,招呼
2020-08-03,7331,5,6,11,大華,招呼
2020-08-04,7331,10,10,20,大華,招呼
2020-08-05,7331,9,16,25,大華,招呼
2020-08-06,7331,19,10,29,大華,招呼
2020-08-07,7331,18,11,29,大華,招呼
2020-08-08,7331,81,65,146,大華,招呼
2020-08-09,7331,80,46,126,大華,招呼
2020-08-10,7331,8,27,35,大華,招呼
2020-08-11,7331,7,6,13,大華,招呼
2020-08-12,7331,17,19,36,大華,招呼
2020-08-13,7331,19,4,23,大華,招呼
2020-08-14,7331,11,8,19,大華,招呼
2020-08-15,7331,67,43,110,大華,招呼
2020-08-16,7331,123,28,151,大華,招呼
2020-08-17,7331,23,12,35,大華,招呼
2020-08-18,7331,13,12,25,大華,招呼
2020-08-19,7331,38,82,120,大華,招呼
2020-08-20,7331,25,6,31,大華,招呼
2020-08-21,7331,19,13,32,大華,招呼
2020-08-22,7331,59,22,81,大華,招呼
2020-08-23,7331,25,24,49,大華,招呼
2020-08-24,7331,40,17,57,大華,招呼
2020-08-25,7331,15,13,28,大華,招呼
2020-08-26,7331,13,6,19,大華,招呼
2020-08-27,7331,29,8,37,大華,招呼
2020-08-28,7331,3,5,8,大華,招呼
2020-08-29,7331,56,27,83,大華,招呼
2020-08-30,7331,55,16,71,大華,招呼
2020-08-31,7331,3,4,7,大華,招呼
2020-09-01,7331,11,7,18,大華,招呼
2020-09-02,7331,6,10,16,大華,招呼
2020-09-03,7331,14,6,20,大華,招呼
2020-09-04,7331,9,2,11,大華,招呼
2020-09-05,7331,150,29,179,大華,招呼
2020-09-06,7331,97,64,161,大華,招呼
2020-09-07,7331,16,14,30,大華,招呼
2020-09-08,7331,25,16,41,大華,招呼
2020-09-09,7331,39,17,56,大華,招呼
2020-09-10,7331,19,8,27,大華,招呼
2020-09-11,7331,29,6,35,大華,招呼
2020-09-12,7331,50,31,81,大華,招呼
2020-09-13,7331,23,13,36,大華,招呼
2020-09-14,7331,18,17,35,大華,招呼
2020-09-15,7331,21,21,42,大華,招呼
2020-09-16,7331,35,14,49,大華,招呼
2020-09-17,7331,39,15,54,大華,招呼
2020-09-18,7331,15,9,24,大華,招呼
2020-09-19,7331,36,31,67,大華,招呼
2020-09-20,7331,18,8,26,大華,招呼
2020-09-21,7331,13,11,24,大華,招呼
2020-09-22,7331,9,11,20,大華,招呼
2020-09-23,7331,19,15,34,大華,招呼
2020-09-24,7331,11,55,66,大華,招呼
2020-09-25,7331,53,1,54,大華,招呼
2020-09-26,7331,33,17,50,大華,招呼
2020-09-27,7331,29,11,40,大華,招呼
2020-09-28,7331,1,1,2,大華,招呼
2020-09-29,7331,47,12,59,大華,招呼
2020-09-30,7331,8,4,12,大華,招呼
2020-10-01,7331,43,12,55,大華,招呼
2020-10-02,7331,68,49,117,大華,招呼
2020-10-03,7331,91,45,136,大華,招呼
2020-10-04,7331,116,92,208,大華,招呼
2020-10-05,7331,11,13,24,大華,招呼
2020-10-06,7331,14,22,36,大華,招呼
2020-10-07,7331,35,18,53,大華,招呼
2020-10-08,7331,8,5,13,大華,招呼
2020-10-09,7331,53,29,82,大華,招呼
2020-10-10,7331,38,32,70,大華,招呼
2020-10-11,7331,22,22,44,大華,招呼
2020-10-12,7331,11,10,21,大華,招呼
2020-10-13,7331,7,3,10,大華,招呼
2020-10-14,7331,8,9,17,大華,招呼
2020-10-15,7331,18,12,30,大華,招呼
2020-10-16,7331,2,2,4,大華,招呼
2020-10-17,7331,29,28,57,大華,招呼
2020-10-18,7331,18,10,28,大華,招呼
2020-10-19,7331,13,11,24,大華,招呼
2020-10-20,7331,17,10,27,大華,招呼
2020-10-21,7331,30,9,39,大華,招呼
2020-10-22,7331,1,1,2,大華,招呼
2020-10-23,7331,4,3,7,大華,招呼
2020-10-24,7331,31,24,55,大華,招呼
2020-10-25,7331,70,30,100,大華,招呼
2020-10-26,7331,24,17,41,大華,招呼
2020-10-27,7331,17,11,28,大華,招呼
2020-10-28,7331,13,18,31,大華,招呼
2020-10-29,7331,9,7,16,大華,招呼
2020-10-30,7331,9,6,15,大華,招呼
2020-10-31,7331,28,20,48,大華,招呼
2020-11-01,7331,75,18,93,大華,招呼
2020-11-02,7331,18,20,38,大華,招呼
2020-11-03,7331,6,7,13,大華,招呼
2020-11-04,7331,7,8,15,大華,招呼
2020-11-05,7331,3,4,7,大華,招呼
2020-11-06,7331,4,3,7,大華,招呼
2020-11-07,7331,25,20,45,大華,招呼
2020-11-08,7331,19,115,134,大華,招呼
2020-11-09,7331,4,7,11,大華,招呼
2020-11-10,7331,11,13,24,大華,招呼
2020-11-11,7331,21,19,40,大華,招呼
2020-11-12,7331,4,5,9,大華,招呼
2020-11-13,7331,5,4,9,大華,招呼
2020-11-14,7331,9,9,18,大華,招呼
2020-11-15,7331,83,18,101,大華,招呼
2020-11-16,7331,14,16,30,大華,招呼
2020-11-17,7331,17,17,34,大華,招呼
2020-11-18,7331,31,15,46,大華,招呼
2020-11-19,7331,13,15,28,大華,招呼
2020-11-20,7331,7,4,11,大華,招呼
2020-11-21,7331,16,32,48,大華,招呼
2020-11-22,7331,41,28,69,大華,招呼
2020-11-23,7331,11,11,22,大華,招呼
2020-11-24,7331,12,12,24,大華,招呼
2020-11-25,7331,31,38,69,大華,招呼
2020-11-26,7331,8,6,14,大華,招呼
2020-11-27,7331,9,6,15,大華,招呼
2020-11-28,7331,29,29,58,大華,招呼
2020-11-29,7331,45,294,339,大華,招呼
2020-11-30,7331,9,7,16,大華,招呼
2020-12-01,7331,11,17,28,大華,招呼
2020-12-02,7331,3,4,7,大華,招呼
2020-12-03,7331,1,1,2,大華,招呼
2020-12-04,7331,0,1,1,大華,招呼
2020-12-05,7331,0,0,0,大華,招呼
2020-12-06,7331,0,0,0,大華,招呼
2020-12-07,7331,0,2,2,大華,招呼
2020-12-08,7331,0,0,0,大華,招呼
2020-12-09,7331,0,0,0,大華,招呼
2020-12-10,7331,0,0,0,大華,招呼
2020-12-11,7331,0,0,0,大華,招呼
2020-12-12,7331,0,0,0,大華,招呼
2020-12-13,7331,0,0,0,大華,招呼
2020-12-14,7331,4,2,6,大華,招呼
2020-12-15,7331,2,2,4,大華,招呼
2020-12-16,7331,11,11,22,大華,招呼
2020-12-17,7331,3,1,4,大華,招呼
2020-12-18,7331,2,2,4,大華,招呼
2020-12-19,7331,3,3,6,大華,招呼
2020-12-20,7331,4,2,6,大華,招呼
2020-12-21,7331,17,19,36,大華,招呼
2020-12-22,7331,2,2,4,大華,招呼
2020-12-23,7331,11,10,21,大華,招呼
2020-12-24,7331,0,0,0,大華,招呼
2020-12-25,7331,1,3,4,大華,招呼
2020-12-26,7331,10,8,18,大華,招呼
2020-12-27,7331,24,8,32,大華,招呼
2020-12-28,7331,1,6,7,大華,招呼
2020-12-29,7331,15,10,25,大華,招呼
2020-12-30,7331,1,1,2,大華,招呼
2020-12-31,7331,1,1,2,大華,招呼
2020-01-01,7332,2128,2277,4405,十分,丙簡
2020-01-02,7332,2299,2454,4753,十分,丙簡
2020-01-03,7332,2224,2097,4321,十分,丙簡
2020-01-04,7332,1875,2218,4093,十分,丙簡
2020-01-05,7332,1813,1769,3582,十分,丙簡
2020-01-06,7332,1304,1305,2609,十分,丙簡
2020-01-07,7332,1389,1396,2785,十分,丙簡
2020-01-08,7332,1025,1039,2064,十分,丙簡
2020-01-09,7332,987,1123,2110,十分,丙簡
2020-01-10,7332,1090,1094,2184,十分,丙簡
2020-01-11,7332,1216,1268,2484,十分,丙簡
2020-01-12,7332,1088,1138,2226,十分,丙簡
2020-01-13,7332,1020,1099,2119,十分,丙簡
2020-01-14,7332,1101,1334,2435,十分,丙簡
2020-01-15,7332,810,736,1546,十分,丙簡
2020-01-16,7332,801,771,1572,十分,丙簡
2020-01-17,7332,978,889,1867,十分,丙簡
2020-01-18,7332,1206,1209,2415,十分,丙簡
2020-01-19,7332,1070,1032,2102,十分,丙簡
2020-01-20,7332,1207,1151,2358,十分,丙簡
2020-01-21,7332,919,1129,2048,十分,丙簡
2020-01-22,7332,942,919,1861,十分,丙簡
2020-01-23,7332,1013,1010,2023,十分,丙簡
2020-01-24,7332,904,851,1755,十分,丙簡
2020-01-25,7332,2781,2856,5637,十分,丙簡
2020-01-26,7332,1275,1235,2510,十分,丙簡
2020-01-27,7332,2639,2605,5244,十分,丙簡
2020-01-28,7332,2084,2273,4357,十分,丙簡
2020-01-29,7332,1606,1696,3302,十分,丙簡
2020-01-30,7332,1500,1563,3063,十分,丙簡
2020-01-31,7332,1467,1582,3049,十分,丙簡
2020-02-01,7332,2051,2100,4151,十分,丙簡
2020-02-02,7332,1420,1471,2891,十分,丙簡
2020-02-03,7332,878,910,1788,十分,丙簡
2020-02-04,7332,701,664,1365,十分,丙簡
2020-02-05,7332,709,681,1390,十分,丙簡
2020-02-06,7332,958,942,1900,十分,丙簡
2020-02-07,7332,813,846,1659,十分,丙簡
2020-02-08,7332,4308,4525,8833,十分,丙簡
2020-02-09,7332,1195,998,2193,十分,丙簡
2020-02-10,7332,1049,1040,2089,十分,丙簡
2020-02-11,7332,752,750,1502,十分,丙簡
2020-02-12,7332,1039,1004,2043,十分,丙簡
2020-02-13,7332,948,851,1799,十分,丙簡
2020-02-14,7332,948,917,1865,十分,丙簡
2020-02-15,7332,1243,1243,2486,十分,丙簡
2020-02-16,7332,555,527,1082,十分,丙簡
2020-02-17,7332,977,948,1925,十分,丙簡
2020-02-18,7332,962,985,1947,十分,丙簡
2020-02-19,7332,1048,1073,2121,十分,丙簡
2020-02-20,7332,964,960,1924,十分,丙簡
2020-02-21,7332,1038,1002,2040,十分,丙簡
2020-02-22,7332,983,922,1905,十分,丙簡
2020-02-23,7332,1143,1134,2277,十分,丙簡
2020-02-24,7332,949,924,1873,十分,丙簡
2020-02-25,7332,756,767,1523,十分,丙簡
2020-02-26,7332,789,989,1778,十分,丙簡
2020-02-27,7332,543,520,1063,十分,丙簡
2020-02-28,7332,1473,1425,2898,十分,丙簡
2020-02-29,7332,1364,1411,2775,十分,丙簡
2020-03-01,7332,647,574,1221,十分,丙簡
2020-03-02,7332,330,320,650,十分,丙簡
2020-03-03,7332,320,322,642,十分,丙簡
2020-03-04,7332,252,200,452,十分,丙簡
2020-03-05,7332,203,211,414,十分,丙簡
2020-03-06,7332,418,416,834,十分,丙簡
2020-03-07,7332,709,679,1388,十分,丙簡
2020-03-08,7332,667,643,1310,十分,丙簡
2020-03-09,7332,440,442,882,十分,丙簡
2020-03-10,7332,217,200,417,十分,丙簡
2020-03-11,7332,375,396,771,十分,丙簡
2020-03-12,7332,252,250,502,十分,丙簡
2020-03-13,7332,249,216,465,十分,丙簡
2020-03-14,7332,404,464,868,十分,丙簡
2020-03-15,7332,788,771,1559,十分,丙簡
2020-03-16,7332,427,420,847,十分,丙簡
2020-03-17,7332,298,288,586,十分,丙簡
2020-03-18,7332,214,215,429,十分,丙簡
2020-03-19,7332,141,151,292,十分,丙簡
2020-03-20,7332,186,197,383,十分,丙簡
2020-03-21,7332,463,468,931,十分,丙簡
2020-03-22,7332,508,483,991,十分,丙簡
2020-03-23,7332,130,134,264,十分,丙簡
2020-03-24,7332,120,116,236,十分,丙簡
2020-03-25,7332,150,133,283,十分,丙簡
2020-03-26,7332,146,137,283,十分,丙簡
2020-03-27,7332,150,139,289,十分,丙簡
2020-03-28,7332,110,111,221,十分,丙簡
2020-03-29,7332,426,398,824,十分,丙簡
2020-03-30,7332,147,158,305,十分,丙簡
2020-03-31,7332,158,148,306,十分,丙簡
2020-04-01,7332,160,151,311,十分,丙簡
2020-04-02,7332,245,256,501,十分,丙簡
2020-04-03,7332,483,461,944,十分,丙簡
2020-04-04,7332,281,262,543,十分,丙簡
2020-04-05,7332,229,213,442,十分,丙簡
2020-04-06,7332,118,129,247,十分,丙簡
2020-04-07,7332,56,58,114,十分,丙簡
2020-04-08,7332,87,84,171,十分,丙簡
2020-04-09,7332,123,123,246,十分,丙簡
2020-04-10,7332,177,160,337,十分,丙簡
2020-04-11,7332,248,213,461,十分,丙簡
2020-04-12,7332,92,85,177,十分,丙簡
2020-04-13,7332,122,119,241,十分,丙簡
2020-04-14,7332,112,133,245,十分,丙簡
2020-04-15,7332,169,149,318,十分,丙簡
2020-04-16,7332,156,136,292,十分,丙簡
2020-04-17,7332,194,179,373,十分,丙簡
2020-04-18,7332,556,492,1048,十分,丙簡
2020-04-19,7332,430,416,846,十分,丙簡
2020-04-20,7332,120,121,241,十分,丙簡
2020-04-21,7332,112,107,219,十分,丙簡
2020-04-22,7332,73,89,162,十分,丙簡
2020-04-23,7332,80,78,158,十分,丙簡
2020-04-24,7332,85,51,136,十分,丙簡
2020-04-25,7332,197,212,409,十分,丙簡
2020-04-26,7332,246,222,468,十分,丙簡
2020-04-27,7332,141,134,275,十分,丙簡
2020-04-28,7332,127,125,252,十分,丙簡
2020-04-29,7332,171,181,352,十分,丙簡
2020-04-30,7332,172,179,351,十分,丙簡
2020-05-01,7332,598,558,1156,十分,丙簡
2020-05-02,7332,706,720,1426,十分,丙簡
2020-05-03,7332,541,526,1067,十分,丙簡
2020-05-04,7332,190,206,396,十分,丙簡
2020-05-05,7332,195,190,385,十分,丙簡
2020-05-06,7332,161,159,320,十分,丙簡
2020-05-07,7332,182,154,336,十分,丙簡
2020-05-08,7332,256,215,471,十分,丙簡
2020-05-09,7332,871,587,1458,十分,丙簡
2020-05-10,7332,457,450,907,十分,丙簡
2020-05-11,7332,153,170,323,十分,丙簡
2020-05-12,7332,120,105,225,十分,丙簡
2020-05-13,7332,203,391,594,十分,丙簡
2020-05-14,7332,225,206,431,十分,丙簡
2020-05-15,7332,245,241,486,十分,丙簡
2020-05-16,7332,505,474,979,十分,丙簡
2020-05-17,7332,503,516,1019,十分,丙簡
2020-05-18,7332,129,134,263,十分,丙簡
2020-05-19,7332,66,70,136,十分,丙簡
2020-05-20,7332,134,120,254,十分,丙簡
2020-05-21,7332,129,129,258,十分,丙簡
2020-05-22,7332,95,106,201,十分,丙簡
2020-05-23,7332,180,177,357,十分,丙簡
2020-05-24,7332,663,734,1397,十分,丙簡
2020-05-25,7332,160,156,316,十分,丙簡
2020-05-26,7332,197,180,377,十分,丙簡
2020-05-27,7332,184,169,353,十分,丙簡
2020-05-28,7332,90,102,192,十分,丙簡
2020-05-29,7332,172,179,351,十分,丙簡
2020-05-30,7332,674,701,1375,十分,丙簡
2020-05-31,7332,858,794,1652,十分,丙簡
2020-06-01,7332,218,192,410,十分,丙簡
2020-06-02,7332,179,186,365,十分,丙簡
2020-06-03,7332,351,345,696,十分,丙簡
2020-06-04,7332,402,344,746,十分,丙簡
2020-06-05,7332,256,257,513,十分,丙簡
2020-06-06,7332,818,784,1602,十分,丙簡
2020-06-07,7332,587,595,1182,十分,丙簡
2020-06-08,7332,193,177,370,十分,丙簡
2020-06-09,7332,230,283,513,十分,丙簡
2020-06-10,7332,413,488,901,十分,丙簡
2020-06-11,7332,489,467,956,十分,丙簡
2020-06-12,7332,514,515,1029,十分,丙簡
2020-06-13,7332,903,883,1786,十分,丙簡
2020-06-14,7332,840,797,1637,十分,丙簡
2020-06-15,7332,250,219,469,十分,丙簡
2020-06-16,7332,441,388,829,十分,丙簡
2020-06-17,7332,362,377,739,十分,丙簡
2020-06-18,7332,311,289,600,十分,丙簡
2020-06-19,7332,374,456,830,十分,丙簡
2020-06-20,7332,626,693,1319,十分,丙簡
2020-06-21,7332,785,856,1641,十分,丙簡
2020-06-22,7332,311,275,586,十分,丙簡
2020-06-23,7332,538,438,976,十分,丙簡
2020-06-24,7332,260,270,530,十分,丙簡
2020-06-25,7332,1040,1095,2135,十分,丙簡
2020-06-26,7332,1792,1820,3612,十分,丙簡
2020-06-27,7332,1723,1714,3437,十分,丙簡
2020-06-28,7332,792,746,1538,十分,丙簡
2020-06-29,7332,301,293,594,十分,丙簡
2020-06-30,7332,254,277,531,十分,丙簡
2020-07-01,7332,212,229,441,十分,丙簡
2020-07-02,7332,350,285,635,十分,丙簡
2020-07-03,7332,337,315,652,十分,丙簡
2020-07-04,7332,692,693,1385,十分,丙簡
2020-07-05,7332,838,802,1640,十分,丙簡
2020-07-06,7332,335,355,690,十分,丙簡
2020-07-07,7332,357,351,708,十分,丙簡
2020-07-08,7332,413,394,807,十分,丙簡
2020-07-09,7332,420,396,816,十分,丙簡
2020-07-10,7332,457,362,819,十分,丙簡
2020-07-11,7332,742,700,1442,十分,丙簡
2020-07-12,7332,1018,1015,2033,十分,丙簡
2020-07-13,7332,424,407,831,十分,丙簡
2020-07-14,7332,392,377,769,十分,丙簡
2020-07-15,7332,355,433,788,十分,丙簡
2020-07-16,7332,485,581,1066,十分,丙簡
2020-07-17,7332,647,598,1245,十分,丙簡
2020-07-18,7332,1019,957,1976,十分,丙簡
2020-07-19,7332,894,890,1784,十分,丙簡
2020-07-20,7332,440,424,864,十分,丙簡
2020-07-21,7332,570,397,967,十分,丙簡
2020-07-22,7332,504,535,1039,十分,丙簡
2020-07-23,7332,543,581,1124,十分,丙簡
2020-07-24,7332,536,562,1098,十分,丙簡
2020-07-25,7332,749,1015,1764,十分,丙簡
2020-07-26,7332,981,1001,1982,十分,丙簡
2020-07-27,7332,499,455,954,十分,丙簡
2020-07-28,7332,387,509,896,十分,丙簡
2020-07-29,7332,444,481,925,十分,丙簡
2020-07-30,7332,539,635,1174,十分,丙簡
2020-07-31,7332,559,569,1128,十分,丙簡
2020-08-01,7332,1081,1055,2136,十分,丙簡
2020-08-02,7332,750,740,1490,十分,丙簡
2020-08-03,7332,93,120,213,十分,丙簡
2020-08-04,7332,331,392,723,十分,丙簡
2020-08-05,7332,396,388,784,十分,丙簡
2020-08-06,7332,440,476,916,十分,丙簡
2020-08-07,7332,451,399,850,十分,丙簡
2020-08-08,7332,712,748,1460,十分,丙簡
2020-08-09,7332,902,882,1784,十分,丙簡
2020-08-10,7332,526,527,1053,十分,丙簡
2020-08-11,7332,272,284,556,十分,丙簡
2020-08-12,7332,393,425,818,十分,丙簡
2020-08-13,7332,741,572,1313,十分,丙簡
2020-08-14,7332,693,708,1401,十分,丙簡
2020-08-15,7332,1200,1105,2305,十分,丙簡
2020-08-16,7332,1196,1345,2541,十分,丙簡
2020-08-17,7332,627,584,1211,十分,丙簡
2020-08-18,7332,509,460,969,十分,丙簡
2020-08-19,7332,423,462,885,十分,丙簡
2020-08-20,7332,447,637,1084,十分,丙簡
2020-08-21,7332,572,543,1115,十分,丙簡
2020-08-22,7332,965,1022,1987,十分,丙簡
2020-08-23,7332,782,949,1731,十分,丙簡
2020-08-24,7332,591,563,1154,十分,丙簡
2020-08-25,7332,510,497,1007,十分,丙簡
2020-08-26,7332,430,390,820,十分,丙簡
2020-08-27,7332,392,405,797,十分,丙簡
2020-08-28,7332,339,423,762,十分,丙簡
2020-08-29,7332,733,600,1333,十分,丙簡
2020-08-30,7332,719,904,1623,十分,丙簡
2020-08-31,7332,227,216,443,十分,丙簡
2020-09-01,7332,185,249,434,十分,丙簡
2020-09-02,7332,245,263,508,十分,丙簡
2020-09-03,7332,360,248,608,十分,丙簡
2020-09-04,7332,286,310,596,十分,丙簡
2020-09-05,7332,693,850,1543,十分,丙簡
2020-09-06,7332,891,855,1746,十分,丙簡
2020-09-07,7332,409,301,710,十分,丙簡
2020-09-08,7332,434,427,861,十分,丙簡
2020-09-09,7332,425,320,745,十分,丙簡
2020-09-10,7332,224,231,455,十分,丙簡
2020-09-11,7332,323,358,681,十分,丙簡
2020-09-12,7332,855,854,1709,十分,丙簡
2020-09-13,7332,453,517,970,十分,丙簡
2020-09-14,7332,227,239,466,十分,丙簡
2020-09-15,7332,401,206,607,十分,丙簡
2020-09-16,7332,195,178,373,十分,丙簡
2020-09-17,7332,246,198,444,十分,丙簡
2020-09-18,7332,328,442,770,十分,丙簡
2020-09-19,7332,795,740,1535,十分,丙簡
2020-09-20,7332,657,779,1436,十分,丙簡
2020-09-21,7332,238,289,527,十分,丙簡
2020-09-22,7332,347,209,556,十分,丙簡
2020-09-23,7332,457,308,765,十分,丙簡
2020-09-24,7332,221,200,421,十分,丙簡
2020-09-25,7332,266,397,663,十分,丙簡
2020-09-26,7332,456,544,1000,十分,丙簡
2020-09-27,7332,744,422,1166,十分,丙簡
2020-09-28,7332,434,187,621,十分,丙簡
2020-09-29,7332,362,310,672,十分,丙簡
2020-09-30,7332,172,275,447,十分,丙簡
2020-10-01,7332,1097,1065,2162,十分,丙簡
2020-10-02,7332,1900,1950,3850,十分,丙簡
2020-10-03,7332,1745,1776,3521,十分,丙簡
2020-10-04,7332,803,925,1728,十分,丙簡
2020-10-05,7332,176,300,476,十分,丙簡
2020-10-06,7332,394,449,843,十分,丙簡
2020-10-07,7332,425,344,769,十分,丙簡
2020-10-08,7332,301,261,562,十分,丙簡
2020-10-09,7332,1089,1033,2122,十分,丙簡
2020-10-10,7332,1420,1372,2792,十分,丙簡
2020-10-11,7332,714,665,1379,十分,丙簡
2020-10-12,7332,260,159,419,十分,丙簡
2020-10-13,7332,510,453,963,十分,丙簡
2020-10-14,7332,278,669,947,十分,丙簡
2020-10-15,7332,425,241,666,十分,丙簡
2020-10-16,7332,295,220,515,十分,丙簡
2020-10-17,7332,511,600,1111,十分,丙簡
2020-10-18,7332,535,483,1018,十分,丙簡
2020-10-19,7332,396,382,778,十分,丙簡
2020-10-20,7332,202,521,723,十分,丙簡
2020-10-21,7332,276,403,679,十分,丙簡
2020-10-22,7332,344,317,661,十分,丙簡
2020-10-23,7332,302,208,510,十分,丙簡
2020-10-24,7332,861,1014,1875,十分,丙簡
2020-10-25,7332,851,735,1586,十分,丙簡
2020-10-26,7332,411,529,940,十分,丙簡
2020-10-27,7332,578,568,1146,十分,丙簡
2020-10-28,7332,400,414,814,十分,丙簡
2020-10-29,7332,245,239,484,十分,丙簡
2020-10-30,7332,300,314,614,十分,丙簡
2020-10-31,7332,837,817,1654,十分,丙簡
2020-11-01,7332,1059,736,1795,十分,丙簡
2020-11-02,7332,438,326,764,十分,丙簡
2020-11-03,7332,392,343,735,十分,丙簡
2020-11-04,7332,194,324,518,十分,丙簡
2020-11-05,7332,377,284,661,十分,丙簡
2020-11-06,7332,232,199,431,十分,丙簡
2020-11-07,7332,587,960,1547,十分,丙簡
2020-11-08,7332,581,538,1119,十分,丙簡
2020-11-09,7332,231,264,495,十分,丙簡
2020-11-10,7332,307,283,590,十分,丙簡
2020-11-11,7332,386,326,712,十分,丙簡
2020-11-12,7332,244,360,604,十分,丙簡
2020-11-13,7332,361,250,611,十分,丙簡
2020-11-14,7332,549,722,1271,十分,丙簡
2020-11-15,7332,1027,849,1876,十分,丙簡
2020-11-16,7332,394,447,841,十分,丙簡
2020-11-17,7332,617,481,1098,十分,丙簡
2020-11-18,7332,388,256,644,十分,丙簡
2020-11-19,7332,548,753,1301,十分,丙簡
2020-11-20,7332,466,377,843,十分,丙簡
2020-11-21,7332,630,1079,1709,十分,丙簡
2020-11-22,7332,1022,1063,2085,十分,丙簡
2020-11-23,7332,184,197,381,十分,丙簡
2020-11-24,7332,379,433,812,十分,丙簡
2020-11-25,7332,297,357,654,十分,丙簡
2020-11-26,7332,361,395,756,十分,丙簡
2020-11-27,7332,325,314,639,十分,丙簡
2020-11-28,7332,445,535,980,十分,丙簡
2020-11-29,7332,577,470,1047,十分,丙簡
2020-11-30,7332,218,329,547,十分,丙簡
2020-12-01,7332,123,133,256,十分,丙簡
2020-12-02,7332,132,149,281,十分,丙簡
2020-12-03,7332,338,262,600,十分,丙簡
2020-12-04,7332,34,14,48,十分,丙簡
2020-12-05,7332,0,1,1,十分,丙簡
2020-12-06,7332,0,0,0,十分,丙簡
2020-12-07,7332,4,11,15,十分,丙簡
2020-12-08,7332,4,7,11,十分,丙簡
2020-12-09,7332,4,6,10,十分,丙簡
2020-12-10,7332,4,6,10,十分,丙簡
2020-12-11,7332,3,3,6,十分,丙簡
2020-12-12,7332,3,0,3,十分,丙簡
2020-12-13,7332,0,0,0,十分,丙簡
2020-12-14,7332,148,164,312,十分,丙簡
2020-12-15,7332,76,93,169,十分,丙簡
2020-12-16,7332,75,84,159,十分,丙簡
2020-12-17,7332,102,104,206,十分,丙簡
2020-12-18,7332,201,225,426,十分,丙簡
2020-12-19,7332,347,302,649,十分,丙簡
2020-12-20,7332,229,262,491,十分,丙簡
2020-12-21,7332,200,135,335,十分,丙簡
2020-12-22,7332,214,138,352,十分,丙簡
2020-12-23,7332,116,71,187,十分,丙簡
2020-12-24,7332,123,233,356,十分,丙簡
2020-12-25,7332,271,279,550,十分,丙簡
2020-12-26,7332,543,481,1024,十分,丙簡
2020-12-27,7332,605,655,1260,十分,丙簡
2020-12-28,7332,230,168,398,十分,丙簡
2020-12-29,7332,141,164,305,十分,丙簡
2020-12-30,7332,108,115,223,十分,丙簡
2020-12-31,7332,202,195,397,十分,丙簡
2020-01-01,7333,13,20,33,望古,招呼
2020-01-02,7333,12,9,21,望古,招呼
2020-01-03,7333,19,31,50,望古,招呼
2020-01-04,7333,16,34,50,望古,招呼
2020-01-05,7333,32,39,71,望古,招呼
2020-01-06,7333,12,22,34,望古,招呼
2020-01-07,7333,37,43,80,望古,招呼
2020-01-08,7333,10,9,19,望古,招呼
2020-01-09,7333,10,9,19,望古,招呼
2020-01-10,7333,23,21,44,望古,招呼
2020-01-11,7333,22,25,47,望古,招呼
2020-01-12,7333,8,12,20,望古,招呼
2020-01-13,7333,5,4,9,望古,招呼
2020-01-14,7333,12,11,23,望古,招呼
2020-01-15,7333,8,10,18,望古,招呼
2020-01-16,7333,8,7,15,望古,招呼
2020-01-17,7333,7,7,14,望古,招呼
2020-01-18,7333,12,18,30,望古,招呼
2020-01-19,7333,13,16,29,望古,招呼
2020-01-20,7333,12,12,24,望古,招呼
2020-01-21,7333,11,8,19,望古,招呼
2020-01-22,7333,15,9,24,望古,招呼
2020-01-23,7333,10,14,24,望古,招呼
2020-01-24,7333,10,9,19,望古,招呼
2020-01-25,7333,12,31,43,望古,招呼
2020-01-26,7333,2,6,8,望古,招呼
2020-01-27,7333,10,19,29,望古,招呼
2020-01-28,7333,10,21,31,望古,招呼
2020-01-29,7333,12,13,25,望古,招呼
2020-01-30,7333,17,16,33,望古,招呼
2020-01-31,7333,14,20,34,望古,招呼
2020-02-01,7333,29,45,74,望古,招呼
2020-02-02,7333,21,44,65,望古,招呼
2020-02-03,7333,20,24,44,望古,招呼
2020-02-04,7333,2,5,7,望古,招呼
2020-02-05,7333,6,2,8,望古,招呼
2020-02-06,7333,12,11,23,望古,招呼
2020-02-07,7333,27,27,54,望古,招呼
2020-02-08,7333,30,25,55,望古,招呼
2020-02-09,7333,17,15,32,望古,招呼
2020-02-10,7333,11,7,18,望古,招呼
2020-02-11,7333,6,9,15,望古,招呼
2020-02-12,7333,18,27,45,望古,招呼
2020-02-13,7333,9,7,16,望古,招呼
2020-02-14,7333,19,11,30,望古,招呼
2020-02-15,7333,11,23,34,望古,招呼
2020-02-16,7333,5,13,18,望古,招呼
2020-02-17,7333,6,4,10,望古,招呼
2020-02-18,7333,16,17,33,望古,招呼
2020-02-19,7333,10,14,24,望古,招呼
2020-02-20,7333,14,18,32,望古,招呼
2020-02-21,7333,19,28,47,望古,招呼
2020-02-22,7333,13,48,61,望古,招呼
2020-02-23,7333,49,29,78,望古,招呼
2020-02-24,7333,19,29,48,望古,招呼
2020-02-25,7333,13,14,27,望古,招呼
2020-02-26,7333,27,31,58,望古,招呼
2020-02-27,7333,24,29,53,望古,招呼
2020-02-28,7333,38,52,90,望古,招呼
2020-02-29,7333,69,92,161,望古,招呼
2020-03-01,7333,25,31,56,望古,招呼
2020-03-02,7333,12,14,26,望古,招呼
2020-03-03,7333,22,12,34,望古,招呼
2020-03-04,7333,4,2,6,望古,招呼
2020-03-05,7333,6,8,14,望古,招呼
2020-03-06,7333,5,4,9,望古,招呼
2020-03-07,7333,33,71,104,望古,招呼
2020-03-08,7333,19,56,75,望古,招呼
2020-03-09,7333,14,15,29,望古,招呼
2020-03-10,7333,7,3,10,望古,招呼
2020-03-11,7333,8,7,15,望古,招呼
2020-03-12,7333,10,8,18,望古,招呼
2020-03-13,7333,6,4,10,望古,招呼
2020-03-14,7333,23,27,50,望古,招呼
2020-03-15,7333,46,86,132,望古,招呼
2020-03-16,7333,11,15,26,望古,招呼
2020-03-17,7333,14,13,27,望古,招呼
2020-03-18,7333,8,6,14,望古,招呼
2020-03-19,7333,16,19,35,望古,招呼
2020-03-20,7333,16,6,22,望古,招呼
2020-03-21,7333,27,49,76,望古,招呼
2020-03-22,7333,30,52,82,望古,招呼
2020-03-23,7333,9,11,20,望古,招呼
2020-03-24,7333,13,10,23,望古,招呼
2020-03-25,7333,14,10,24,望古,招呼
2020-03-26,7333,22,28,50,望古,招呼
2020-03-27,7333,16,22,38,望古,招呼
2020-03-28,7333,12,11,23,望古,招呼
2020-03-29,7333,20,43,63,望古,招呼
2020-03-30,7333,22,20,42,望古,招呼
2020-03-31,7333,5,4,9,望古,招呼
2020-04-01,7333,7,8,15,望古,招呼
2020-04-02,7333,13,19,32,望古,招呼
2020-04-03,7333,19,38,57,望古,招呼
2020-04-04,7333,25,18,43,望古,招呼
2020-04-05,7333,6,18,24,望古,招呼
2020-04-06,7333,11,10,21,望古,招呼
2020-04-07,7333,10,7,17,望古,招呼
2020-04-08,7333,9,7,16,望古,招呼
2020-04-09,7333,10,6,16,望古,招呼
2020-04-10,7333,21,28,49,望古,招呼
2020-04-11,7333,24,28,52,望古,招呼
2020-04-12,7333,12,12,24,望古,招呼
2020-04-13,7333,8,14,22,望古,招呼
2020-04-14,7333,29,26,55,望古,招呼
2020-04-15,7333,20,27,47,望古,招呼
2020-04-16,7333,18,19,37,望古,招呼
2020-04-17,7333,14,20,34,望古,招呼
2020-04-18,7333,78,104,182,望古,招呼
2020-04-19,7333,43,86,129,望古,招呼
2020-04-20,7333,10,6,16,望古,招呼
2020-04-21,7333,10,15,25,望古,招呼
2020-04-22,7333,5,6,11,望古,招呼
2020-04-23,7333,6,7,13,望古,招呼
2020-04-24,7333,6,6,12,望古,招呼
2020-04-25,7333,15,24,39,望古,招呼
2020-04-26,7333,15,38,53,望古,招呼
2020-04-27,7333,6,16,22,望古,招呼
2020-04-28,7333,15,20,35,望古,招呼
2020-04-29,7333,13,25,38,望古,招呼
2020-04-30,7333,15,21,36,望古,招呼
2020-05-01,7333,51,95,146,望古,招呼
2020-05-02,7333,92,168,260,望古,招呼
2020-05-03,7333,42,92,134,望古,招呼
2020-05-04,7333,40,30,70,望古,招呼
2020-05-05,7333,20,40,60,望古,招呼
2020-05-06,7333,11,29,40,望古,招呼
2020-05-07,7333,10,15,25,望古,招呼
2020-05-08,7333,27,31,58,望古,招呼
2020-05-09,7333,100,148,248,望古,招呼
2020-05-10,7333,23,47,70,望古,招呼
2020-05-11,7333,12,31,43,望古,招呼
2020-05-12,7333,12,11,23,望古,招呼
2020-05-13,7333,16,26,42,望古,招呼
2020-05-14,7333,32,45,77,望古,招呼
2020-05-15,7333,38,47,85,望古,招呼
2020-05-16,7333,40,119,159,望古,招呼
2020-05-17,7333,46,82,128,望古,招呼
2020-05-18,7333,8,24,32,望古,招呼
2020-05-19,7333,11,10,21,望古,招呼
2020-05-20,7333,13,19,32,望古,招呼
2020-05-21,7333,13,13,26,望古,招呼
2020-05-22,7333,8,8,16,望古,招呼
2020-05-23,7333,24,38,62,望古,招呼
2020-05-24,7333,51,101,152,望古,招呼
2020-05-25,7333,19,19,38,望古,招呼
2020-05-26,7333,12,17,29,望古,招呼
2020-05-27,7333,38,62,100,望古,招呼
2020-05-28,7333,9,11,20,望古,招呼
2020-05-29,7333,17,13,30,望古,招呼
2020-05-30,7333,37,105,142,望古,招呼
2020-05-31,7333,56,147,203,望古,招呼
2020-06-01,7333,8,17,25,望古,招呼
2020-06-02,7333,51,31,82,望古,招呼
2020-06-03,7333,32,34,66,望古,招呼
2020-06-04,7333,24,32,56,望古,招呼
2020-06-05,7333,38,28,66,望古,招呼
2020-06-06,7333,67,83,150,望古,招呼
2020-06-07,7333,26,72,98,望古,招呼
2020-06-08,7333,8,7,15,望古,招呼
2020-06-09,7333,16,24,40,望古,招呼
2020-06-10,7333,10,26,36,望古,招呼
2020-06-11,7333,29,51,80,望古,招呼
2020-06-12,7333,42,24,66,望古,招呼
2020-06-13,7333,75,119,194,望古,招呼
2020-06-14,7333,77,119,196,望古,招呼
2020-06-15,7333,46,58,104,望古,招呼
2020-06-16,7333,15,41,56,望古,招呼
2020-06-17,7333,53,34,87,望古,招呼
2020-06-18,7333,22,35,57,望古,招呼
2020-06-19,7333,63,81,144,望古,招呼
2020-06-20,7333,53,75,128,望古,招呼
2020-06-21,7333,57,146,203,望古,招呼
2020-06-22,7333,31,31,62,望古,招呼
2020-06-23,7333,26,40,66,望古,招呼
2020-06-24,7333,38,29,67,望古,招呼
2020-06-25,7333,43,93,136,望古,招呼
2020-06-26,7333,88,159,247,望古,招呼
2020-06-27,7333,113,198,311,望古,招呼
2020-06-28,7333,59,82,141,望古,招呼
2020-06-29,7333,16,18,34,望古,招呼
2020-06-30,7333,32,45,77,望古,招呼
2020-07-01,7333,14,31,45,望古,招呼
2020-07-02,7333,7,27,34,望古,招呼
2020-07-03,7333,21,35,56,望古,招呼
2020-07-04,7333,100,133,233,望古,招呼
2020-07-05,7333,98,227,325,望古,招呼
2020-07-06,7333,47,53,100,望古,招呼
2020-07-07,7333,12,29,41,望古,招呼
2020-07-08,7333,21,49,70,望古,招呼
2020-07-09,7333,12,47,59,望古,招呼
2020-07-10,7333,21,43,64,望古,招呼
2020-07-11,7333,86,126,212,望古,招呼
2020-07-12,7333,71,234,305,望古,招呼
2020-07-13,7333,24,43,67,望古,招呼
2020-07-14,7333,32,50,82,望古,招呼
2020-07-15,7333,11,60,71,望古,招呼
2020-07-16,7333,35,32,67,望古,招呼
2020-07-17,7333,24,59,83,望古,招呼
2020-07-18,7333,96,178,274,望古,招呼
2020-07-19,7333,56,117,173,望古,招呼
2020-07-20,7333,18,26,44,望古,招呼
2020-07-21,7333,17,30,47,望古,招呼
2020-07-22,7333,21,35,56,望古,招呼
2020-07-23,7333,28,56,84,望古,招呼
2020-07-24,7333,54,50,104,望古,招呼
2020-07-25,7333,60,149,209,望古,招呼
2020-07-26,7333,87,92,179,望古,招呼
2020-07-27,7333,40,54,94,望古,招呼
2020-07-28,7333,15,37,52,望古,招呼
2020-07-29,7333,34,36,70,望古,招呼
2020-07-30,7333,25,35,60,望古,招呼
2020-07-31,7333,41,66,107,望古,招呼
2020-08-01,7333,130,163,293,望古,招呼
2020-08-02,7333,78,174,252,望古,招呼
2020-08-03,7333,1,2,3,望古,招呼
2020-08-04,7333,13,13,26,望古,招呼
2020-08-05,7333,31,24,55,望古,招呼
2020-08-06,7333,20,33,53,望古,招呼
2020-08-07,7333,21,17,38,望古,招呼
2020-08-08,7333,45,59,104,望古,招呼
2020-08-09,7333,49,176,225,望古,招呼
2020-08-10,7333,44,62,106,望古,招呼
2020-08-11,7333,13,20,33,望古,招呼
2020-08-12,7333,18,38,56,望古,招呼
2020-08-13,7333,47,55,102,望古,招呼
2020-08-14,7333,18,44,62,望古,招呼
2020-08-15,7333,126,117,243,望古,招呼
2020-08-16,7333,28,75,103,望古,招呼
2020-08-17,7333,22,19,41,望古,招呼
2020-08-18,7333,22,43,65,望古,招呼
2020-08-19,7333,39,82,121,望古,招呼
2020-08-20,7333,34,41,75,望古,招呼
2020-08-21,7333,23,42,65,望古,招呼
2020-08-22,7333,68,86,154,望古,招呼
2020-08-23,7333,34,44,78,望古,招呼
2020-08-24,7333,40,41,81,望古,招呼
2020-08-25,7333,40,32,72,望古,招呼
2020-08-26,7333,20,36,56,望古,招呼
2020-08-27,7333,9,48,57,望古,招呼
2020-08-28,7333,15,14,29,望古,招呼
2020-08-29,7333,37,70,107,望古,招呼
2020-08-30,7333,87,54,141,望古,招呼
2020-08-31,7333,8,26,34,望古,招呼
2020-09-01,7333,8,7,15,望古,招呼
2020-09-02,7333,7,9,16,望古,招呼
2020-09-03,7333,11,8,19,望古,招呼
2020-09-04,7333,13,28,41,望古,招呼
2020-09-05,7333,86,110,196,望古,招呼
2020-09-06,7333,95,49,144,望古,招呼
2020-09-07,7333,31,31,62,望古,招呼
2020-09-08,7333,18,34,52,望古,招呼
2020-09-09,7333,26,23,49,望古,招呼
2020-09-10,7333,14,32,46,望古,招呼
2020-09-11,7333,19,19,38,望古,招呼
2020-09-12,7333,23,41,64,望古,招呼
2020-09-13,7333,14,23,37,望古,招呼
2020-09-14,7333,8,17,25,望古,招呼
2020-09-15,7333,15,15,30,望古,招呼
2020-09-16,7333,35,16,51,望古,招呼
2020-09-17,7333,23,15,38,望古,招呼
2020-09-18,7333,43,48,91,望古,招呼
2020-09-19,7333,46,46,92,望古,招呼
2020-09-20,7333,17,19,36,望古,招呼
2020-09-21,7333,20,23,43,望古,招呼
2020-09-22,7333,52,68,120,望古,招呼
2020-09-23,7333,26,61,87,望古,招呼
2020-09-24,7333,15,15,30,望古,招呼
2020-09-25,7333,12,12,24,望古,招呼
2020-09-26,7333,35,54,89,望古,招呼
2020-09-27,7333,12,15,27,望古,招呼
2020-09-28,7333,3,3,6,望古,招呼
2020-09-29,7333,23,19,42,望古,招呼
2020-09-30,7333,5,18,23,望古,招呼
2020-10-01,7333,27,40,67,望古,招呼
2020-10-02,7333,89,137,226,望古,招呼
2020-10-03,7333,47,82,129,望古,招呼
2020-10-04,7333,65,83,148,望古,招呼
2020-10-05,7333,6,5,11,望古,招呼
2020-10-06,7333,11,12,23,望古,招呼
2020-10-07,7333,26,17,43,望古,招呼
2020-10-08,7333,12,16,28,望古,招呼
2020-10-09,7333,25,29,54,望古,招呼
2020-10-10,7333,15,25,40,望古,招呼
2020-10-11,7333,35,11,46,望古,招呼
2020-10-12,7333,6,14,20,望古,招呼
2020-10-13,7333,6,7,13,望古,招呼
2020-10-14,7333,15,22,37,望古,招呼
2020-10-15,7333,15,15,30,望古,招呼
2020-10-16,7333,12,19,31,望古,招呼
2020-10-17,7333,14,16,30,望古,招呼
2020-10-18,7333,14,31,45,望古,招呼
2020-10-19,7333,10,7,17,望古,招呼
2020-10-20,7333,14,10,24,望古,招呼
2020-10-21,7333,12,8,20,望古,招呼
2020-10-22,7333,6,6,12,望古,招呼
2020-10-23,7333,7,6,13,望古,招呼
2020-10-24,7333,32,126,158,望古,招呼
2020-10-25,7333,11,21,32,望古,招呼
2020-10-26,7333,20,25,45,望古,招呼
2020-10-27,7333,20,30,50,望古,招呼
2020-10-28,7333,17,36,53,望古,招呼
2020-10-29,7333,14,13,27,望古,招呼
2020-10-30,7333,24,23,47,望古,招呼
2020-10-31,7333,26,62,88,望古,招呼
2020-11-01,7333,85,114,199,望古,招呼
2020-11-02,7333,26,26,52,望古,招呼
2020-11-03,7333,48,21,69,望古,招呼
2020-11-04,7333,10,10,20,望古,招呼
2020-11-05,7333,22,32,54,望古,招呼
2020-11-06,7333,12,9,21,望古,招呼
2020-11-07,7333,28,26,54,望古,招呼
2020-11-08,7333,20,24,44,望古,招呼
2020-11-09,7333,4,8,12,望古,招呼
2020-11-10,7333,7,7,14,望古,招呼
2020-11-11,7333,12,13,25,望古,招呼
2020-11-12,7333,3,6,9,望古,招呼
2020-11-13,7333,12,9,21,望古,招呼
2020-11-14,7333,14,26,40,望古,招呼
2020-11-15,7333,16,39,55,望古,招呼
2020-11-16,7333,6,6,12,望古,招呼
2020-11-17,7333,11,18,29,望古,招呼
2020-11-18,7333,35,40,75,望古,招呼
2020-11-19,7333,26,30,56,望古,招呼
2020-11-20,7333,29,26,55,望古,招呼
2020-11-21,7333,7,8,15,望古,招呼
2020-11-22,7333,40,85,125,望古,招呼
2020-11-23,7333,10,11,21,望古,招呼
2020-11-24,7333,30,53,83,望古,招呼
2020-11-25,7333,8,20,28,望古,招呼
2020-11-26,7333,14,23,37,望古,招呼
2020-11-27,7333,7,8,15,望古,招呼
2020-11-28,7333,15,31,46,望古,招呼
2020-11-29,7333,24,23,47,望古,招呼
2020-11-30,7333,11,7,18,望古,招呼
2020-12-01,7333,5,5,10,望古,招呼
2020-12-02,7333,1,3,4,望古,招呼
2020-12-03,7333,6,4,10,望古,招呼
2020-12-04,7333,3,1,4,望古,招呼
2020-12-05,7333,0,0,0,望古,招呼
2020-12-06,7333,0,0,0,望古,招呼
2020-12-07,7333,0,0,0,望古,招呼
2020-12-08,7333,0,0,0,望古,招呼
2020-12-09,7333,0,0,0,望古,招呼
2020-12-10,7333,0,0,0,望古,招呼
2020-12-11,7333,0,0,0,望古,招呼
2020-12-12,7333,0,0,0,望古,招呼
2020-12-13,7333,0,0,0,望古,招呼
2020-12-14,7333,2,2,4,望古,招呼
2020-12-15,7333,3,5,8,望古,招呼
2020-12-16,7333,2,4,6,望古,招呼
2020-12-17,7333,13,12,25,望古,招呼
2020-12-18,7333,5,6,11,望古,招呼
2020-12-19,7333,15,15,30,望古,招呼
2020-12-20,7333,27,29,56,望古,招呼
2020-12-21,7333,3,2,5,望古,招呼
2020-12-22,7333,2,4,6,望古,招呼
2020-12-23,7333,6,14,20,望古,招呼
2020-12-24,7333,4,7,11,望古,招呼
2020-12-25,7333,6,6,12,望古,招呼
2020-12-26,7333,8,14,22,望古,招呼
2020-12-27,7333,11,14,25,望古,招呼
2020-12-28,7333,8,4,12,望古,招呼
2020-12-29,7333,13,13,26,望古,招呼
2020-12-30,7333,4,3,7,望古,招呼
2020-12-31,7333,2,2,4,望古,招呼
2020-01-01,7334,30,20,50,嶺腳,招呼
2020-01-02,7334,25,26,51,嶺腳,招呼
2020-01-03,7334,30,23,53,嶺腳,招呼
2020-01-04,7334,39,58,97,嶺腳,招呼
2020-01-05,7334,37,26,63,嶺腳,招呼
2020-01-06,7334,27,22,49,嶺腳,招呼
2020-01-07,7334,50,42,92,嶺腳,招呼
2020-01-08,7334,25,25,50,嶺腳,招呼
2020-01-09,7334,21,15,36,嶺腳,招呼
2020-01-10,7334,20,22,42,嶺腳,招呼
2020-01-11,7334,35,49,84,嶺腳,招呼
2020-01-12,7334,28,25,53,嶺腳,招呼
2020-01-13,7334,19,21,40,嶺腳,招呼
2020-01-14,7334,31,363,394,嶺腳,招呼
2020-01-15,7334,17,25,42,嶺腳,招呼
2020-01-16,7334,24,20,44,嶺腳,招呼
2020-01-17,7334,26,22,48,嶺腳,招呼
2020-01-18,7334,43,30,73,嶺腳,招呼
2020-01-19,7334,32,34,66,嶺腳,招呼
2020-01-20,7334,31,19,50,嶺腳,招呼
2020-01-21,7334,34,23,57,嶺腳,招呼
2020-01-22,7334,15,19,34,嶺腳,招呼
2020-01-23,7334,24,74,98,嶺腳,招呼
2020-01-24,7334,19,20,39,嶺腳,招呼
2020-01-25,7334,57,39,96,嶺腳,招呼
2020-01-26,7334,29,22,51,嶺腳,招呼
2020-01-27,7334,13,27,40,嶺腳,招呼
2020-01-28,7334,54,42,96,嶺腳,招呼
2020-01-29,7334,40,44,84,嶺腳,招呼
2020-01-30,7334,35,70,105,嶺腳,招呼
2020-01-31,7334,36,26,62,嶺腳,招呼
2020-02-01,7334,51,64,115,嶺腳,招呼
2020-02-02,7334,51,36,87,嶺腳,招呼
2020-02-03,7334,22,23,45,嶺腳,招呼
2020-02-04,7334,26,19,45,嶺腳,招呼
2020-02-05,7334,16,21,37,嶺腳,招呼
2020-02-06,7334,45,20,65,嶺腳,招呼
2020-02-07,7334,21,22,43,嶺腳,招呼
2020-02-08,7334,34,43,77,嶺腳,招呼
2020-02-09,7334,41,21,62,嶺腳,招呼
2020-02-10,7334,20,16,36,嶺腳,招呼
2020-02-11,7334,29,17,46,嶺腳,招呼
2020-02-12,7334,28,16,44,嶺腳,招呼
2020-02-13,7334,37,30,67,嶺腳,招呼
2020-02-14,7334,16,13,29,嶺腳,招呼
2020-02-15,7334,25,16,41,嶺腳,招呼
2020-02-16,7334,25,62,87,嶺腳,招呼
2020-02-17,7334,13,18,31,嶺腳,招呼
2020-02-18,7334,23,18,41,嶺腳,招呼
2020-02-19,7334,33,23,56,嶺腳,招呼
2020-02-20,7334,27,27,54,嶺腳,招呼
2020-02-21,7334,35,23,58,嶺腳,招呼
2020-02-22,7334,56,17,73,嶺腳,招呼
2020-02-23,7334,44,61,105,嶺腳,招呼
2020-02-24,7334,32,19,51,嶺腳,招呼
2020-02-25,7334,38,23,61,嶺腳,招呼
2020-02-26,7334,29,22,51,嶺腳,招呼
2020-02-27,7334,23,32,55,嶺腳,招呼
2020-02-28,7334,72,50,122,嶺腳,招呼
2020-02-29,7334,66,36,102,嶺腳,招呼
2020-03-01,7334,12,15,27,嶺腳,招呼
2020-03-02,7334,19,30,49,嶺腳,招呼
2020-03-03,7334,19,17,36,嶺腳,招呼
2020-03-04,7334,15,18,33,嶺腳,招呼
2020-03-05,7334,19,22,41,嶺腳,招呼
2020-03-06,7334,16,14,30,嶺腳,招呼
2020-03-07,7334,51,43,94,嶺腳,招呼
2020-03-08,7334,52,91,143,嶺腳,招呼
2020-03-09,7334,13,23,36,嶺腳,招呼
2020-03-10,7334,17,19,36,嶺腳,招呼
2020-03-11,7334,11,16,27,嶺腳,招呼
2020-03-12,7334,18,20,38,嶺腳,招呼
2020-03-13,7334,9,15,24,嶺腳,招呼
2020-03-14,7334,34,47,81,嶺腳,招呼
2020-03-15,7334,35,31,66,嶺腳,招呼
2020-03-16,7334,12,16,28,嶺腳,招呼
2020-03-17,7334,21,17,38,嶺腳,招呼
2020-03-18,7334,13,15,28,嶺腳,招呼
2020-03-19,7334,17,21,38,嶺腳,招呼
2020-03-20,7334,14,23,37,嶺腳,招呼
2020-03-21,7334,41,40,81,嶺腳,招呼
2020-03-22,7334,88,34,122,嶺腳,招呼
2020-03-23,7334,13,17,30,嶺腳,招呼
2020-03-24,7334,17,16,33,嶺腳,招呼
2020-03-25,7334,19,26,45,嶺腳,招呼
2020-03-26,7334,32,23,55,嶺腳,招呼
2020-03-27,7334,32,19,51,嶺腳,招呼
2020-03-28,7334,19,16,35,嶺腳,招呼
2020-03-29,7334,48,15,63,嶺腳,招呼
2020-03-30,7334,11,17,28,嶺腳,招呼
2020-03-31,7334,15,14,29,嶺腳,招呼
2020-04-01,7334,17,18,35,嶺腳,招呼
2020-04-02,7334,17,22,39,嶺腳,招呼
2020-04-03,7334,40,22,62,嶺腳,招呼
2020-04-04,7334,15,335,350,嶺腳,招呼
2020-04-05,7334,26,18,44,嶺腳,招呼
2020-04-06,7334,16,20,36,嶺腳,招呼
2020-04-07,7334,11,15,26,嶺腳,招呼
2020-04-08,7334,13,14,27,嶺腳,招呼
2020-04-09,7334,14,13,27,嶺腳,招呼
2020-04-10,7334,32,21,53,嶺腳,招呼
2020-04-11,7334,30,31,61,嶺腳,招呼
2020-04-12,7334,20,10,30,嶺腳,招呼
2020-04-13,7334,23,14,37,嶺腳,招呼
2020-04-14,7334,28,32,60,嶺腳,招呼
2020-04-15,7334,14,14,28,嶺腳,招呼
2020-04-16,7334,30,22,52,嶺腳,招呼
2020-04-17,7334,31,31,62,嶺腳,招呼
2020-04-18,7334,75,60,135,嶺腳,招呼
2020-04-19,7334,57,34,91,嶺腳,招呼
2020-04-20,7334,10,16,26,嶺腳,招呼
2020-04-21,7334,32,23,55,嶺腳,招呼
2020-04-22,7334,14,20,34,嶺腳,招呼
2020-04-23,7334,14,15,29,嶺腳,招呼
2020-04-24,7334,13,15,28,嶺腳,招呼
2020-04-25,7334,32,27,59,嶺腳,招呼
2020-04-26,7334,37,29,66,嶺腳,招呼
2020-04-27,7334,11,17,28,嶺腳,招呼
2020-04-28,7334,21,19,40,嶺腳,招呼
2020-04-29,7334,24,22,46,嶺腳,招呼
2020-04-30,7334,26,21,47,嶺腳,招呼
2020-05-01,7334,76,67,143,嶺腳,招呼
2020-05-02,7334,79,38,117,嶺腳,招呼
2020-05-03,7334,92,52,144,嶺腳,招呼
2020-05-04,7334,19,31,50,嶺腳,招呼
2020-05-05,7334,50,39,89,嶺腳,招呼
2020-05-06,7334,44,39,83,嶺腳,招呼
2020-05-07,7334,40,29,69,嶺腳,招呼
2020-05-08,7334,26,23,49,嶺腳,招呼
2020-05-09,7334,106,82,188,嶺腳,招呼
2020-05-10,7334,60,37,97,嶺腳,招呼
2020-05-11,7334,43,21,64,嶺腳,招呼
2020-05-12,7334,18,17,35,嶺腳,招呼
2020-05-13,7334,43,37,80,嶺腳,招呼
2020-05-14,7334,28,34,62,嶺腳,招呼
2020-05-15,7334,41,43,84,嶺腳,招呼
2020-05-16,7334,90,45,135,嶺腳,招呼
2020-05-17,7334,89,48,137,嶺腳,招呼
2020-05-18,7334,40,41,81,嶺腳,招呼
2020-05-19,7334,12,12,24,嶺腳,招呼
2020-05-20,7334,19,20,39,嶺腳,招呼
2020-05-21,7334,27,28,55,嶺腳,招呼
2020-05-22,7334,19,23,42,嶺腳,招呼
2020-05-23,7334,23,19,42,嶺腳,招呼
2020-05-24,7334,79,68,147,嶺腳,招呼
2020-05-25,7334,18,23,41,嶺腳,招呼
2020-05-26,7334,28,26,54,嶺腳,招呼
2020-05-27,7334,36,15,51,嶺腳,招呼
2020-05-28,7334,27,30,57,嶺腳,招呼
2020-05-29,7334,15,23,38,嶺腳,招呼
2020-05-30,7334,78,56,134,嶺腳,招呼
2020-05-31,7334,109,59,168,嶺腳,招呼
2020-06-01,7334,25,26,51,嶺腳,招呼
2020-06-02,7334,16,32,48,嶺腳,招呼
2020-06-03,7334,63,48,111,嶺腳,招呼
2020-06-04,7334,31,26,57,嶺腳,招呼
2020-06-05,7334,37,52,89,嶺腳,招呼
2020-06-06,7334,82,84,166,嶺腳,招呼
2020-06-07,7334,81,54,135,嶺腳,招呼
2020-06-08,7334,11,17,28,嶺腳,招呼
2020-06-09,7334,44,29,73,嶺腳,招呼
2020-06-10,7334,35,24,59,嶺腳,招呼
2020-06-11,7334,61,33,94,嶺腳,招呼
2020-06-12,7334,30,34,64,嶺腳,招呼
2020-06-13,7334,111,85,196,嶺腳,招呼
2020-06-14,7334,131,84,215,嶺腳,招呼
2020-06-15,7334,41,36,77,嶺腳,招呼
2020-06-16,7334,49,45,94,嶺腳,招呼
2020-06-17,7334,39,53,92,嶺腳,招呼
2020-06-18,7334,37,35,72,嶺腳,招呼
2020-06-19,7334,55,36,91,嶺腳,招呼
2020-06-20,7334,86,67,153,嶺腳,招呼
2020-06-21,7334,155,70,225,嶺腳,招呼
2020-06-22,7334,25,31,56,嶺腳,招呼
2020-06-23,7334,25,27,52,嶺腳,招呼
2020-06-24,7334,32,52,84,嶺腳,招呼
2020-06-25,7334,89,85,174,嶺腳,招呼
2020-06-26,7334,185,144,329,嶺腳,招呼
2020-06-27,7334,218,203,421,嶺腳,招呼
2020-06-28,7334,120,64,184,嶺腳,招呼
2020-06-29,7334,22,25,47,嶺腳,招呼
2020-06-30,7334,34,48,82,嶺腳,招呼
2020-07-01,7334,40,21,61,嶺腳,招呼
2020-07-02,7334,44,34,78,嶺腳,招呼
2020-07-03,7334,37,24,61,嶺腳,招呼
2020-07-04,7334,70,43,113,嶺腳,招呼
2020-07-05,7334,202,84,286,嶺腳,招呼
2020-07-06,7334,22,38,60,嶺腳,招呼
2020-07-07,7334,20,20,40,嶺腳,招呼
2020-07-08,7334,56,28,84,嶺腳,招呼
2020-07-09,7334,96,72,168,嶺腳,招呼
2020-07-10,7334,52,43,95,嶺腳,招呼
2020-07-11,7334,85,55,140,嶺腳,招呼
2020-07-12,7334,181,80,261,嶺腳,招呼
2020-07-13,7334,46,34,80,嶺腳,招呼
2020-07-14,7334,44,36,80,嶺腳,招呼
2020-07-15,7334,74,29,103,嶺腳,招呼
2020-07-16,7334,48,50,98,嶺腳,招呼
2020-07-17,7334,83,67,150,嶺腳,招呼
2020-07-18,7334,176,94,270,嶺腳,招呼
2020-07-19,7334,132,100,232,嶺腳,招呼
2020-07-20,7334,24,31,55,嶺腳,招呼
2020-07-21,7334,44,43,87,嶺腳,招呼
2020-07-22,7334,45,34,79,嶺腳,招呼
2020-07-23,7334,69,51,120,嶺腳,招呼
2020-07-24,7334,49,60,109,嶺腳,招呼
2020-07-25,7334,145,73,218,嶺腳,招呼
2020-07-26,7334,82,106,188,嶺腳,招呼
2020-07-27,7334,38,38,76,嶺腳,招呼
2020-07-28,7334,62,55,117,嶺腳,招呼
2020-07-29,7334,26,24,50,嶺腳,招呼
2020-07-30,7334,44,46,90,嶺腳,招呼
2020-07-31,7334,39,28,67,嶺腳,招呼
2020-08-01,7334,117,87,204,嶺腳,招呼
2020-08-02,7334,180,119,299,嶺腳,招呼
2020-08-03,7334,17,18,35,嶺腳,招呼
2020-08-04,7334,19,33,52,嶺腳,招呼
2020-08-05,7334,29,43,72,嶺腳,招呼
2020-08-06,7334,36,29,65,嶺腳,招呼
2020-08-07,7334,19,32,51,嶺腳,招呼
2020-08-08,7334,109,96,205,嶺腳,招呼
2020-08-09,7334,133,32,165,嶺腳,招呼
2020-08-10,7334,56,71,127,嶺腳,招呼
2020-08-11,7334,39,15,54,嶺腳,招呼
2020-08-12,7334,44,45,89,嶺腳,招呼
2020-08-13,7334,42,46,88,嶺腳,招呼
2020-08-14,7334,64,47,111,嶺腳,招呼
2020-08-15,7334,97,138,235,嶺腳,招呼
2020-08-16,7334,106,92,198,嶺腳,招呼
2020-08-17,7334,33,38,71,嶺腳,招呼
2020-08-18,7334,52,44,96,嶺腳,招呼
2020-08-19,7334,74,40,114,嶺腳,招呼
2020-08-20,7334,62,40,102,嶺腳,招呼
2020-08-21,7334,73,54,127,嶺腳,招呼
2020-08-22,7334,70,52,122,嶺腳,招呼
2020-08-23,7334,78,74,152,嶺腳,招呼
2020-08-24,7334,27,36,63,嶺腳,招呼
2020-08-25,7334,33,41,74,嶺腳,招呼
2020-08-26,7334,91,88,179,嶺腳,招呼
2020-08-27,7334,44,17,61,嶺腳,招呼
2020-08-28,7334,21,29,50,嶺腳,招呼
2020-08-29,7334,54,27,81,嶺腳,招呼
2020-08-30,7334,66,97,163,嶺腳,招呼
2020-08-31,7334,30,21,51,嶺腳,招呼
2020-09-01,7334,15,17,32,嶺腳,招呼
2020-09-02,7334,24,35,59,嶺腳,招呼
2020-09-03,7334,27,36,63,嶺腳,招呼
2020-09-04,7334,44,22,66,嶺腳,招呼
2020-09-05,7334,90,66,156,嶺腳,招呼
2020-09-06,7334,73,125,198,嶺腳,招呼
2020-09-07,7334,34,29,63,嶺腳,招呼
2020-09-08,7334,60,52,112,嶺腳,招呼
2020-09-09,7334,26,23,49,嶺腳,招呼
2020-09-10,7334,47,36,83,嶺腳,招呼
2020-09-11,7334,19,35,54,嶺腳,招呼
2020-09-12,7334,43,44,87,嶺腳,招呼
2020-09-13,7334,20,17,37,嶺腳,招呼
2020-09-14,7334,25,20,45,嶺腳,招呼
2020-09-15,7334,33,25,58,嶺腳,招呼
2020-09-16,7334,22,50,72,嶺腳,招呼
2020-09-17,7334,23,11,34,嶺腳,招呼
2020-09-18,7334,32,49,81,嶺腳,招呼
2020-09-19,7334,35,53,88,嶺腳,招呼
2020-09-20,7334,21,15,36,嶺腳,招呼
2020-09-21,7334,29,33,62,嶺腳,招呼
2020-09-22,7334,77,21,98,嶺腳,招呼
2020-09-23,7334,53,22,75,嶺腳,招呼
2020-09-24,7334,29,33,62,嶺腳,招呼
2020-09-25,7334,64,26,90,嶺腳,招呼
2020-09-26,7334,51,18,69,嶺腳,招呼
2020-09-27,7334,16,21,37,嶺腳,招呼
2020-09-28,7334,11,12,23,嶺腳,招呼
2020-09-29,7334,24,29,53,嶺腳,招呼
2020-09-30,7334,19,26,45,嶺腳,招呼
2020-10-01,7334,47,46,93,嶺腳,招呼
2020-10-02,7334,110,82,192,嶺腳,招呼
2020-10-03,7334,98,72,170,嶺腳,招呼
2020-10-04,7334,90,58,148,嶺腳,招呼
2020-10-05,7334,8,17,25,嶺腳,招呼
2020-10-06,7334,18,16,34,嶺腳,招呼
2020-10-07,7334,26,24,50,嶺腳,招呼
2020-10-08,7334,19,16,35,嶺腳,招呼
2020-10-09,7334,54,52,106,嶺腳,招呼
2020-10-10,7334,33,32,65,嶺腳,招呼
2020-10-11,7334,13,38,51,嶺腳,招呼
2020-10-12,7334,15,14,29,嶺腳,招呼
2020-10-13,7334,14,16,30,嶺腳,招呼
2020-10-14,7334,14,45,59,嶺腳,招呼
2020-10-15,7334,27,27,54,嶺腳,招呼
2020-10-16,7334,18,20,38,嶺腳,招呼
2020-10-17,7334,21,27,48,嶺腳,招呼
2020-10-18,7334,29,14,43,嶺腳,招呼
2020-10-19,7334,25,25,50,嶺腳,招呼
2020-10-20,7334,22,27,49,嶺腳,招呼
2020-10-21,7334,15,19,34,嶺腳,招呼
2020-10-22,7334,24,25,49,嶺腳,招呼
2020-10-23,7334,19,24,43,嶺腳,招呼
2020-10-24,7334,115,43,158,嶺腳,招呼
2020-10-25,7334,33,27,60,嶺腳,招呼
2020-10-26,7334,24,32,56,嶺腳,招呼
2020-10-27,7334,15,11,26,嶺腳,招呼
2020-10-28,7334,21,12,33,嶺腳,招呼
2020-10-29,7334,29,28,57,嶺腳,招呼
2020-10-30,7334,27,21,48,嶺腳,招呼
2020-10-31,7334,51,44,95,嶺腳,招呼
2020-11-01,7334,78,59,137,嶺腳,招呼
2020-11-02,7334,48,47,95,嶺腳,招呼
2020-11-03,7334,37,62,99,嶺腳,招呼
2020-11-04,7334,22,28,50,嶺腳,招呼
2020-11-05,7334,44,22,66,嶺腳,招呼
2020-11-06,7334,17,28,45,嶺腳,招呼
2020-11-07,7334,28,29,57,嶺腳,招呼
2020-11-08,7334,34,37,71,嶺腳,招呼
2020-11-09,7334,20,22,42,嶺腳,招呼
2020-11-10,7334,16,15,31,嶺腳,招呼
2020-11-11,7334,16,35,51,嶺腳,招呼
2020-11-12,7334,24,18,42,嶺腳,招呼
2020-11-13,7334,20,32,52,嶺腳,招呼
2020-11-14,7334,18,29,47,嶺腳,招呼
2020-11-15,7334,45,31,76,嶺腳,招呼
2020-11-16,7334,21,26,47,嶺腳,招呼
2020-11-17,7334,32,31,63,嶺腳,招呼
2020-11-18,7334,50,22,72,嶺腳,招呼
2020-11-19,7334,27,29,56,嶺腳,招呼
2020-11-20,7334,28,36,64,嶺腳,招呼
2020-11-21,7334,50,55,105,嶺腳,招呼
2020-11-22,7334,86,77,163,嶺腳,招呼
2020-11-23,7334,19,23,42,嶺腳,招呼
2020-11-24,7334,41,47,88,嶺腳,招呼
2020-11-25,7334,28,24,52,嶺腳,招呼
2020-11-26,7334,49,44,93,嶺腳,招呼
2020-11-27,7334,31,32,63,嶺腳,招呼
2020-11-28,7334,39,25,64,嶺腳,招呼
2020-11-29,7334,32,29,61,嶺腳,招呼
2020-11-30,7334,23,24,47,嶺腳,招呼
2020-12-01,7334,16,17,33,嶺腳,招呼
2020-12-02,7334,31,33,64,嶺腳,招呼
2020-12-03,7334,18,21,39,嶺腳,招呼
2020-12-04,7334,8,2,10,嶺腳,招呼
2020-12-05,7334,0,0,0,嶺腳,招呼
2020-12-06,7334,0,0,0,嶺腳,招呼
2020-12-07,7334,1,8,9,嶺腳,招呼
2020-12-08,7334,1,1,2,嶺腳,招呼
2020-12-09,7334,1,1,2,嶺腳,招呼
2020-12-10,7334,1,1,2,嶺腳,招呼
2020-12-11,7334,1,1,2,嶺腳,招呼
2020-12-12,7334,0,0,0,嶺腳,招呼
2020-12-13,7334,0,0,0,嶺腳,招呼
2020-12-14,7334,19,14,33,嶺腳,招呼
2020-12-15,7334,17,18,35,嶺腳,招呼
2020-12-16,7334,10,15,25,嶺腳,招呼
2020-12-17,7334,12,14,26,嶺腳,招呼
2020-12-18,7334,19,15,34,嶺腳,招呼
2020-12-19,7334,24,9,33,嶺腳,招呼
2020-12-20,7334,11,42,53,嶺腳,招呼
2020-12-21,7334,10,11,21,嶺腳,招呼
2020-12-22,7334,19,15,34,嶺腳,招呼
2020-12-23,7334,22,14,36,嶺腳,招呼
2020-12-24,7334,15,18,33,嶺腳,招呼
2020-12-25,7334,21,19,40,嶺腳,招呼
2020-12-26,7334,16,23,39,嶺腳,招呼
2020-12-27,7334,33,28,61,嶺腳,招呼
2020-12-28,7334,10,13,23,嶺腳,招呼
2020-12-29,7334,18,16,34,嶺腳,招呼
2020-12-30,7334,8,11,19,嶺腳,招呼
2020-12-31,7334,11,11,22,嶺腳,招呼
2020-01-01,7335,475,491,966,平溪,簡易
2020-01-02,7335,309,325,634,平溪,簡易
2020-01-03,7335,231,227,458,平溪,簡易
2020-01-04,7335,539,532,1071,平溪,簡易
2020-01-05,7335,647,612,1259,平溪,簡易
2020-01-06,7335,200,214,414,平溪,簡易
2020-01-07,7335,215,217,432,平溪,簡易
2020-01-08,7335,158,183,341,平溪,簡易
2020-01-09,7335,181,154,335,平溪,簡易
2020-01-10,7335,192,196,388,平溪,簡易
2020-01-11,7335,266,260,526,平溪,簡易
2020-01-12,7335,236,234,470,平溪,簡易
2020-01-13,7335,131,131,262,平溪,簡易
2020-01-14,7335,195,203,398,平溪,簡易
2020-01-15,7335,148,156,304,平溪,簡易
2020-01-16,7335,262,407,669,平溪,簡易
2020-01-17,7335,214,245,459,平溪,簡易
2020-01-18,7335,313,322,635,平溪,簡易
2020-01-19,7335,324,386,710,平溪,簡易
2020-01-20,7335,460,410,870,平溪,簡易
2020-01-21,7335,316,366,682,平溪,簡易
2020-01-22,7335,288,352,640,平溪,簡易
2020-01-23,7335,304,332,636,平溪,簡易
2020-01-24,7335,179,223,402,平溪,簡易
2020-01-25,7335,1011,1046,2057,平溪,簡易
2020-01-26,7335,475,514,989,平溪,簡易
2020-01-27,7335,985,1108,2093,平溪,簡易
2020-01-28,7335,1013,1042,2055,平溪,簡易
2020-01-29,7335,570,570,1140,平溪,簡易
2020-01-30,7335,505,578,1083,平溪,簡易
2020-01-31,7335,624,698,1322,平溪,簡易
2020-02-01,7335,1972,2055,4027,平溪,簡易
2020-02-02,7335,855,865,1720,平溪,簡易
2020-02-03,7335,329,380,709,平溪,簡易
2020-02-04,7335,188,206,394,平溪,簡易
2020-02-05,7335,222,218,440,平溪,簡易
2020-02-06,7335,341,354,695,平溪,簡易
2020-02-07,7335,332,345,677,平溪,簡易
2020-02-08,7335,979,1056,2035,平溪,簡易
2020-02-09,7335,367,410,777,平溪,簡易
2020-02-10,7335,281,307,588,平溪,簡易
2020-02-11,7335,277,292,569,平溪,簡易
2020-02-12,7335,367,367,734,平溪,簡易
2020-02-13,7335,217,222,439,平溪,簡易
2020-02-14,7335,257,282,539,平溪,簡易
2020-02-15,7335,409,449,858,平溪,簡易
2020-02-16,7335,195,238,433,平溪,簡易
2020-02-17,7335,225,272,497,平溪,簡易
2020-02-18,7335,249,278,527,平溪,簡易
2020-02-19,7335,254,278,532,平溪,簡易
2020-02-20,7335,265,301,566,平溪,簡易
2020-02-21,7335,305,365,670,平溪,簡易
2020-02-22,7335,281,330,611,平溪,簡易
2020-02-23,7335,366,381,747,平溪,簡易
2020-02-24,7335,298,327,625,平溪,簡易
2020-02-25,7335,201,248,449,平溪,簡易
2020-02-26,7335,219,236,455,平溪,簡易
2020-02-27,7335,150,134,284,平溪,簡易
2020-02-28,7335,657,739,1396,平溪,簡易
2020-02-29,7335,683,731,1414,平溪,簡易
2020-03-01,7335,260,301,561,平溪,簡易
2020-03-02,7335,79,78,157,平溪,簡易
2020-03-03,7335,111,115,226,平溪,簡易
2020-03-04,7335,68,63,131,平溪,簡易
2020-03-05,7335,43,43,86,平溪,簡易
2020-03-06,7335,89,87,176,平溪,簡易
2020-03-07,7335,363,368,731,平溪,簡易
2020-03-08,7335,350,382,732,平溪,簡易
2020-03-09,7335,113,120,233,平溪,簡易
2020-03-10,7335,57,62,119,平溪,簡易
2020-03-11,7335,96,92,188,平溪,簡易
2020-03-12,7335,71,97,168,平溪,簡易
2020-03-13,7335,70,72,142,平溪,簡易
2020-03-14,7335,113,152,265,平溪,簡易
2020-03-15,7335,381,465,846,平溪,簡易
2020-03-16,7335,100,117,217,平溪,簡易
2020-03-17,7335,90,89,179,平溪,簡易
2020-03-18,7335,98,93,191,平溪,簡易
2020-03-19,7335,72,67,139,平溪,簡易
2020-03-20,7335,105,106,211,平溪,簡易
2020-03-21,7335,351,384,735,平溪,簡易
2020-03-22,7335,381,432,813,平溪,簡易
2020-03-23,7335,84,84,168,平溪,簡易
2020-03-24,7335,73,70,143,平溪,簡易
2020-03-25,7335,90,93,183,平溪,簡易
2020-03-26,7335,96,115,211,平溪,簡易
2020-03-27,7335,109,107,216,平溪,簡易
2020-03-28,7335,62,75,137,平溪,簡易
2020-03-29,7335,273,264,537,平溪,簡易
2020-03-30,7335,86,98,184,平溪,簡易
2020-03-31,7335,96,104,200,平溪,簡易
2020-04-01,7335,109,114,223,平溪,簡易
2020-04-02,7335,174,167,341,平溪,簡易
2020-04-03,7335,286,284,570,平溪,簡易
2020-04-04,7335,130,147,277,平溪,簡易
2020-04-05,7335,169,116,285,平溪,簡易
2020-04-06,7335,76,89,165,平溪,簡易
2020-04-07,7335,34,38,72,平溪,簡易
2020-04-08,7335,46,54,100,平溪,簡易
2020-04-09,7335,58,63,121,平溪,簡易
2020-04-10,7335,112,112,224,平溪,簡易
2020-04-11,7335,115,127,242,平溪,簡易
2020-04-12,7335,63,69,132,平溪,簡易
2020-04-13,7335,92,91,183,平溪,簡易
2020-04-14,7335,76,70,146,平溪,簡易
2020-04-15,7335,96,102,198,平溪,簡易
2020-04-16,7335,140,142,282,平溪,簡易
2020-04-17,7335,131,127,258,平溪,簡易
2020-04-18,7335,366,388,754,平溪,簡易
2020-04-19,7335,252,233,485,平溪,簡易
2020-04-20,7335,59,78,137,平溪,簡易
2020-04-21,7335,56,65,121,平溪,簡易
2020-04-22,7335,61,62,123,平溪,簡易
2020-04-23,7335,44,49,93,平溪,簡易
2020-04-24,7335,65,64,129,平溪,簡易
2020-04-25,7335,124,122,246,平溪,簡易
2020-04-26,7335,128,147,275,平溪,簡易
2020-04-27,7335,75,83,158,平溪,簡易
2020-04-28,7335,106,89,195,平溪,簡易
2020-04-29,7335,88,91,179,平溪,簡易
2020-04-30,7335,134,133,267,平溪,簡易
2020-05-01,7335,345,395,740,平溪,簡易
2020-05-02,7335,427,444,871,平溪,簡易
2020-05-03,7335,365,391,756,平溪,簡易
2020-05-04,7335,148,165,313,平溪,簡易
2020-05-05,7335,97,98,195,平溪,簡易
2020-05-06,7335,109,92,201,平溪,簡易
2020-05-07,7335,103,99,202,平溪,簡易
2020-05-08,7335,96,109,205,平溪,簡易
2020-05-09,7335,345,314,659,平溪,簡易
2020-05-10,7335,260,285,545,平溪,簡易
2020-05-11,7335,90,103,193,平溪,簡易
2020-05-12,7335,65,61,126,平溪,簡易
2020-05-13,7335,276,129,405,平溪,簡易
2020-05-14,7335,151,150,301,平溪,簡易
2020-05-15,7335,158,145,303,平溪,簡易
2020-05-16,7335,285,304,589,平溪,簡易
2020-05-17,7335,345,360,705,平溪,簡易
2020-05-18,7335,94,97,191,平溪,簡易
2020-05-19,7335,39,44,83,平溪,簡易
2020-05-20,7335,64,82,146,平溪,簡易
2020-05-21,7335,59,70,129,平溪,簡易
2020-05-22,7335,65,64,129,平溪,簡易
2020-05-23,7335,117,108,225,平溪,簡易
2020-05-24,7335,374,364,738,平溪,簡易
2020-05-25,7335,78,93,171,平溪,簡易
2020-05-26,7335,92,90,182,平溪,簡易
2020-05-27,7335,111,68,179,平溪,簡易
2020-05-28,7335,113,115,228,平溪,簡易
2020-05-29,7335,83,96,179,平溪,簡易
2020-05-30,7335,458,452,910,平溪,簡易
2020-05-31,7335,499,492,991,平溪,簡易
2020-06-01,7335,106,98,204,平溪,簡易
2020-06-02,7335,127,144,271,平溪,簡易
2020-06-03,7335,256,304,560,平溪,簡易
2020-06-04,7335,254,220,474,平溪,簡易
2020-06-05,7335,109,118,227,平溪,簡易
2020-06-06,7335,455,505,960,平溪,簡易
2020-06-07,7335,283,259,542,平溪,簡易
2020-06-08,7335,103,112,215,平溪,簡易
2020-06-09,7335,178,135,313,平溪,簡易
2020-06-10,7335,198,197,395,平溪,簡易
2020-06-11,7335,114,337,451,平溪,簡易
2020-06-12,7335,248,263,511,平溪,簡易
2020-06-13,7335,586,621,1207,平溪,簡易
2020-06-14,7335,494,474,968,平溪,簡易
2020-06-15,7335,142,162,304,平溪,簡易
2020-06-16,7335,164,163,327,平溪,簡易
2020-06-17,7335,133,143,276,平溪,簡易
2020-06-18,7335,160,162,322,平溪,簡易
2020-06-19,7335,236,158,394,平溪,簡易
2020-06-20,7335,406,421,827,平溪,簡易
2020-06-21,7335,451,433,884,平溪,簡易
2020-06-22,7335,149,156,305,平溪,簡易
2020-06-23,7335,133,149,282,平溪,簡易
2020-06-24,7335,150,136,286,平溪,簡易
2020-06-25,7335,657,648,1305,平溪,簡易
2020-06-26,7335,931,1050,1981,平溪,簡易
2020-06-27,7335,844,951,1795,平溪,簡易
2020-06-28,7335,457,423,880,平溪,簡易
2020-06-29,7335,194,139,333,平溪,簡易
2020-06-30,7335,172,152,324,平溪,簡易
2020-07-01,7335,127,127,254,平溪,簡易
2020-07-02,7335,144,145,289,平溪,簡易
2020-07-03,7335,168,208,376,平溪,簡易
2020-07-04,7335,362,380,742,平溪,簡易
2020-07-05,7335,402,447,849,平溪,簡易
2020-07-06,7335,156,173,329,平溪,簡易
2020-07-07,7335,229,240,469,平溪,簡易
2020-07-08,7335,227,212,439,平溪,簡易
2020-07-09,7335,228,240,468,平溪,簡易
2020-07-10,7335,199,173,372,平溪,簡易
2020-07-11,7335,456,500,956,平溪,簡易
2020-07-12,7335,592,566,1158,平溪,簡易
2020-07-13,7335,207,213,420,平溪,簡易
2020-07-14,7335,245,224,469,平溪,簡易
2020-07-15,7335,278,130,408,平溪,簡易
2020-07-16,7335,286,304,590,平溪,簡易
2020-07-17,7335,334,342,676,平溪,簡易
2020-07-18,7335,597,611,1208,平溪,簡易
2020-07-19,7335,591,532,1123,平溪,簡易
2020-07-20,7335,296,383,679,平溪,簡易
2020-07-21,7335,227,271,498,平溪,簡易
2020-07-22,7335,358,323,681,平溪,簡易
2020-07-23,7335,326,341,667,平溪,簡易
2020-07-24,7335,298,283,581,平溪,簡易
2020-07-25,7335,449,468,917,平溪,簡易
2020-07-26,7335,488,540,1028,平溪,簡易
2020-07-27,7335,324,408,732,平溪,簡易
2020-07-28,7335,229,243,472,平溪,簡易
2020-07-29,7335,553,272,825,平溪,簡易
2020-07-30,7335,273,303,576,平溪,簡易
2020-07-31,7335,372,320,692,平溪,簡易
2020-08-01,7335,691,717,1408,平溪,簡易
2020-08-02,7335,415,471,886,平溪,簡易
2020-08-03,7335,95,79,174,平溪,簡易
2020-08-04,7335,169,175,344,平溪,簡易
2020-08-05,7335,278,284,562,平溪,簡易
2020-08-06,7335,259,277,536,平溪,簡易
2020-08-07,7335,242,260,502,平溪,簡易
2020-08-08,7335,453,525,978,平溪,簡易
2020-08-09,7335,466,436,902,平溪,簡易
2020-08-10,7335,334,334,668,平溪,簡易
2020-08-11,7335,130,170,300,平溪,簡易
2020-08-12,7335,220,243,463,平溪,簡易
2020-08-13,7335,239,323,562,平溪,簡易
2020-08-14,7335,311,280,591,平溪,簡易
2020-08-15,7335,1478,706,2184,平溪,簡易
2020-08-16,7335,779,702,1481,平溪,簡易
2020-08-17,7335,327,364,691,平溪,簡易
2020-08-18,7335,310,335,645,平溪,簡易
2020-08-19,7335,344,216,560,平溪,簡易
2020-08-20,7335,267,306,573,平溪,簡易
2020-08-21,7335,370,461,831,平溪,簡易
2020-08-22,7335,516,602,1118,平溪,簡易
2020-08-23,7335,469,435,904,平溪,簡易
2020-08-24,7335,365,393,758,平溪,簡易
2020-08-25,7335,385,386,771,平溪,簡易
2020-08-26,7335,273,312,585,平溪,簡易
2020-08-27,7335,173,191,364,平溪,簡易
2020-08-28,7335,207,190,397,平溪,簡易
2020-08-29,7335,370,412,782,平溪,簡易
2020-08-30,7335,502,462,964,平溪,簡易
2020-08-31,7335,115,130,245,平溪,簡易
2020-09-01,7335,178,110,288,平溪,簡易
2020-09-02,7335,114,108,222,平溪,簡易
2020-09-03,7335,121,142,263,平溪,簡易
2020-09-04,7335,224,200,424,平溪,簡易
2020-09-05,7335,390,429,819,平溪,簡易
2020-09-06,7335,445,461,906,平溪,簡易
2020-09-07,7335,192,295,487,平溪,簡易
2020-09-08,7335,200,188,388,平溪,簡易
2020-09-09,7335,214,239,453,平溪,簡易
2020-09-10,7335,148,152,300,平溪,簡易
2020-09-11,7335,277,335,612,平溪,簡易
2020-09-12,7335,417,396,813,平溪,簡易
2020-09-13,7335,225,232,457,平溪,簡易
2020-09-14,7335,106,131,237,平溪,簡易
2020-09-15,7335,121,133,254,平溪,簡易
2020-09-16,7335,146,160,306,平溪,簡易
2020-09-17,7335,105,98,203,平溪,簡易
2020-09-18,7335,181,185,366,平溪,簡易
2020-09-19,7335,442,576,1018,平溪,簡易
2020-09-20,7335,208,260,468,平溪,簡易
2020-09-21,7335,166,245,411,平溪,簡易
2020-09-22,7335,141,182,323,平溪,簡易
2020-09-23,7335,142,287,429,平溪,簡易
2020-09-24,7335,94,123,217,平溪,簡易
2020-09-25,7335,107,228,335,平溪,簡易
2020-09-26,7335,219,260,479,平溪,簡易
2020-09-27,7335,184,266,450,平溪,簡易
2020-09-28,7335,117,269,386,平溪,簡易
2020-09-29,7335,189,119,308,平溪,簡易
2020-09-30,7335,125,106,231,平溪,簡易
2020-10-01,7335,581,638,1219,平溪,簡易
2020-10-02,7335,1029,1106,2135,平溪,簡易
2020-10-03,7335,982,1042,2024,平溪,簡易
2020-10-04,7335,497,516,1013,平溪,簡易
2020-10-05,7335,92,92,184,平溪,簡易
2020-10-06,7335,184,335,519,平溪,簡易
2020-10-07,7335,208,155,363,平溪,簡易
2020-10-08,7335,131,281,412,平溪,簡易
2020-10-09,7335,585,604,1189,平溪,簡易
2020-10-10,7335,733,814,1547,平溪,簡易
2020-10-11,7335,328,311,639,平溪,簡易
2020-10-12,7335,65,155,220,平溪,簡易
2020-10-13,7335,65,67,132,平溪,簡易
2020-10-14,7335,143,199,342,平溪,簡易
2020-10-15,7335,126,216,342,平溪,簡易
2020-10-16,7335,163,177,340,平溪,簡易
2020-10-17,7335,329,296,625,平溪,簡易
2020-10-18,7335,222,278,500,平溪,簡易
2020-10-19,7335,93,232,325,平溪,簡易
2020-10-20,7335,166,120,286,平溪,簡易
2020-10-21,7335,118,86,204,平溪,簡易
2020-10-22,7335,102,118,220,平溪,簡易
2020-10-23,7335,129,180,309,平溪,簡易
2020-10-24,7335,350,376,726,平溪,簡易
2020-10-25,7335,431,536,967,平溪,簡易
2020-10-26,7335,237,208,445,平溪,簡易
2020-10-27,7335,284,172,456,平溪,簡易
2020-10-28,7335,112,142,254,平溪,簡易
2020-10-29,7335,109,168,277,平溪,簡易
2020-10-30,7335,128,202,330,平溪,簡易
2020-10-31,7335,530,468,998,平溪,簡易
2020-11-01,7335,466,611,1077,平溪,簡易
2020-11-02,7335,166,162,328,平溪,簡易
2020-11-03,7335,72,108,180,平溪,簡易
2020-11-04,7335,110,104,214,平溪,簡易
2020-11-05,7335,154,130,284,平溪,簡易
2020-11-06,7335,126,144,270,平溪,簡易
2020-11-07,7335,330,348,678,平溪,簡易
2020-11-08,7335,617,315,932,平溪,簡易
2020-11-09,7335,132,150,282,平溪,簡易
2020-11-10,7335,60,98,158,平溪,簡易
2020-11-11,7335,207,253,460,平溪,簡易
2020-11-12,7335,136,147,283,平溪,簡易
2020-11-13,7335,109,194,303,平溪,簡易
2020-11-14,7335,262,271,533,平溪,簡易
2020-11-15,7335,534,687,1221,平溪,簡易
2020-11-16,7335,286,257,543,平溪,簡易
2020-11-17,7335,128,147,275,平溪,簡易
2020-11-18,7335,176,159,335,平溪,簡易
2020-11-19,7335,188,199,387,平溪,簡易
2020-11-20,7335,250,315,565,平溪,簡易
2020-11-21,7335,295,270,565,平溪,簡易
2020-11-22,7335,521,567,1088,平溪,簡易
2020-11-23,7335,105,106,211,平溪,簡易
2020-11-24,7335,112,131,243,平溪,簡易
2020-11-25,7335,132,125,257,平溪,簡易
2020-11-26,7335,167,187,354,平溪,簡易
2020-11-27,7335,129,228,357,平溪,簡易
2020-11-28,7335,262,259,521,平溪,簡易
2020-11-29,7335,236,294,530,平溪,簡易
2020-11-30,7335,134,158,292,平溪,簡易
2020-12-01,7335,35,59,94,平溪,簡易
2020-12-02,7335,91,63,154,平溪,簡易
2020-12-03,7335,66,304,370,平溪,簡易
2020-12-04,7335,10,28,38,平溪,簡易
2020-12-05,7335,0,0,0,平溪,簡易
2020-12-06,7335,0,0,0,平溪,簡易
2020-12-07,7335,0,7,7,平溪,簡易
2020-12-08,7335,0,1,1,平溪,簡易
2020-12-09,7335,0,0,0,平溪,簡易
2020-12-10,7335,0,0,0,平溪,簡易
2020-12-11,7335,0,0,0,平溪,簡易
2020-12-12,7335,0,0,0,平溪,簡易
2020-12-13,7335,0,2,2,平溪,簡易
2020-12-14,7335,52,96,148,平溪,簡易
2020-12-15,7335,47,57,104,平溪,簡易
2020-12-16,7335,36,32,68,平溪,簡易
2020-12-17,7335,52,70,122,平溪,簡易
2020-12-18,7335,54,94,148,平溪,簡易
2020-12-19,7335,186,267,453,平溪,簡易
2020-12-20,7335,108,150,258,平溪,簡易
2020-12-21,7335,101,88,189,平溪,簡易
2020-12-22,7335,91,90,181,平溪,簡易
2020-12-23,7335,63,37,100,平溪,簡易
2020-12-24,7335,52,55,107,平溪,簡易
2020-12-25,7335,160,189,349,平溪,簡易
2020-12-26,7335,359,320,679,平溪,簡易
2020-12-27,7335,393,406,799,平溪,簡易
2020-12-28,7335,68,81,149,平溪,簡易
2020-12-29,7335,101,108,209,平溪,簡易
2020-12-30,7335,41,33,74,平溪,簡易
2020-12-31,7335,104,101,205,平溪,簡易
2020-01-01,7336,704,630,1334,菁桐,簡易
2020-01-02,7336,666,696,1362,菁桐,簡易
2020-01-03,7336,469,484,953,菁桐,簡易
2020-01-04,7336,1179,918,2097,菁桐,簡易
2020-01-05,7336,597,667,1264,菁桐,簡易
2020-01-06,7336,391,409,800,菁桐,簡易
2020-01-07,7336,393,373,766,菁桐,簡易
2020-01-08,7336,275,250,525,菁桐,簡易
2020-01-09,7336,403,286,689,菁桐,簡易
2020-01-10,7336,226,216,442,菁桐,簡易
2020-01-11,7336,399,340,739,菁桐,簡易
2020-01-12,7336,337,279,616,菁桐,簡易
2020-01-13,7336,254,260,514,菁桐,簡易
2020-01-14,7336,346,351,697,菁桐,簡易
2020-01-15,7336,200,205,405,菁桐,簡易
2020-01-16,7336,397,371,768,菁桐,簡易
2020-01-17,7336,321,240,561,菁桐,簡易
2020-01-18,7336,478,394,872,菁桐,簡易
2020-01-19,7336,395,346,741,菁桐,簡易
2020-01-20,7336,442,520,962,菁桐,簡易
2020-01-21,7336,424,358,782,菁桐,簡易
2020-01-22,7336,338,358,696,菁桐,簡易
2020-01-23,7336,292,308,600,菁桐,簡易
2020-01-24,7336,230,218,448,菁桐,簡易
2020-01-25,7336,1209,1208,2417,菁桐,簡易
2020-01-26,7336,571,538,1109,菁桐,簡易
2020-01-27,7336,1103,1110,2213,菁桐,簡易
2020-01-28,7336,1367,1309,2676,菁桐,簡易
2020-01-29,7336,704,687,1391,菁桐,簡易
2020-01-30,7336,719,650,1369,菁桐,簡易
2020-01-31,7336,659,568,1227,菁桐,簡易
2020-02-01,7336,899,888,1787,菁桐,簡易
2020-02-02,7336,793,764,1557,菁桐,簡易
2020-02-03,7336,524,426,950,菁桐,簡易
2020-02-04,7336,218,242,460,菁桐,簡易
2020-02-05,7336,169,198,367,菁桐,簡易
2020-02-06,7336,360,364,724,菁桐,簡易
2020-02-07,7336,283,284,567,菁桐,簡易
2020-02-08,7336,899,852,1751,菁桐,簡易
2020-02-09,7336,392,348,740,菁桐,簡易
2020-02-10,7336,242,207,449,菁桐,簡易
2020-02-11,7336,268,258,526,菁桐,簡易
2020-02-12,7336,352,374,726,菁桐,簡易
2020-02-13,7336,244,242,486,菁桐,簡易
2020-02-14,7336,259,271,530,菁桐,簡易
2020-02-15,7336,400,346,746,菁桐,簡易
2020-02-16,7336,234,211,445,菁桐,簡易
2020-02-17,7336,197,175,372,菁桐,簡易
2020-02-18,7336,232,237,469,菁桐,簡易
2020-02-19,7336,241,242,483,菁桐,簡易
2020-02-20,7336,281,269,550,菁桐,簡易
2020-02-21,7336,312,273,585,菁桐,簡易
2020-02-22,7336,343,378,721,菁桐,簡易
2020-02-23,7336,355,332,687,菁桐,簡易
2020-02-24,7336,254,240,494,菁桐,簡易
2020-02-25,7336,204,198,402,菁桐,簡易
2020-02-26,7336,433,134,567,菁桐,簡易
2020-02-27,7336,114,115,229,菁桐,簡易
2020-02-28,7336,657,682,1339,菁桐,簡易
2020-02-29,7336,724,609,1333,菁桐,簡易
2020-03-01,7336,269,231,500,菁桐,簡易
2020-03-02,7336,54,51,105,菁桐,簡易
2020-03-03,7336,62,70,132,菁桐,簡易
2020-03-04,7336,24,56,80,菁桐,簡易
2020-03-05,7336,44,54,98,菁桐,簡易
2020-03-06,7336,62,66,128,菁桐,簡易
2020-03-07,7336,323,358,681,菁桐,簡易
2020-03-08,7336,277,249,526,菁桐,簡易
2020-03-09,7336,109,116,225,菁桐,簡易
2020-03-10,7336,46,49,95,菁桐,簡易
2020-03-11,7336,101,80,181,菁桐,簡易
2020-03-12,7336,70,65,135,菁桐,簡易
2020-03-13,7336,59,48,107,菁桐,簡易
2020-03-14,7336,170,118,288,菁桐,簡易
2020-03-15,7336,406,314,720,菁桐,簡易
2020-03-16,7336,144,100,244,菁桐,簡易
2020-03-17,7336,75,104,179,菁桐,簡易
2020-03-18,7336,42,55,97,菁桐,簡易
2020-03-19,7336,59,49,108,菁桐,簡易
2020-03-20,7336,52,46,98,菁桐,簡易
2020-03-21,7336,241,231,472,菁桐,簡易
2020-03-22,7336,244,244,488,菁桐,簡易
2020-03-23,7336,52,45,97,菁桐,簡易
2020-03-24,7336,57,74,131,菁桐,簡易
2020-03-25,7336,66,77,143,菁桐,簡易
2020-03-26,7336,96,92,188,菁桐,簡易
2020-03-27,7336,60,58,118,菁桐,簡易
2020-03-28,7336,53,48,101,菁桐,簡易
2020-03-29,7336,236,238,474,菁桐,簡易
2020-03-30,7336,72,46,118,菁桐,簡易
2020-03-31,7336,50,57,107,菁桐,簡易
2020-04-01,7336,66,65,131,菁桐,簡易
2020-04-02,7336,123,122,245,菁桐,簡易
2020-04-03,7336,192,227,419,菁桐,簡易
2020-04-04,7336,128,126,254,菁桐,簡易
2020-04-05,7336,98,163,261,菁桐,簡易
2020-04-06,7336,46,38,84,菁桐,簡易
2020-04-07,7336,20,42,62,菁桐,簡易
2020-04-08,7336,29,31,60,菁桐,簡易
2020-04-09,7336,54,55,109,菁桐,簡易
2020-04-10,7336,66,79,145,菁桐,簡易
2020-04-11,7336,97,94,191,菁桐,簡易
2020-04-12,7336,43,56,99,菁桐,簡易
2020-04-13,7336,39,50,89,菁桐,簡易
2020-04-14,7336,67,70,137,菁桐,簡易
2020-04-15,7336,73,58,131,菁桐,簡易
2020-04-16,7336,95,105,200,菁桐,簡易
2020-04-17,7336,89,93,182,菁桐,簡易
2020-04-18,7336,308,297,605,菁桐,簡易
2020-04-19,7336,235,235,470,菁桐,簡易
2020-04-20,7336,74,69,143,菁桐,簡易
2020-04-21,7336,58,56,114,菁桐,簡易
2020-04-22,7336,25,30,55,菁桐,簡易
2020-04-23,7336,40,44,84,菁桐,簡易
2020-04-24,7336,33,33,66,菁桐,簡易
2020-04-25,7336,125,146,271,菁桐,簡易
2020-04-26,7336,148,131,279,菁桐,簡易
2020-04-27,7336,61,45,106,菁桐,簡易
2020-04-28,7336,106,99,205,菁桐,簡易
2020-04-29,7336,124,107,231,菁桐,簡易
2020-04-30,7336,102,108,210,菁桐,簡易
2020-05-01,7336,353,327,680,菁桐,簡易
2020-05-02,7336,455,406,861,菁桐,簡易
2020-05-03,7336,305,329,634,菁桐,簡易
2020-05-04,7336,125,114,239,菁桐,簡易
2020-05-05,7336,113,111,224,菁桐,簡易
2020-05-06,7336,117,135,252,菁桐,簡易
2020-05-07,7336,85,88,173,菁桐,簡易
2020-05-08,7336,146,139,285,菁桐,簡易
2020-05-09,7336,302,329,631,菁桐,簡易
2020-05-10,7336,303,268,571,菁桐,簡易
2020-05-11,7336,71,74,145,菁桐,簡易
2020-05-12,7336,35,36,71,菁桐,簡易
2020-05-13,7336,94,98,192,菁桐,簡易
2020-05-14,7336,138,132,270,菁桐,簡易
2020-05-15,7336,133,138,271,菁桐,簡易
2020-05-16,7336,302,296,598,菁桐,簡易
2020-05-17,7336,332,344,676,菁桐,簡易
2020-05-18,7336,74,74,148,菁桐,簡易
2020-05-19,7336,41,38,79,菁桐,簡易
2020-05-20,7336,55,55,110,菁桐,簡易
2020-05-21,7336,64,65,129,菁桐,簡易
2020-05-22,7336,36,32,68,菁桐,簡易
2020-05-23,7336,96,108,204,菁桐,簡易
2020-05-24,7336,494,431,925,菁桐,簡易
2020-05-25,7336,90,101,191,菁桐,簡易
2020-05-26,7336,65,73,138,菁桐,簡易
2020-05-27,7336,72,125,197,菁桐,簡易
2020-05-28,7336,68,65,133,菁桐,簡易
2020-05-29,7336,88,84,172,菁桐,簡易
2020-05-30,7336,471,476,947,菁桐,簡易
2020-05-31,7336,496,488,984,菁桐,簡易
2020-06-01,7336,121,139,260,菁桐,簡易
2020-06-02,7336,117,111,228,菁桐,簡易
2020-06-03,7336,164,134,298,菁桐,簡易
2020-06-04,7336,265,272,537,菁桐,簡易
2020-06-05,7336,146,135,281,菁桐,簡易
2020-06-06,7336,400,376,776,菁桐,簡易
2020-06-07,7336,433,372,805,菁桐,簡易
2020-06-08,7336,75,64,139,菁桐,簡易
2020-06-09,7336,164,174,338,菁桐,簡易
2020-06-10,7336,134,145,279,菁桐,簡易
2020-06-11,7336,161,157,318,菁桐,簡易
2020-06-12,7336,141,129,270,菁桐,簡易
2020-06-13,7336,513,505,1018,菁桐,簡易
2020-06-14,7336,511,520,1031,菁桐,簡易
2020-06-15,7336,152,145,297,菁桐,簡易
2020-06-16,7336,158,192,350,菁桐,簡易
2020-06-17,7336,158,160,318,菁桐,簡易
2020-06-18,7336,149,181,330,菁桐,簡易
2020-06-19,7336,286,281,567,菁桐,簡易
2020-06-20,7336,498,394,892,菁桐,簡易
2020-06-21,7336,496,421,917,菁桐,簡易
2020-06-22,7336,163,178,341,菁桐,簡易
2020-06-23,7336,162,379,541,菁桐,簡易
2020-06-24,7336,142,145,287,菁桐,簡易
2020-06-25,7336,673,655,1328,菁桐,簡易
2020-06-26,7336,1319,1247,2566,菁桐,簡易
2020-06-27,7336,1166,1085,2251,菁桐,簡易
2020-06-28,7336,472,447,919,菁桐,簡易
2020-06-29,7336,99,136,235,菁桐,簡易
2020-06-30,7336,178,177,355,菁桐,簡易
2020-07-01,7336,116,114,230,菁桐,簡易
2020-07-02,7336,191,244,435,菁桐,簡易
2020-07-03,7336,129,138,267,菁桐,簡易
2020-07-04,7336,410,356,766,菁桐,簡易
2020-07-05,7336,454,410,864,菁桐,簡易
2020-07-06,7336,213,165,378,菁桐,簡易
2020-07-07,7336,211,215,426,菁桐,簡易
2020-07-08,7336,190,176,366,菁桐,簡易
2020-07-09,7336,194,192,386,菁桐,簡易
2020-07-10,7336,206,249,455,菁桐,簡易
2020-07-11,7336,458,479,937,菁桐,簡易
2020-07-12,7336,696,682,1378,菁桐,簡易
2020-07-13,7336,186,218,404,菁桐,簡易
2020-07-14,7336,171,172,343,菁桐,簡易
2020-07-15,7336,265,185,450,菁桐,簡易
2020-07-16,7336,376,276,652,菁桐,簡易
2020-07-17,7336,456,463,919,菁桐,簡易
2020-07-18,7336,618,673,1291,菁桐,簡易
2020-07-19,7336,558,613,1171,菁桐,簡易
2020-07-20,7336,308,299,607,菁桐,簡易
2020-07-21,7336,280,257,537,菁桐,簡易
2020-07-22,7336,316,329,645,菁桐,簡易
2020-07-23,7336,417,290,707,菁桐,簡易
2020-07-24,7336,388,392,780,菁桐,簡易
2020-07-25,7336,762,547,1309,菁桐,簡易
2020-07-26,7336,649,564,1213,菁桐,簡易
2020-07-27,7336,327,268,595,菁桐,簡易
2020-07-28,7336,286,215,501,菁桐,簡易
2020-07-29,7336,314,313,627,菁桐,簡易
2020-07-30,7336,467,339,806,菁桐,簡易
2020-07-31,7336,328,360,688,菁桐,簡易
2020-08-01,7336,804,622,1426,菁桐,簡易
2020-08-02,7336,499,425,924,菁桐,簡易
2020-08-03,7336,82,85,167,菁桐,簡易
2020-08-04,7336,251,218,469,菁桐,簡易
2020-08-05,7336,234,238,472,菁桐,簡易
2020-08-06,7336,301,259,560,菁桐,簡易
2020-08-07,7336,281,280,561,菁桐,簡易
2020-08-08,7336,574,439,1013,菁桐,簡易
2020-08-09,7336,470,588,1058,菁桐,簡易
2020-08-10,7336,304,332,636,菁桐,簡易
2020-08-11,7336,219,181,400,菁桐,簡易
2020-08-12,7336,347,281,628,菁桐,簡易
2020-08-13,7336,424,448,872,菁桐,簡易
2020-08-14,7336,525,514,1039,菁桐,簡易
2020-08-15,7336,666,796,1462,菁桐,簡易
2020-08-16,7336,886,724,1610,菁桐,簡易
2020-08-17,7336,322,342,664,菁桐,簡易
2020-08-18,7336,318,308,626,菁桐,簡易
2020-08-19,7336,267,269,536,菁桐,簡易
2020-08-20,7336,313,244,557,菁桐,簡易
2020-08-21,7336,406,419,825,菁桐,簡易
2020-08-22,7336,628,469,1097,菁桐,簡易
2020-08-23,7336,675,512,1187,菁桐,簡易
2020-08-24,7336,370,375,745,菁桐,簡易
2020-08-25,7336,317,335,652,菁桐,簡易
2020-08-26,7336,321,293,614,菁桐,簡易
2020-08-27,7336,305,220,525,菁桐,簡易
2020-08-28,7336,246,186,432,菁桐,簡易
2020-08-29,7336,341,417,758,菁桐,簡易
2020-08-30,7336,527,378,905,菁桐,簡易
2020-08-31,7336,107,104,211,菁桐,簡易
2020-09-01,7336,64,72,136,菁桐,簡易
2020-09-02,7336,90,95,185,菁桐,簡易
2020-09-03,7336,129,223,352,菁桐,簡易
2020-09-04,7336,170,176,346,菁桐,簡易
2020-09-05,7336,608,460,1068,菁桐,簡易
2020-09-06,7336,611,542,1153,菁桐,簡易
2020-09-07,7336,185,189,374,菁桐,簡易
2020-09-08,7336,223,254,477,菁桐,簡易
2020-09-09,7336,128,167,295,菁桐,簡易
2020-09-10,7336,150,138,288,菁桐,簡易
2020-09-11,7336,205,136,341,菁桐,簡易
2020-09-12,7336,453,423,876,菁桐,簡易
2020-09-13,7336,332,240,572,菁桐,簡易
2020-09-14,7336,132,86,218,菁桐,簡易
2020-09-15,7336,95,273,368,菁桐,簡易
2020-09-16,7336,148,129,277,菁桐,簡易
2020-09-17,7336,156,139,295,菁桐,簡易
2020-09-18,7336,350,179,529,菁桐,簡易
2020-09-19,7336,501,395,896,菁桐,簡易
2020-09-20,7336,502,303,805,菁桐,簡易
2020-09-21,7336,288,136,424,菁桐,簡易
2020-09-22,7336,104,293,397,菁桐,簡易
2020-09-23,7336,228,209,437,菁桐,簡易
2020-09-24,7336,262,169,431,菁桐,簡易
2020-09-25,7336,230,105,335,菁桐,簡易
2020-09-26,7336,302,209,511,菁桐,簡易
2020-09-27,7336,343,497,840,菁桐,簡易
2020-09-28,7336,70,144,214,菁桐,簡易
2020-09-29,7336,125,221,346,菁桐,簡易
2020-09-30,7336,182,86,268,菁桐,簡易
2020-10-01,7336,671,703,1374,菁桐,簡易
2020-10-02,7336,1539,1424,2963,菁桐,簡易
2020-10-03,7336,1367,1259,2626,菁桐,簡易
2020-10-04,7336,727,612,1339,菁桐,簡易
2020-10-05,7336,152,67,219,菁桐,簡易
2020-10-06,7336,168,116,284,菁桐,簡易
2020-10-07,7336,172,306,478,菁桐,簡易
2020-10-08,7336,168,121,289,菁桐,簡易
2020-10-09,7336,807,794,1601,菁桐,簡易
2020-10-10,7336,1073,1029,2102,菁桐,簡易
2020-10-11,7336,463,451,914,菁桐,簡易
2020-10-12,7336,115,93,208,菁桐,簡易
2020-10-13,7336,387,421,808,菁桐,簡易
2020-10-14,7336,633,170,803,菁桐,簡易
2020-10-15,7336,183,243,426,菁桐,簡易
2020-10-16,7336,119,170,289,菁桐,簡易
2020-10-17,7336,400,336,736,菁桐,簡易
2020-10-18,7336,286,309,595,菁桐,簡易
2020-10-19,7336,328,218,546,菁桐,簡易
2020-10-20,7336,413,144,557,菁桐,簡易
2020-10-21,7336,175,228,403,菁桐,簡易
2020-10-22,7336,159,208,367,菁桐,簡易
2020-10-23,7336,168,196,364,菁桐,簡易
2020-10-24,7336,912,640,1552,菁桐,簡易
2020-10-25,7336,598,616,1214,菁桐,簡易
2020-10-26,7336,293,173,466,菁桐,簡易
2020-10-27,7336,349,465,814,菁桐,簡易
2020-10-28,7336,341,320,661,菁桐,簡易
2020-10-29,7336,140,113,253,菁桐,簡易
2020-10-30,7336,290,231,521,菁桐,簡易
2020-10-31,7336,517,508,1025,菁桐,簡易
2020-11-01,7336,573,621,1194,菁桐,簡易
2020-11-02,7336,198,224,422,菁桐,簡易
2020-11-03,7336,314,334,648,菁桐,簡易
2020-11-04,7336,131,130,261,菁桐,簡易
2020-11-05,7336,172,230,402,菁桐,簡易
2020-11-06,7336,152,138,290,菁桐,簡易
2020-11-07,7336,695,401,1096,菁桐,簡易
2020-11-08,7336,382,362,744,菁桐,簡易
2020-11-09,7336,133,115,248,菁桐,簡易
2020-11-10,7336,224,220,444,菁桐,簡易
2020-11-11,7336,237,122,359,菁桐,簡易
2020-11-12,7336,299,212,511,菁桐,簡易
2020-11-13,7336,147,144,291,菁桐,簡易
2020-11-14,7336,498,390,888,菁桐,簡易
2020-11-15,7336,563,474,1037,菁桐,簡易
2020-11-16,7336,247,285,532,菁桐,簡易
2020-11-17,7336,314,447,761,菁桐,簡易
2020-11-18,7336,156,313,469,菁桐,簡易
2020-11-19,7336,521,348,869,菁桐,簡易
2020-11-20,7336,263,296,559,菁桐,簡易
2020-11-21,7336,821,443,1264,菁桐,簡易
2020-11-22,7336,660,742,1402,菁桐,簡易
2020-11-23,7336,215,167,382,菁桐,簡易
2020-11-24,7336,349,244,593,菁桐,簡易
2020-11-25,7336,194,154,348,菁桐,簡易
2020-11-26,7336,295,216,511,菁桐,簡易
2020-11-27,7336,182,146,328,菁桐,簡易
2020-11-28,7336,592,514,1106,菁桐,簡易
2020-11-29,7336,318,319,637,菁桐,簡易
2020-11-30,7336,261,130,391,菁桐,簡易
2020-12-01,7336,33,49,82,菁桐,簡易
2020-12-02,7336,66,70,136,菁桐,簡易
2020-12-03,7336,208,66,274,菁桐,簡易
2020-12-04,7336,10,7,17,菁桐,簡易
2020-12-05,7336,0,0,0,菁桐,簡易
2020-12-06,7336,0,0,0,菁桐,簡易
2020-12-07,7336,1,8,9,菁桐,簡易
2020-12-08,7336,1,1,2,菁桐,簡易
2020-12-09,7336,1,1,2,菁桐,簡易
2020-12-10,7336,1,1,2,菁桐,簡易
2020-12-11,7336,1,1,2,菁桐,簡易
2020-12-12,7336,0,0,0,菁桐,簡易
2020-12-13,7336,0,1,1,菁桐,簡易
2020-12-14,7336,72,29,101,菁桐,簡易
2020-12-15,7336,47,31,78,菁桐,簡易
2020-12-16,7336,31,24,55,菁桐,簡易
2020-12-17,7336,33,17,50,菁桐,簡易
2020-12-18,7336,100,34,134,菁桐,簡易
2020-12-19,7336,162,165,327,菁桐,簡易
2020-12-20,7336,218,129,347,菁桐,簡易
2020-12-21,7336,65,139,204,菁桐,簡易
2020-12-22,7336,60,120,180,菁桐,簡易
2020-12-23,7336,47,86,133,菁桐,簡易
2020-12-24,7336,142,66,208,菁桐,簡易
2020-12-25,7336,71,68,139,菁桐,簡易
2020-12-26,7336,260,359,619,菁桐,簡易
2020-12-27,7336,327,274,601,菁桐,簡易
2020-12-28,7336,74,132,206,菁桐,簡易
2020-12-29,7336,81,53,134,菁桐,簡易
2020-12-30,7336,20,18,38,菁桐,簡易
2020-12-31,7336,47,51,98,菁桐,簡易
2020-01-01,7350,1021,1012,2033,猴硐,三等
2020-01-02,7350,891,823,1714,猴硐,三等
2020-01-03,7350,787,770,1557,猴硐,三等
2020-01-04,7350,1310,1298,2608,猴硐,三等
2020-01-05,7350,1038,1062,2100,猴硐,三等
2020-01-06,7350,614,588,1202,猴硐,三等
2020-01-07,7350,597,586,1183,猴硐,三等
2020-01-08,7350,475,494,969,猴硐,三等
2020-01-09,7350,556,570,1126,猴硐,三等
2020-01-10,7350,511,560,1071,猴硐,三等
2020-01-11,7350,788,791,1579,猴硐,三等
2020-01-12,7350,658,724,1382,猴硐,三等
2020-01-13,7350,461,433,894,猴硐,三等
2020-01-14,7350,537,542,1079,猴硐,三等
2020-01-15,7350,389,376,765,猴硐,三等
2020-01-16,7350,663,704,1367,猴硐,三等
2020-01-17,7350,560,571,1131,猴硐,三等
2020-01-18,7350,706,746,1452,猴硐,三等
2020-01-19,7350,634,643,1277,猴硐,三等
2020-01-20,7350,945,932,1877,猴硐,三等
2020-01-21,7350,978,847,1825,猴硐,三等
2020-01-22,7350,769,771,1540,猴硐,三等
2020-01-23,7350,770,747,1517,猴硐,三等
2020-01-24,7350,310,316,626,猴硐,三等
2020-01-25,7350,1092,1073,2165,猴硐,三等
2020-01-26,7350,608,618,1226,猴硐,三等
2020-01-27,7350,1156,1111,2267,猴硐,三等
2020-01-28,7350,1206,1206,2412,猴硐,三等
2020-01-29,7350,951,843,1794,猴硐,三等
2020-01-30,7350,940,934,1874,猴硐,三等
2020-01-31,7350,1004,996,2000,猴硐,三等
2020-02-01,7350,1117,1102,2219,猴硐,三等
2020-02-02,7350,1130,1156,2286,猴硐,三等
2020-02-03,7350,679,672,1351,猴硐,三等
2020-02-04,7350,506,451,957,猴硐,三等
2020-02-05,7350,413,379,792,猴硐,三等
2020-02-06,7350,580,577,1157,猴硐,三等
2020-02-07,7350,465,480,945,猴硐,三等
2020-02-08,7350,1073,1013,2086,猴硐,三等
2020-02-09,7350,682,654,1336,猴硐,三等
2020-02-10,7350,652,619,1271,猴硐,三等
2020-02-11,7350,556,572,1128,猴硐,三等
2020-02-12,7350,831,814,1645,猴硐,三等
2020-02-13,7350,534,551,1085,猴硐,三等
2020-02-14,7350,612,620,1232,猴硐,三等
2020-02-15,7350,726,745,1471,猴硐,三等
2020-02-16,7350,610,461,1071,猴硐,三等
2020-02-17,7350,638,613,1251,猴硐,三等
2020-02-18,7350,628,643,1271,猴硐,三等
2020-02-19,7350,740,716,1456,猴硐,三等
2020-02-20,7350,687,684,1371,猴硐,三等
2020-02-21,7350,786,796,1582,猴硐,三等
2020-02-22,7350,616,712,1328,猴硐,三等
2020-02-23,7350,803,823,1626,猴硐,三等
2020-02-24,7350,701,750,1451,猴硐,三等
2020-02-25,7350,500,507,1007,猴硐,三等
2020-02-26,7350,429,440,869,猴硐,三等
2020-02-27,7350,310,344,654,猴硐,三等
2020-02-28,7350,1195,1245,2440,猴硐,三等
2020-02-29,7350,1274,1208,2482,猴硐,三等
2020-03-01,7350,530,557,1087,猴硐,三等
2020-03-02,7350,204,222,426,猴硐,三等
2020-03-03,7350,180,196,376,猴硐,三等
2020-03-04,7350,97,96,193,猴硐,三等
2020-03-05,7350,119,108,227,猴硐,三等
2020-03-06,7350,240,258,498,猴硐,三等
2020-03-07,7350,687,692,1379,猴硐,三等
2020-03-08,7350,669,690,1359,猴硐,三等
2020-03-09,7350,189,196,385,猴硐,三等
2020-03-10,7350,102,92,194,猴硐,三等
2020-03-11,7350,174,177,351,猴硐,三等
2020-03-12,7350,135,144,279,猴硐,三等
2020-03-13,7350,133,144,277,猴硐,三等
2020-03-14,7350,406,383,789,猴硐,三等
2020-03-15,7350,822,780,1602,猴硐,三等
2020-03-16,7350,220,240,460,猴硐,三等
2020-03-17,7350,172,193,365,猴硐,三等
2020-03-18,7350,180,168,348,猴硐,三等
2020-03-19,7350,106,106,212,猴硐,三等
2020-03-20,7350,150,131,281,猴硐,三等
2020-03-21,7350,567,554,1121,猴硐,三等
2020-03-22,7350,642,726,1368,猴硐,三等
2020-03-23,7350,118,110,228,猴硐,三等
2020-03-24,7350,127,127,254,猴硐,三等
2020-03-25,7350,152,166,318,猴硐,三等
2020-03-26,7350,179,191,370,猴硐,三等
2020-03-27,7350,144,144,288,猴硐,三等
2020-03-28,7350,155,166,321,猴硐,三等
2020-03-29,7350,449,465,914,猴硐,三等
2020-03-30,7350,149,148,297,猴硐,三等
2020-03-31,7350,137,138,275,猴硐,三等
2020-04-01,7350,164,154,318,猴硐,三等
2020-04-02,7350,288,302,590,猴硐,三等
2020-04-03,7350,518,524,1042,猴硐,三等
2020-04-04,7350,284,262,546,猴硐,三等
2020-04-05,7350,309,260,569,猴硐,三等
2020-04-06,7350,138,131,269,猴硐,三等
2020-04-07,7350,60,64,124,猴硐,三等
2020-04-08,7350,89,101,190,猴硐,三等
2020-04-09,7350,105,114,219,猴硐,三等
2020-04-10,7350,168,210,378,猴硐,三等
2020-04-11,7350,347,398,745,猴硐,三等
2020-04-12,7350,188,187,375,猴硐,三等
2020-04-13,7350,164,156,320,猴硐,三等
2020-04-14,7350,176,192,368,猴硐,三等
2020-04-15,7350,174,184,358,猴硐,三等
2020-04-16,7350,257,261,518,猴硐,三等
2020-04-17,7350,237,245,482,猴硐,三等
2020-04-18,7350,728,690,1418,猴硐,三等
2020-04-19,7350,544,578,1122,猴硐,三等
2020-04-20,7350,128,141,269,猴硐,三等
2020-04-21,7350,94,103,197,猴硐,三等
2020-04-22,7350,74,76,150,猴硐,三等
2020-04-23,7350,96,87,183,猴硐,三等
2020-04-24,7350,84,89,173,猴硐,三等
2020-04-25,7350,239,239,478,猴硐,三等
2020-04-26,7350,309,335,644,猴硐,三等
2020-04-27,7350,139,114,253,猴硐,三等
2020-04-28,7350,123,136,259,猴硐,三等
2020-04-29,7350,245,258,503,猴硐,三等
2020-04-30,7350,207,197,404,猴硐,三等
2020-05-01,7350,745,687,1432,猴硐,三等
2020-05-02,7350,875,828,1703,猴硐,三等
2020-05-03,7350,743,689,1432,猴硐,三等
2020-05-04,7350,232,213,445,猴硐,三等
2020-05-05,7350,239,213,452,猴硐,三等
2020-05-06,7350,133,126,259,猴硐,三等
2020-05-07,7350,119,109,228,猴硐,三等
2020-05-08,7350,202,199,401,猴硐,三等
2020-05-09,7350,720,817,1537,猴硐,三等
2020-05-10,7350,497,561,1058,猴硐,三等
2020-05-11,7350,131,126,257,猴硐,三等
2020-05-12,7350,152,173,325,猴硐,三等
2020-05-13,7350,187,220,407,猴硐,三等
2020-05-14,7350,202,252,454,猴硐,三等
2020-05-15,7350,263,253,516,猴硐,三等
2020-05-16,7350,691,660,1351,猴硐,三等
2020-05-17,7350,622,606,1228,猴硐,三等
2020-05-18,7350,151,145,296,猴硐,三等
2020-05-19,7350,112,113,225,猴硐,三等
2020-05-20,7350,122,159,281,猴硐,三等
2020-05-21,7350,128,127,255,猴硐,三等
2020-05-22,7350,111,102,213,猴硐,三等
2020-05-23,7350,219,240,459,猴硐,三等
2020-05-24,7350,685,660,1345,猴硐,三等
2020-05-25,7350,146,134,280,猴硐,三等
2020-05-26,7350,152,144,296,猴硐,三等
2020-05-27,7350,118,110,228,猴硐,三等
2020-05-28,7350,195,204,399,猴硐,三等
2020-05-29,7350,204,215,419,猴硐,三等
2020-05-30,7350,878,839,1717,猴硐,三等
2020-05-31,7350,921,857,1778,猴硐,三等
2020-06-01,7350,192,197,389,猴硐,三等
2020-06-02,7350,170,165,335,猴硐,三等
2020-06-03,7350,348,347,695,猴硐,三等
2020-06-04,7350,273,282,555,猴硐,三等
2020-06-05,7350,230,240,470,猴硐,三等
2020-06-06,7350,808,708,1516,猴硐,三等
2020-06-07,7350,568,552,1120,猴硐,三等
2020-06-08,7350,185,169,354,猴硐,三等
2020-06-09,7350,275,248,523,猴硐,三等
2020-06-10,7350,400,420,820,猴硐,三等
2020-06-11,7350,497,263,760,猴硐,三等
2020-06-12,7350,489,459,948,猴硐,三等
2020-06-13,7350,1047,1087,2134,猴硐,三等
2020-06-14,7350,920,893,1813,猴硐,三等
2020-06-15,7350,251,233,484,猴硐,三等
2020-06-16,7350,323,311,634,猴硐,三等
2020-06-17,7350,326,325,651,猴硐,三等
2020-06-18,7350,278,276,554,猴硐,三等
2020-06-19,7350,351,335,686,猴硐,三等
2020-06-20,7350,755,792,1547,猴硐,三等
2020-06-21,7350,811,732,1543,猴硐,三等
2020-06-22,7350,385,381,766,猴硐,三等
2020-06-23,7350,430,345,775,猴硐,三等
2020-06-24,7350,308,291,599,猴硐,三等
2020-06-25,7350,1113,1081,2194,猴硐,三等
2020-06-26,7350,1912,1777,3689,猴硐,三等
2020-06-27,7350,1700,1508,3208,猴硐,三等
2020-06-28,7350,949,900,1849,猴硐,三等
2020-06-29,7350,346,311,657,猴硐,三等
2020-06-30,7350,281,312,593,猴硐,三等
2020-07-01,7350,340,319,659,猴硐,三等
2020-07-02,7350,370,362,732,猴硐,三等
2020-07-03,7350,347,324,671,猴硐,三等
2020-07-04,7350,862,823,1685,猴硐,三等
2020-07-05,7350,993,853,1846,猴硐,三等
2020-07-06,7350,363,369,732,猴硐,三等
2020-07-07,7350,332,339,671,猴硐,三等
2020-07-08,7350,375,380,755,猴硐,三等
2020-07-09,7350,458,461,919,猴硐,三等
2020-07-10,7350,499,492,991,猴硐,三等
2020-07-11,7350,925,876,1801,猴硐,三等
2020-07-12,7350,1147,948,2095,猴硐,三等
2020-07-13,7350,526,496,1022,猴硐,三等
2020-07-14,7350,504,503,1007,猴硐,三等
2020-07-15,7350,414,394,808,猴硐,三等
2020-07-16,7350,651,638,1289,猴硐,三等
2020-07-17,7350,652,568,1220,猴硐,三等
2020-07-18,7350,1195,1010,2205,猴硐,三等
2020-07-19,7350,1132,856,1988,猴硐,三等
2020-07-20,7350,674,622,1296,猴硐,三等
2020-07-21,7350,580,734,1314,猴硐,三等
2020-07-22,7350,558,475,1033,猴硐,三等
2020-07-23,7350,590,564,1154,猴硐,三等
2020-07-24,7350,611,623,1234,猴硐,三等
2020-07-25,7350,915,807,1722,猴硐,三等
2020-07-26,7350,1149,972,2121,猴硐,三等
2020-07-27,7350,514,507,1021,猴硐,三等
2020-07-28,7350,590,465,1055,猴硐,三等
2020-07-29,7350,496,502,998,猴硐,三等
2020-07-30,7350,565,555,1120,猴硐,三等
2020-07-31,7350,647,704,1351,猴硐,三等
2020-08-01,7350,1220,1251,2471,猴硐,三等
2020-08-02,7350,885,889,1774,猴硐,三等
2020-08-03,7350,146,146,292,猴硐,三等
2020-08-04,7350,314,276,590,猴硐,三等
2020-08-05,7350,441,409,850,猴硐,三等
2020-08-06,7350,600,583,1183,猴硐,三等
2020-08-07,7350,461,482,943,猴硐,三等
2020-08-08,7350,864,810,1674,猴硐,三等
2020-08-09,7350,1059,1008,2067,猴硐,三等
2020-08-10,7350,611,576,1187,猴硐,三等
2020-08-11,7350,286,284,570,猴硐,三等
2020-08-12,7350,446,421,867,猴硐,三等
2020-08-13,7350,565,566,1131,猴硐,三等
2020-08-14,7350,610,582,1192,猴硐,三等
2020-08-15,7350,1242,1460,2702,猴硐,三等
2020-08-16,7350,1273,1195,2468,猴硐,三等
2020-08-17,7350,685,636,1321,猴硐,三等
2020-08-18,7350,689,649,1338,猴硐,三等
2020-08-19,7350,598,575,1173,猴硐,三等
2020-08-20,7350,726,556,1282,猴硐,三等
2020-08-21,7350,773,706,1479,猴硐,三等
2020-08-22,7350,1220,996,2216,猴硐,三等
2020-08-23,7350,1024,1005,2029,猴硐,三等
2020-08-24,7350,701,674,1375,猴硐,三等
2020-08-25,7350,727,684,1411,猴硐,三等
2020-08-26,7350,567,550,1117,猴硐,三等
2020-08-27,7350,727,507,1234,猴硐,三等
2020-08-28,7350,429,442,871,猴硐,三等
2020-08-29,7350,773,686,1459,猴硐,三等
2020-08-30,7350,836,752,1588,猴硐,三等
2020-08-31,7350,258,218,476,猴硐,三等
2020-09-01,7350,237,206,443,猴硐,三等
2020-09-02,7350,284,270,554,猴硐,三等
2020-09-03,7350,289,256,545,猴硐,三等
2020-09-04,7350,395,438,833,猴硐,三等
2020-09-05,7350,943,914,1857,猴硐,三等
2020-09-06,7350,1103,909,2012,猴硐,三等
2020-09-07,7350,357,359,716,猴硐,三等
2020-09-08,7350,383,366,749,猴硐,三等
2020-09-09,7350,291,315,606,猴硐,三等
2020-09-10,7350,284,261,545,猴硐,三等
2020-09-11,7350,402,390,792,猴硐,三等
2020-09-12,7350,828,868,1696,猴硐,三等
2020-09-13,7350,520,552,1072,猴硐,三等
2020-09-14,7350,202,227,429,猴硐,三等
2020-09-15,7350,226,184,410,猴硐,三等
2020-09-16,7350,370,406,776,猴硐,三等
2020-09-17,7350,232,241,473,猴硐,三等
2020-09-18,7350,217,237,454,猴硐,三等
2020-09-19,7350,894,841,1735,猴硐,三等
2020-09-20,7350,527,559,1086,猴硐,三等
2020-09-21,7350,289,270,559,猴硐,三等
2020-09-22,7350,275,258,533,猴硐,三等
2020-09-23,7350,228,275,503,猴硐,三等
2020-09-24,7350,160,167,327,猴硐,三等
2020-09-25,7350,202,220,422,猴硐,三等
2020-09-26,7350,630,624,1254,猴硐,三等
2020-09-27,7350,301,460,761,猴硐,三等
2020-09-28,7350,188,183,371,猴硐,三等
2020-09-29,7350,193,224,417,猴硐,三等
2020-09-30,7350,148,179,327,猴硐,三等
2020-10-01,7350,1154,1167,2321,猴硐,三等
2020-10-02,7350,1881,1813,3694,猴硐,三等
2020-10-03,7350,1799,1752,3551,猴硐,三等
2020-10-04,7350,818,788,1606,猴硐,三等
2020-10-05,7350,180,138,318,猴硐,三等
2020-10-06,7350,145,139,284,猴硐,三等
2020-10-07,7350,206,182,388,猴硐,三等
2020-10-08,7350,258,236,494,猴硐,三等
2020-10-09,7350,1110,1216,2326,猴硐,三等
2020-10-10,7350,1282,1300,2582,猴硐,三等
2020-10-11,7350,732,744,1476,猴硐,三等
2020-10-12,7350,167,160,327,猴硐,三等
2020-10-13,7350,135,172,307,猴硐,三等
2020-10-14,7350,173,173,346,猴硐,三等
2020-10-15,7350,248,252,500,猴硐,三等
2020-10-16,7350,208,247,455,猴硐,三等
2020-10-17,7350,614,681,1295,猴硐,三等
2020-10-18,7350,385,378,763,猴硐,三等
2020-10-19,7350,175,168,343,猴硐,三等
2020-10-20,7350,177,157,334,猴硐,三等
2020-10-21,7350,332,198,530,猴硐,三等
2020-10-22,7350,188,189,377,猴硐,三等
2020-10-23,7350,186,215,401,猴硐,三等
2020-10-24,7350,751,656,1407,猴硐,三等
2020-10-25,7350,751,737,1488,猴硐,三等
2020-10-26,7350,315,309,624,猴硐,三等
2020-10-27,7350,314,289,603,猴硐,三等
2020-10-28,7350,262,271,533,猴硐,三等
2020-10-29,7350,493,179,672,猴硐,三等
2020-10-30,7350,249,197,446,猴硐,三等
2020-10-31,7350,815,905,1720,猴硐,三等
2020-11-01,7350,891,999,1890,猴硐,三等
2020-11-02,7350,292,396,688,猴硐,三等
2020-11-03,7350,209,196,405,猴硐,三等
2020-11-04,7350,160,172,332,猴硐,三等
2020-11-05,7350,333,381,714,猴硐,三等
2020-11-06,7350,259,300,559,猴硐,三等
2020-11-07,7350,762,764,1526,猴硐,三等
2020-11-08,7350,520,483,1003,猴硐,三等
2020-11-09,7350,252,198,450,猴硐,三等
2020-11-10,7350,157,151,308,猴硐,三等
2020-11-11,7350,234,350,584,猴硐,三等
2020-11-12,7350,200,175,375,猴硐,三等
2020-11-13,7350,194,195,389,猴硐,三等
2020-11-14,7350,668,703,1371,猴硐,三等
2020-11-15,7350,835,895,1730,猴硐,三等
2020-11-16,7350,435,330,765,猴硐,三等
2020-11-17,7350,298,282,580,猴硐,三等
2020-11-18,7350,389,276,665,猴硐,三等
2020-11-19,7350,356,386,742,猴硐,三等
2020-11-20,7350,245,282,527,猴硐,三等
2020-11-21,7350,608,588,1196,猴硐,三等
2020-11-22,7350,1019,981,2000,猴硐,三等
2020-11-23,7350,190,193,383,猴硐,三等
2020-11-24,7350,278,216,494,猴硐,三等
2020-11-25,7350,255,230,485,猴硐,三等
2020-11-26,7350,340,346,686,猴硐,三等
2020-11-27,7350,258,235,493,猴硐,三等
2020-11-28,7350,528,571,1099,猴硐,三等
2020-11-29,7350,839,599,1438,猴硐,三等
2020-11-30,7350,178,167,345,猴硐,三等
2020-12-01,7350,105,95,200,猴硐,三等
2020-12-02,7350,166,211,377,猴硐,三等
2020-12-03,7350,130,130,260,猴硐,三等
2020-12-04,7350,156,122,278,猴硐,三等
2020-12-05,7350,349,204,553,猴硐,三等
2020-12-06,7350,339,255,594,猴硐,三等
2020-12-07,7350,230,123,353,猴硐,三等
2020-12-08,7350,220,139,359,猴硐,三等
2020-12-09,7350,211,128,339,猴硐,三等
2020-12-10,7350,231,185,416,猴硐,三等
2020-12-11,7350,341,297,638,猴硐,三等
2020-12-12,7350,417,271,688,猴硐,三等
2020-12-13,7350,429,488,917,猴硐,三等
2020-12-14,7350,131,137,268,猴硐,三等
2020-12-15,7350,99,93,192,猴硐,三等
2020-12-16,7350,85,88,173,猴硐,三等
2020-12-17,7350,176,162,338,猴硐,三等
2020-12-18,7350,143,157,300,猴硐,三等
2020-12-19,7350,453,436,889,猴硐,三等
2020-12-20,7350,406,469,875,猴硐,三等
2020-12-21,7350,218,199,417,猴硐,三等
2020-12-22,7350,152,153,305,猴硐,三等
2020-12-23,7350,113,128,241,猴硐,三等
2020-12-24,7350,188,145,333,猴硐,三等
2020-12-25,7350,323,301,624,猴硐,三等
2020-12-26,7350,795,797,1592,猴硐,三等
2020-12-27,7350,735,787,1522,猴硐,三等
2020-12-28,7350,292,265,557,猴硐,三等
2020-12-29,7350,270,252,522,猴硐,三等
2020-12-30,7350,138,151,289,猴硐,三等
2020-12-31,7350,276,267,543,猴硐,三等
2020-01-01,7360,5973,7075,13048,瑞芳,一等
2020-01-02,7360,7385,8263,15648,瑞芳,一等
2020-01-03,7360,6811,7913,14724,瑞芳,一等
2020-01-04,7360,6659,7527,14186,瑞芳,一等
2020-01-05,7360,5489,6157,11646,瑞芳,一等
2020-01-06,7360,5433,5982,11415,瑞芳,一等
2020-01-07,7360,5175,5731,10906,瑞芳,一等
2020-01-08,7360,4790,5323,10113,瑞芳,一等
2020-01-09,7360,4897,5331,10228,瑞芳,一等
2020-01-10,7360,5514,6015,11529,瑞芳,一等
2020-01-11,7360,4945,6019,10964,瑞芳,一等
2020-01-12,7360,4434,4924,9358,瑞芳,一等
2020-01-13,7360,4984,5442,10426,瑞芳,一等
2020-01-14,7360,5064,5480,10544,瑞芳,一等
2020-01-15,7360,4417,4839,9256,瑞芳,一等
2020-01-16,7360,5507,5724,11231,瑞芳,一等
2020-01-17,7360,4422,5097,9519,瑞芳,一等
2020-01-18,7360,4428,5198,9626,瑞芳,一等
2020-01-19,7360,4187,4628,8815,瑞芳,一等
2020-01-20,7360,4876,5294,10170,瑞芳,一等
2020-01-21,7360,4719,5285,10004,瑞芳,一等
2020-01-22,7360,4494,4870,9364,瑞芳,一等
2020-01-23,7360,3802,4336,8138,瑞芳,一等
2020-01-24,7360,3246,3919,7165,瑞芳,一等
2020-01-25,7360,6058,6276,12334,瑞芳,一等
2020-01-26,7360,4338,4635,8973,瑞芳,一等
2020-01-27,7360,5963,6828,12791,瑞芳,一等
2020-01-28,7360,6036,6598,12634,瑞芳,一等
2020-01-29,7360,4411,4667,9078,瑞芳,一等
2020-01-30,7360,5107,5594,10701,瑞芳,一等
2020-01-31,7360,5064,5493,10557,瑞芳,一等
2020-02-01,7360,5353,6350,11703,瑞芳,一等
2020-02-02,7360,4722,4957,9679,瑞芳,一等
2020-02-03,7360,4192,4419,8611,瑞芳,一等
2020-02-04,7360,3587,3700,7287,瑞芳,一等
2020-02-05,7360,3493,3885,7378,瑞芳,一等
2020-02-06,7360,4138,4426,8564,瑞芳,一等
2020-02-07,7360,3837,4352,8189,瑞芳,一等
2020-02-08,7360,5971,7289,13260,瑞芳,一等
2020-02-09,7360,3593,3652,7245,瑞芳,一等
2020-02-10,7360,4121,4537,8658,瑞芳,一等
2020-02-11,7360,3646,3931,7577,瑞芳,一等
2020-02-12,7360,4181,4569,8750,瑞芳,一等
2020-02-13,7360,3784,4215,7999,瑞芳,一等
2020-02-14,7360,4024,4437,8461,瑞芳,一等
2020-02-15,7360,3959,4619,8578,瑞芳,一等
2020-02-16,7360,2815,3006,5821,瑞芳,一等
2020-02-17,7360,3911,4363,8274,瑞芳,一等
2020-02-18,7360,4072,4443,8515,瑞芳,一等
2020-02-19,7360,4261,4668,8929,瑞芳,一等
2020-02-20,7360,4043,4403,8446,瑞芳,一等
2020-02-21,7360,4443,4886,9329,瑞芳,一等
2020-02-22,7360,3541,4049,7590,瑞芳,一等
2020-02-23,7360,3837,4355,8192,瑞芳,一等
2020-02-24,7360,4343,4794,9137,瑞芳,一等
2020-02-25,7360,4241,4571,8812,瑞芳,一等
2020-02-26,7360,3998,4422,8420,瑞芳,一等
2020-02-27,7360,4321,4311,8632,瑞芳,一等
2020-02-28,7360,4593,5425,10018,瑞芳,一等
2020-02-29,7360,4438,5014,9452,瑞芳,一等
2020-03-01,7360,3129,3313,6442,瑞芳,一等
2020-03-02,7360,3369,3437,6806,瑞芳,一等
2020-03-03,7360,3406,3634,7040,瑞芳,一等
2020-03-04,7360,3083,3209,6292,瑞芳,一等
2020-03-05,7360,3068,3133,6201,瑞芳,一等
2020-03-06,7360,3975,3968,7943,瑞芳,一等
2020-03-07,7360,3603,4038,7641,瑞芳,一等
2020-03-08,7360,3340,3469,6809,瑞芳,一等
2020-03-09,7360,3716,3847,7563,瑞芳,一等
2020-03-10,7360,2969,3126,6095,瑞芳,一等
2020-03-11,7360,3444,3699,7143,瑞芳,一等
2020-03-12,7360,3285,3269,6554,瑞芳,一等
2020-03-13,7360,3681,3625,7306,瑞芳,一等
2020-03-14,7360,2588,2976,5564,瑞芳,一等
2020-03-15,7360,3894,4330,8224,瑞芳,一等
2020-03-16,7360,3677,3835,7512,瑞芳,一等
2020-03-17,7360,3433,3483,6916,瑞芳,一等
2020-03-18,7360,3241,3304,6545,瑞芳,一等
2020-03-19,7360,2972,3041,6013,瑞芳,一等
2020-03-20,7360,3556,3408,6964,瑞芳,一等
2020-03-21,7360,3007,3485,6492,瑞芳,一等
2020-03-22,7360,2991,3128,6119,瑞芳,一等
2020-03-23,7360,3039,3090,6129,瑞芳,一等
2020-03-24,7360,2891,2941,5832,瑞芳,一等
2020-03-25,7360,2989,3102,6091,瑞芳,一等
2020-03-26,7360,3148,3169,6317,瑞芳,一等
2020-03-27,7360,3474,3420,6894,瑞芳,一等
2020-03-28,7360,1757,2054,3811,瑞芳,一等
2020-03-29,7360,2722,2875,5597,瑞芳,一等
2020-03-30,7360,3037,3166,6203,瑞芳,一等
2020-03-31,7360,3043,3089,6132,瑞芳,一等
2020-04-01,7360,3415,3269,6684,瑞芳,一等
2020-04-02,7360,2104,2351,4455,瑞芳,一等
2020-04-03,7360,2776,3063,5839,瑞芳,一等
2020-04-04,7360,2111,2211,4322,瑞芳,一等
2020-04-05,7360,2252,2280,4532,瑞芳,一等
2020-04-06,7360,2979,2947,5926,瑞芳,一等
2020-04-07,7360,2681,2695,5376,瑞芳,一等
2020-04-08,7360,2739,2771,5510,瑞芳,一等
2020-04-09,7360,2803,2820,5623,瑞芳,一等
2020-04-10,7360,3714,3512,7226,瑞芳,一等
2020-04-11,7360,2088,2257,4345,瑞芳,一等
2020-04-12,7360,1885,1876,3761,瑞芳,一等
2020-04-13,7360,2924,3036,5960,瑞芳,一等
2020-04-14,7360,3070,3133,6203,瑞芳,一等
2020-04-15,7360,3070,3186,6256,瑞芳,一等
2020-04-16,7360,3248,3308,6556,瑞芳,一等
2020-04-17,7360,3678,3597,7275,瑞芳,一等
2020-04-18,7360,3285,3818,7103,瑞芳,一等
2020-04-19,7360,2776,3027,5803,瑞芳,一等
2020-04-20,7360,2931,3037,5968,瑞芳,一等
2020-04-21,7360,2803,2856,5659,瑞芳,一等
2020-04-22,7360,2664,2716,5380,瑞芳,一等
2020-04-23,7360,2689,2683,5372,瑞芳,一等
2020-04-24,7360,3191,2998,6189,瑞芳,一等
2020-04-25,7360,1977,2309,4286,瑞芳,一等
2020-04-26,7360,2077,2210,4287,瑞芳,一等
2020-04-27,7360,2910,3034,5944,瑞芳,一等
2020-04-28,7360,3113,3186,6299,瑞芳,一等
2020-04-29,7360,3131,3209,6340,瑞芳,一等
2020-04-30,7360,3174,3369,6543,瑞芳,一等
2020-05-01,7360,4370,4535,8905,瑞芳,一等
2020-05-02,7360,3669,4219,7888,瑞芳,一等
2020-05-03,7360,3254,3404,6658,瑞芳,一等
2020-05-04,7360,3280,3345,6625,瑞芳,一等
2020-05-05,7360,3158,3263,6421,瑞芳,一等
2020-05-06,7360,3219,3338,6557,瑞芳,一等
2020-05-07,7360,3081,3059,6140,瑞芳,一等
2020-05-08,7360,3863,3899,7762,瑞芳,一等
2020-05-09,7360,3319,4073,7392,瑞芳,一等
2020-05-10,7360,3066,3022,6088,瑞芳,一等
2020-05-11,7360,3172,3193,6365,瑞芳,一等
2020-05-12,7360,2996,3064,6060,瑞芳,一等
2020-05-13,7360,3415,3423,6838,瑞芳,一等
2020-05-14,7360,3291,3340,6631,瑞芳,一等
2020-05-15,7360,3994,3963,7957,瑞芳,一等
2020-05-16,7360,3575,4043,7618,瑞芳,一等
2020-05-17,7360,3369,3259,6628,瑞芳,一等
2020-05-18,7360,3167,3404,6571,瑞芳,一等
2020-05-19,7360,2885,3097,5982,瑞芳,一等
2020-05-20,7360,3161,3163,6324,瑞芳,一等
2020-05-21,7360,3025,3118,6143,瑞芳,一等
2020-05-22,7360,3423,3280,6703,瑞芳,一等
2020-05-23,7360,2092,2283,4375,瑞芳,一等
2020-05-24,7360,3486,3828,7314,瑞芳,一等
2020-05-25,7360,3269,3443,6712,瑞芳,一等
2020-05-26,7360,3248,3326,6574,瑞芳,一等
2020-05-27,7360,3075,3088,6163,瑞芳,一等
2020-05-28,7360,2979,2971,5950,瑞芳,一等
2020-05-29,7360,3818,3725,7543,瑞芳,一等
2020-05-30,7360,3724,4161,7885,瑞芳,一等
2020-05-31,7360,4040,4290,8330,瑞芳,一等
2020-06-01,7360,3455,3456,6911,瑞芳,一等
2020-06-02,7360,3281,3310,6591,瑞芳,一等
2020-06-03,7360,3763,3803,7566,瑞芳,一等
2020-06-04,7360,3480,3596,7076,瑞芳,一等
2020-06-05,7360,3960,3826,7786,瑞芳,一等
2020-06-06,7360,3997,4429,8426,瑞芳,一等
2020-06-07,7360,3395,3334,6729,瑞芳,一等
2020-06-08,7360,3320,3444,6764,瑞芳,一等
2020-06-09,7360,3462,3539,7001,瑞芳,一等
2020-06-10,7360,3759,3783,7542,瑞芳,一等
2020-06-11,7360,3779,3799,7578,瑞芳,一等
2020-06-12,7360,4199,4102,8301,瑞芳,一等
2020-06-13,7360,4476,5026,9502,瑞芳,一等
2020-06-14,7360,4242,4582,8824,瑞芳,一等
2020-06-15,7360,3643,3731,7374,瑞芳,一等
2020-06-16,7360,3859,4012,7871,瑞芳,一等
2020-06-17,7360,3450,3566,7016,瑞芳,一等
2020-06-18,7360,3436,3585,7021,瑞芳,一等
2020-06-19,7360,3782,3840,7622,瑞芳,一等
2020-06-20,7360,4078,4538,8616,瑞芳,一等
2020-06-21,7360,3870,4116,7986,瑞芳,一等
2020-06-22,7360,3659,3661,7320,瑞芳,一等
2020-06-23,7360,3582,3724,7306,瑞芳,一等
2020-06-24,7360,4065,4301,8366,瑞芳,一等
2020-06-25,7360,4606,5378,9984,瑞芳,一等
2020-06-26,7360,6998,7579,14577,瑞芳,一等
2020-06-27,7360,5875,6342,12217,瑞芳,一等
2020-06-28,7360,3972,4242,8214,瑞芳,一等
2020-06-29,7360,3659,3779,7438,瑞芳,一等
2020-06-30,7360,3653,3779,7432,瑞芳,一等
2020-07-01,7360,3416,3532,6948,瑞芳,一等
2020-07-02,7360,3411,3528,6939,瑞芳,一等
2020-07-03,7360,3834,3782,7616,瑞芳,一等
2020-07-04,7360,3800,4295,8095,瑞芳,一等
2020-07-05,7360,3750,3918,7668,瑞芳,一等
2020-07-06,7360,3753,3819,7572,瑞芳,一等
2020-07-07,7360,3652,3688,7340,瑞芳,一等
2020-07-08,7360,3758,3919,7677,瑞芳,一等
2020-07-09,7360,3824,3872,7696,瑞芳,一等
2020-07-10,7360,4327,4378,8705,瑞芳,一等
2020-07-11,7360,4385,4913,9298,瑞芳,一等
2020-07-12,7360,4344,4421,8765,瑞芳,一等
2020-07-13,7360,3839,4049,7888,瑞芳,一等
2020-07-14,7360,3821,4084,7905,瑞芳,一等
2020-07-15,7360,3520,3723,7243,瑞芳,一等
2020-07-16,7360,4151,4272,8423,瑞芳,一等
2020-07-17,7360,4541,4570,9111,瑞芳,一等
2020-07-18,7360,4633,5162,9795,瑞芳,一等
2020-07-19,7360,4440,4710,9150,瑞芳,一等
2020-07-20,7360,3924,4105,8029,瑞芳,一等
2020-07-21,7360,3902,4069,7971,瑞芳,一等
2020-07-22,7360,3957,4177,8134,瑞芳,一等
2020-07-23,7360,4089,4299,8388,瑞芳,一等
2020-07-24,7360,4658,4483,9141,瑞芳,一等
2020-07-25,7360,4437,4833,9270,瑞芳,一等
2020-07-26,7360,4389,4414,8803,瑞芳,一等
2020-07-27,7360,3862,3905,7767,瑞芳,一等
2020-07-28,7360,3674,3814,7488,瑞芳,一等
2020-07-29,7360,4038,4242,8280,瑞芳,一等
2020-07-30,7360,4085,4287,8372,瑞芳,一等
2020-07-31,7360,4259,4298,8557,瑞芳,一等
2020-08-01,7360,4470,4976,9446,瑞芳,一等
2020-08-02,7360,3921,4070,7991,瑞芳,一等
2020-08-03,7360,2811,2913,5724,瑞芳,一等
2020-08-04,7360,3307,3423,6730,瑞芳,一等
2020-08-05,7360,3523,3719,7242,瑞芳,一等
2020-08-06,7360,3747,3845,7592,瑞芳,一等
2020-08-07,7360,3986,3985,7971,瑞芳,一等
2020-08-08,7360,3813,4341,8154,瑞芳,一等
2020-08-09,7360,4236,4233,8469,瑞芳,一等
2020-08-10,7360,3896,4153,8049,瑞芳,一等
2020-08-11,7360,3435,3517,6952,瑞芳,一等
2020-08-12,7360,3621,3773,7394,瑞芳,一等
2020-08-13,7360,4083,4253,8336,瑞芳,一等
2020-08-14,7360,4563,4299,8862,瑞芳,一等
2020-08-15,7360,4789,5477,10266,瑞芳,一等
2020-08-16,7360,4858,4996,9854,瑞芳,一等
2020-08-17,7360,4019,4354,8373,瑞芳,一等
2020-08-18,7360,3953,4234,8187,瑞芳,一等
2020-08-19,7360,4076,4143,8219,瑞芳,一等
2020-08-20,7360,4079,4238,8317,瑞芳,一等
2020-08-21,7360,4701,4688,9389,瑞芳,一等
2020-08-22,7360,4032,4606,8638,瑞芳,一等
2020-08-23,7360,3647,3781,7428,瑞芳,一等
2020-08-24,7360,4119,4471,8590,瑞芳,一等
2020-08-25,7360,4288,4426,8714,瑞芳,一等
2020-08-26,7360,4163,4097,8260,瑞芳,一等
2020-08-27,7360,3521,3606,7127,瑞芳,一等
2020-08-28,7360,3558,3754,7312,瑞芳,一等
2020-08-29,7360,3628,4057,7685,瑞芳,一等
2020-08-30,7360,3709,4052,7761,瑞芳,一等
2020-08-31,7360,3356,3428,6784,瑞芳,一等
2020-09-01,7360,3311,3384,6695,瑞芳,一等
2020-09-02,7360,3459,3501,6960,瑞芳,一等
2020-09-03,7360,3416,3535,6951,瑞芳,一等
2020-09-04,7360,4568,4186,8754,瑞芳,一等
2020-09-05,7360,4155,4610,8765,瑞芳,一等
2020-09-06,7360,4028,4362,8390,瑞芳,一等
2020-09-07,7360,3785,3938,7723,瑞芳,一等
2020-09-08,7360,3705,3781,7486,瑞芳,一等
2020-09-09,7360,3572,3724,7296,瑞芳,一等
2020-09-10,7360,3726,3659,7385,瑞芳,一等
2020-09-11,7360,4322,4281,8603,瑞芳,一等
2020-09-12,7360,4034,4415,8449,瑞芳,一等
2020-09-13,7360,3272,3306,6578,瑞芳,一等
2020-09-14,7360,3428,3454,6882,瑞芳,一等
2020-09-15,7360,3486,3562,7048,瑞芳,一等
2020-09-16,7360,3488,3568,7056,瑞芳,一等
2020-09-17,7360,3434,3582,7016,瑞芳,一等
2020-09-18,7360,4278,3994,8272,瑞芳,一等
2020-09-19,7360,4013,4515,8528,瑞芳,一等
2020-09-20,7360,3400,3615,7015,瑞芳,一等
2020-09-21,7360,3675,3735,7410,瑞芳,一等
2020-09-22,7360,3591,3724,7315,瑞芳,一等
2020-09-23,7360,3804,3909,7713,瑞芳,一等
2020-09-24,7360,3280,3364,6644,瑞芳,一等
2020-09-25,7360,3618,3535,7153,瑞芳,一等
2020-09-26,7360,3814,4245,8059,瑞芳,一等
2020-09-27,7360,2622,2660,5282,瑞芳,一等
2020-09-28,7360,3151,3202,6353,瑞芳,一等
2020-09-29,7360,3419,3403,6822,瑞芳,一等
2020-09-30,7360,4009,3975,7984,瑞芳,一等
2020-10-01,7360,4740,5643,10383,瑞芳,一等
2020-10-02,7360,7035,7347,14382,瑞芳,一等
2020-10-03,7360,6064,6465,12529,瑞芳,一等
2020-10-04,7360,4316,4295,8611,瑞芳,一等
2020-10-05,7360,3366,3362,6728,瑞芳,一等
2020-10-06,7360,3470,3420,6890,瑞芳,一等
2020-10-07,7360,3581,3533,7114,瑞芳,一等
2020-10-08,7360,3900,3985,7885,瑞芳,一等
2020-10-09,7360,5061,5672,10733,瑞芳,一等
2020-10-10,7360,5379,5662,11041,瑞芳,一等
2020-10-11,7360,3861,3881,7742,瑞芳,一等
2020-10-12,7360,3241,3402,6643,瑞芳,一等
2020-10-13,7360,3210,3227,6437,瑞芳,一等
2020-10-14,7360,3431,3415,6846,瑞芳,一等
2020-10-15,7360,3562,3650,7212,瑞芳,一等
2020-10-16,7360,4002,4058,8060,瑞芳,一等
2020-10-17,7360,3694,3915,7609,瑞芳,一等
2020-10-18,7360,3346,3449,6795,瑞芳,一等
2020-10-19,7360,3473,3431,6904,瑞芳,一等
2020-10-20,7360,3456,3522,6978,瑞芳,一等
2020-10-21,7360,3304,3364,6668,瑞芳,一等
2020-10-22,7360,3043,3119,6162,瑞芳,一等
2020-10-23,7360,4183,3981,8164,瑞芳,一等
2020-10-24,7360,4360,4749,9109,瑞芳,一等
2020-10-25,7360,4264,4437,8701,瑞芳,一等
2020-10-26,7360,3953,4105,8058,瑞芳,一等
2020-10-27,7360,3864,3885,7749,瑞芳,一等
2020-10-28,7360,3748,3753,7501,瑞芳,一等
2020-10-29,7360,3338,3422,6760,瑞芳,一等
2020-10-30,7360,4398,4238,8636,瑞芳,一等
2020-10-31,7360,4751,5106,9857,瑞芳,一等
2020-11-01,7360,4652,4682,9334,瑞芳,一等
2020-11-02,7360,3538,3640,7178,瑞芳,一等
2020-11-03,7360,3389,3429,6818,瑞芳,一等
2020-11-04,7360,3588,3549,7137,瑞芳,一等
2020-11-05,7360,3477,3621,7098,瑞芳,一等
2020-11-06,7360,3968,3859,7827,瑞芳,一等
2020-11-07,7360,4030,4424,8454,瑞芳,一等
2020-11-08,7360,2913,3244,6157,瑞芳,一等
2020-11-09,7360,3507,3565,7072,瑞芳,一等
2020-11-10,7360,3283,3304,6587,瑞芳,一等
2020-11-11,7360,3770,3666,7436,瑞芳,一等
2020-11-12,7360,3395,3462,6857,瑞芳,一等
2020-11-13,7360,3891,3957,7848,瑞芳,一等
2020-11-14,7360,3582,4008,7590,瑞芳,一等
2020-11-15,7360,4825,5024,9849,瑞芳,一等
2020-11-16,7360,3859,4024,7883,瑞芳,一等
2020-11-17,7360,3894,3845,7739,瑞芳,一等
2020-11-18,7360,4122,4176,8298,瑞芳,一等
2020-11-19,7360,3982,4033,8015,瑞芳,一等
2020-11-20,7360,4572,4412,8984,瑞芳,一等
2020-11-21,7360,3816,4130,7946,瑞芳,一等
2020-11-22,7360,4935,5047,9982,瑞芳,一等
2020-11-23,7360,3571,3555,7126,瑞芳,一等
2020-11-24,7360,3371,3614,6985,瑞芳,一等
2020-11-25,7360,3778,3831,7609,瑞芳,一等
2020-11-26,7360,3960,4105,8065,瑞芳,一等
2020-11-27,7360,4096,4040,8136,瑞芳,一等
2020-11-28,7360,3241,3847,7088,瑞芳,一等
2020-11-29,7360,3391,3275,6666,瑞芳,一等
2020-11-30,7360,3263,3263,6526,瑞芳,一等
2020-12-01,7360,2933,3020,5953,瑞芳,一等
2020-12-02,7360,3034,3120,6154,瑞芳,一等
2020-12-03,7360,3060,3107,6167,瑞芳,一等
2020-12-04,7360,2522,2649,5171,瑞芳,一等
2020-12-05,7360,1877,2734,4611,瑞芳,一等
2020-12-06,7360,2035,2375,4410,瑞芳,一等
2020-12-07,7360,2343,2549,4892,瑞芳,一等
2020-12-08,7360,2228,2429,4657,瑞芳,一等
2020-12-09,7360,2162,2349,4511,瑞芳,一等
2020-12-10,7360,2319,2393,4712,瑞芳,一等
2020-12-11,7360,2865,2821,5686,瑞芳,一等
2020-12-12,7360,2322,2976,5298,瑞芳,一等
2020-12-13,7360,2917,3170,6087,瑞芳,一等
2020-12-14,7360,3035,2971,6006,瑞芳,一等
2020-12-15,7360,2850,2856,5706,瑞芳,一等
2020-12-16,7360,2764,2810,5574,瑞芳,一等
2020-12-17,7360,2860,2871,5731,瑞芳,一等
2020-12-18,7360,3743,3539,7282,瑞芳,一等
2020-12-19,7360,2656,2944,5600,瑞芳,一等
2020-12-20,7360,2713,2887,5600,瑞芳,一等
2020-12-21,7360,3072,3054,6126,瑞芳,一等
2020-12-22,7360,2818,2896,5714,瑞芳,一等
2020-12-23,7360,2829,2952,5781,瑞芳,一等
2020-12-24,7360,3008,3148,6156,瑞芳,一等
2020-12-25,7360,3760,3635,7395,瑞芳,一等
2020-12-26,7360,3361,3802,7163,瑞芳,一等
2020-12-27,7360,3377,3461,6838,瑞芳,一等
2020-12-28,7360,3154,3271,6425,瑞芳,一等
2020-12-29,7360,3192,3283,6475,瑞芳,一等
2020-12-30,7360,2950,2948,5898,瑞芳,一等
2020-12-31,7360,3523,3602,7125,瑞芳,一等
2020-01-01,7361,229,228,457,海科館,招呼
2020-01-02,7361,243,264,507,海科館,招呼
2020-01-03,7361,140,139,279,海科館,招呼
2020-01-04,7361,247,314,561,海科館,招呼
2020-01-05,7361,229,260,489,海科館,招呼
2020-01-06,7361,111,115,226,海科館,招呼
2020-01-07,7361,107,97,204,海科館,招呼
2020-01-08,7361,92,92,184,海科館,招呼
2020-01-09,7361,89,95,184,海科館,招呼
2020-01-10,7361,94,95,189,海科館,招呼
2020-01-11,7361,157,160,317,海科館,招呼
2020-01-12,7361,162,182,344,海科館,招呼
2020-01-13,7361,86,87,173,海科館,招呼
2020-01-14,7361,99,126,225,海科館,招呼
2020-01-15,7361,83,90,173,海科館,招呼
2020-01-16,7361,196,204,400,海科館,招呼
2020-01-17,7361,90,91,181,海科館,招呼
2020-01-18,7361,198,218,416,海科館,招呼
2020-01-19,7361,175,198,373,海科館,招呼
2020-01-20,7361,157,173,330,海科館,招呼
2020-01-21,7361,174,185,359,海科館,招呼
2020-01-22,7361,192,178,370,海科館,招呼
2020-01-23,7361,169,159,328,海科館,招呼
2020-01-24,7361,88,102,190,海科館,招呼
2020-01-25,7361,365,385,750,海科館,招呼
2020-01-26,7361,207,246,453,海科館,招呼
2020-01-27,7361,365,430,795,海科館,招呼
2020-01-28,7361,535,604,1139,海科館,招呼
2020-01-29,7361,257,275,532,海科館,招呼
2020-01-30,7361,255,258,513,海科館,招呼
2020-01-31,7361,192,205,397,海科館,招呼
2020-02-01,7361,211,219,430,海科館,招呼
2020-02-02,7361,236,256,492,海科館,招呼
2020-02-03,7361,142,145,287,海科館,招呼
2020-02-04,7361,86,106,192,海科館,招呼
2020-02-05,7361,61,75,136,海科館,招呼
2020-02-06,7361,175,193,368,海科館,招呼
2020-02-07,7361,108,99,207,海科館,招呼
2020-02-08,7361,148,149,297,海科館,招呼
2020-02-09,7361,107,129,236,海科館,招呼
2020-02-10,7361,85,73,158,海科館,招呼
2020-02-11,7361,111,116,227,海科館,招呼
2020-02-12,7361,69,75,144,海科館,招呼
2020-02-13,7361,31,44,75,海科館,招呼
2020-02-14,7361,49,52,101,海科館,招呼
2020-02-15,7361,74,102,176,海科館,招呼
2020-02-16,7361,38,58,96,海科館,招呼
2020-02-17,7361,20,31,51,海科館,招呼
2020-02-18,7361,66,52,118,海科館,招呼
2020-02-19,7361,37,70,107,海科館,招呼
2020-02-20,7361,40,61,101,海科館,招呼
2020-02-21,7361,122,71,193,海科館,招呼
2020-02-22,7361,37,48,85,海科館,招呼
2020-02-23,7361,95,100,195,海科館,招呼
2020-02-24,7361,56,50,106,海科館,招呼
2020-02-25,7361,38,56,94,海科館,招呼
2020-02-26,7361,33,34,67,海科館,招呼
2020-02-27,7361,27,25,52,海科館,招呼
2020-02-28,7361,150,182,332,海科館,招呼
2020-02-29,7361,153,188,341,海科館,招呼
2020-03-01,7361,64,96,160,海科館,招呼
2020-03-02,7361,17,10,27,海科館,招呼
2020-03-03,7361,16,34,50,海科館,招呼
2020-03-04,7361,10,8,18,海科館,招呼
2020-03-05,7361,5,3,8,海科館,招呼
2020-03-06,7361,34,28,62,海科館,招呼
2020-03-07,7361,104,150,254,海科館,招呼
2020-03-08,7361,73,104,177,海科館,招呼
2020-03-09,7361,19,24,43,海科館,招呼
2020-03-10,7361,7,10,17,海科館,招呼
2020-03-11,7361,16,22,38,海科館,招呼
2020-03-12,7361,58,61,119,海科館,招呼
2020-03-13,7361,9,10,19,海科館,招呼
2020-03-14,7361,40,61,101,海科館,招呼
2020-03-15,7361,106,138,244,海科館,招呼
2020-03-16,7361,27,25,52,海科館,招呼
2020-03-17,7361,16,18,34,海科館,招呼
2020-03-18,7361,15,16,31,海科館,招呼
2020-03-19,7361,12,13,25,海科館,招呼
2020-03-20,7361,11,23,34,海科館,招呼
2020-03-21,7361,60,89,149,海科館,招呼
2020-03-22,7361,95,94,189,海科館,招呼
2020-03-23,7361,7,11,18,海科館,招呼
2020-03-24,7361,12,12,24,海科館,招呼
2020-03-25,7361,15,14,29,海科館,招呼
2020-03-26,7361,33,29,62,海科館,招呼
2020-03-27,7361,17,21,38,海科館,招呼
2020-03-28,7361,41,57,98,海科館,招呼
2020-03-29,7361,49,71,120,海科館,招呼
2020-03-30,7361,13,15,28,海科館,招呼
2020-03-31,7361,9,43,52,海科館,招呼
2020-04-01,7361,13,14,27,海科館,招呼
2020-04-02,7361,14,36,50,海科館,招呼
2020-04-03,7361,58,61,119,海科館,招呼
2020-04-04,7361,48,43,91,海科館,招呼
2020-04-05,7361,24,32,56,海科館,招呼
2020-04-06,7361,15,15,30,海科館,招呼
2020-04-07,7361,10,21,31,海科館,招呼
2020-04-08,7361,11,9,20,海科館,招呼
2020-04-09,7361,12,20,32,海科館,招呼
2020-04-10,7361,25,34,59,海科館,招呼
2020-04-11,7361,38,45,83,海科館,招呼
2020-04-12,7361,17,32,49,海科館,招呼
2020-04-13,7361,22,22,44,海科館,招呼
2020-04-14,7361,20,28,48,海科館,招呼
2020-04-15,7361,31,30,61,海科館,招呼
2020-04-16,7361,28,22,50,海科館,招呼
2020-04-17,7361,29,29,58,海科館,招呼
2020-04-18,7361,96,112,208,海科館,招呼
2020-04-19,7361,76,98,174,海科館,招呼
2020-04-20,7361,10,8,18,海科館,招呼
2020-04-21,7361,7,13,20,海科館,招呼
2020-04-22,7361,1,6,7,海科館,招呼
2020-04-23,7361,3,9,12,海科館,招呼
2020-04-24,7361,16,18,34,海科館,招呼
2020-04-25,7361,45,57,102,海科館,招呼
2020-04-26,7361,42,47,89,海科館,招呼
2020-04-27,7361,22,22,44,海科館,招呼
2020-04-28,7361,20,36,56,海科館,招呼
2020-04-29,7361,19,23,42,海科館,招呼
2020-04-30,7361,31,37,68,海科館,招呼
2020-05-01,7361,73,113,186,海科館,招呼
2020-05-02,7361,122,159,281,海科館,招呼
2020-05-03,7361,133,124,257,海科館,招呼
2020-05-04,7361,22,24,46,海科館,招呼
2020-05-05,7361,41,41,82,海科館,招呼
2020-05-06,7361,23,20,43,海科館,招呼
2020-05-07,7361,19,25,44,海科館,招呼
2020-05-08,7361,37,49,86,海科館,招呼
2020-05-09,7361,132,155,287,海科館,招呼
2020-05-10,7361,108,99,207,海科館,招呼
2020-05-11,7361,7,7,14,海科館,招呼
2020-05-12,7361,6,11,17,海科館,招呼
2020-05-13,7361,31,50,81,海科館,招呼
2020-05-14,7361,22,34,56,海科館,招呼
2020-05-15,7361,40,32,72,海科館,招呼
2020-05-16,7361,95,138,233,海科館,招呼
2020-05-17,7361,95,126,221,海科館,招呼
2020-05-18,7361,11,12,23,海科館,招呼
2020-05-19,7361,18,14,32,海科館,招呼
2020-05-20,7361,19,16,35,海科館,招呼
2020-05-21,7361,15,14,29,海科館,招呼
2020-05-22,7361,9,16,25,海科館,招呼
2020-05-23,7361,13,25,38,海科館,招呼
2020-05-24,7361,128,136,264,海科館,招呼
2020-05-25,7361,18,22,40,海科館,招呼
2020-05-26,7361,47,21,68,海科館,招呼
2020-05-27,7361,29,25,54,海科館,招呼
2020-05-28,7361,11,37,48,海科館,招呼
2020-05-29,7361,38,60,98,海科館,招呼
2020-05-30,7361,104,174,278,海科館,招呼
2020-05-31,7361,116,135,251,海科館,招呼
2020-06-01,7361,19,26,45,海科館,招呼
2020-06-02,7361,19,28,47,海科館,招呼
2020-06-03,7361,31,41,72,海科館,招呼
2020-06-04,7361,37,55,92,海科館,招呼
2020-06-05,7361,17,33,50,海科館,招呼
2020-06-06,7361,122,206,328,海科館,招呼
2020-06-07,7361,98,119,217,海科館,招呼
2020-06-08,7361,24,18,42,海科館,招呼
2020-06-09,7361,60,32,92,海科館,招呼
2020-06-10,7361,50,52,102,海科館,招呼
2020-06-11,7361,75,65,140,海科館,招呼
2020-06-12,7361,57,78,135,海科館,招呼
2020-06-13,7361,174,224,398,海科館,招呼
2020-06-14,7361,108,156,264,海科館,招呼
2020-06-15,7361,18,26,44,海科館,招呼
2020-06-16,7361,29,35,64,海科館,招呼
2020-06-17,7361,50,56,106,海科館,招呼
2020-06-18,7361,26,47,73,海科館,招呼
2020-06-19,7361,34,41,75,海科館,招呼
2020-06-20,7361,304,117,421,海科館,招呼
2020-06-21,7361,128,182,310,海科館,招呼
2020-06-22,7361,41,41,82,海科館,招呼
2020-06-23,7361,38,52,90,海科館,招呼
2020-06-24,7361,34,74,108,海科館,招呼
2020-06-25,7361,136,231,367,海科館,招呼
2020-06-26,7361,456,579,1035,海科館,招呼
2020-06-27,7361,365,451,816,海科館,招呼
2020-06-28,7361,164,168,332,海科館,招呼
2020-06-29,7361,23,42,65,海科館,招呼
2020-06-30,7361,72,88,160,海科館,招呼
2020-07-01,7361,80,91,171,海科館,招呼
2020-07-02,7361,68,74,142,海科館,招呼
2020-07-03,7361,48,62,110,海科館,招呼
2020-07-04,7361,131,203,334,海科館,招呼
2020-07-05,7361,150,235,385,海科館,招呼
2020-07-06,7361,28,30,58,海科館,招呼
2020-07-07,7361,58,59,117,海科館,招呼
2020-07-08,7361,62,68,130,海科館,招呼
2020-07-09,7361,76,89,165,海科館,招呼
2020-07-10,7361,55,125,180,海科館,招呼
2020-07-11,7361,113,195,308,海科館,招呼
2020-07-12,7361,178,249,427,海科館,招呼
2020-07-13,7361,93,104,197,海科館,招呼
2020-07-14,7361,55,57,112,海科館,招呼
2020-07-15,7361,84,106,190,海科館,招呼
2020-07-16,7361,101,136,237,海科館,招呼
2020-07-17,7361,141,186,327,海科館,招呼
2020-07-18,7361,234,315,549,海科館,招呼
2020-07-19,7361,153,286,439,海科館,招呼
2020-07-20,7361,99,144,243,海科館,招呼
2020-07-21,7361,88,86,174,海科館,招呼
2020-07-22,7361,107,115,222,海科館,招呼
2020-07-23,7361,205,233,438,海科館,招呼
2020-07-24,7361,117,134,251,海科館,招呼
2020-07-25,7361,154,226,380,海科館,招呼
2020-07-26,7361,196,266,462,海科館,招呼
2020-07-27,7361,96,114,210,海科館,招呼
2020-07-28,7361,66,121,187,海科館,招呼
2020-07-29,7361,197,246,443,海科館,招呼
2020-07-30,7361,140,179,319,海科館,招呼
2020-07-31,7361,84,139,223,海科館,招呼
2020-08-01,7361,210,319,529,海科館,招呼
2020-08-02,7361,185,298,483,海科館,招呼
2020-08-03,7361,49,57,106,海科館,招呼
2020-08-04,7361,48,108,156,海科館,招呼
2020-08-05,7361,190,215,405,海科館,招呼
2020-08-06,7361,49,100,149,海科館,招呼
2020-08-07,7361,116,147,263,海科館,招呼
2020-08-08,7361,157,206,363,海科館,招呼
2020-08-09,7361,135,187,322,海科館,招呼
2020-08-10,7361,100,111,211,海科館,招呼
2020-08-11,7361,142,127,269,海科館,招呼
2020-08-12,7361,62,88,150,海科館,招呼
2020-08-13,7361,104,145,249,海科館,招呼
2020-08-14,7361,93,108,201,海科館,招呼
2020-08-15,7361,185,260,445,海科館,招呼
2020-08-16,7361,183,273,456,海科館,招呼
2020-08-17,7361,88,98,186,海科館,招呼
2020-08-18,7361,132,181,313,海科館,招呼
2020-08-19,7361,126,126,252,海科館,招呼
2020-08-20,7361,81,97,178,海科館,招呼
2020-08-21,7361,99,183,282,海科館,招呼
2020-08-22,7361,167,234,401,海科館,招呼
2020-08-23,7361,143,193,336,海科館,招呼
2020-08-24,7361,77,120,197,海科館,招呼
2020-08-25,7361,249,309,558,海科館,招呼
2020-08-26,7361,147,151,298,海科館,招呼
2020-08-27,7361,95,96,191,海科館,招呼
2020-08-28,7361,95,82,177,海科館,招呼
2020-08-29,7361,116,156,272,海科館,招呼
2020-08-30,7361,139,173,312,海科館,招呼
2020-08-31,7361,18,15,33,海科館,招呼
2020-09-01,7361,15,20,35,海科館,招呼
2020-09-02,7361,22,25,47,海科館,招呼
2020-09-03,7361,16,18,34,海科館,招呼
2020-09-04,7361,46,45,91,海科館,招呼
2020-09-05,7361,140,186,326,海科館,招呼
2020-09-06,7361,97,137,234,海科館,招呼
2020-09-07,7361,27,33,60,海科館,招呼
2020-09-08,7361,49,53,102,海科館,招呼
2020-09-09,7361,33,38,71,海科館,招呼
2020-09-10,7361,43,40,83,海科館,招呼
2020-09-11,7361,43,65,108,海科館,招呼
2020-09-12,7361,94,159,253,海科館,招呼
2020-09-13,7361,66,89,155,海科館,招呼
2020-09-14,7361,8,22,30,海科館,招呼
2020-09-15,7361,27,21,48,海科館,招呼
2020-09-16,7361,25,33,58,海科館,招呼
2020-09-17,7361,16,25,41,海科館,招呼
2020-09-18,7361,29,41,70,海科館,招呼
2020-09-19,7361,79,161,240,海科館,招呼
2020-09-20,7361,77,112,189,海科館,招呼
2020-09-21,7361,19,24,43,海科館,招呼
2020-09-22,7361,46,56,102,海科館,招呼
2020-09-23,7361,56,98,154,海科館,招呼
2020-09-24,7361,17,31,48,海科館,招呼
2020-09-25,7361,22,33,55,海科館,招呼
2020-09-26,7361,83,107,190,海科館,招呼
2020-09-27,7361,87,103,190,海科館,招呼
2020-09-28,7361,8,5,13,海科館,招呼
2020-09-29,7361,30,32,62,海科館,招呼
2020-09-30,7361,16,13,29,海科館,招呼
2020-10-01,7361,139,208,347,海科館,招呼
2020-10-02,7361,304,481,785,海科館,招呼
2020-10-03,7361,286,384,670,海科館,招呼
2020-10-04,7361,137,171,308,海科館,招呼
2020-10-05,7361,14,10,24,海科館,招呼
2020-10-06,7361,21,24,45,海科館,招呼
2020-10-07,7361,30,52,82,海科館,招呼
2020-10-08,7361,20,66,86,海科館,招呼
2020-10-09,7361,239,249,488,海科館,招呼
2020-10-10,7361,176,268,444,海科館,招呼
2020-10-11,7361,123,172,295,海科館,招呼
2020-10-12,7361,10,10,20,海科館,招呼
2020-10-13,7361,24,9,33,海科館,招呼
2020-10-14,7361,22,30,52,海科館,招呼
2020-10-15,7361,56,75,131,海科館,招呼
2020-10-16,7361,38,49,87,海科館,招呼
2020-10-17,7361,95,124,219,海科館,招呼
2020-10-18,7361,74,61,135,海科館,招呼
2020-10-19,7361,11,4,15,海科館,招呼
2020-10-20,7361,29,30,59,海科館,招呼
2020-10-21,7361,7,16,23,海科館,招呼
2020-10-22,7361,12,12,24,海科館,招呼
2020-10-23,7361,73,77,150,海科館,招呼
2020-10-24,7361,124,240,364,海科館,招呼
2020-10-25,7361,141,182,323,海科館,招呼
2020-10-26,7361,26,47,73,海科館,招呼
2020-10-27,7361,34,43,77,海科館,招呼
2020-10-28,7361,35,90,125,海科館,招呼
2020-10-29,7361,15,24,39,海科館,招呼
2020-10-30,7361,32,35,67,海科館,招呼
2020-10-31,7361,114,169,283,海科館,招呼
2020-11-01,7361,150,204,354,海科館,招呼
2020-11-02,7361,33,41,74,海科館,招呼
2020-11-03,7361,14,18,32,海科館,招呼
2020-11-04,7361,30,30,60,海科館,招呼
2020-11-05,7361,32,24,56,海科館,招呼
2020-11-06,7361,33,28,61,海科館,招呼
2020-11-07,7361,77,120,197,海科館,招呼
2020-11-08,7361,90,143,233,海科館,招呼
2020-11-09,7361,2,12,14,海科館,招呼
2020-11-10,7361,11,9,20,海科館,招呼
2020-11-11,7361,25,32,57,海科館,招呼
2020-11-12,7361,40,47,87,海科館,招呼
2020-11-13,7361,21,59,80,海科館,招呼
2020-11-14,7361,81,121,202,海科館,招呼
2020-11-15,7361,104,153,257,海科館,招呼
2020-11-16,7361,37,28,65,海科館,招呼
2020-11-17,7361,39,45,84,海科館,招呼
2020-11-18,7361,49,66,115,海科館,招呼
2020-11-19,7361,23,40,63,海科館,招呼
2020-11-20,7361,23,37,60,海科館,招呼
2020-11-21,7361,67,115,182,海科館,招呼
2020-11-22,7361,126,145,271,海科館,招呼
2020-11-23,7361,14,18,32,海科館,招呼
2020-11-24,7361,40,81,121,海科館,招呼
2020-11-25,7361,17,31,48,海科館,招呼
2020-11-26,7361,55,78,133,海科館,招呼
2020-11-27,7361,22,22,44,海科館,招呼
2020-11-28,7361,85,123,208,海科館,招呼
2020-11-29,7361,96,83,179,海科館,招呼
2020-11-30,7361,21,12,33,海科館,招呼
2020-12-01,7361,3,5,8,海科館,招呼
2020-12-02,7361,2,4,6,海科館,招呼
2020-12-03,7361,91,7,98,海科館,招呼
2020-12-04,7361,0,0,0,海科館,招呼
2020-12-05,7361,0,16,16,海科館,招呼
2020-12-06,7361,15,1,16,海科館,招呼
2020-12-07,7361,0,0,0,海科館,招呼
2020-12-08,7361,0,2,2,海科館,招呼
2020-12-09,7361,0,0,0,海科館,招呼
2020-12-10,7361,0,2,2,海科館,招呼
2020-12-11,7361,0,0,0,海科館,招呼
2020-12-12,7361,0,0,0,海科館,招呼
2020-12-13,7361,0,0,0,海科館,招呼
2020-12-14,7361,2,0,2,海科館,招呼
2020-12-15,7361,7,8,15,海科館,招呼
2020-12-16,7361,5,5,10,海科館,招呼
2020-12-17,7361,7,5,12,海科館,招呼
2020-12-18,7361,14,16,30,海科館,招呼
2020-12-19,7361,44,117,161,海科館,招呼
2020-12-20,7361,33,35,68,海科館,招呼
2020-12-21,7361,6,10,16,海科館,招呼
2020-12-22,7361,7,11,18,海科館,招呼
2020-12-23,7361,9,9,18,海科館,招呼
2020-12-24,7361,7,16,23,海科館,招呼
2020-12-25,7361,14,29,43,海科館,招呼
2020-12-26,7361,64,75,139,海科館,招呼
2020-12-27,7361,51,120,171,海科館,招呼
2020-12-28,7361,16,10,26,海科館,招呼
2020-12-29,7361,25,31,56,海科館,招呼
2020-12-30,7361,4,4,8,海科館,招呼
2020-12-31,7361,3,18,21,海科館,招呼
2020-01-01,7362,268,307,575,八斗子,招呼
2020-01-02,7362,334,350,684,八斗子,招呼
2020-01-03,7362,293,346,639,八斗子,招呼
2020-01-04,7362,612,692,1304,八斗子,招呼
2020-01-05,7362,268,321,589,八斗子,招呼
2020-01-06,7362,179,245,424,八斗子,招呼
2020-01-07,7362,192,225,417,八斗子,招呼
2020-01-08,7362,159,170,329,八斗子,招呼
2020-01-09,7362,159,166,325,八斗子,招呼
2020-01-10,7362,127,147,274,八斗子,招呼
2020-01-11,7362,226,250,476,八斗子,招呼
2020-01-12,7362,133,207,340,八斗子,招呼
2020-01-13,7362,128,134,262,八斗子,招呼
2020-01-14,7362,143,140,283,八斗子,招呼
2020-01-15,7362,66,77,143,八斗子,招呼
2020-01-16,7362,192,221,413,八斗子,招呼
2020-01-17,7362,139,148,287,八斗子,招呼
2020-01-18,7362,153,195,348,八斗子,招呼
2020-01-19,7362,136,161,297,八斗子,招呼
2020-01-20,7362,180,213,393,八斗子,招呼
2020-01-21,7362,221,271,492,八斗子,招呼
2020-01-22,7362,173,205,378,八斗子,招呼
2020-01-23,7362,181,241,422,八斗子,招呼
2020-01-24,7362,102,105,207,八斗子,招呼
2020-01-25,7362,413,443,856,八斗子,招呼
2020-01-26,7362,194,245,439,八斗子,招呼
2020-01-27,7362,464,506,970,八斗子,招呼
2020-01-28,7362,555,606,1161,八斗子,招呼
2020-01-29,7362,300,307,607,八斗子,招呼
2020-01-30,7362,286,324,610,八斗子,招呼
2020-01-31,7362,299,388,687,八斗子,招呼
2020-02-01,7362,483,544,1027,八斗子,招呼
2020-02-02,7362,304,376,680,八斗子,招呼
2020-02-03,7362,182,196,378,八斗子,招呼
2020-02-04,7362,105,158,263,八斗子,招呼
2020-02-05,7362,111,111,222,八斗子,招呼
2020-02-06,7362,149,174,323,八斗子,招呼
2020-02-07,7362,107,125,232,八斗子,招呼
2020-02-08,7362,439,443,882,八斗子,招呼
2020-02-09,7362,98,101,199,八斗子,招呼
2020-02-10,7362,130,161,291,八斗子,招呼
2020-02-11,7362,119,140,259,八斗子,招呼
2020-02-12,7362,250,274,524,八斗子,招呼
2020-02-13,7362,199,235,434,八斗子,招呼
2020-02-14,7362,193,206,399,八斗子,招呼
2020-02-15,7362,257,328,585,八斗子,招呼
2020-02-16,7362,135,146,281,八斗子,招呼
2020-02-17,7362,143,167,310,八斗子,招呼
2020-02-18,7362,157,208,365,八斗子,招呼
2020-02-19,7362,173,203,376,八斗子,招呼
2020-02-20,7362,211,256,467,八斗子,招呼
2020-02-21,7362,238,339,577,八斗子,招呼
2020-02-22,7362,198,205,403,八斗子,招呼
2020-02-23,7362,231,263,494,八斗子,招呼
2020-02-24,7362,185,222,407,八斗子,招呼
2020-02-25,7362,156,177,333,八斗子,招呼
2020-02-26,7362,74,94,168,八斗子,招呼
2020-02-27,7362,67,85,152,八斗子,招呼
2020-02-28,7362,413,487,900,八斗子,招呼
2020-02-29,7362,394,461,855,八斗子,招呼
2020-03-01,7362,167,181,348,八斗子,招呼
2020-03-02,7362,23,32,55,八斗子,招呼
2020-03-03,7362,48,70,118,八斗子,招呼
2020-03-04,7362,15,16,31,八斗子,招呼
2020-03-05,7362,25,34,59,八斗子,招呼
2020-03-06,7362,56,90,146,八斗子,招呼
2020-03-07,7362,192,235,427,八斗子,招呼
2020-03-08,7362,175,257,432,八斗子,招呼
2020-03-09,7362,95,138,233,八斗子,招呼
2020-03-10,7362,26,36,62,八斗子,招呼
2020-03-11,7362,60,59,119,八斗子,招呼
2020-03-12,7362,46,49,95,八斗子,招呼
2020-03-13,7362,33,72,105,八斗子,招呼
2020-03-14,7362,83,88,171,八斗子,招呼
2020-03-15,7362,208,263,471,八斗子,招呼
2020-03-16,7362,80,95,175,八斗子,招呼
2020-03-17,7362,71,81,152,八斗子,招呼
2020-03-18,7362,32,40,72,八斗子,招呼
2020-03-19,7362,22,21,43,八斗子,招呼
2020-03-20,7362,32,42,74,八斗子,招呼
2020-03-21,7362,172,217,389,八斗子,招呼
2020-03-22,7362,142,187,329,八斗子,招呼
2020-03-23,7362,23,33,56,八斗子,招呼
2020-03-24,7362,27,29,56,八斗子,招呼
2020-03-25,7362,43,66,109,八斗子,招呼
2020-03-26,7362,46,61,107,八斗子,招呼
2020-03-27,7362,47,49,96,八斗子,招呼
2020-03-28,7362,35,56,91,八斗子,招呼
2020-03-29,7362,147,194,341,八斗子,招呼
2020-03-30,7362,45,48,93,八斗子,招呼
2020-03-31,7362,36,48,84,八斗子,招呼
2020-04-01,7362,33,44,77,八斗子,招呼
2020-04-02,7362,73,91,164,八斗子,招呼
2020-04-03,7362,151,203,354,八斗子,招呼
2020-04-04,7362,60,99,159,八斗子,招呼
2020-04-05,7362,83,97,180,八斗子,招呼
2020-04-06,7362,12,17,29,八斗子,招呼
2020-04-07,7362,10,12,22,八斗子,招呼
2020-04-08,7362,12,26,38,八斗子,招呼
2020-04-09,7362,29,38,67,八斗子,招呼
2020-04-10,7362,39,61,100,八斗子,招呼
2020-04-11,7362,65,99,164,八斗子,招呼
2020-04-12,7362,44,51,95,八斗子,招呼
2020-04-13,7362,42,44,86,八斗子,招呼
2020-04-14,7362,43,62,105,八斗子,招呼
2020-04-15,7362,44,74,118,八斗子,招呼
2020-04-16,7362,72,96,168,八斗子,招呼
2020-04-17,7362,63,86,149,八斗子,招呼
2020-04-18,7362,193,259,452,八斗子,招呼
2020-04-19,7362,160,179,339,八斗子,招呼
2020-04-20,7362,46,51,97,八斗子,招呼
2020-04-21,7362,34,32,66,八斗子,招呼
2020-04-22,7362,12,9,21,八斗子,招呼
2020-04-23,7362,16,16,32,八斗子,招呼
2020-04-24,7362,18,15,33,八斗子,招呼
2020-04-25,7362,78,88,166,八斗子,招呼
2020-04-26,7362,80,100,180,八斗子,招呼
2020-04-27,7362,20,25,45,八斗子,招呼
2020-04-28,7362,78,82,160,八斗子,招呼
2020-04-29,7362,85,94,179,八斗子,招呼
2020-04-30,7362,68,82,150,八斗子,招呼
2020-05-01,7362,233,258,491,八斗子,招呼
2020-05-02,7362,267,384,651,八斗子,招呼
2020-05-03,7362,197,242,439,八斗子,招呼
2020-05-04,7362,58,72,130,八斗子,招呼
2020-05-05,7362,57,74,131,八斗子,招呼
2020-05-06,7362,44,83,127,八斗子,招呼
2020-05-07,7362,39,54,93,八斗子,招呼
2020-05-08,7362,69,79,148,八斗子,招呼
2020-05-09,7362,185,229,414,八斗子,招呼
2020-05-10,7362,159,217,376,八斗子,招呼
2020-05-11,7362,17,22,39,八斗子,招呼
2020-05-12,7362,19,19,38,八斗子,招呼
2020-05-13,7362,73,77,150,八斗子,招呼
2020-05-14,7362,93,120,213,八斗子,招呼
2020-05-15,7362,104,144,248,八斗子,招呼
2020-05-16,7362,191,222,413,八斗子,招呼
2020-05-17,7362,200,219,419,八斗子,招呼
2020-05-18,7362,47,61,108,八斗子,招呼
2020-05-19,7362,6,10,16,八斗子,招呼
2020-05-20,7362,37,34,71,八斗子,招呼
2020-05-21,7362,27,28,55,八斗子,招呼
2020-05-22,7362,29,25,54,八斗子,招呼
2020-05-23,7362,41,47,88,八斗子,招呼
2020-05-24,7362,265,355,620,八斗子,招呼
2020-05-25,7362,60,65,125,八斗子,招呼
2020-05-26,7362,30,36,66,八斗子,招呼
2020-05-27,7362,34,59,93,八斗子,招呼
2020-05-28,7362,32,37,69,八斗子,招呼
2020-05-29,7362,57,49,106,八斗子,招呼
2020-05-30,7362,352,380,732,八斗子,招呼
2020-05-31,7362,323,403,726,八斗子,招呼
2020-06-01,7362,80,106,186,八斗子,招呼
2020-06-02,7362,70,94,164,八斗子,招呼
2020-06-03,7362,69,99,168,八斗子,招呼
2020-06-04,7362,122,124,246,八斗子,招呼
2020-06-05,7362,96,118,214,八斗子,招呼
2020-06-06,7362,277,331,608,八斗子,招呼
2020-06-07,7362,290,293,583,八斗子,招呼
2020-06-08,7362,78,114,192,八斗子,招呼
2020-06-09,7362,119,152,271,八斗子,招呼
2020-06-10,7362,103,142,245,八斗子,招呼
2020-06-11,7362,126,150,276,八斗子,招呼
2020-06-12,7362,130,127,257,八斗子,招呼
2020-06-13,7362,360,438,798,八斗子,招呼
2020-06-14,7362,403,449,852,八斗子,招呼
2020-06-15,7362,81,103,184,八斗子,招呼
2020-06-16,7362,185,209,394,八斗子,招呼
2020-06-17,7362,82,106,188,八斗子,招呼
2020-06-18,7362,121,136,257,八斗子,招呼
2020-06-19,7362,139,147,286,八斗子,招呼
2020-06-20,7362,280,358,638,八斗子,招呼
2020-06-21,7362,226,256,482,八斗子,招呼
2020-06-22,7362,140,180,320,八斗子,招呼
2020-06-23,7362,73,110,183,八斗子,招呼
2020-06-24,7362,106,124,230,八斗子,招呼
2020-06-25,7362,396,470,866,八斗子,招呼
2020-06-26,7362,820,952,1772,八斗子,招呼
2020-06-27,7362,672,775,1447,八斗子,招呼
2020-06-28,7362,267,348,615,八斗子,招呼
2020-06-29,7362,101,97,198,八斗子,招呼
2020-06-30,7362,159,183,342,八斗子,招呼
2020-07-01,7362,99,116,215,八斗子,招呼
2020-07-02,7362,118,144,262,八斗子,招呼
2020-07-03,7362,101,132,233,八斗子,招呼
2020-07-04,7362,256,349,605,八斗子,招呼
2020-07-05,7362,234,272,506,八斗子,招呼
2020-07-06,7362,144,149,293,八斗子,招呼
2020-07-07,7362,135,179,314,八斗子,招呼
2020-07-08,7362,138,156,294,八斗子,招呼
2020-07-09,7362,117,145,262,八斗子,招呼
2020-07-10,7362,140,158,298,八斗子,招呼
2020-07-11,7362,327,391,718,八斗子,招呼
2020-07-12,7362,349,386,735,八斗子,招呼
2020-07-13,7362,176,186,362,八斗子,招呼
2020-07-14,7362,133,203,336,八斗子,招呼
2020-07-15,7362,122,151,273,八斗子,招呼
2020-07-16,7362,210,273,483,八斗子,招呼
2020-07-17,7362,277,338,615,八斗子,招呼
2020-07-18,7362,449,507,956,八斗子,招呼
2020-07-19,7362,382,445,827,八斗子,招呼
2020-07-20,7362,234,284,518,八斗子,招呼
2020-07-21,7362,209,243,452,八斗子,招呼
2020-07-22,7362,167,265,432,八斗子,招呼
2020-07-23,7362,205,299,504,八斗子,招呼
2020-07-24,7362,277,344,621,八斗子,招呼
2020-07-25,7362,395,490,885,八斗子,招呼
2020-07-26,7362,395,419,814,八斗子,招呼
2020-07-27,7362,218,297,515,八斗子,招呼
2020-07-28,7362,141,166,307,八斗子,招呼
2020-07-29,7362,221,256,477,八斗子,招呼
2020-07-30,7362,195,333,528,八斗子,招呼
2020-07-31,7362,160,199,359,八斗子,招呼
2020-08-01,7362,390,542,932,八斗子,招呼
2020-08-02,7362,272,342,614,八斗子,招呼
2020-08-03,7362,51,79,130,八斗子,招呼
2020-08-04,7362,176,171,347,八斗子,招呼
2020-08-05,7362,148,176,324,八斗子,招呼
2020-08-06,7362,185,214,399,八斗子,招呼
2020-08-07,7362,169,225,394,八斗子,招呼
2020-08-08,7362,320,430,750,八斗子,招呼
2020-08-09,7362,315,354,669,八斗子,招呼
2020-08-10,7362,238,222,460,八斗子,招呼
2020-08-11,7362,123,142,265,八斗子,招呼
2020-08-12,7362,199,219,418,八斗子,招呼
2020-08-13,7362,212,237,449,八斗子,招呼
2020-08-14,7362,272,312,584,八斗子,招呼
2020-08-15,7362,478,530,1008,八斗子,招呼
2020-08-16,7362,445,529,974,八斗子,招呼
2020-08-17,7362,252,320,572,八斗子,招呼
2020-08-18,7362,234,303,537,八斗子,招呼
2020-08-19,7362,206,281,487,八斗子,招呼
2020-08-20,7362,186,261,447,八斗子,招呼
2020-08-21,7362,250,267,517,八斗子,招呼
2020-08-22,7362,354,404,758,八斗子,招呼
2020-08-23,7362,346,386,732,八斗子,招呼
2020-08-24,7362,263,326,589,八斗子,招呼
2020-08-25,7362,260,283,543,八斗子,招呼
2020-08-26,7362,178,239,417,八斗子,招呼
2020-08-27,7362,162,200,362,八斗子,招呼
2020-08-28,7362,141,159,300,八斗子,招呼
2020-08-29,7362,195,278,473,八斗子,招呼
2020-08-30,7362,203,268,471,八斗子,招呼
2020-08-31,7362,63,110,173,八斗子,招呼
2020-09-01,7362,54,66,120,八斗子,招呼
2020-09-02,7362,69,96,165,八斗子,招呼
2020-09-03,7362,83,98,181,八斗子,招呼
2020-09-04,7362,143,189,332,八斗子,招呼
2020-09-05,7362,402,435,837,八斗子,招呼
2020-09-06,7362,340,445,785,八斗子,招呼
2020-09-07,7362,138,163,301,八斗子,招呼
2020-09-08,7362,135,177,312,八斗子,招呼
2020-09-09,7362,135,132,267,八斗子,招呼
2020-09-10,7362,94,145,239,八斗子,招呼
2020-09-11,7362,84,110,194,八斗子,招呼
2020-09-12,7362,283,383,666,八斗子,招呼
2020-09-13,7362,129,166,295,八斗子,招呼
2020-09-14,7362,72,79,151,八斗子,招呼
2020-09-15,7362,92,138,230,八斗子,招呼
2020-09-16,7362,43,56,99,八斗子,招呼
2020-09-17,7362,106,140,246,八斗子,招呼
2020-09-18,7362,111,171,282,八斗子,招呼
2020-09-19,7362,265,341,606,八斗子,招呼
2020-09-20,7362,192,289,481,八斗子,招呼
2020-09-21,7362,161,214,375,八斗子,招呼
2020-09-22,7362,117,88,205,八斗子,招呼
2020-09-23,7362,138,192,330,八斗子,招呼
2020-09-24,7362,109,199,308,八斗子,招呼
2020-09-25,7362,104,80,184,八斗子,招呼
2020-09-26,7362,156,204,360,八斗子,招呼
2020-09-27,7362,91,148,239,八斗子,招呼
2020-09-28,7362,48,90,138,八斗子,招呼
2020-09-29,7362,81,94,175,八斗子,招呼
2020-09-30,7362,38,49,87,八斗子,招呼
2020-10-01,7362,390,480,870,八斗子,招呼
2020-10-02,7362,893,1001,1894,八斗子,招呼
2020-10-03,7362,762,886,1648,八斗子,招呼
2020-10-04,7362,370,383,753,八斗子,招呼
2020-10-05,7362,50,48,98,八斗子,招呼
2020-10-06,7362,62,71,133,八斗子,招呼
2020-10-07,7362,111,125,236,八斗子,招呼
2020-10-08,7362,184,137,321,八斗子,招呼
2020-10-09,7362,534,605,1139,八斗子,招呼
2020-10-10,7362,590,748,1338,八斗子,招呼
2020-10-11,7362,205,261,466,八斗子,招呼
2020-10-12,7362,60,76,136,八斗子,招呼
2020-10-13,7362,48,60,108,八斗子,招呼
2020-10-14,7362,68,92,160,八斗子,招呼
2020-10-15,7362,81,151,232,八斗子,招呼
2020-10-16,7362,115,137,252,八斗子,招呼
2020-10-17,7362,213,242,455,八斗子,招呼
2020-10-18,7362,172,218,390,八斗子,招呼
2020-10-19,7362,46,63,109,八斗子,招呼
2020-10-20,7362,77,104,181,八斗子,招呼
2020-10-21,7362,63,73,136,八斗子,招呼
2020-10-22,7362,43,35,78,八斗子,招呼
2020-10-23,7362,147,160,307,八斗子,招呼
2020-10-24,7362,256,368,624,八斗子,招呼
2020-10-25,7362,283,388,671,八斗子,招呼
2020-10-26,7362,157,200,357,八斗子,招呼
2020-10-27,7362,159,167,326,八斗子,招呼
2020-10-28,7362,186,156,342,八斗子,招呼
2020-10-29,7362,62,76,138,八斗子,招呼
2020-10-30,7362,118,238,356,八斗子,招呼
2020-10-31,7362,357,390,747,八斗子,招呼
2020-11-01,7362,469,455,924,八斗子,招呼
2020-11-02,7362,100,110,210,八斗子,招呼
2020-11-03,7362,68,65,133,八斗子,招呼
2020-11-04,7362,168,89,257,八斗子,招呼
2020-11-05,7362,95,96,191,八斗子,招呼
2020-11-06,7362,89,107,196,八斗子,招呼
2020-11-07,7362,218,246,464,八斗子,招呼
2020-11-08,7362,156,163,319,八斗子,招呼
2020-11-09,7362,80,75,155,八斗子,招呼
2020-11-10,7362,38,72,110,八斗子,招呼
2020-11-11,7362,68,77,145,八斗子,招呼
2020-11-12,7362,91,108,199,八斗子,招呼
2020-11-13,7362,93,108,201,八斗子,招呼
2020-11-14,7362,180,212,392,八斗子,招呼
2020-11-15,7362,280,347,627,八斗子,招呼
2020-11-16,7362,172,158,330,八斗子,招呼
2020-11-17,7362,89,147,236,八斗子,招呼
2020-11-18,7362,102,124,226,八斗子,招呼
2020-11-19,7362,110,176,286,八斗子,招呼
2020-11-20,7362,194,161,355,八斗子,招呼
2020-11-21,7362,264,286,550,八斗子,招呼
2020-11-22,7362,406,425,831,八斗子,招呼
2020-11-23,7362,86,132,218,八斗子,招呼
2020-11-24,7362,62,75,137,八斗子,招呼
2020-11-25,7362,100,123,223,八斗子,招呼
2020-11-26,7362,115,133,248,八斗子,招呼
2020-11-27,7362,91,108,199,八斗子,招呼
2020-11-28,7362,359,402,761,八斗子,招呼
2020-11-29,7362,188,300,488,八斗子,招呼
2020-11-30,7362,65,73,138,八斗子,招呼
2020-12-01,7362,15,22,37,八斗子,招呼
2020-12-02,7362,27,60,87,八斗子,招呼
2020-12-03,7362,38,137,175,八斗子,招呼
2020-12-04,7362,3,3,6,八斗子,招呼
2020-12-05,7362,0,0,0,八斗子,招呼
2020-12-06,7362,0,4,4,八斗子,招呼
2020-12-07,7362,0,0,0,八斗子,招呼
2020-12-08,7362,0,0,0,八斗子,招呼
2020-12-09,7362,0,0,0,八斗子,招呼
2020-12-10,7362,0,0,0,八斗子,招呼
2020-12-11,7362,0,0,0,八斗子,招呼
2020-12-12,7362,0,0,0,八斗子,招呼
2020-12-13,7362,0,0,0,八斗子,招呼
2020-12-14,7362,6,17,23,八斗子,招呼
2020-12-15,7362,8,12,20,八斗子,招呼
2020-12-16,7362,10,11,21,八斗子,招呼
2020-12-17,7362,10,30,40,八斗子,招呼
2020-12-18,7362,41,35,76,八斗子,招呼
2020-12-19,7362,81,100,181,八斗子,招呼
2020-12-20,7362,50,72,122,八斗子,招呼
2020-12-21,7362,9,21,30,八斗子,招呼
2020-12-22,7362,20,27,47,八斗子,招呼
2020-12-23,7362,36,38,74,八斗子,招呼
2020-12-24,7362,24,37,61,八斗子,招呼
2020-12-25,7362,72,81,153,八斗子,招呼
2020-12-26,7362,156,174,330,八斗子,招呼
2020-12-27,7362,155,155,310,八斗子,招呼
2020-12-28,7362,28,31,59,八斗子,招呼
2020-12-29,7362,46,48,94,八斗子,招呼
2020-12-30,7362,16,32,48,八斗子,招呼
2020-12-31,7362,28,34,62,八斗子,招呼
2020-01-01,7380,457,518,975,四腳亭,三等
2020-01-02,7380,673,653,1326,四腳亭,三等
2020-01-03,7380,696,692,1388,四腳亭,三等
2020-01-04,7380,631,552,1183,四腳亭,三等
2020-01-05,7380,525,475,1000,四腳亭,三等
2020-01-06,7380,683,684,1367,四腳亭,三等
2020-01-07,7380,679,672,1351,四腳亭,三等
2020-01-08,7380,670,667,1337,四腳亭,三等
2020-01-09,7380,666,684,1350,四腳亭,三等
2020-01-10,7380,759,788,1547,四腳亭,三等
2020-01-11,7380,870,553,1423,四腳亭,三等
2020-01-12,7380,471,432,903,四腳亭,三等
2020-01-13,7380,679,659,1338,四腳亭,三等
2020-01-14,7380,1239,618,1857,四腳亭,三等
2020-01-15,7380,550,636,1186,四腳亭,三等
2020-01-16,7380,700,686,1386,四腳亭,三等
2020-01-17,7380,633,595,1228,四腳亭,三等
2020-01-18,7380,513,508,1021,四腳亭,三等
2020-01-19,7380,554,439,993,四腳亭,三等
2020-01-20,7380,677,712,1389,四腳亭,三等
2020-01-21,7380,650,668,1318,四腳亭,三等
2020-01-22,7380,645,636,1281,四腳亭,三等
2020-01-23,7380,575,469,1044,四腳亭,三等
2020-01-24,7380,365,412,777,四腳亭,三等
2020-01-25,7380,516,491,1007,四腳亭,三等
2020-01-26,7380,520,495,1015,四腳亭,三等
2020-01-27,7380,579,487,1066,四腳亭,三等
2020-01-28,7380,499,478,977,四腳亭,三等
2020-01-29,7380,502,431,933,四腳亭,三等
2020-01-30,7380,596,576,1172,四腳亭,三等
2020-01-31,7380,645,614,1259,四腳亭,三等
2020-02-01,7380,442,485,927,四腳亭,三等
2020-02-02,7380,528,492,1020,四腳亭,三等
2020-02-03,7380,649,625,1274,四腳亭,三等
2020-02-04,7380,591,593,1184,四腳亭,三等
2020-02-05,7380,593,542,1135,四腳亭,三等
2020-02-06,7380,561,542,1103,四腳亭,三等
2020-02-07,7380,627,609,1236,四腳亭,三等
2020-02-08,7380,439,442,881,四腳亭,三等
2020-02-09,7380,371,371,742,四腳亭,三等
2020-02-10,7380,648,601,1249,四腳亭,三等
2020-02-11,7380,622,583,1205,四腳亭,三等
2020-02-12,7380,634,619,1253,四腳亭,三等
2020-02-13,7380,567,559,1126,四腳亭,三等
2020-02-14,7380,571,579,1150,四腳亭,三等
2020-02-15,7380,514,494,1008,四腳亭,三等
2020-02-16,7380,313,315,628,四腳亭,三等
2020-02-17,7380,559,558,1117,四腳亭,三等
2020-02-18,7380,606,579,1185,四腳亭,三等
2020-02-19,7380,606,567,1173,四腳亭,三等
2020-02-20,7380,582,588,1170,四腳亭,三等
2020-02-21,7380,655,633,1288,四腳亭,三等
2020-02-22,7380,427,454,881,四腳亭,三等
2020-02-23,7380,369,350,719,四腳亭,三等
2020-02-24,7380,670,609,1279,四腳亭,三等
2020-02-25,7380,647,641,1288,四腳亭,三等
2020-02-26,7380,652,634,1286,四腳亭,三等
2020-02-27,7380,637,627,1264,四腳亭,三等
2020-02-28,7380,474,461,935,四腳亭,三等
2020-02-29,7380,407,445,852,四腳亭,三等
2020-03-01,7380,423,321,744,四腳亭,三等
2020-03-02,7380,660,596,1256,四腳亭,三等
2020-03-03,7380,612,612,1224,四腳亭,三等
2020-03-04,7380,621,561,1182,四腳亭,三等
2020-03-05,7380,576,598,1174,四腳亭,三等
2020-03-06,7380,601,637,1238,四腳亭,三等
2020-03-07,7380,463,475,938,四腳亭,三等
2020-03-08,7380,749,347,1096,四腳亭,三等
2020-03-09,7380,623,623,1246,四腳亭,三等
2020-03-10,7380,701,617,1318,四腳亭,三等
2020-03-11,7380,646,607,1253,四腳亭,三等
2020-03-12,7380,598,583,1181,四腳亭,三等
2020-03-13,7380,610,649,1259,四腳亭,三等
2020-03-14,7380,415,380,795,四腳亭,三等
2020-03-15,7380,431,387,818,四腳亭,三等
2020-03-16,7380,641,609,1250,四腳亭,三等
2020-03-17,7380,612,632,1244,四腳亭,三等
2020-03-18,7380,638,627,1265,四腳亭,三等
2020-03-19,7380,570,587,1157,四腳亭,三等
2020-03-20,7380,607,634,1241,四腳亭,三等
2020-03-21,7380,368,416,784,四腳亭,三等
2020-03-22,7380,366,331,697,四腳亭,三等
2020-03-23,7380,574,573,1147,四腳亭,三等
2020-03-24,7380,573,565,1138,四腳亭,三等
2020-03-25,7380,587,589,1176,四腳亭,三等
2020-03-26,7380,570,585,1155,四腳亭,三等
2020-03-27,7380,598,614,1212,四腳亭,三等
2020-03-28,7380,296,319,615,四腳亭,三等
2020-03-29,7380,331,299,630,四腳亭,三等
2020-03-30,7380,575,576,1151,四腳亭,三等
2020-03-31,7380,604,602,1206,四腳亭,三等
2020-04-01,7380,558,618,1176,四腳亭,三等
2020-04-02,7380,378,413,791,四腳亭,三等
2020-04-03,7380,410,409,819,四腳亭,三等
2020-04-04,7380,637,311,948,四腳亭,三等
2020-04-05,7380,345,264,609,四腳亭,三等
2020-04-06,7380,563,555,1118,四腳亭,三等
2020-04-07,7380,537,559,1096,四腳亭,三等
2020-04-08,7380,542,515,1057,四腳亭,三等
2020-04-09,7380,545,536,1081,四腳亭,三等
2020-04-10,7380,595,625,1220,四腳亭,三等
2020-04-11,7380,362,345,707,四腳亭,三等
2020-04-12,7380,300,261,561,四腳亭,三等
2020-04-13,7380,581,566,1147,四腳亭,三等
2020-04-14,7380,605,603,1208,四腳亭,三等
2020-04-15,7380,615,603,1218,四腳亭,三等
2020-04-16,7380,585,580,1165,四腳亭,三等
2020-04-17,7380,625,607,1232,四腳亭,三等
2020-04-18,7380,397,441,838,四腳亭,三等
2020-04-19,7380,325,315,640,四腳亭,三等
2020-04-20,7380,582,587,1169,四腳亭,三等
2020-04-21,7380,590,584,1174,四腳亭,三等
2020-04-22,7380,571,582,1153,四腳亭,三等
2020-04-23,7380,564,554,1118,四腳亭,三等
2020-04-24,7380,592,587,1179,四腳亭,三等
2020-04-25,7380,307,332,639,四腳亭,三等
2020-04-26,7380,319,279,598,四腳亭,三等
2020-04-27,7380,582,588,1170,四腳亭,三等
2020-04-28,7380,595,600,1195,四腳亭,三等
2020-04-29,7380,608,592,1200,四腳亭,三等
2020-04-30,7380,605,621,1226,四腳亭,三等
2020-05-01,7380,642,595,1237,四腳亭,三等
2020-05-02,7380,384,426,810,四腳亭,三等
2020-05-03,7380,365,322,687,四腳亭,三等
2020-05-04,7380,613,587,1200,四腳亭,三等
2020-05-05,7380,574,607,1181,四腳亭,三等
2020-05-06,7380,616,612,1228,四腳亭,三等
2020-05-07,7380,566,574,1140,四腳亭,三等
2020-05-08,7380,594,629,1223,四腳亭,三等
2020-05-09,7380,402,468,870,四腳亭,三等
2020-05-10,7380,449,371,820,四腳亭,三等
2020-05-11,7380,626,570,1196,四腳亭,三等
2020-05-12,7380,637,627,1264,四腳亭,三等
2020-05-13,7380,620,601,1221,四腳亭,三等
2020-05-14,7380,606,598,1204,四腳亭,三等
2020-05-15,7380,631,688,1319,四腳亭,三等
2020-05-16,7380,392,408,800,四腳亭,三等
2020-05-17,7380,400,421,821,四腳亭,三等
2020-05-18,7380,619,584,1203,四腳亭,三等
2020-05-19,7380,590,590,1180,四腳亭,三等
2020-05-20,7380,581,574,1155,四腳亭,三等
2020-05-21,7380,584,601,1185,四腳亭,三等
2020-05-22,7380,610,605,1215,四腳亭,三等
2020-05-23,7380,376,354,730,四腳亭,三等
2020-05-24,7380,439,379,818,四腳亭,三等
2020-05-25,7380,689,628,1317,四腳亭,三等
2020-05-26,7380,620,617,1237,四腳亭,三等
2020-05-27,7380,576,579,1155,四腳亭,三等
2020-05-28,7380,614,602,1216,四腳亭,三等
2020-05-29,7380,642,635,1277,四腳亭,三等
2020-05-30,7380,455,470,925,四腳亭,三等
2020-05-31,7380,416,400,816,四腳亭,三等
2020-06-01,7380,620,621,1241,四腳亭,三等
2020-06-02,7380,609,599,1208,四腳亭,三等
2020-06-03,7380,630,608,1238,四腳亭,三等
2020-06-04,7380,591,580,1171,四腳亭,三等
2020-06-05,7380,614,622,1236,四腳亭,三等
2020-06-06,7380,460,491,951,四腳亭,三等
2020-06-07,7380,391,482,873,四腳亭,三等
2020-06-08,7380,621,587,1208,四腳亭,三等
2020-06-09,7380,603,619,1222,四腳亭,三等
2020-06-10,7380,626,620,1246,四腳亭,三等
2020-06-11,7380,630,630,1260,四腳亭,三等
2020-06-12,7380,659,674,1333,四腳亭,三等
2020-06-13,7380,481,493,974,四腳亭,三等
2020-06-14,7380,472,388,860,四腳亭,三等
2020-06-15,7380,633,624,1257,四腳亭,三等
2020-06-16,7380,655,673,1328,四腳亭,三等
2020-06-17,7380,599,629,1228,四腳亭,三等
2020-06-18,7380,620,610,1230,四腳亭,三等
2020-06-19,7380,645,604,1249,四腳亭,三等
2020-06-20,7380,553,577,1130,四腳亭,三等
2020-06-21,7380,431,378,809,四腳亭,三等
2020-06-22,7380,657,611,1268,四腳亭,三等
2020-06-23,7380,618,614,1232,四腳亭,三等
2020-06-24,7380,639,650,1289,四腳亭,三等
2020-06-25,7380,472,507,979,四腳亭,三等
2020-06-26,7380,593,539,1132,四腳亭,三等
2020-06-27,7380,464,434,898,四腳亭,三等
2020-06-28,7380,419,381,800,四腳亭,三等
2020-06-29,7380,662,614,1276,四腳亭,三等
2020-06-30,7380,602,570,1172,四腳亭,三等
2020-07-01,7380,594,588,1182,四腳亭,三等
2020-07-02,7380,613,565,1178,四腳亭,三等
2020-07-03,7380,629,604,1233,四腳亭,三等
2020-07-04,7380,506,498,1004,四腳亭,三等
2020-07-05,7380,462,413,875,四腳亭,三等
2020-07-06,7380,669,610,1279,四腳亭,三等
2020-07-07,7380,644,617,1261,四腳亭,三等
2020-07-08,7380,594,573,1167,四腳亭,三等
2020-07-09,7380,629,597,1226,四腳亭,三等
2020-07-10,7380,690,636,1326,四腳亭,三等
2020-07-11,7380,506,527,1033,四腳亭,三等
2020-07-12,7380,477,438,915,四腳亭,三等
2020-07-13,7380,666,604,1270,四腳亭,三等
2020-07-14,7380,601,667,1268,四腳亭,三等
2020-07-15,7380,646,602,1248,四腳亭,三等
2020-07-16,7380,629,606,1235,四腳亭,三等
2020-07-17,7380,637,611,1248,四腳亭,三等
2020-07-18,7380,525,503,1028,四腳亭,三等
2020-07-19,7380,439,428,867,四腳亭,三等
2020-07-20,7380,692,668,1360,四腳亭,三等
2020-07-21,7380,642,627,1269,四腳亭,三等
2020-07-22,7380,628,591,1219,四腳亭,三等
2020-07-23,7380,631,625,1256,四腳亭,三等
2020-07-24,7380,698,609,1307,四腳亭,三等
2020-07-25,7380,479,430,909,四腳亭,三等
2020-07-26,7380,500,429,929,四腳亭,三等
2020-07-27,7380,605,576,1181,四腳亭,三等
2020-07-28,7380,619,581,1200,四腳亭,三等
2020-07-29,7380,624,646,1270,四腳亭,三等
2020-07-30,7380,640,615,1255,四腳亭,三等
2020-07-31,7380,619,674,1293,四腳亭,三等
2020-08-01,7380,602,574,1176,四腳亭,三等
2020-08-02,7380,491,489,980,四腳亭,三等
2020-08-03,7380,599,525,1124,四腳亭,三等
2020-08-04,7380,618,582,1200,四腳亭,三等
2020-08-05,7380,628,595,1223,四腳亭,三等
2020-08-06,7380,605,579,1184,四腳亭,三等
2020-08-07,7380,649,638,1287,四腳亭,三等
2020-08-08,7380,495,508,1003,四腳亭,三等
2020-08-09,7380,451,449,900,四腳亭,三等
2020-08-10,7380,820,603,1423,四腳亭,三等
2020-08-11,7380,627,598,1225,四腳亭,三等
2020-08-12,7380,625,587,1212,四腳亭,三等
2020-08-13,7380,663,628,1291,四腳亭,三等
2020-08-14,7380,652,628,1280,四腳亭,三等
2020-08-15,7380,490,517,1007,四腳亭,三等
2020-08-16,7380,462,419,881,四腳亭,三等
2020-08-17,7380,680,625,1305,四腳亭,三等
2020-08-18,7380,691,598,1289,四腳亭,三等
2020-08-19,7380,639,623,1262,四腳亭,三等
2020-08-20,7380,633,612,1245,四腳亭,三等
2020-08-21,7380,664,622,1286,四腳亭,三等
2020-08-22,7380,495,487,982,四腳亭,三等
2020-08-23,7380,391,365,756,四腳亭,三等
2020-08-24,7380,674,588,1262,四腳亭,三等
2020-08-25,7380,605,572,1177,四腳亭,三等
2020-08-26,7380,604,596,1200,四腳亭,三等
2020-08-27,7380,619,597,1216,四腳亭,三等
2020-08-28,7380,614,586,1200,四腳亭,三等
2020-08-29,7380,461,441,902,四腳亭,三等
2020-08-30,7380,393,384,777,四腳亭,三等
2020-08-31,7380,659,627,1286,四腳亭,三等
2020-09-01,7380,647,647,1294,四腳亭,三等
2020-09-02,7380,656,602,1258,四腳亭,三等
2020-09-03,7380,630,575,1205,四腳亭,三等
2020-09-04,7380,676,644,1320,四腳亭,三等
2020-09-05,7380,503,487,990,四腳亭,三等
2020-09-06,7380,438,454,892,四腳亭,三等
2020-09-07,7380,765,672,1437,四腳亭,三等
2020-09-08,7380,669,624,1293,四腳亭,三等
2020-09-09,7380,638,637,1275,四腳亭,三等
2020-09-10,7380,634,617,1251,四腳亭,三等
2020-09-11,7380,672,671,1343,四腳亭,三等
2020-09-12,7380,545,501,1046,四腳亭,三等
2020-09-13,7380,483,397,880,四腳亭,三等
2020-09-14,7380,686,668,1354,四腳亭,三等
2020-09-15,7380,660,658,1318,四腳亭,三等
2020-09-16,7380,631,613,1244,四腳亭,三等
2020-09-17,7380,613,621,1234,四腳亭,三等
2020-09-18,7380,654,691,1345,四腳亭,三等
2020-09-19,7380,493,459,952,四腳亭,三等
2020-09-20,7380,413,406,819,四腳亭,三等
2020-09-21,7380,659,648,1307,四腳亭,三等
2020-09-22,7380,660,630,1290,四腳亭,三等
2020-09-23,7380,701,688,1389,四腳亭,三等
2020-09-24,7380,649,621,1270,四腳亭,三等
2020-09-25,7380,646,634,1280,四腳亭,三等
2020-09-26,7380,585,602,1187,四腳亭,三等
2020-09-27,7380,417,408,825,四腳亭,三等
2020-09-28,7380,636,628,1264,四腳亭,三等
2020-09-29,7380,681,640,1321,四腳亭,三等
2020-09-30,7380,685,726,1411,四腳亭,三等
2020-10-01,7380,553,604,1157,四腳亭,三等
2020-10-02,7380,631,634,1265,四腳亭,三等
2020-10-03,7380,588,593,1181,四腳亭,三等
2020-10-04,7380,535,474,1009,四腳亭,三等
2020-10-05,7380,681,665,1346,四腳亭,三等
2020-10-06,7380,631,650,1281,四腳亭,三等
2020-10-07,7380,641,662,1303,四腳亭,三等
2020-10-08,7380,682,683,1365,四腳亭,三等
2020-10-09,7380,569,532,1101,四腳亭,三等
2020-10-10,7380,407,434,841,四腳亭,三等
2020-10-11,7380,393,389,782,四腳亭,三等
2020-10-12,7380,698,659,1357,四腳亭,三等
2020-10-13,7380,663,655,1318,四腳亭,三等
2020-10-14,7380,651,655,1306,四腳亭,三等
2020-10-15,7380,659,651,1310,四腳亭,三等
2020-10-16,7380,666,729,1395,四腳亭,三等
2020-10-17,7380,467,498,965,四腳亭,三等
2020-10-18,7380,455,413,868,四腳亭,三等
2020-10-19,7380,686,670,1356,四腳亭,三等
2020-10-20,7380,633,657,1290,四腳亭,三等
2020-10-21,7380,650,644,1294,四腳亭,三等
2020-10-22,7380,588,631,1219,四腳亭,三等
2020-10-23,7380,696,700,1396,四腳亭,三等
2020-10-24,7380,520,528,1048,四腳亭,三等
2020-10-25,7380,524,565,1089,四腳亭,三等
2020-10-26,7380,677,648,1325,四腳亭,三等
2020-10-27,7380,700,692,1392,四腳亭,三等
2020-10-28,7380,637,660,1297,四腳亭,三等
2020-10-29,7380,664,677,1341,四腳亭,三等
2020-10-30,7380,690,692,1382,四腳亭,三等
2020-10-31,7380,576,551,1127,四腳亭,三等
2020-11-01,7380,478,440,918,四腳亭,三等
2020-11-02,7380,769,668,1437,四腳亭,三等
2020-11-03,7380,685,671,1356,四腳亭,三等
2020-11-04,7380,652,654,1306,四腳亭,三等
2020-11-05,7380,655,649,1304,四腳亭,三等
2020-11-06,7380,671,682,1353,四腳亭,三等
2020-11-07,7380,518,533,1051,四腳亭,三等
2020-11-08,7380,450,408,858,四腳亭,三等
2020-11-09,7380,675,678,1353,四腳亭,三等
2020-11-10,7380,633,682,1315,四腳亭,三等
2020-11-11,7380,687,665,1352,四腳亭,三等
2020-11-12,7380,625,651,1276,四腳亭,三等
2020-11-13,7380,684,700,1384,四腳亭,三等
2020-11-14,7380,507,505,1012,四腳亭,三等
2020-11-15,7380,541,529,1070,四腳亭,三等
2020-11-16,7380,721,722,1443,四腳亭,三等
2020-11-17,7380,666,715,1381,四腳亭,三等
2020-11-18,7380,690,735,1425,四腳亭,三等
2020-11-19,7380,670,699,1369,四腳亭,三等
2020-11-20,7380,677,730,1407,四腳亭,三等
2020-11-21,7380,572,635,1207,四腳亭,三等
2020-11-22,7380,532,502,1034,四腳亭,三等
2020-11-23,7380,657,667,1324,四腳亭,三等
2020-11-24,7380,669,688,1357,四腳亭,三等
2020-11-25,7380,705,720,1425,四腳亭,三等
2020-11-26,7380,698,692,1390,四腳亭,三等
2020-11-27,7380,666,697,1363,四腳亭,三等
2020-11-28,7380,490,488,978,四腳亭,三等
2020-11-29,7380,388,385,773,四腳亭,三等
2020-11-30,7380,694,676,1370,四腳亭,三等
2020-12-01,7380,651,667,1318,四腳亭,三等
2020-12-02,7380,626,617,1243,四腳亭,三等
2020-12-03,7380,654,661,1315,四腳亭,三等
2020-12-04,7380,481,555,1036,四腳亭,三等
2020-12-05,7380,350,421,771,四腳亭,三等
2020-12-06,7380,314,327,641,四腳亭,三等
2020-12-07,7380,589,620,1209,四腳亭,三等
2020-12-08,7380,573,618,1191,四腳亭,三等
2020-12-09,7380,577,586,1163,四腳亭,三等
2020-12-10,7380,580,643,1223,四腳亭,三等
2020-12-11,7380,613,766,1379,四腳亭,三等
2020-12-12,7380,447,496,943,四腳亭,三等
2020-12-13,7380,449,465,914,四腳亭,三等
2020-12-14,7380,626,665,1291,四腳亭,三等
2020-12-15,7380,606,631,1237,四腳亭,三等
2020-12-16,7380,614,605,1219,四腳亭,三等
2020-12-17,7380,596,640,1236,四腳亭,三等
2020-12-18,7380,635,695,1330,四腳亭,三等
2020-12-19,7380,435,522,957,四腳亭,三等
2020-12-20,7380,433,413,846,四腳亭,三等
2020-12-21,7380,642,660,1302,四腳亭,三等
2020-12-22,7380,588,655,1243,四腳亭,三等
2020-12-23,7380,654,633,1287,四腳亭,三等
2020-12-24,7380,649,691,1340,四腳亭,三等
2020-12-25,7380,666,709,1375,四腳亭,三等
2020-12-26,7380,482,507,989,四腳亭,三等
2020-12-27,7380,530,441,971,四腳亭,三等
2020-12-28,7380,647,675,1322,四腳亭,三等
2020-12-29,7380,645,683,1328,四腳亭,三等
2020-12-30,7380,650,646,1296,四腳亭,三等
2020-12-31,7380,609,604,1213,四腳亭,三等
2020-01-01,7390,231,263,494,暖暖,招呼
2020-01-02,7390,453,464,917,暖暖,招呼
2020-01-03,7390,449,451,900,暖暖,招呼
2020-01-04,7390,365,375,740,暖暖,招呼
2020-01-05,7390,321,297,618,暖暖,招呼
2020-01-06,7390,454,429,883,暖暖,招呼
2020-01-07,7390,426,419,845,暖暖,招呼
2020-01-08,7390,428,447,875,暖暖,招呼
2020-01-09,7390,455,450,905,暖暖,招呼
2020-01-10,7390,428,562,990,暖暖,招呼
2020-01-11,7390,322,366,688,暖暖,招呼
2020-01-12,7390,289,274,563,暖暖,招呼
2020-01-13,7390,457,431,888,暖暖,招呼
2020-01-14,7390,479,461,940,暖暖,招呼
2020-01-15,7390,332,419,751,暖暖,招呼
2020-01-16,7390,444,464,908,暖暖,招呼
2020-01-17,7390,411,425,836,暖暖,招呼
2020-01-18,7390,343,359,702,暖暖,招呼
2020-01-19,7390,293,288,581,暖暖,招呼
2020-01-20,7390,394,393,787,暖暖,招呼
2020-01-21,7390,420,424,844,暖暖,招呼
2020-01-22,7390,405,396,801,暖暖,招呼
2020-01-23,7390,277,308,585,暖暖,招呼
2020-01-24,7390,214,239,453,暖暖,招呼
2020-01-25,7390,283,288,571,暖暖,招呼
2020-01-26,7390,244,275,519,暖暖,招呼
2020-01-27,7390,282,305,587,暖暖,招呼
2020-01-28,7390,280,268,548,暖暖,招呼
2020-01-29,7390,293,265,558,暖暖,招呼
2020-01-30,7390,363,376,739,暖暖,招呼
2020-01-31,7390,407,388,795,暖暖,招呼
2020-02-01,7390,262,279,541,暖暖,招呼
2020-02-02,7390,266,280,546,暖暖,招呼
2020-02-03,7390,380,416,796,暖暖,招呼
2020-02-04,7390,376,345,721,暖暖,招呼
2020-02-05,7390,394,385,779,暖暖,招呼
2020-02-06,7390,414,386,800,暖暖,招呼
2020-02-07,7390,402,381,783,暖暖,招呼
2020-02-08,7390,245,292,537,暖暖,招呼
2020-02-09,7390,237,237,474,暖暖,招呼
2020-02-10,7390,404,374,778,暖暖,招呼
2020-02-11,7390,375,383,758,暖暖,招呼
2020-02-12,7390,427,433,860,暖暖,招呼
2020-02-13,7390,369,374,743,暖暖,招呼
2020-02-14,7390,419,394,813,暖暖,招呼
2020-02-15,7390,317,348,665,暖暖,招呼
2020-02-16,7390,215,207,422,暖暖,招呼
2020-02-17,7390,347,369,716,暖暖,招呼
2020-02-18,7390,388,395,783,暖暖,招呼
2020-02-19,7390,380,397,777,暖暖,招呼
2020-02-20,7390,388,382,770,暖暖,招呼
2020-02-21,7390,422,431,853,暖暖,招呼
2020-02-22,7390,291,290,581,暖暖,招呼
2020-02-23,7390,231,226,457,暖暖,招呼
2020-02-24,7390,377,376,753,暖暖,招呼
2020-02-25,7390,402,410,812,暖暖,招呼
2020-02-26,7390,417,441,858,暖暖,招呼
2020-02-27,7390,413,414,827,暖暖,招呼
2020-02-28,7390,296,338,634,暖暖,招呼
2020-02-29,7390,264,305,569,暖暖,招呼
2020-03-01,7390,247,208,455,暖暖,招呼
2020-03-02,7390,398,402,800,暖暖,招呼
2020-03-03,7390,380,397,777,暖暖,招呼
2020-03-04,7390,384,365,749,暖暖,招呼
2020-03-05,7390,364,359,723,暖暖,招呼
2020-03-06,7390,406,436,842,暖暖,招呼
2020-03-07,7390,318,327,645,暖暖,招呼
2020-03-08,7390,279,226,505,暖暖,招呼
2020-03-09,7390,417,432,849,暖暖,招呼
2020-03-10,7390,366,392,758,暖暖,招呼
2020-03-11,7390,423,436,859,暖暖,招呼
2020-03-12,7390,398,410,808,暖暖,招呼
2020-03-13,7390,395,428,823,暖暖,招呼
2020-03-14,7390,250,320,570,暖暖,招呼
2020-03-15,7390,273,267,540,暖暖,招呼
2020-03-16,7390,414,396,810,暖暖,招呼
2020-03-17,7390,416,406,822,暖暖,招呼
2020-03-18,7390,402,395,797,暖暖,招呼
2020-03-19,7390,348,388,736,暖暖,招呼
2020-03-20,7390,381,421,802,暖暖,招呼
2020-03-21,7390,272,320,592,暖暖,招呼
2020-03-22,7390,202,194,396,暖暖,招呼
2020-03-23,7390,375,383,758,暖暖,招呼
2020-03-24,7390,234,399,633,暖暖,招呼
2020-03-25,7390,370,394,764,暖暖,招呼
2020-03-26,7390,382,367,749,暖暖,招呼
2020-03-27,7390,347,402,749,暖暖,招呼
2020-03-28,7390,212,235,447,暖暖,招呼
2020-03-29,7390,232,221,453,暖暖,招呼
2020-03-30,7390,356,371,727,暖暖,招呼
2020-03-31,7390,369,396,765,暖暖,招呼
2020-04-01,7390,354,399,753,暖暖,招呼
2020-04-02,7390,227,272,499,暖暖,招呼
2020-04-03,7390,228,257,485,暖暖,招呼
2020-04-04,7390,163,221,384,暖暖,招呼
2020-04-05,7390,193,159,352,暖暖,招呼
2020-04-06,7390,386,405,791,暖暖,招呼
2020-04-07,7390,382,386,768,暖暖,招呼
2020-04-08,7390,351,401,752,暖暖,招呼
2020-04-09,7390,359,365,724,暖暖,招呼
2020-04-10,7390,379,459,838,暖暖,招呼
2020-04-11,7390,233,249,482,暖暖,招呼
2020-04-12,7390,182,206,388,暖暖,招呼
2020-04-13,7390,374,385,759,暖暖,招呼
2020-04-14,7390,383,405,788,暖暖,招呼
2020-04-15,7390,383,390,773,暖暖,招呼
2020-04-16,7390,372,381,753,暖暖,招呼
2020-04-17,7390,396,453,849,暖暖,招呼
2020-04-18,7390,309,337,646,暖暖,招呼
2020-04-19,7390,235,218,453,暖暖,招呼
2020-04-20,7390,410,401,811,暖暖,招呼
2020-04-21,7390,357,389,746,暖暖,招呼
2020-04-22,7390,377,392,769,暖暖,招呼
2020-04-23,7390,381,407,788,暖暖,招呼
2020-04-24,7390,375,402,777,暖暖,招呼
2020-04-25,7390,258,296,554,暖暖,招呼
2020-04-26,7390,185,171,356,暖暖,招呼
2020-04-27,7390,377,414,791,暖暖,招呼
2020-04-28,7390,414,443,857,暖暖,招呼
2020-04-29,7390,403,452,855,暖暖,招呼
2020-04-30,7390,414,431,845,暖暖,招呼
2020-05-01,7390,363,470,833,暖暖,招呼
2020-05-02,7390,244,292,536,暖暖,招呼
2020-05-03,7390,242,231,473,暖暖,招呼
2020-05-04,7390,392,417,809,暖暖,招呼
2020-05-05,7390,401,408,809,暖暖,招呼
2020-05-06,7390,392,413,805,暖暖,招呼
2020-05-07,7390,393,392,785,暖暖,招呼
2020-05-08,7390,392,482,874,暖暖,招呼
2020-05-09,7390,262,326,588,暖暖,招呼
2020-05-10,7390,260,253,513,暖暖,招呼
2020-05-11,7390,385,395,780,暖暖,招呼
2020-05-12,7390,409,446,855,暖暖,招呼
2020-05-13,7390,395,405,800,暖暖,招呼
2020-05-14,7390,434,421,855,暖暖,招呼
2020-05-15,7390,388,428,816,暖暖,招呼
2020-05-16,7390,237,307,544,暖暖,招呼
2020-05-17,7390,213,250,463,暖暖,招呼
2020-05-18,7390,387,432,819,暖暖,招呼
2020-05-19,7390,374,409,783,暖暖,招呼
2020-05-20,7390,414,451,865,暖暖,招呼
2020-05-21,7390,413,416,829,暖暖,招呼
2020-05-22,7390,391,432,823,暖暖,招呼
2020-05-23,7390,237,289,526,暖暖,招呼
2020-05-24,7390,260,290,550,暖暖,招呼
2020-05-25,7390,397,403,800,暖暖,招呼
2020-05-26,7390,401,437,838,暖暖,招呼
2020-05-27,7390,390,423,813,暖暖,招呼
2020-05-28,7390,404,437,841,暖暖,招呼
2020-05-29,7390,425,477,902,暖暖,招呼
2020-05-30,7390,322,361,683,暖暖,招呼
2020-05-31,7390,284,302,586,暖暖,招呼
2020-06-01,7390,439,448,887,暖暖,招呼
2020-06-02,7390,418,433,851,暖暖,招呼
2020-06-03,7390,409,447,856,暖暖,招呼
2020-06-04,7390,421,434,855,暖暖,招呼
2020-06-05,7390,429,436,865,暖暖,招呼
2020-06-06,7390,265,340,605,暖暖,招呼
2020-06-07,7390,261,266,527,暖暖,招呼
2020-06-08,7390,406,430,836,暖暖,招呼
2020-06-09,7390,462,430,892,暖暖,招呼
2020-06-10,7390,435,447,882,暖暖,招呼
2020-06-11,7390,453,485,938,暖暖,招呼
2020-06-12,7390,462,505,967,暖暖,招呼
2020-06-13,7390,365,404,769,暖暖,招呼
2020-06-14,7390,318,398,716,暖暖,招呼
2020-06-15,7390,411,413,824,暖暖,招呼
2020-06-16,7390,409,435,844,暖暖,招呼
2020-06-17,7390,401,461,862,暖暖,招呼
2020-06-18,7390,440,436,876,暖暖,招呼
2020-06-19,7390,430,436,866,暖暖,招呼
2020-06-20,7390,335,384,719,暖暖,招呼
2020-06-21,7390,301,311,612,暖暖,招呼
2020-06-22,7390,421,445,866,暖暖,招呼
2020-06-23,7390,443,444,887,暖暖,招呼
2020-06-24,7390,408,409,817,暖暖,招呼
2020-06-25,7390,240,299,539,暖暖,招呼
2020-06-26,7390,346,363,709,暖暖,招呼
2020-06-27,7390,311,347,658,暖暖,招呼
2020-06-28,7390,237,247,484,暖暖,招呼
2020-06-29,7390,410,440,850,暖暖,招呼
2020-06-30,7390,414,404,818,暖暖,招呼
2020-07-01,7390,406,400,806,暖暖,招呼
2020-07-02,7390,408,371,779,暖暖,招呼
2020-07-03,7390,455,464,919,暖暖,招呼
2020-07-04,7390,281,301,582,暖暖,招呼
2020-07-05,7390,228,296,524,暖暖,招呼
2020-07-06,7390,413,395,808,暖暖,招呼
2020-07-07,7390,374,400,774,暖暖,招呼
2020-07-08,7390,403,398,801,暖暖,招呼
2020-07-09,7390,410,429,839,暖暖,招呼
2020-07-10,7390,433,437,870,暖暖,招呼
2020-07-11,7390,269,308,577,暖暖,招呼
2020-07-12,7390,212,270,482,暖暖,招呼
2020-07-13,7390,404,444,848,暖暖,招呼
2020-07-14,7390,431,414,845,暖暖,招呼
2020-07-15,7390,394,400,794,暖暖,招呼
2020-07-16,7390,398,402,800,暖暖,招呼
2020-07-17,7390,405,440,845,暖暖,招呼
2020-07-18,7390,328,370,698,暖暖,招呼
2020-07-19,7390,268,304,572,暖暖,招呼
2020-07-20,7390,412,455,867,暖暖,招呼
2020-07-21,7390,412,388,800,暖暖,招呼
2020-07-22,7390,366,385,751,暖暖,招呼
2020-07-23,7390,400,395,795,暖暖,招呼
2020-07-24,7390,434,439,873,暖暖,招呼
2020-07-25,7390,291,303,594,暖暖,招呼
2020-07-26,7390,254,290,544,暖暖,招呼
2020-07-27,7390,421,450,871,暖暖,招呼
2020-07-28,7390,407,432,839,暖暖,招呼
2020-07-29,7390,371,476,847,暖暖,招呼
2020-07-30,7390,409,430,839,暖暖,招呼
2020-07-31,7390,435,420,855,暖暖,招呼
2020-08-01,7390,362,392,754,暖暖,招呼
2020-08-02,7390,270,315,585,暖暖,招呼
2020-08-03,7390,349,384,733,暖暖,招呼
2020-08-04,7390,399,396,795,暖暖,招呼
2020-08-05,7390,399,406,805,暖暖,招呼
2020-08-06,7390,415,397,812,暖暖,招呼
2020-08-07,7390,390,410,800,暖暖,招呼
2020-08-08,7390,301,355,656,暖暖,招呼
2020-08-09,7390,280,303,583,暖暖,招呼
2020-08-10,7390,410,448,858,暖暖,招呼
2020-08-11,7390,414,424,838,暖暖,招呼
2020-08-12,7390,418,436,854,暖暖,招呼
2020-08-13,7390,413,456,869,暖暖,招呼
2020-08-14,7390,431,417,848,暖暖,招呼
2020-08-15,7390,314,383,697,暖暖,招呼
2020-08-16,7390,371,371,742,暖暖,招呼
2020-08-17,7390,411,448,859,暖暖,招呼
2020-08-18,7390,422,453,875,暖暖,招呼
2020-08-19,7390,376,403,779,暖暖,招呼
2020-08-20,7390,418,433,851,暖暖,招呼
2020-08-21,7390,431,495,926,暖暖,招呼
2020-08-22,7390,319,399,718,暖暖,招呼
2020-08-23,7390,244,275,519,暖暖,招呼
2020-08-24,7390,385,415,800,暖暖,招呼
2020-08-25,7390,414,437,851,暖暖,招呼
2020-08-26,7390,390,418,808,暖暖,招呼
2020-08-27,7390,422,430,852,暖暖,招呼
2020-08-28,7390,407,458,865,暖暖,招呼
2020-08-29,7390,341,382,723,暖暖,招呼
2020-08-30,7390,227,282,509,暖暖,招呼
2020-08-31,7390,413,410,823,暖暖,招呼
2020-09-01,7390,408,418,826,暖暖,招呼
2020-09-02,7390,426,417,843,暖暖,招呼
2020-09-03,7390,400,430,830,暖暖,招呼
2020-09-04,7390,420,423,843,暖暖,招呼
2020-09-05,7390,329,310,639,暖暖,招呼
2020-09-06,7390,253,327,580,暖暖,招呼
2020-09-07,7390,442,485,927,暖暖,招呼
2020-09-08,7390,407,424,831,暖暖,招呼
2020-09-09,7390,422,502,924,暖暖,招呼
2020-09-10,7390,411,460,871,暖暖,招呼
2020-09-11,7390,450,435,885,暖暖,招呼
2020-09-12,7390,309,348,657,暖暖,招呼
2020-09-13,7390,228,230,458,暖暖,招呼
2020-09-14,7390,432,435,867,暖暖,招呼
2020-09-15,7390,430,472,902,暖暖,招呼
2020-09-16,7390,448,485,933,暖暖,招呼
2020-09-17,7390,417,442,859,暖暖,招呼
2020-09-18,7390,454,468,922,暖暖,招呼
2020-09-19,7390,351,359,710,暖暖,招呼
2020-09-20,7390,198,220,418,暖暖,招呼
2020-09-21,7390,426,424,850,暖暖,招呼
2020-09-22,7390,448,462,910,暖暖,招呼
2020-09-23,7390,451,461,912,暖暖,招呼
2020-09-24,7390,420,424,844,暖暖,招呼
2020-09-25,7390,420,430,850,暖暖,招呼
2020-09-26,7390,363,395,758,暖暖,招呼
2020-09-27,7390,223,257,480,暖暖,招呼
2020-09-28,7390,438,447,885,暖暖,招呼
2020-09-29,7390,461,475,936,暖暖,招呼
2020-09-30,7390,400,517,917,暖暖,招呼
2020-10-01,7390,329,390,719,暖暖,招呼
2020-10-02,7390,390,435,825,暖暖,招呼
2020-10-03,7390,360,432,792,暖暖,招呼
2020-10-04,7390,285,270,555,暖暖,招呼
2020-10-05,7390,428,468,896,暖暖,招呼
2020-10-06,7390,436,442,878,暖暖,招呼
2020-10-07,7390,458,485,943,暖暖,招呼
2020-10-08,7390,426,496,922,暖暖,招呼
2020-10-09,7390,333,442,775,暖暖,招呼
2020-10-10,7390,262,308,570,暖暖,招呼
2020-10-11,7390,248,255,503,暖暖,招呼
2020-10-12,7390,459,481,940,暖暖,招呼
2020-10-13,7390,467,482,949,暖暖,招呼
2020-10-14,7390,452,478,930,暖暖,招呼
2020-10-15,7390,429,469,898,暖暖,招呼
2020-10-16,7390,459,476,935,暖暖,招呼
2020-10-17,7390,326,369,695,暖暖,招呼
2020-10-18,7390,237,250,487,暖暖,招呼
2020-10-19,7390,444,471,915,暖暖,招呼
2020-10-20,7390,475,493,968,暖暖,招呼
2020-10-21,7390,439,468,907,暖暖,招呼
2020-10-22,7390,406,453,859,暖暖,招呼
2020-10-23,7390,434,526,960,暖暖,招呼
2020-10-24,7390,387,393,780,暖暖,招呼
2020-10-25,7390,274,319,593,暖暖,招呼
2020-10-26,7390,470,503,973,暖暖,招呼
2020-10-27,7390,470,497,967,暖暖,招呼
2020-10-28,7390,447,493,940,暖暖,招呼
2020-10-29,7390,461,493,954,暖暖,招呼
2020-10-30,7390,488,554,1042,暖暖,招呼
2020-10-31,7390,390,500,890,暖暖,招呼
2020-11-01,7390,312,339,651,暖暖,招呼
2020-11-02,7390,461,527,988,暖暖,招呼
2020-11-03,7390,459,461,920,暖暖,招呼
2020-11-04,7390,471,477,948,暖暖,招呼
2020-11-05,7390,458,455,913,暖暖,招呼
2020-11-06,7390,474,466,940,暖暖,招呼
2020-11-07,7390,350,405,755,暖暖,招呼
2020-11-08,7390,245,245,490,暖暖,招呼
2020-11-09,7390,475,504,979,暖暖,招呼
2020-11-10,7390,424,487,911,暖暖,招呼
2020-11-11,7390,502,495,997,暖暖,招呼
2020-11-12,7390,441,492,933,暖暖,招呼
2020-11-13,7390,473,576,1049,暖暖,招呼
2020-11-14,7390,350,382,732,暖暖,招呼
2020-11-15,7390,391,404,795,暖暖,招呼
2020-11-16,7390,500,547,1047,暖暖,招呼
2020-11-17,7390,469,545,1014,暖暖,招呼
2020-11-18,7390,519,568,1087,暖暖,招呼
2020-11-19,7390,477,540,1017,暖暖,招呼
2020-11-20,7390,478,538,1016,暖暖,招呼
2020-11-21,7390,330,366,696,暖暖,招呼
2020-11-22,7390,312,355,667,暖暖,招呼
2020-11-23,7390,486,510,996,暖暖,招呼
2020-11-24,7390,458,479,937,暖暖,招呼
2020-11-25,7390,469,509,978,暖暖,招呼
2020-11-26,7390,457,503,960,暖暖,招呼
2020-11-27,7390,455,504,959,暖暖,招呼
2020-11-28,7390,362,385,747,暖暖,招呼
2020-11-29,7390,247,240,487,暖暖,招呼
2020-11-30,7390,444,464,908,暖暖,招呼
2020-12-01,7390,434,459,893,暖暖,招呼
2020-12-02,7390,369,445,814,暖暖,招呼
2020-12-03,7390,418,471,889,暖暖,招呼
2020-12-04,7390,281,402,683,暖暖,招呼
2020-12-05,7390,163,272,435,暖暖,招呼
2020-12-06,7390,144,233,377,暖暖,招呼
2020-12-07,7390,303,455,758,暖暖,招呼
2020-12-08,7390,355,435,790,暖暖,招呼
2020-12-09,7390,333,450,783,暖暖,招呼
2020-12-10,7390,340,422,762,暖暖,招呼
2020-12-11,7390,391,516,907,暖暖,招呼
2020-12-12,7390,290,356,646,暖暖,招呼
2020-12-13,7390,255,322,577,暖暖,招呼
2020-12-14,7390,368,462,830,暖暖,招呼
2020-12-15,7390,367,433,800,暖暖,招呼
2020-12-16,7390,339,466,805,暖暖,招呼
2020-12-17,7390,369,475,844,暖暖,招呼
2020-12-18,7390,376,500,876,暖暖,招呼
2020-12-19,7390,245,365,610,暖暖,招呼
2020-12-20,7390,201,240,441,暖暖,招呼
2020-12-21,7390,366,426,792,暖暖,招呼
2020-12-22,7390,400,463,863,暖暖,招呼
2020-12-23,7390,371,450,821,暖暖,招呼
2020-12-24,7390,375,478,853,暖暖,招呼
2020-12-25,7390,405,554,959,暖暖,招呼
2020-12-26,7390,303,405,708,暖暖,招呼
2020-12-27,7390,302,378,680,暖暖,招呼
2020-12-28,7390,419,477,896,暖暖,招呼
2020-12-29,7390,410,475,885,暖暖,招呼
2020-12-30,7390,381,452,833,暖暖,招呼
2020-12-31,7390,377,444,821,暖暖,招呼
